Player,Pos,Age,Tm,G,GS,MP,FG,FGA,FG%,3P,3PA,3P%,2P,2PA,2P%,eFG%,FT,FTA,FT%,ORB,DRB,TRB,AST,STL,BLK,TOV,PF,PTS,Yr
A.J. Hammons,C,24,DAL,22,0,163,17,42,0.405,5,10,0.5,12,32,0.375,0.464,9,20,0.45,8,28,36,4,1,13,10,21,48,2017
Aaron Brooks,PG,32,IND,65,0,894,121,300,0.403,48,128,0.375,73,172,0.424,0.483,32,40,0.8,18,51,69,125,25,9,66,93,322,2017
Aaron Harrison,SG,22,CHO,5,0,17,0,4,0.0,0,2,0.0,0,2,0.0,0.0,1,2,0.5,0,3,3,3,0,0,0,2,1,2017
Adreian Payne,PF,25,MIN,18,0,135,23,54,0.426,3,15,0.2,20,39,0.513,0.454,14,19,0.737,9,24,33,7,8,7,8,32,63,2017
Alan Anderson,SF,34,LAC,30,0,308,30,80,0.375,14,44,0.318,16,36,0.444,0.463,12,16,0.75,3,21,24,11,3,0,7,35,86,2017
Alan Williams,C,24,PHO,47,0,708,138,267,0.517,0,1,0.0,138,266,0.519,0.517,70,112,0.625,94,198,292,23,27,32,37,125,346,2017
Alec Burks,SG,25,UTA,42,0,653,99,248,0.399,25,76,0.329,74,172,0.43,0.45,60,78,0.769,17,103,120,30,18,5,35,50,283,2017
Alex Poythress,PF,23,PHI,6,1,157,25,54,0.463,6,19,0.316,19,35,0.543,0.519,8,10,0.8,11,18,29,5,3,2,3,14,64,2017
Alexis Ajinca,C,28,NOP,39,15,584,89,178,0.5,0,4,0.0,89,174,0.511,0.5,29,40,0.725,46,131,177,12,20,22,31,77,207,2017
Allen Crabbe,SG,24,POR,79,7,2254,303,647,0.468,134,302,0.444,169,345,0.49,0.572,105,124,0.847,19,206,225,93,54,20,62,171,845,2017
Alonzo Gee,SF,29,DEN,13,0,89,3,14,0.214,0,3,0.0,3,11,0.273,0.214,5,9,0.556,4,11,15,6,5,1,4,14,11,2017
Amir Johnson,PF,29,BOS,80,77,1608,213,370,0.576,27,66,0.409,186,304,0.612,0.612,67,100,0.67,117,248,365,140,52,62,77,211,520,2017
Andre Roberson,SF,25,OKC,79,79,2376,215,463,0.464,45,184,0.245,170,279,0.609,0.513,47,111,0.423,98,304,402,79,94,79,51,204,522,2017
Andrew Harrison,PG,22,MEM,72,18,1474,117,360,0.325,43,156,0.276,74,204,0.363,0.385,148,194,0.763,23,113,136,198,54,20,85,194,425,2017
Anthony Bennett,PF,23,BRK,23,1,264,38,92,0.413,13,48,0.271,25,44,0.568,0.484,26,36,0.722,25,53,78,12,5,3,12,18,115,2017
Anthony Brown,SF,24,TOT,11,0,159,18,50,0.36,7,27,0.259,11,23,0.478,0.43,0,0,0.0,8,25,33,8,5,1,6,15,43,2017
Anthony Tolliver,PF,31,SAC,65,9,1477,155,351,0.442,90,230,0.391,65,121,0.537,0.57,61,82,0.744,51,188,239,77,33,20,56,109,461,2017
Archie Goodwin,SG,22,TOT,15,0,214,36,66,0.545,5,15,0.333,31,51,0.608,0.583,33,42,0.786,7,21,28,24,4,5,14,8,110,2017
Arinze Onuaku,C,29,ORL,8,0,28,2,4,0.5,0,0,0.0,2,4,0.5,0.5,0,0,0.0,2,4,6,2,0,1,2,3,4,2017
Aron Baynes,C,30,DET,75,2,1163,143,279,0.513,0,0,0.0,143,279,0.513,0.513,79,94,0.84,111,222,333,32,17,39,50,166,365,2017
Avery Bradley,SG,26,BOS,55,55,1835,359,775,0.463,108,277,0.39,251,498,0.504,0.533,68,93,0.731,65,269,334,121,68,11,88,141,894,2017
Axel Toupane,SF,24,TOT,4,0,47,5,9,0.556,1,4,0.25,4,5,0.8,0.611,0,0,0.0,0,1,1,0,1,1,0,6,11,2017
Ben Bentil,PF,21,DAL,3,0,10,0,3,0.0,0,1,0.0,0,2,0.0,0.0,0,0,0.0,0,2,2,0,0,0,1,1,0,2017
Boban Marjanovic,C,28,DET,35,0,293,72,132,0.545,0,0,0.0,72,132,0.545,0.545,47,58,0.81,46,84,130,9,6,12,10,25,191,2017
Bobby Portis,PF,21,CHI,64,13,1000,183,375,0.488,32,96,0.333,151,279,0.541,0.531,39,59,0.661,75,221,296,35,16,11,37,94,437,2017
Brandon Bass,PF,31,LAC,52,0,577,107,186,0.575,1,3,0.333,106,183,0.579,0.578,77,88,0.875,43,86,129,21,14,11,29,45,292,2017
Brandon Jennings,PG,27,TOT,81,13,1802,192,535,0.359,79,252,0.313,113,283,0.399,0.433,114,152,0.75,29,167,196,395,70,5,128,116,577,2017
Briante Weber,PG,24,TOT,20,0,205,25,60,0.417,1,10,0.1,24,50,0.48,0.425,11,16,0.688,8,18,26,21,12,1,8,16,62,2017
Brice Johnson,PF,22,LAC,3,0,9,2,7,0.286,0,0,0.0,2,7,0.286,0.286,0,0,0.0,1,2,3,1,2,1,1,0,4,2017
Bruno Caboclo,SF,21,TOR,9,0,40,6,16,0.375,2,6,0.333,4,10,0.4,0.438,0,0,0.0,5,5,10,4,2,1,2,4,14,2017
Bryn Forbes,SG,23,SAS,36,0,285,36,99,0.364,17,53,0.321,19,46,0.413,0.449,5,6,0.833,2,21,23,23,1,0,11,20,94,2017
C.J. McCollum,SG,25,POR,80,80,2796,692,1441,0.48,185,440,0.42,507,1001,0.506,0.544,268,294,0.912,60,231,291,285,72,42,172,202,1837,2017
C.J. Miles,SF,29,IND,76,29,1776,281,647,0.434,169,409,0.413,112,238,0.471,0.565,84,93,0.903,30,199,229,48,46,25,40,151,815,2017
C.J. Watson,PG,32,ORL,62,9,1012,96,248,0.387,32,105,0.305,64,143,0.448,0.452,57,66,0.864,16,73,89,114,43,2,47,84,281,2017
C.J. Wilcox,SG,26,ORL,22,0,108,8,31,0.258,3,15,0.2,5,16,0.313,0.306,2,2,1.0,4,8,12,12,2,1,6,8,21,2017
Cameron Payne,PG,22,TOT,31,0,462,64,193,0.332,27,86,0.314,37,107,0.346,0.402,5,8,0.625,3,45,48,55,14,5,29,52,160,2017
Chasson Randle,PG,23,TOT,26,0,299,40,98,0.408,16,47,0.34,24,51,0.471,0.49,41,43,0.953,6,26,32,34,9,2,19,39,137,2017
Cheick Diallo,PF,20,NOP,17,0,199,36,76,0.474,0,0,0.0,36,76,0.474,0.474,15,21,0.714,23,50,73,4,4,7,7,17,87,2017
Chinanu Onuaku,C,20,HOU,5,1,52,5,7,0.714,0,0,0.0,5,7,0.714,0.714,4,4,1.0,2,8,10,3,3,1,4,6,14,2017
Chris Andersen,C,38,CLE,12,0,114,9,22,0.409,0,3,0.0,9,19,0.474,0.409,10,14,0.714,9,22,31,5,5,7,5,20,28,2017
Chris McCullough,PF,21,TOT,16,0,80,16,32,0.5,1,7,0.143,15,25,0.6,0.516,3,5,0.6,9,10,19,2,2,2,3,7,36,2017
Christian Wood,PF,21,CHO,13,0,107,12,23,0.522,0,5,0.0,12,18,0.667,0.522,11,15,0.733,14,15,29,2,3,6,7,11,35,2017
Clint Capela,C,22,HOU,65,59,1551,362,563,0.643,0,0,0.0,362,563,0.643,0.643,94,177,0.531,178,348,526,64,34,80,87,179,818,2017
Cole Aldrich,C,28,MIN,62,0,531,45,86,0.523,0,0,0.0,45,86,0.523,0.523,15,22,0.682,51,107,158,25,25,23,17,85,105,2017
Cory Joseph,SG,25,TOR,80,22,2003,299,661,0.452,48,135,0.356,251,526,0.477,0.489,94,122,0.77,51,184,235,265,66,13,108,140,740,2017
Cristiano Felicio,C,24,CHI,66,0,1040,128,222,0.577,0,0,0.0,128,222,0.577,0.577,60,93,0.645,124,187,311,40,25,16,33,110,316,2017
Dahntay Jones,SF,36,CLE,1,0,12,3,8,0.375,0,2,0.0,3,6,0.5,0.375,3,4,0.75,1,1,2,1,0,0,1,1,9,2017
Damian Jones,C,21,GSW,10,0,85,8,16,0.5,0,0,0.0,8,16,0.5,0.5,3,10,0.3,9,14,23,0,1,4,6,15,19,2017
Danny Green,SG,29,SAS,68,68,1807,176,449,0.392,118,311,0.379,58,138,0.42,0.523,27,32,0.844,31,193,224,124,71,58,76,120,497,2017
Danuel House,SG,23,WAS,1,0,1,0,0,0.0,0,0,0.0,0,0,0.0,0.0,0,0,0.0,0,1,1,0,0,0,0,0,0,2017
Darrun Hilliard,SG,23,DET,39,1,381,47,126,0.373,12,46,0.261,35,80,0.438,0.421,21,28,0.75,2,31,33,33,11,2,28,39,127,2017
David Nwaba,SG,24,LAL,20,2,397,47,81,0.58,1,5,0.2,46,76,0.605,0.586,25,39,0.641,16,46,62,14,13,7,11,36,120,2017
Davis Bertans,PF,24,SAS,67,6,808,103,234,0.44,69,173,0.399,34,61,0.557,0.588,28,34,0.824,22,77,99,46,20,28,32,75,303,2017
DeAndre Liggins,SG,28,TOT,62,19,777,55,142,0.387,17,46,0.37,38,96,0.396,0.447,25,40,0.625,20,88,108,54,47,14,42,81,152,2017
DeAndre' Bembry,SF,22,ATL,38,1,371,47,98,0.48,1,18,0.056,46,80,0.575,0.485,6,16,0.375,14,45,59,28,8,5,16,21,101,2017
DeMarre Carroll,SF,30,TOR,72,72,1882,220,549,0.401,109,320,0.341,111,229,0.485,0.5,89,117,0.761,63,212,275,74,81,27,54,143,638,2017
Dejounte Murray,PG,20,SAS,38,8,322,50,116,0.431,9,23,0.391,41,93,0.441,0.47,21,30,0.7,6,36,42,48,8,6,38,29,130,2017
Delon Wright,PG,24,TOR,27,0,446,49,116,0.422,10,30,0.333,39,86,0.453,0.466,42,55,0.764,16,32,48,57,27,11,25,31,150,2017
Demetrius Jackson,PG,22,BOS,5,0,17,3,4,0.75,1,1,1.0,2,3,0.667,0.875,3,6,0.5,2,2,4,3,0,0,0,0,10,2017
Denzel Valentine,SG,23,CHI,57,0,976,102,288,0.354,73,208,0.351,29,80,0.363,0.481,14,18,0.778,11,140,151,63,30,7,49,86,291,2017
Dewayne Dedmon,C,27,SAS,76,37,1330,161,259,0.622,0,0,0.0,161,259,0.622,0.622,65,93,0.699,129,366,495,44,37,61,61,180,387,2017
Deyonta Davis,C,20,MEM,36,0,238,24,47,0.511,0,0,0.0,24,47,0.511,0.511,10,18,0.556,20,40,60,2,3,17,8,40,58,2017
Diamond Stone,C,19,LAC,7,0,24,3,13,0.231,0,0,0.0,3,13,0.231,0.231,4,4,1.0,1,5,6,0,0,1,2,5,10,2017
Donatas Motiejunas,PF,26,NOP,34,0,479,57,138,0.413,11,47,0.234,46,91,0.505,0.453,25,49,0.51,26,75,101,34,18,11,31,55,150,2017
Dwight Powell,C,25,DAL,77,3,1333,194,377,0.515,21,74,0.284,173,303,0.571,0.542,107,141,0.759,93,213,306,49,61,39,34,135,516,2017
Ed Davis,PF,27,POR,46,12,789,75,142,0.528,0,0,0.0,75,142,0.528,0.528,50,81,0.617,96,147,243,27,15,22,37,137,200,2017
Elijah Millsap,SG,29,PHO,2,0,23,1,7,0.143,0,2,0.0,1,5,0.2,0.143,1,2,0.5,3,3,6,1,0,0,2,2,3,2017
Eric Bledsoe,PG,27,PHO,66,66,2176,449,1034,0.434,104,310,0.335,345,724,0.477,0.485,388,458,0.847,52,268,320,418,92,31,223,164,1390,2017
Ersan Ilyasova,PF,29,TOT,82,52,2142,384,890,0.431,142,402,0.353,242,488,0.496,0.511,161,207,0.778,115,366,481,141,58,23,116,211,1071,2017
Fred VanVleet,PG,22,TOR,37,0,294,39,111,0.351,11,29,0.379,28,82,0.341,0.401,18,22,0.818,4,38,42,35,17,2,15,36,107,2017
Garrett Temple,SG,30,SAC,65,21,1728,183,432,0.424,82,220,0.373,101,212,0.476,0.519,58,74,0.784,32,151,183,169,84,28,78,141,506,2017
Gary Neal,SG,32,ATL,2,0,18,0,7,0.0,0,2,0.0,0,5,0.0,0.0,4,4,1.0,0,1,1,1,0,0,0,1,4,2017
Georges Niang,PF,23,IND,23,0,93,9,36,0.25,1,12,0.083,8,24,0.333,0.264,2,2,1.0,2,15,17,5,3,0,5,6,21,2017
Georgios Papagiannis,C,19,SAC,22,0,355,56,102,0.549,0,2,0.0,56,100,0.56,0.549,12,14,0.857,24,62,86,20,3,17,24,44,124,2017
Gerald Green,SF,31,BOS,47,0,538,95,232,0.409,39,111,0.351,56,121,0.463,0.494,33,41,0.805,17,68,85,33,9,7,25,48,262,2017
Glenn Robinson,SF,23,IND,69,27,1426,158,338,0.467,49,125,0.392,109,213,0.512,0.54,54,76,0.711,57,188,245,47,41,20,37,63,419,2017
Hassan Whiteside,C,27,MIA,77,77,2513,542,973,0.557,0,0,0.0,542,973,0.557,0.557,225,358,0.628,293,795,1088,57,56,161,154,226,1309,2017
Henry Ellenson,PF,20,DET,19,2,146,23,64,0.359,10,35,0.286,13,29,0.448,0.438,4,8,0.5,8,33,41,7,1,1,14,6,60,2017
Hollis Thompson,SG,25,TOT,40,9,752,77,200,0.385,32,95,0.337,45,105,0.429,0.465,19,29,0.655,19,92,111,35,20,6,11,69,205,2017
Ian Clark,SG,25,GSW,77,0,1137,211,433,0.487,61,163,0.374,150,270,0.556,0.558,44,58,0.759,22,100,122,90,39,8,55,77,527,2017
Ian Mahinmi,C,30,WAS,31,0,555,65,111,0.586,0,0,0.0,65,111,0.586,0.586,43,75,0.573,47,103,150,19,33,24,34,90,173,2017
Isaiah Canaan,SG,25,CHI,39,0,592,63,173,0.364,25,94,0.266,38,79,0.481,0.436,30,33,0.909,6,43,49,37,22,1,20,35,181,2017
Isaiah Taylor,PG,22,HOU,4,0,52,1,7,0.143,0,2,0.0,1,5,0.2,0.143,1,2,0.5,1,2,3,3,1,1,0,6,3,2017
Ivica Zubac,C,19,LAL,38,11,609,126,238,0.529,0,3,0.0,126,235,0.536,0.529,32,49,0.653,41,118,159,30,14,33,30,66,284,2017
JaMychal Green,PF,26,MEM,77,75,2101,250,500,0.5,55,145,0.379,195,355,0.549,0.555,134,167,0.802,167,377,544,84,46,34,94,248,689,2017
Jae Crowder,SF,26,BOS,72,72,2335,333,720,0.463,157,394,0.398,176,326,0.54,0.572,176,217,0.811,48,367,415,155,72,23,79,161,999,2017
Jake Layman,SF,22,POR,35,1,249,26,89,0.292,13,51,0.255,13,38,0.342,0.365,13,17,0.765,6,18,24,11,9,3,11,22,78,2017
Jakob Poeltl,C,21,TOR,54,4,626,67,115,0.583,0,0,0.0,67,115,0.583,0.583,31,57,0.544,78,87,165,12,17,20,29,113,165,2017
James Ennis,SF,26,MEM,64,28,1501,146,321,0.455,51,137,0.372,95,184,0.516,0.534,86,110,0.782,69,190,259,64,46,19,59,165,429,2017
James Johnson,PF,29,MIA,76,5,2085,368,769,0.479,87,256,0.34,281,513,0.548,0.535,152,215,0.707,66,309,375,276,76,86,171,197,975,2017
James Michael McAdoo,PF,24,GSW,52,2,457,62,117,0.53,2,8,0.25,60,109,0.55,0.538,21,42,0.5,34,56,90,17,18,29,19,47,147,2017
James Young,SG,21,BOS,29,0,220,25,58,0.431,12,35,0.343,13,23,0.565,0.534,6,9,0.667,6,20,26,4,10,2,4,15,68,2017
Jared Sullinger,PF,24,TOR,11,1,118,15,48,0.313,3,18,0.167,12,30,0.4,0.344,4,8,0.5,10,17,27,3,4,1,4,17,37,2017
Jarell Martin,PF,22,MEM,42,3,558,58,151,0.384,9,25,0.36,49,126,0.389,0.414,40,50,0.8,42,120,162,8,17,9,28,91,165,2017
Jarnell Stokes,C,23,DEN,2,0,7,1,1,1.0,0,0,0.0,1,1,1.0,1.0,1,2,0.5,1,1,2,2,1,0,0,3,3,2017
Jarrod Uthoff,PF,23,DAL,9,0,115,16,38,0.421,3,9,0.333,13,29,0.448,0.461,5,7,0.714,8,14,22,9,2,4,3,8,40,2017
Jason Smith,C,30,WAS,74,3,1068,174,329,0.529,37,78,0.474,137,251,0.546,0.585,35,51,0.686,64,194,258,37,21,55,58,168,420,2017
Jeremy Lamb,SG,24,CHO,62,5,1143,226,491,0.46,41,146,0.281,185,345,0.536,0.502,110,129,0.853,30,234,264,75,27,23,40,98,603,2017
Jeremy Lin,PG,28,BRK,36,33,883,175,400,0.438,58,156,0.372,117,244,0.48,0.51,115,141,0.816,11,124,135,184,41,14,86,79,523,2017
Jerian Grant,PG,24,CHI,63,28,1028,128,301,0.425,49,134,0.366,79,167,0.473,0.507,65,73,0.89,17,94,111,120,47,8,44,93,370,2017
Joe Harris,SG,25,BRK,52,11,1138,154,362,0.425,85,221,0.385,69,141,0.489,0.543,35,49,0.714,16,131,147,54,30,8,55,121,428,2017
Joe Young,PG,24,IND,33,0,135,26,72,0.361,5,23,0.217,21,49,0.429,0.396,11,15,0.733,1,16,17,15,4,0,5,5,68,2017
Joel Anthony,C,34,SAS,19,0,122,10,16,0.625,0,0,0.0,10,16,0.625,0.625,5,8,0.625,8,23,31,3,2,6,4,11,25,2017
Joel Bolomboy,PF,23,UTA,12,0,53,9,16,0.563,1,4,0.25,8,12,0.667,0.594,3,6,0.5,4,13,17,2,1,2,2,1,22,2017
John Jenkins,SG,25,PHO,4,0,13,2,5,0.4,1,2,0.5,1,3,0.333,0.5,2,2,1.0,0,1,1,1,0,0,0,0,7,2017
Jon Leuer,PF,27,DET,75,34,1944,310,646,0.48,49,167,0.293,261,479,0.545,0.518,98,113,0.867,102,300,402,111,31,26,66,145,767,2017
Jonathon Simmons,SG,27,SAS,78,8,1392,177,421,0.42,30,102,0.294,147,319,0.461,0.456,99,132,0.75,20,140,160,126,47,25,76,146,483,2017
Jordan Clarkson,SG,24,LAL,82,19,2397,477,1071,0.445,117,356,0.329,360,715,0.503,0.5,134,168,0.798,49,197,246,213,88,8,164,150,1205,2017
Jordan Crawford,SG,28,NOP,19,0,442,105,218,0.482,37,95,0.389,68,123,0.553,0.567,20,26,0.769,4,30,34,57,11,2,25,30,267,2017
Jordan Farmar,PG,30,SAC,2,0,35,4,12,0.333,4,9,0.444,0,3,0.0,0.5,0,0,0.0,1,2,3,9,2,0,3,1,12,2017
Jordan McRae,SG,25,CLE,37,4,384,58,150,0.387,18,51,0.353,40,99,0.404,0.447,27,34,0.794,6,34,40,19,8,6,14,31,161,2017
Jordan Mickey,PF,22,BOS,25,1,141,15,34,0.441,0,1,0.0,15,33,0.455,0.441,8,14,0.571,13,21,34,7,3,6,9,12,38,2017
Josh Huestis,PF,25,OKC,2,0,31,6,11,0.545,2,4,0.5,4,7,0.571,0.636,0,1,0.0,4,5,9,3,0,3,0,0,14,2017
Josh McRoberts,PF,29,MIA,22,14,381,44,118,0.373,13,31,0.419,31,87,0.356,0.428,6,9,0.667,23,51,74,50,10,4,23,31,107,2017
Josh Richardson,SG,23,MIA,53,34,1614,202,513,0.394,75,227,0.33,127,286,0.444,0.467,60,77,0.779,35,133,168,140,60,39,65,132,539,2017
Juan Hernangomez,PF,21,DEN,62,9,842,101,224,0.451,46,113,0.407,55,111,0.495,0.554,57,76,0.75,43,144,187,29,29,12,31,62,305,2017
Justin Anderson,SF,23,TOT,75,10,1228,186,439,0.424,58,194,0.299,128,245,0.522,0.49,102,129,0.791,69,176,245,66,41,23,66,109,532,2017
Justin Hamilton,C,26,BRK,64,7,1177,174,379,0.459,55,181,0.304,119,198,0.601,0.532,39,52,0.75,71,191,262,55,29,43,43,91,442,2017
Justin Harper,PF,27,PHI,3,0,31,5,12,0.417,2,7,0.286,3,5,0.6,0.5,0,0,0.0,2,3,5,2,0,0,4,2,12,2017
Justin Holiday,SG,27,NYK,82,4,1639,233,538,0.433,97,273,0.355,136,265,0.513,0.523,66,80,0.825,27,198,225,102,65,31,66,109,629,2017
Kay Felder,PG,21,CLE,42,0,386,62,158,0.392,7,22,0.318,55,136,0.404,0.415,35,49,0.714,3,38,41,58,18,7,31,38,166,2017
Kent Bazemore,SF,27,ATL,73,64,1963,295,721,0.409,92,266,0.346,203,455,0.446,0.473,119,168,0.708,45,186,231,177,91,52,125,165,801,2017
Kevon Looney,C,20,GSW,53,4,447,56,107,0.523,2,9,0.222,54,98,0.551,0.533,21,34,0.618,44,80,124,29,14,17,17,64,135,2017
Khris Middleton,SF,25,MIL,29,23,889,150,333,0.45,45,104,0.433,105,229,0.459,0.518,81,92,0.88,11,112,123,99,41,7,65,79,426,2017
Kosta Koufos,C,27,SAC,71,62,1419,216,392,0.551,0,1,0.0,216,391,0.552,0.551,38,62,0.613,118,285,403,47,36,48,61,172,470,2017
Kyle Anderson,SG,23,SAS,72,14,1020,93,209,0.445,15,40,0.375,78,169,0.462,0.481,45,57,0.789,33,175,208,91,51,26,39,63,246,2017
Kyle Wiltjer,PF,24,HOU,14,0,44,4,14,0.286,4,13,0.308,0,1,0.0,0.429,1,2,0.5,4,6,10,2,3,1,5,4,13,2017
Lamar Patterson,SG,25,ATL,5,0,40,3,15,0.2,1,6,0.167,2,9,0.222,0.233,2,3,0.667,1,6,7,6,1,0,4,6,9,2017
Lance Thomas,PF,28,NYK,46,15,968,97,244,0.398,38,85,0.447,59,159,0.371,0.475,43,51,0.843,32,110,142,35,21,5,25,85,275,2017
Langston Galloway,PG,25,TOT,74,2,1495,207,545,0.38,120,308,0.39,87,237,0.367,0.49,51,64,0.797,27,129,156,93,46,6,46,96,585,2017
Larry Sanders,C,28,CLE,5,0,13,1,4,0.25,0,0,0.0,1,4,0.25,0.25,2,2,1.0,3,1,4,0,1,1,2,5,4,2017
Lucas Nogueira,C,24,TOR,57,6,1088,103,156,0.66,3,12,0.25,100,144,0.694,0.67,44,67,0.657,82,161,243,42,52,90,46,137,253,2017
Luke Babbitt,SF,27,MIA,68,55,1065,113,281,0.402,87,210,0.414,26,71,0.366,0.557,11,15,0.733,13,129,142,36,21,11,25,118,324,2017
Malachi Richardson,SG,21,SAC,22,0,198,28,68,0.412,8,28,0.286,20,40,0.5,0.471,15,19,0.789,3,20,23,11,5,1,8,23,79,2017
Malik Beasley,SG,20,DEN,22,1,165,33,73,0.452,9,28,0.321,24,45,0.533,0.514,8,10,0.8,5,12,17,11,7,0,8,10,83,2017
Manny Harris,SG,27,DAL,4,0,25,3,15,0.2,0,2,0.0,3,13,0.231,0.2,2,4,0.5,3,6,9,2,0,0,2,1,8,2017
Marcin Gortat,C,32,WAS,82,82,2556,390,674,0.579,0,2,0.0,390,672,0.58,0.579,103,159,0.648,238,611,849,121,40,65,118,213,883,2017
Marcus Georges-Hunt,SG,22,ORL,5,0,48,2,7,0.286,1,2,0.5,1,5,0.2,0.357,9,10,0.9,1,8,9,3,1,0,2,5,14,2017
Marcus Morris,SF,27,DET,79,79,2565,421,1007,0.418,118,357,0.331,303,650,0.466,0.477,145,185,0.784,77,289,366,160,52,25,87,168,1105,2017
Marcus Smart,SG,22,BOS,79,24,2399,269,749,0.359,94,332,0.283,175,417,0.42,0.422,203,250,0.812,78,228,306,364,125,34,159,192,835,2017
Marcus Thornton,SG,29,WAS,33,1,575,84,210,0.4,28,80,0.35,56,130,0.431,0.467,23,27,0.852,22,54,76,41,19,3,25,48,219,2017
Marshall Plumlee,C,24,NYK,21,1,170,16,30,0.533,0,0,0.0,16,30,0.533,0.533,8,19,0.421,23,28,51,10,4,4,12,23,40,2017
Matt Barnes,SF,36,TOT,74,18,1777,185,473,0.391,87,263,0.331,98,210,0.467,0.483,70,89,0.787,70,317,387,194,48,26,107,185,527,2017
Maurice Ndour,PF,24,NYK,32,4,331,39,86,0.453,1,7,0.143,38,79,0.481,0.459,19,26,0.731,22,42,64,8,15,8,12,30,98,2017
Michael Gbinije,SG,24,DET,9,0,32,1,10,0.1,0,4,0.0,1,6,0.167,0.1,2,2,1.0,2,1,3,2,0,0,0,2,4,2017
Mike Muscala,C,25,ATL,70,3,1237,170,337,0.504,46,110,0.418,124,227,0.546,0.573,49,64,0.766,76,164,240,95,30,41,55,97,435,2017
Mike Scott,PF,28,ATL,18,0,195,17,59,0.288,4,27,0.148,13,32,0.406,0.322,7,8,0.875,10,27,37,17,4,3,8,12,45,2017
Mike Tobey,C,22,CHO,2,0,25,1,4,0.25,0,0,0.0,1,4,0.25,0.25,0,0,0.0,2,1,3,1,0,0,1,2,2,2017
Miles Plumlee,C,28,TOT,45,12,484,44,92,0.478,0,0,0.0,44,92,0.478,0.478,25,39,0.641,38,57,95,21,18,13,30,73,113,2017
Montrezl Harrell,C,23,HOU,58,14,1064,225,345,0.652,1,7,0.143,224,338,0.663,0.654,76,121,0.628,81,138,219,64,20,42,44,126,527,2017
Nicolas Brussino,SF,23,DAL,54,2,521,52,141,0.369,29,95,0.305,23,46,0.5,0.472,17,22,0.773,26,69,95,47,17,8,26,43,150,2017
Noah Vonleh,PF,21,POR,74,41,1265,130,270,0.481,7,20,0.35,123,250,0.492,0.494,60,94,0.638,131,256,387,31,30,27,64,154,327,2017
Norman Powell,SG,23,TOR,76,18,1368,227,506,0.449,56,173,0.324,171,333,0.514,0.504,126,159,0.792,26,142,168,82,51,14,70,127,636,2017
Okaro White,PF,24,MIA,35,0,471,33,87,0.379,12,34,0.353,21,53,0.396,0.448,20,22,0.909,25,57,82,21,10,10,18,52,98,2017
P.J. Tucker,SF,31,TOT,81,21,2236,199,482,0.413,70,196,0.357,129,286,0.451,0.485,72,93,0.774,117,355,472,99,116,19,66,196,540,2017
Pascal Siakam,PF,22,TOR,55,38,859,103,205,0.502,1,7,0.143,102,198,0.515,0.505,22,32,0.688,64,121,185,17,26,45,33,109,229,2017
Patricio Garino,SG,23,ORL,5,0,43,0,7,0.0,0,5,0.0,0,2,0.0,0.0,0,0,0.0,1,6,7,0,0,0,3,4,0,2017
Patrick Beverley,SG,28,HOU,67,67,2058,228,543,0.42,110,288,0.382,118,255,0.463,0.521,73,95,0.768,95,299,394,281,99,25,100,222,639,2017
Patrick McCaw,SG,21,GSW,71,20,1074,106,245,0.433,41,123,0.333,65,122,0.533,0.516,29,37,0.784,22,79,101,77,32,15,36,62,282,2017
Patrick Patterson,PF,27,TOR,65,8,1599,154,384,0.401,94,253,0.372,60,131,0.458,0.523,43,60,0.717,62,229,291,76,40,23,38,120,445,2017
Paul Zipser,SF,22,CHI,44,18,843,88,221,0.398,33,99,0.333,55,122,0.451,0.473,31,40,0.775,15,110,125,36,15,16,40,78,240,2017
Pierre Jackson,PG,25,DAL,8,1,84,13,39,0.333,3,11,0.273,10,28,0.357,0.372,6,7,0.857,1,8,9,19,2,0,3,5,35,2017
Quincy Acy,PF,26,TOT,38,1,558,70,170,0.412,37,90,0.411,33,80,0.413,0.521,45,60,0.75,20,95,115,18,14,15,21,67,222,2017
Quinn Cook,PG,23,TOT,14,0,188,33,66,0.5,11,26,0.423,22,40,0.55,0.583,2,5,0.4,1,6,7,26,4,0,13,13,79,2017
R.J. Hunter,SG,23,CHI,3,0,9,0,1,0.0,0,1,0.0,0,0,0.0,0.0,0,0,0.0,0,1,1,0,0,0,0,0,0,2017
Rakeem Christmas,PF,25,IND,29,0,219,19,43,0.442,0,0,0.0,19,43,0.442,0.442,21,29,0.724,26,30,56,4,3,6,8,37,59,2017
Ramon Sessions,PG,30,CHO,50,1,811,100,263,0.38,21,62,0.339,79,201,0.393,0.42,91,118,0.771,11,62,73,129,26,3,46,43,312,2017
Rashad Vaughn,SG,20,MIL,41,2,458,57,156,0.365,26,81,0.321,31,75,0.413,0.449,2,5,0.4,4,45,49,23,19,10,14,32,142,2017
Raul Neto,PG,24,UTA,40,0,346,41,91,0.451,10,31,0.323,31,60,0.517,0.505,8,9,0.889,4,26,30,34,21,5,15,48,100,2017
Reggie Bullock,SF,25,DET,31,5,467,54,128,0.422,28,73,0.384,26,55,0.473,0.531,5,7,0.714,13,51,64,29,18,3,10,22,141,2017
Reggie Jackson,PG,26,DET,52,50,1424,284,677,0.419,66,184,0.359,218,493,0.442,0.468,118,136,0.868,21,92,113,270,35,5,114,129,752,2017
Reggie Williams,SF,30,NOP,6,0,79,8,23,0.348,5,11,0.455,3,12,0.25,0.457,6,7,0.857,2,4,6,4,3,0,0,2,27,2017
Richaun Holmes,C,23,PHI,57,17,1193,230,412,0.558,27,77,0.351,203,335,0.606,0.591,72,103,0.699,94,217,311,58,42,55,55,136,559,2017
Robert Covington,SF,26,PHI,67,67,2119,292,732,0.399,137,412,0.333,155,320,0.484,0.492,143,174,0.822,92,344,436,102,127,69,131,203,864,2017
Rodney McGruder,SG,25,MIA,78,65,1966,190,460,0.413,73,220,0.332,117,240,0.488,0.492,44,71,0.62,95,162,257,124,45,18,56,140,497,2017
Ron Baker,SG,23,NYK,52,13,857,82,217,0.378,23,86,0.267,59,131,0.45,0.431,28,43,0.651,12,86,98,107,34,8,56,74,215,2017
Rudy Gobert,C,24,UTA,81,81,2744,413,624,0.662,0,1,0.0,413,623,0.663,0.662,311,476,0.653,314,721,1035,97,49,214,148,246,1137,2017
Ryan Anderson,PF,28,HOU,72,72,2116,323,773,0.418,204,506,0.403,119,267,0.446,0.55,129,150,0.86,112,218,330,68,32,14,55,142,979,2017
Ryan Kelly,PF,25,ATL,16,0,110,8,28,0.286,4,10,0.4,4,18,0.222,0.357,5,6,0.833,1,17,18,8,4,5,4,5,25,2017
Salah Mejri,C,30,DAL,73,11,905,88,137,0.642,1,3,0.333,87,134,0.649,0.646,36,61,0.59,97,211,308,14,32,61,40,152,213,2017
Sam Dekker,SF,22,HOU,77,2,1419,203,429,0.473,60,187,0.321,143,242,0.591,0.543,38,68,0.559,94,190,284,76,38,21,41,83,504,2017
Sean Kilpatrick,SG,27,BRK,70,24,1754,305,735,0.415,105,308,0.341,200,427,0.468,0.486,204,242,0.843,22,258,280,157,46,6,136,118,919,2017
Semaj Christon,PG,24,OKC,64,1,973,77,223,0.345,12,63,0.19,65,160,0.406,0.372,17,31,0.548,19,69,88,130,28,6,43,79,183,2017
Seth Curry,PG,26,DAL,70,42,2029,338,703,0.481,137,322,0.425,201,381,0.528,0.578,85,100,0.85,25,153,178,188,79,7,92,126,898,2017
Shabazz Muhammad,SF,24,MIN,78,1,1516,288,598,0.482,49,146,0.336,239,452,0.529,0.523,147,190,0.774,84,136,220,35,22,6,56,86,772,2017
Shabazz Napier,PG,25,POR,53,2,512,73,183,0.399,34,92,0.37,39,91,0.429,0.492,38,49,0.776,8,53,61,67,32,2,41,38,218,2017
Shaun Livingston,PG,31,GSW,76,3,1345,173,316,0.547,1,3,0.333,172,313,0.55,0.549,42,60,0.7,28,123,151,139,38,20,61,120,389,2017
Shawn Long,C,24,PHI,18,0,234,61,109,0.56,7,19,0.368,54,90,0.6,0.592,19,35,0.543,41,44,85,13,9,9,13,49,148,2017
Sheldon McClellan,SG,24,WAS,30,3,287,30,75,0.4,7,30,0.233,23,45,0.511,0.447,23,27,0.852,4,30,34,15,8,2,5,17,90,2017
Shelvin Mack,PG,26,UTA,55,9,1205,170,381,0.446,37,120,0.308,133,261,0.51,0.495,53,77,0.688,20,108,128,154,42,3,90,100,430,2017
Skal Labissiere,PF,20,SAC,33,12,612,117,218,0.537,3,8,0.375,114,210,0.543,0.544,52,74,0.703,51,111,162,27,16,13,37,64,289,2017
Solomon Hill,SF,25,NOP,80,71,2374,183,477,0.384,94,270,0.348,89,207,0.43,0.482,103,128,0.805,51,256,307,141,71,32,82,182,563,2017
Spencer Dinwiddie,PG,23,BRK,59,18,1334,134,302,0.444,38,101,0.376,96,201,0.478,0.507,126,159,0.792,27,137,164,185,44,23,66,119,432,2017
Stanley Johnson,SF,20,DET,77,1,1371,129,365,0.353,45,154,0.292,84,211,0.398,0.415,36,53,0.679,36,153,189,105,56,24,71,121,339,2017
Stephen Zimmerman,C,20,ORL,19,0,108,10,31,0.323,0,0,0.0,10,31,0.323,0.323,3,5,0.6,11,24,35,4,2,5,3,17,23,2017
Steve Novak,PF,33,MIL,8,0,22,2,7,0.286,1,6,0.167,1,1,1.0,0.357,0,0,0.0,0,3,3,0,0,0,0,1,5,2017
T.J. Warren,SF,23,PHO,66,59,2048,403,814,0.495,26,98,0.265,377,716,0.527,0.511,119,154,0.773,125,214,339,75,76,39,57,175,951,2017
Tarik Black,C,25,LAL,67,16,1091,150,294,0.51,1,2,0.5,149,292,0.51,0.512,82,109,0.752,143,199,342,39,30,44,58,173,383,2017
Terrence Jones,PF,25,TOT,54,12,1270,231,491,0.47,19,75,0.253,212,416,0.51,0.49,103,170,0.606,65,241,306,58,40,54,48,67,584,2017
Terry Rozier,PG,22,BOS,74,0,1263,151,411,0.367,57,179,0.318,94,232,0.405,0.437,51,66,0.773,40,187,227,131,45,11,47,69,410,2017
Tiago Splitter,C,32,PHI,8,0,76,14,31,0.452,2,6,0.333,12,25,0.48,0.484,9,11,0.818,8,14,22,4,1,1,6,8,39,2017
Tim Frazier,PG,26,NOP,65,35,1525,163,404,0.403,40,128,0.313,123,276,0.446,0.453,98,129,0.76,34,139,173,335,56,6,101,133,464,2017
Tim Quarterman,SG,22,POR,16,0,80,13,29,0.448,5,13,0.385,8,16,0.5,0.534,0,3,0.0,4,10,14,11,2,3,11,6,31,2017
Treveon Graham,SG,23,CHO,27,1,189,19,40,0.475,9,15,0.6,10,25,0.4,0.588,10,15,0.667,5,17,22,6,6,1,3,18,57,2017
Tristan Thompson,C,25,CLE,78,78,2336,262,437,0.6,0,3,0.0,262,434,0.604,0.6,106,213,0.498,287,429,716,77,39,84,64,176,630,2017
Troy Daniels,SG,25,MEM,67,3,1183,185,495,0.374,138,355,0.389,47,140,0.336,0.513,43,54,0.796,21,79,100,46,21,4,45,90,551,2017
Troy Williams,SF,22,TOT,30,16,557,73,167,0.437,18,62,0.29,55,105,0.524,0.491,21,32,0.656,15,54,69,25,27,10,33,60,185,2017
Tyler Ennis,PG,22,TOT,53,2,588,90,208,0.433,27,70,0.386,63,138,0.457,0.498,21,25,0.84,10,36,46,86,26,2,45,58,228,2017
Tyler Johnson,PG,24,MIA,73,0,2178,357,824,0.433,93,250,0.372,264,574,0.46,0.49,195,254,0.768,50,243,293,233,84,44,90,176,1002,2017
Tyler Ulis,PG,21,PHO,61,15,1123,184,437,0.421,21,79,0.266,163,358,0.455,0.445,55,71,0.775,20,75,95,226,48,5,77,73,444,2017
Tyus Jones,PG,20,MIN,60,0,774,75,181,0.414,26,73,0.356,49,108,0.454,0.486,33,43,0.767,10,57,67,156,47,5,38,50,209,2017
Wade Baldwin,PG,20,MEM,33,1,405,36,115,0.313,3,22,0.136,33,93,0.355,0.326,31,37,0.838,11,35,46,61,18,7,40,40,106,2017
Wayne Selden,SG,22,TOT,14,5,236,25,58,0.431,7,28,0.25,18,30,0.6,0.491,14,22,0.636,1,15,16,13,6,1,12,18,71,2017
Will Barton,SG,26,DEN,60,19,1705,295,666,0.443,87,235,0.37,208,431,0.483,0.508,143,190,0.753,58,200,258,206,48,28,97,110,820,2017
Willie Reed,C,26,MIA,71,5,1031,162,285,0.568,1,4,0.25,161,281,0.573,0.57,49,88,0.557,129,203,332,26,18,47,31,137,374,2017
Yogi Ferrell,PG,23,TOT,46,29,1197,160,394,0.406,68,176,0.386,92,218,0.422,0.492,74,89,0.831,20,91,111,172,42,9,70,90,462,2017
