Player,Age,G,GS,MP,FG,FGA,FG%,3P,3PA,3P%,2P,2PA,2P%,eFG%,FT,FTA,FT%,ORB,DRB,TRB,AST,STL,BLK,TOV,PF,PTS
A.J. Davis,53.0,96,36,1894,271,613,0.442088091354,83,272,0.305147058824,188,341,1.095,0.509787928222,144,191,0.753926701571,66,236,302,85,74,19,133,172,769
A.J. Guyton,24.0,30,21,727,126,283,0.445229681979,41,97,0.422680412371,85,186,0.457,0.517667844523,34,45,0.755555555556,21,48,69,68,14,5,43,49,327
A.J. Hammons,24.0,15,14,385,80,156,0.512820512821,5,20,0.25,75,136,0.551,0.528846153846,16,20,0.8,29,83,112,17,5,30,21,69,181
A.J. Ussery,23.0,3,0,18,1,3,0.333333333333,0,0,0.0,1,3,0.333,0.333333333333,0,0,0.0,4,1,5,2,1,2,5,3,2
Aaron Bowen,24.0,36,11,579,85,164,0.518292682927,3,10,0.3,82,154,0.532,0.52743902439,18,30,0.6,40,58,98,23,21,6,36,93,191
Aaron Brooks,23.0,2,2,85,18,38,0.473684210526,5,9,0.555555555556,13,29,0.448,0.539473684211,5,8,0.625,2,8,10,10,0,0,8,10,46
Aaron Craft,47.0,80,80,2858,322,717,0.449093444909,54,203,0.266009852217,268,514,1.043,0.486750348675,168,210,0.8,46,338,384,529,184,39,157,221,866
Aaron Dotson,23.0,3,0,24,1,6,0.166666666667,0,2,0.0,1,4,0.25,0.166666666667,0,0,0.0,2,2,4,1,2,1,2,2,2
Aaron Harrison,129.0,104,72,3298,570,1368,0.416666666667,182,498,0.36546184739,388,870,2.637,0.483187134503,498,604,0.824503311258,66,390,456,256,132,36,210,282,1820
Aaron Johnson,0.0,18,2,318,34,76,0.447368421053,11,29,0.379310344828,23,47,0.489,0.519736842105,26,38,0.684210526316,7,12,19,67,19,0,39,42,105
Aaron Miles,49.0,44,37,1342,195,407,0.479115479115,4,16,0.25,191,391,0.985,0.484029484029,136,173,0.78612716763,38,111,149,327,72,5,104,116,530
Aaron Owens,28.0,12,6,330,45,96,0.46875,2,9,0.222222222222,43,87,0.494,0.479166666667,47,62,0.758064516129,3,29,32,53,19,0,29,39,139
Aaron Thomas,25.0,43,27,1130,246,548,0.448905109489,43,138,0.311594202899,203,410,0.495,0.488138686131,85,111,0.765765765766,15,137,152,69,35,7,62,61,620
Abdel Nader,23.0,40,40,1340,295,660,0.44696969697,99,284,0.348591549296,196,376,0.521,0.52196969697,162,204,0.794117647059,29,219,248,155,40,33,146,101,851
Abdoulaye N'Diaye,0.0,44,0,651,88,146,0.602739726027,0,0,0.0,88,146,0.603,0.602739726027,18,30,0.6,67,107,174,20,12,41,49,124,194
Abdul Gaddy,0.0,46,32,1251,160,327,0.489296636086,47,112,0.419642857143,113,215,0.526,0.561162079511,49,85,0.576470588235,48,99,147,231,37,9,106,125,416
Abdul Mills,0.0,39,15,994,111,272,0.408088235294,28,90,0.311111111111,83,182,0.456,0.459558823529,48,72,0.666666666667,24,68,92,143,48,1,62,81,298
Abdulai Jalloh,0.0,120,41,2601,407,901,0.451720310766,55,175,0.314285714286,352,726,1.957,0.482241953385,446,551,0.80943738657,79,332,411,326,168,19,300,344,1315
Adam Haluska,0.0,11,11,424,69,165,0.418181818182,17,56,0.303571428571,52,109,0.477,0.469696969697,51,58,0.879310344828,17,35,52,32,9,0,22,23,206
Adam Harrington,103.0,100,49,2736,474,1110,0.427027027027,125,296,0.422297297297,349,814,1.611,0.483333333333,226,281,0.804270462633,47,190,237,227,85,14,165,237,1299
Adam Koch,0.0,117,80,3160,297,634,0.468454258675,27,93,0.290322580645,270,541,1.51,0.489747634069,264,322,0.819875776398,210,422,632,163,94,69,155,253,885
Adam Liberty,0.0,16,0,188,16,51,0.313725490196,0,4,0.0,16,47,0.34,0.313725490196,9,19,0.473684210526,3,16,19,29,8,1,18,29,41
Adam Parada,23.0,23,1,317,45,87,0.51724137931,0,0,0.0,45,87,0.517,0.51724137931,29,40,0.725,24,54,78,12,12,16,26,55,119
Adam Spanich,30.0,11,0,99,7,28,0.25,5,15,0.333333333333,2,13,0.154,0.339285714286,3,3,1.0,2,6,8,7,0,1,7,9,22
Adam Woodbury,23.0,24,5,301,28,61,0.459016393443,0,2,0.0,28,59,0.475,0.459016393443,15,22,0.681818181818,26,59,85,12,7,6,13,38,71
Adam Zahn,0.0,4,0,48,8,15,0.533333333333,0,0,0.0,8,15,0.533,0.533333333333,7,12,0.583333333333,5,5,10,0,2,0,3,9,23
Adonis Thomas,63.0,86,79,3051,586,1332,0.43993993994,175,441,0.396825396825,411,891,1.322,0.505630630631,176,215,0.818604651163,67,330,397,122,70,19,150,162,1523
Adreian Payne,93.0,37,18,1037,196,411,0.476885644769,8,53,0.150943396226,188,358,2.045,0.486618004866,119,164,0.725609756098,90,220,310,83,29,34,85,123,519
Adrian Oliver,0.0,5,0,85,11,28,0.392857142857,4,12,0.333333333333,7,16,0.438,0.464285714286,7,7,1.0,4,8,12,5,2,0,5,7,33
Adrian Thomas,76.0,118,7,1948,227,595,0.381512605042,198,521,0.380038387716,29,74,1.118,0.547899159664,8,11,0.727272727273,25,163,188,54,43,11,43,152,660
Ajani Williams,24.0,29,0,278,33,69,0.478260869565,0,2,0.0,33,67,0.493,0.478260869565,34,47,0.723404255319,14,34,48,4,2,13,18,35,100
Akeem Ellis,0.0,32,10,634,72,186,0.387096774194,48,135,0.355555555556,24,51,0.471,0.516129032258,24,39,0.615384615385,26,68,94,31,13,2,22,57,216
Akeem Richmond,47.0,43,10,732,130,344,0.377906976744,117,313,0.373801916933,13,31,0.728,0.547965116279,35,43,0.813953488372,16,51,67,35,16,1,19,49,412
Akeem Scott,0.0,5,0,85,20,31,0.645161290323,2,5,0.4,18,26,0.692,0.677419354839,10,15,0.666666666667,0,9,9,15,5,2,12,19,52
Akeem Wright,0.0,2,0,28,2,11,0.181818181818,0,1,0.0,2,10,0.2,0.181818181818,4,7,0.571428571429,1,4,5,0,0,0,3,1,8
Akil Mitchell,46.0,53,34,1450,219,385,0.568831168831,10,51,0.196078431373,209,334,1.111,0.581818181818,66,137,0.481751824818,141,327,468,89,51,39,93,130,514
Akin Akingbala,23.0,14,7,311,42,84,0.5,0,0,0.0,42,84,0.5,0.5,23,36,0.638888888889,27,68,95,16,8,20,31,36,107
Al Nolen,0.0,2,0,34,2,7,0.285714285714,2,4,0.5,0,3,0.0,0.428571428571,0,2,0.0,1,1,2,7,1,0,2,3,6
Alade Aminu,0.0,92,62,2538,490,946,0.517970401691,0,2,0.0,490,944,1.57,0.517970401691,272,404,0.673267326733,254,392,646,52,92,74,146,256,1252
Alan Anderson,81.0,44,24,1386,281,518,0.542471042471,50,125,0.4,231,393,1.818,0.590733590734,181,216,0.837962962963,66,129,195,143,46,2,144,137,793
Alan Williams,24.0,1,1,28,7,14,0.5,0,0,0.0,7,14,0.5,0.5,6,8,0.75,3,6,9,1,1,0,2,4,20
Alando Tucker,74.0,46,41,1562,344,696,0.494252873563,61,160,0.38125,283,536,1.397,0.538074712644,183,225,0.813333333333,97,119,216,80,49,2,66,52,932
Alec Brown,46.0,67,47,1482,257,558,0.460573476703,71,198,0.358585858586,186,360,0.969,0.524193548387,63,79,0.79746835443,122,197,319,61,44,129,69,207,648
Alec Burks,25.0,1,1,21,5,17,0.294117647059,1,8,0.125,4,9,0.444,0.323529411765,2,3,0.666666666667,2,3,5,3,1,0,3,2,13
Alejandro Carmona,22.0,7,0,84,8,26,0.307692307692,0,0,0.0,8,26,0.308,0.307692307692,1,2,0.5,6,5,11,3,2,0,5,11,17
Alejo Rodriguez,0.0,14,1,173,7,21,0.333333333333,0,1,0.0,7,20,0.833,0.333333333333,9,21,0.428571428571,27,44,71,5,8,6,8,30,23
Aleks Ugrinoski,0.0,18,0,150,16,48,0.333333333333,1,5,0.2,15,43,0.349,0.34375,6,7,0.857142857143,3,4,7,29,5,0,21,13,39
Aleksander Czyz,0.0,74,24,1722,308,638,0.48275862069,32,96,0.333333333333,276,542,1.49,0.507836990596,184,280,0.657142857143,180,306,486,74,72,32,130,164,832
Alex Acker,49.0,21,13,749,139,317,0.438485804416,26,74,0.351351351351,113,243,0.957,0.479495268139,74,89,0.831460674157,26,77,103,92,37,10,58,57,378
Alex Caruso,22.0,50,46,1513,204,444,0.459459459459,61,152,0.401315789474,143,292,0.49,0.528153153153,125,167,0.748502994012,42,153,195,260,108,28,156,132,594
Alex Davis,99.0,152,120,3852,437,953,0.458551941238,30,79,0.379746835443,407,874,1.86,0.474291710388,326,454,0.718061674009,289,470,759,137,97,219,231,534,1230
Alex Hamilton,23.0,43,5,1004,165,362,0.455801104972,12,53,0.22641509434,153,309,0.495,0.472375690608,148,212,0.698113207547,32,114,146,193,49,7,97,67,490
Alex Johnson,29.0,10,0,79,6,17,0.352941176471,3,6,0.5,3,11,0.273,0.441176470588,6,10,0.6,2,11,13,10,2,0,5,5,21
Alex Kirk,23.0,41,37,1164,211,431,0.489559164733,7,32,0.21875,204,399,0.511,0.497679814385,72,99,0.727272727273,101,164,265,48,27,49,74,115,501
Alex Oriakhi,0.0,86,52,1604,238,478,0.497907949791,0,6,0.0,238,472,1.514,0.497907949791,140,182,0.769230769231,194,338,532,16,30,74,100,262,616
Alex Poythress,23.0,46,45,1430,330,625,0.528,31,77,0.402597402597,299,548,0.546,0.5528,159,203,0.783251231527,117,208,325,69,34,63,123,177,850
Alex Ruoff,0.0,74,2,1892,224,536,0.417910447761,108,296,0.364864864865,116,240,1.533,0.518656716418,68,86,0.790697674419,48,174,222,112,78,18,92,144,624
Alex Scales,52.0,35,15,948,148,335,0.441791044776,29,98,0.295918367347,119,237,0.991,0.485074626866,79,99,0.79797979798,14,67,81,65,48,11,64,75,404
Alex Smith,0.0,3,0,17,0,3,0.0,0,0,0.0,0,3,0.0,0.0,3,4,0.75,3,1,4,0,0,0,2,4,3
Alex Stepheson,28.0,32,31,1060,205,354,0.579096045198,0,3,0.0,205,351,0.584,0.579096045198,84,173,0.485549132948,152,276,428,33,14,42,73,90,494
Alex Zampier,0.0,1,0,3,0,0,0.0,0,0,0.0,0,0,0.0,0.0,0,0,0.0,0,0,0,0,0,0,0,2,0
Alexander Johnson,49.0,27,14,847,178,314,0.566878980892,0,1,0.0,178,313,1.116,0.566878980892,216,294,0.734693877551,69,218,287,37,17,32,104,96,572
Alexis Ajinca,41.0,33,21,822,161,308,0.522727272727,0,6,0.0,161,302,1.044,0.522727272727,130,171,0.760233918129,90,151,241,13,18,88,94,126,452
Alexis Wangmene,50.0,19,0,76,3,16,0.1875,0,0,0.0,3,16,0.188,0.1875,1,2,0.5,5,14,19,3,1,1,11,19,7
Alfonzo McKinnie,24.0,50,34,1525,291,573,0.507853403141,41,133,0.308270676692,250,440,0.568,0.543630017452,120,170,0.705882352941,132,328,460,37,28,25,70,131,743
Alfred Aboya,177.0,102,12,1618,132,294,0.448979591837,2,10,0.2,130,284,2.542,0.452380952381,102,130,0.784615384615,150,146,296,50,54,38,74,294,368
Alfred Neale,25.0,17,0,267,32,85,0.376470588235,16,44,0.363636363636,16,41,0.39,0.470588235294,19,28,0.678571428571,8,40,48,7,7,0,9,18,99
Ali Berdiel,0.0,24,11,676,84,202,0.415841584158,16,47,0.340425531915,68,155,0.439,0.455445544554,54,71,0.760563380282,20,69,89,116,37,7,63,62,238
Allan Ray,22.0,2,0,35,10,18,0.555555555556,2,6,0.333333333333,8,12,0.667,0.611111111111,7,7,1.0,2,3,5,4,0,0,2,10,29
Allen Crabbe,21.0,6,6,231,39,95,0.410526315789,12,38,0.315789473684,27,57,0.474,0.473684210526,6,8,0.75,10,30,40,7,6,5,8,17,96
Allen Durham,27.0,24,7,565,90,163,0.552147239264,4,9,0.444444444444,86,154,0.558,0.564417177914,28,41,0.682926829268,78,100,178,24,13,19,26,48,212
Alonzo Gee,22.0,36,35,1376,272,530,0.51320754717,25,62,0.403225806452,247,468,0.528,0.53679245283,196,279,0.702508960573,81,159,240,46,53,20,117,105,765
Aloysius Anagonye,25.0,24,23,670,92,217,0.423963133641,0,3,0.0,92,214,0.43,0.423963133641,60,83,0.722891566265,61,75,136,33,28,13,43,81,244
Alpha Bangura,0.0,138,69,3625,749,1608,0.4657960199,28,120,0.233333333333,721,1488,2.393,0.474502487562,504,656,0.768292682927,211,317,528,186,160,22,267,304,2030
Alton Ford,110.0,79,65,2032,236,533,0.44277673546,4,32,0.125,232,501,1.68,0.446529080675,221,292,0.756849315068,118,384,502,89,37,34,151,295,697
Altron Jackson,22.0,13,0,87,7,23,0.304347826087,2,4,0.5,5,19,0.263,0.347826086957,3,4,0.75,2,10,12,2,2,0,3,16,19
Alvin Broussard,23.0,7,1,80,10,23,0.434782608696,2,5,0.4,8,18,0.444,0.478260869565,10,16,0.625,6,10,16,5,6,0,7,20,32
Alvin Pettway,24.0,1,0,5,1,1,1.0,0,0,0.0,1,1,1.0,1.0,0,0,0.0,0,0,0,0,0,1,0,1,2
Amadou Mbodji,81.0,38,3,406,40,62,0.645161290323,0,0,0.0,40,62,2.139,0.645161290323,21,32,0.65625,45,57,102,6,8,16,17,83,101
Amara Sy,0.0,16,15,553,90,170,0.529411764706,11,26,0.423076923077,79,144,0.549,0.561764705882,49,64,0.765625,44,72,116,56,15,10,53,56,240
Amir Johnson,37.0,40,34,1283,276,430,0.641860465116,2,4,0.5,274,426,1.294,0.644186046512,170,231,0.735930735931,130,210,340,67,42,96,112,164,724
Amir Williams,47.0,67,26,1022,99,171,0.578947368421,0,0,0.0,99,171,1.167,0.578947368421,77,118,0.652542372881,114,191,305,29,26,63,50,143,275
Andrae Nelson,0.0,2,0,8,0,2,0.0,0,0,0.0,0,2,0.0,0.0,0,0,0.0,0,0,0,0,0,0,2,6,0
Andray Blatche,19.0,6,2,148,25,49,0.510204081633,1,5,0.2,24,44,0.545,0.520408163265,16,19,0.842105263158,6,35,41,8,8,9,19,16,67
Andre Barrett,247.0,247,222,8543,1383,3045,0.454187192118,279,736,0.379076086957,1104,2309,4.136,0.5,663,811,0.817509247842,148,632,780,1793,293,21,664,418,3708
Andre Brown,52.0,33,30,1233,261,462,0.564935064935,0,4,0.0,261,458,1.14,0.564935064935,95,188,0.505319148936,133,206,339,36,21,22,95,124,617
Andre Dawkins,168.0,170,56,4802,862,1971,0.43734145104,566,1345,0.420817843866,296,626,3.457,0.580923389143,278,354,0.785310734463,67,347,414,295,115,25,240,370,2568
Andre Emmett,136.0,155,90,4792,1049,2054,0.510710808179,156,416,0.375,893,1638,2.563,0.548685491723,513,709,0.723554301834,246,530,776,356,224,27,353,232,2767
Andre Ingram,238.0,337,142,8763,1162,2506,0.463687150838,610,1331,0.45830202855,552,1175,4.061,0.585395051875,540,636,0.849056603774,209,847,1056,547,338,40,313,596,3474
Andre Jones,0.0,7,3,125,15,42,0.357142857143,2,7,0.285714285714,13,35,0.371,0.380952380952,15,21,0.714285714286,4,16,20,11,4,1,5,12,47
Andre Joseph,25.0,2,2,55,4,12,0.333333333333,0,0,0.0,4,12,0.333,0.333333333333,0,0,0.0,0,1,1,5,2,0,7,5,8
Andre McCollum,57.0,70,47,1967,296,704,0.420454545455,73,209,0.349282296651,223,495,0.887,0.472301136364,191,233,0.81974248927,39,194,233,204,61,12,188,149,856
Andre Owens,26.0,50,43,1927,284,633,0.448657187994,46,146,0.315068493151,238,487,0.489,0.484992101106,214,277,0.772563176895,56,227,283,158,53,5,112,157,828
Andre Patterson,122.0,126,40,2855,348,685,0.50802919708,3,17,0.176470588235,345,668,2.47,0.510218978102,152,202,0.752475247525,199,373,572,160,84,125,147,289,851
Andre Roberson,22.0,17,17,539,116,225,0.515555555556,10,32,0.3125,106,193,0.549,0.537777777778,28,61,0.459016393443,56,108,164,27,42,22,37,47,270
Andre Smith,0.0,8,0,99,11,37,0.297297297297,2,17,0.117647058824,9,20,0.45,0.324324324324,5,8,0.625,3,3,6,10,7,0,8,16,29
Andre Stringer,47.0,88,38,1911,229,577,0.396880415945,135,352,0.383522727273,94,225,0.845,0.513864818024,78,100,0.78,42,163,205,289,71,5,140,151,671
Andre Woolridge,29.0,3,3,102,12,29,0.413793103448,3,9,0.333333333333,9,20,0.45,0.465517241379,11,18,0.611111111111,0,9,9,18,2,0,14,6,38
Andreas Glyniadakis,97.0,100,65,2501,424,800,0.53,0,0,0.0,424,800,2.08,0.53,321,401,0.800498753117,192,331,523,48,35,129,218,390,1169
Andres Sandoval,0.0,2,1,34,3,13,0.230769230769,0,3,0.0,3,10,0.3,0.230769230769,4,9,0.444444444444,0,4,4,2,3,0,1,1,10
Andrew Drevo,0.0,50,37,1372,218,461,0.472885032538,49,140,0.35,169,321,0.526,0.526030368764,86,99,0.868686868687,97,218,315,103,40,38,97,148,571
Andrew Gonzalez,0.0,1,0,3,0,1,0.0,0,0,0.0,0,1,0.0,0.0,0,0,0.0,1,0,1,0,0,0,0,0,0
Andrew Goudelock,95.0,103,103,3809,833,1752,0.475456621005,194,530,0.366037735849,639,1222,2.197,0.530821917808,314,376,0.835106382979,60,344,404,533,120,14,292,165,2174
Andrew Harrison,21.0,46,45,1622,262,599,0.437395659432,76,208,0.365384615385,186,391,0.476,0.500834724541,249,318,0.783018867925,22,177,199,226,67,24,148,146,849
Andrew Warren,81.0,58,6,906,80,252,0.31746031746,44,176,0.25,36,76,1.421,0.404761904762,26,32,0.8125,34,68,102,46,54,4,32,90,230
Andy Rautins,26.0,48,31,1424,223,507,0.439842209073,152,348,0.436781609195,71,159,0.447,0.589743589744,48,62,0.774193548387,21,114,135,115,48,5,103,93,646
Ansu Sesay,25.0,45,41,1376,230,522,0.44061302682,3,21,0.142857142857,227,501,0.453,0.443486590038,163,220,0.740909090909,54,151,205,112,39,35,107,117,626
Anthony Bennett,45.0,8,6,177,33,84,0.392857142857,12,37,0.324324324324,21,47,0.939,0.464285714286,13,18,0.722222222222,8,27,35,11,10,6,11,10,91
Anthony Blakes,0.0,52,5,612,67,169,0.396449704142,6,34,0.176470588235,61,135,0.452,0.414201183432,40,56,0.714285714286,48,67,115,59,29,5,53,45,180
Anthony Brown,47.0,31,26,1141,203,451,0.450110864745,72,169,0.426035502959,131,282,0.926,0.529933481153,112,141,0.794326241135,20,138,158,87,28,7,90,85,590
Anthony Coleman,102.0,68,19,1451,150,374,0.401069518717,21,68,0.308823529412,129,306,1.882,0.429144385027,78,102,0.764705882353,75,220,295,70,33,42,82,157,399
Anthony Danridge,0.0,41,1,672,119,207,0.574879227053,0,4,0.0,119,203,0.586,0.574879227053,55,66,0.833333333333,34,45,79,37,14,7,40,42,293
Anthony Fuqua,69.0,113,48,1757,117,237,0.493670886076,0,1,0.0,117,236,1.455,0.493670886076,124,187,0.663101604278,197,228,425,41,35,80,114,270,358
Anthony Goods,0.0,123,100,3838,616,1528,0.403141361257,243,633,0.383886255924,373,895,2.302,0.482657068063,430,495,0.868686868687,42,371,413,272,91,8,299,177,1905
Anthony Grundy,26.0,44,43,1753,340,787,0.432020330368,101,256,0.39453125,239,531,0.45,0.496188055909,231,292,0.791095890411,61,176,237,193,109,7,144,119,1012
Anthony Gurley,0.0,1,0,6,0,1,0.0,0,0,0.0,0,1,0.0,0.0,2,2,1.0,0,0,0,0,0,1,1,1,2
Anthony Harris,270.0,180,58,3797,683,1526,0.447575360419,42,157,0.267515923567,641,1369,4.405,0.461336828309,253,359,0.704735376045,109,400,509,597,120,16,361,390,1661
Anthony Johnson,27.0,18,13,399,73,159,0.459119496855,3,13,0.230769230769,70,146,0.979,0.468553459119,32,43,0.744186046512,10,37,47,44,31,1,32,41,181
Anthony Kent,139.0,190,64,3721,404,813,0.49692496925,1,1,1.0,403,812,2.704,0.4975399754,182,334,0.544910179641,330,491,821,103,86,182,200,505,991
Anthony Kyle,0.0,30,0,406,38,92,0.413043478261,7,20,0.35,31,72,0.646,0.451086956522,14,21,0.666666666667,12,37,49,93,23,0,40,35,97
Anthony Mason,0.0,97,66,3172,586,1192,0.491610738255,53,168,0.315476190476,533,1024,1.575,0.513842281879,225,288,0.78125,147,380,527,258,115,86,214,305,1450
Anthony McHenry,23.0,19,8,243,19,55,0.345454545455,5,12,0.416666666667,14,43,0.326,0.390909090909,6,15,0.4,13,26,39,24,11,12,21,36,49
Anthony Moody,0.0,6,1,79,11,32,0.34375,4,10,0.4,7,22,0.318,0.40625,1,3,0.333333333333,1,7,8,7,5,1,6,4,27
Anthony Newell,0.0,1,1,27,1,6,0.166666666667,0,3,0.0,1,3,0.333,0.166666666667,0,0,0.0,1,5,6,0,2,0,3,3,2
Anthony Pelle,29.0,29,24,731,68,156,0.435897435897,0,1,0.0,68,155,0.439,0.435897435897,46,73,0.630136986301,58,123,181,20,12,49,58,89,182
Anthony Richardson,0.0,164,122,4844,874,1864,0.468884120172,92,260,0.353846153846,782,1604,2.86,0.49356223176,354,484,0.731404958678,370,600,970,248,210,216,298,442,2194
Anthony Roberson,45.0,28,4,741,173,382,0.452879581152,69,164,0.420731707317,104,218,0.95,0.543193717277,64,79,0.810126582278,23,46,69,50,33,4,38,67,479
Anthony Simpson,0.0,8,4,156,24,49,0.489795918367,0,1,0.0,24,48,0.5,0.489795918367,7,11,0.636363636364,3,40,43,13,6,5,9,22,55
Anthony Stover,0.0,25,5,371,20,40,0.5,0,1,0.0,20,39,0.513,0.5,5,13,0.384615384615,22,37,59,8,8,33,16,45,45
Anthony Terrell,77.0,128,36,2587,343,718,0.477715877437,0,9,0.0,343,709,1.476,0.477715877437,127,230,0.552173913043,197,284,481,113,65,56,130,198,813
Anthony Tolliver,115.0,73,53,2444,382,789,0.484157160963,129,340,0.379411764706,253,449,2.796,0.565906210393,189,250,0.756,183,408,591,124,84,80,147,258,1082
Anthony Vereen,112.0,127,16,2084,360,687,0.524017467249,3,21,0.142857142857,357,666,1.927,0.526200873362,203,284,0.714788732394,151,271,422,103,38,22,119,314,926
Anthony Walker,45.0,16,2,148,17,30,0.566666666667,0,0,0.0,17,30,0.84,0.566666666667,7,11,0.636363636364,5,15,20,2,5,19,6,21,41
Anthony Washington,0.0,2,0,21,3,7,0.428571428571,0,0,0.0,3,7,0.429,0.428571428571,0,0,0.0,1,1,2,1,0,2,1,3,6
Anthony Wilkins,102.0,113,25,1794,197,506,0.389328063241,51,178,0.286516853933,146,328,1.745,0.439723320158,76,109,0.697247706422,44,184,228,106,38,1,75,111,521
Antoine Agudio,194.0,301,204,8204,1032,2322,0.444444444444,480,1110,0.432432432432,552,1212,3.191,0.547803617571,572,707,0.809052333805,90,554,644,616,240,6,422,456,3116
Antoine Hood,53.0,67,6,1280,153,370,0.413513513514,48,147,0.326530612245,105,223,0.887,0.478378378378,98,133,0.736842105263,40,106,146,134,45,5,91,125,452
Antoine Jordan,48.0,8,0,75,6,20,0.3,1,3,0.333333333333,5,17,0.682,0.325,3,8,0.375,1,3,4,5,2,0,5,12,16
Antoine Landry,0.0,10,2,206,22,73,0.301369863014,1,9,0.111111111111,21,64,0.328,0.308219178082,11,17,0.647058823529,1,9,10,23,5,1,18,18,56
Antoine Pettway,22.0,47,1,951,122,267,0.456928838951,4,21,0.190476190476,118,246,0.48,0.464419475655,83,103,0.805825242718,19,63,82,146,41,2,40,75,331
Antoine Walker,69.0,87,56,2539,432,1066,0.405253283302,124,434,0.285714285714,308,632,0.97,0.463414634146,117,219,0.534246575342,129,359,488,250,50,40,208,241,1105
Antoine Wright,55.0,29,14,894,140,339,0.412979351032,60,165,0.363636363636,80,174,0.922,0.501474926254,52,71,0.732394366197,31,124,155,60,41,8,52,85,392
Antonio Anderson,125.0,127,96,4345,500,1105,0.452488687783,115,351,0.327635327635,385,754,2.427,0.504524886878,262,362,0.723756906077,65,370,435,573,131,46,347,352,1377
Antonio Barton,24.0,3,0,32,1,9,0.111111111111,0,4,0.0,1,5,0.2,0.111111111111,1,2,0.5,0,1,1,1,0,0,4,1,3
Antonio Daniels,71.0,62,56,2256,248,570,0.435087719298,40,115,0.347826086957,208,455,0.916,0.470175438596,318,374,0.850267379679,24,240,264,535,87,8,157,99,854
Antonio Grant,0.0,45,7,565,77,187,0.411764705882,18,50,0.36,59,137,0.431,0.459893048128,23,45,0.511111111111,41,59,100,25,27,5,28,49,195
Antonio Graves,0.0,27,3,637,87,216,0.402777777778,24,64,0.375,63,152,0.414,0.458333333333,41,54,0.759259259259,13,40,53,46,10,4,40,64,239
Antonio Meeking,151.0,175,119,5397,928,2110,0.43981042654,55,214,0.257009345794,873,1896,2.719,0.452843601896,692,1006,0.687872763419,377,806,1183,276,110,48,362,518,2603
Antonio Smith,0.0,10,9,217,20,44,0.454545454545,0,0,0.0,20,44,0.455,0.454545454545,4,11,0.363636363636,32,45,77,6,2,2,10,21,44
Antwain Smith,26.0,36,23,1036,189,418,0.452153110048,5,22,0.227272727273,184,396,0.465,0.458133971292,111,157,0.707006369427,82,177,259,25,28,29,48,76,494
Antwaine Wiggins,28.0,39,10,731,141,250,0.564,17,48,0.354166666667,124,202,0.614,0.598,41,71,0.577464788732,53,73,126,26,24,16,33,44,340
Antwan Jones,25.0,7,4,110,10,26,0.384615384615,0,0,0.0,10,26,0.385,0.384615384615,4,5,0.8,5,7,12,4,1,0,8,2,24
Antywane Robinson,45.0,52,3,936,152,353,0.43059490085,37,112,0.330357142857,115,241,1.012,0.483002832861,27,39,0.692307692308,43,93,136,44,18,28,32,69,368
Anwar Ferguson,0.0,9,0,86,9,16,0.5625,0,0,0.0,9,16,0.563,0.5625,4,8,0.5,2,11,13,2,0,9,3,15,22
Aqeel Quinn,24.0,1,0,9,3,4,0.75,2,3,0.666666666667,1,1,1.0,1.0,1,1,1.0,0,4,4,0,0,0,0,0,9
Aquille Carr,0.0,10,0,140,35,88,0.397727272727,9,23,0.391304347826,26,65,0.4,0.448863636364,28,41,0.682926829268,1,8,9,19,12,0,21,21,107
Archie Goodwin,61.0,48,44,1587,304,682,0.445747800587,46,169,0.272189349112,258,513,1.537,0.479472140762,261,363,0.719008264463,79,181,260,103,63,12,126,111,915
Arinze Onuaku,101.0,116,78,3156,686,1137,0.603342128408,0,1,0.0,686,1136,2.315,0.603342128408,324,614,0.527687296417,421,781,1202,116,79,103,243,317,1696
Aristide Sawadogo,0.0,61,0,329,30,57,0.526315789474,0,0,0.0,30,57,2.594,0.526315789474,10,22,0.454545454545,40,53,93,1,3,22,10,62,70
Armon Johnson,68.0,17,4,446,99,199,0.497487437186,4,19,0.210526315789,95,180,1.027,0.507537688442,30,42,0.714285714286,22,46,68,75,16,3,35,40,232
Arnett Moultrie,45.0,15,4,410,63,137,0.459854014599,0,1,0.0,63,136,0.928,0.459854014599,26,35,0.742857142857,22,57,79,24,12,5,29,29,152
Aron Baynes,53.0,13,13,362,82,158,0.518987341772,0,0,0.0,82,158,1.025,0.518987341772,34,46,0.739130434783,49,68,117,19,7,16,28,50,198
Art Long,30.0,10,9,223,47,82,0.573170731707,1,3,0.333333333333,46,79,0.582,0.579268292683,22,32,0.6875,14,62,76,24,5,15,32,38,117
Arthur Edwards,24.0,47,3,967,119,288,0.413194444444,60,181,0.331491712707,59,107,0.551,0.517361111111,56,73,0.767123287671,27,150,177,57,40,33,78,86,354
Artie Griffin,0.0,44,42,1504,201,541,0.371534195933,103,270,0.381481481481,98,271,0.362,0.466728280961,125,150,0.833333333333,41,120,161,123,48,9,96,97,630
Asaad Woods,24.0,23,1,175,12,30,0.4,5,17,0.294117647059,7,13,0.538,0.483333333333,9,12,0.75,4,17,21,3,3,1,7,35,38
Asauhn Dixon-Tatum,72.0,89,9,1384,175,338,0.51775147929,0,1,0.0,175,337,1.45,0.51775147929,81,129,0.627906976744,153,166,319,16,13,78,65,188,431
Ashanti Cook,0.0,17,4,294,24,66,0.363636363636,12,27,0.444444444444,12,39,0.308,0.454545454545,4,5,0.8,6,19,25,31,7,0,9,33,64
Ashton Mitchell,0.0,11,3,226,18,52,0.346153846154,6,28,0.214285714286,12,24,0.5,0.403846153846,18,29,0.620689655172,4,19,23,49,7,1,33,35,60
Ashton Pitts,27.0,2,0,15,1,1,1.0,0,0,0.0,1,1,1.0,1.0,0,0,0.0,0,0,0,0,0,0,2,3,2
Ashton Smith,26.0,24,0,256,22,57,0.385964912281,8,24,0.333333333333,14,33,0.424,0.456140350877,8,14,0.571428571429,6,17,23,29,4,1,22,26,60
Askia Booker,45.0,89,40,2307,452,1067,0.423617619494,108,317,0.340694006309,344,750,0.916,0.474226804124,239,326,0.733128834356,58,260,318,387,85,5,200,223,1251
Ater Majok,27.0,23,18,507,57,95,0.6,0,0,0.0,57,95,0.6,0.6,17,24,0.708333333333,53,68,121,17,17,64,25,94,131
Atila Santos,0.0,20,0,311,30,68,0.441176470588,0,0,0.0,30,68,0.441,0.441176470588,30,37,0.810810810811,22,53,75,4,8,13,30,52,90
Aubrey Coleman,0.0,62,29,1662,284,640,0.44375,26,113,0.230088495575,258,527,1.754,0.4640625,148,226,0.654867256637,74,206,280,128,81,15,105,110,742
Augustine Okosun,0.0,14,0,79,6,13,0.461538461538,0,0,0.0,6,13,0.462,0.461538461538,2,3,0.666666666667,8,14,22,1,1,7,7,22,14
Augustus Gilchrist,0.0,69,3,1108,177,322,0.549689440994,1,12,0.0833333333333,176,310,1.103,0.551242236025,126,193,0.652849740933,112,187,299,24,23,65,66,154,481
Austin Daye,51.0,11,5,324,68,167,0.407185628743,14,49,0.285714285714,54,118,0.919,0.449101796407,37,42,0.880952380952,7,76,83,28,8,13,33,43,187
Austin Freeman,0.0,41,1,779,158,343,0.460641399417,63,169,0.372781065089,95,174,0.546,0.552478134111,60,78,0.769230769231,10,80,90,97,24,7,54,56,439
Austin Nichols,45.0,95,51,2447,382,857,0.445740956826,22,64,0.34375,360,793,0.908,0.458576429405,241,276,0.873188405797,77,181,258,124,60,15,94,229,1027
Austin Witter,23.0,22,0,315,35,79,0.443037974684,15,47,0.31914893617,20,32,0.625,0.537974683544,1,8,0.125,17,41,58,16,11,22,10,39,86
Avery Bradley,20.0,9,6,290,57,126,0.452380952381,10,27,0.37037037037,47,99,0.475,0.492063492063,30,35,0.857142857143,7,36,43,47,27,3,39,29,154
Awvee Storey,29.0,3,0,73,13,26,0.5,2,5,0.4,11,21,0.524,0.538461538462,0,2,0.0,7,11,18,2,5,0,3,10,28
Axel Toupane,47.0,68,27,1942,319,715,0.446153846154,72,219,0.328767123288,247,496,0.995,0.496503496503,336,421,0.79809976247,43,283,326,245,72,11,190,199,1046
Ayinde Ubaka,0.0,12,0,169,14,29,0.48275862069,1,5,0.2,13,24,0.542,0.5,9,11,0.818181818182,1,12,13,10,4,0,7,7,38
B.J. Elder,24.0,45,45,1640,356,729,0.488340192044,67,180,0.372222222222,289,549,0.526,0.534293552812,117,161,0.726708074534,54,113,167,86,30,11,111,126,896
B.J. Jenkins,0.0,23,10,568,67,166,0.403614457831,20,66,0.30303030303,47,100,0.47,0.463855421687,47,52,0.903846153846,11,41,52,63,25,3,34,46,201
B.J. McKie,24.0,56,0,1032,140,335,0.417910447761,24,77,0.311688311688,116,258,0.45,0.453731343284,123,163,0.754601226994,41,86,127,177,41,0,116,111,427
BJ Young,0.0,58,2,540,196,374,0.524064171123,4,22,0.181818181818,192,352,1.636,0.529411764706,70,110,0.636363636364,28,62,90,76,18,4,70,54,466
Babacar Camara,25.0,6,3,64,5,21,0.238095238095,0,0,0.0,5,21,0.238,0.238095238095,0,1,0.0,5,6,11,8,0,0,2,17,10
Badou Gaye,25.0,12,1,138,22,44,0.5,0,1,0.0,22,43,0.512,0.5,8,18,0.444444444444,18,33,51,5,2,7,16,28,52
Bakari Hendrix,54.0,87,44,1980,307,725,0.423448275862,47,177,0.265536723164,260,548,0.945,0.455862068966,161,210,0.766666666667,112,283,395,87,30,33,135,205,822
Bamba Fall,0.0,17,0,249,29,48,0.604166666667,0,0,0.0,29,48,0.604,0.604166666667,18,36,0.5,30,38,68,3,0,32,9,44,76
Baron Davis,36.0,6,0,135,27,76,0.355263157895,14,44,0.318181818182,13,32,0.406,0.447368421053,9,10,0.9,2,13,15,21,7,2,12,18,77
Bayonne Taty,30.0,23,0,234,12,33,0.363636363636,0,0,0.0,12,33,0.364,0.363636363636,12,19,0.631578947368,23,45,68,1,5,7,15,44,36
Beau Beech,22.0,36,12,695,87,236,0.368644067797,52,142,0.366197183099,35,94,0.372,0.478813559322,39,50,0.78,23,77,100,44,39,5,37,102,265
Ben Adams,51.0,15,0,243,36,69,0.521739130435,1,8,0.125,35,61,1.135,0.528985507246,28,37,0.756756756757,6,23,29,35,13,1,28,28,101
Ben Bentil,21.0,20,4,434,77,212,0.36320754717,27,87,0.310344827586,50,125,0.4,0.426886792453,60,75,0.8,24,67,91,12,15,5,27,40,241
Ben Colon,0.0,11,0,181,12,28,0.428571428571,0,0,0.0,12,28,0.429,0.428571428571,6,13,0.461538461538,17,27,44,5,8,4,12,29,30
Ben Gordon,33.0,25,17,737,130,280,0.464285714286,72,158,0.455696202532,58,122,0.475,0.592857142857,47,53,0.88679245283,5,62,67,85,23,6,42,62,379
Ben Hansbrough,27.0,7,1,157,19,43,0.441860465116,5,13,0.384615384615,14,30,0.467,0.5,13,17,0.764705882353,1,14,15,20,10,2,12,19,56
Ben McCauley,0.0,14,3,257,21,66,0.318181818182,8,24,0.333333333333,13,42,0.31,0.378787878788,5,5,1.0,18,26,44,20,8,2,14,22,55
Ben Strong,216.0,212,75,4589,653,1324,0.493202416918,44,133,0.330827067669,609,1191,4.172,0.509818731118,234,347,0.674351585014,357,753,1110,208,80,195,216,409,1584
Ben Uzoh,144.0,144,114,4346,696,1628,0.427518427518,39,144,0.270833333333,657,1484,2.819,0.439496314496,304,424,0.716981132075,178,455,633,633,184,42,295,279,1735
Bennet Davis,0.0,107,46,2509,364,801,0.45443196005,10,50,0.2,354,751,1.336,0.460674157303,291,384,0.7578125,196,362,558,149,66,90,147,264,1029
Bennie Lewis,53.0,14,3,229,30,84,0.357142857143,17,51,0.333333333333,13,33,0.433,0.458333333333,7,13,0.538461538462,4,17,21,17,7,2,11,11,84
Bernard James,57.0,3,3,95,28,40,0.7,0,1,0.0,28,39,1.426,0.7,5,12,0.416666666667,17,21,38,3,3,14,4,6,61
Bernard King,47.0,59,46,1952,328,678,0.483775811209,39,119,0.327731092437,289,559,1.034,0.512536873156,217,263,0.825095057034,68,156,224,273,65,17,154,213,912
Bernard Toombs,0.0,2,0,11,2,5,0.4,0,0,0.0,2,5,0.4,0.4,0,0,0.0,0,2,2,0,0,0,0,0,4
Billy Baptist,0.0,42,6,798,120,280,0.428571428571,23,90,0.255555555556,97,190,0.511,0.469642857143,36,57,0.631578947368,61,115,176,48,26,18,50,87,299
Billy McShepard,0.0,16,8,375,56,123,0.455284552846,3,15,0.2,53,108,0.491,0.467479674797,29,35,0.828571428571,25,80,105,10,10,14,20,32,144
Billy Rush,0.0,14,13,321,43,110,0.390909090909,9,43,0.209302325581,34,67,0.507,0.431818181818,25,30,0.833333333333,7,49,56,15,8,6,21,20,120
Billy Thomas,152.0,195,173,6251,971,2261,0.429455992923,379,1019,0.37193326791,592,1242,2.379,0.513268465281,401,491,0.816700610998,138,469,607,498,300,67,345,389,2722
Billy White,0.0,3,0,25,2,6,0.333333333333,1,1,1.0,1,5,0.2,0.416666666667,1,2,0.5,1,3,4,2,1,0,1,6,6
Blake Ahearn,253.0,272,217,9698,1649,3751,0.439616102373,742,1838,0.403699673558,907,1913,4.572,0.538523060517,1471,1541,0.95457495133,101,592,693,1330,251,23,829,689,5511
Bo Barnes,25.0,3,0,25,3,8,0.375,1,4,0.25,2,4,0.5,0.4375,0,0,0.0,0,2,2,1,1,0,1,1,7
Bo Spencer,0.0,104,12,2478,438,1144,0.382867132867,154,536,0.287313432836,284,608,1.989,0.450174825175,138,178,0.775280898876,36,284,320,356,126,20,232,192,1168
Boban Marjanovic,27.0,3,3,79,33,41,0.80487804878,0,0,0.0,33,41,0.805,0.80487804878,5,8,0.625,14,23,37,7,1,4,9,8,71
Bobby Jones,72.0,57,48,1899,300,635,0.472440944882,46,154,0.298701298701,254,481,1.515,0.508661417323,248,316,0.784810126582,152,274,426,133,73,30,152,242,894
Bobby Portis,21.0,1,1,39,12,24,0.5,1,4,0.25,11,20,0.55,0.520833333333,7,8,0.875,6,3,9,3,1,3,3,4,32
Bobby Ray Parks Jr.,22.0,32,4,426,55,129,0.426356589147,6,31,0.193548387097,49,98,0.5,0.449612403101,31,47,0.659574468085,24,37,61,26,18,3,21,46,147
Bobby Simmons,83.0,45,40,1463,238,495,0.480808080808,35,97,0.360824742268,203,398,1.613,0.516161616162,167,199,0.839195979899,99,225,324,98,40,15,110,178,678
Boo Jackson,0.0,100,38,2286,352,728,0.483516483516,0,2,0.0,352,726,1.969,0.483516483516,234,362,0.646408839779,234,332,566,74,46,28,118,226,938
Booker Woodfox,104.0,190,28,4123,760,1725,0.440579710145,319,750,0.425333333333,441,975,1.8,0.533043478261,320,369,0.867208672087,61,287,348,341,141,4,200,218,2159
Boris Dallo,22.0,46,19,1082,142,336,0.422619047619,24,93,0.258064516129,118,243,0.486,0.458333333333,54,77,0.701298701299,35,162,197,179,34,2,130,58,362
Boubacar Moungoro,43.0,90,8,1307,134,392,0.341836734694,98,303,0.323432343234,36,89,0.843,0.466836734694,29,40,0.725,15,123,138,63,47,12,52,148,395
Bracey Wright,21.0,30,30,1127,218,473,0.46088794926,47,110,0.427272727273,171,363,0.471,0.510570824524,176,220,0.8,22,95,117,124,28,10,83,73,659
Brad Buckman,23.0,42,2,723,97,255,0.380392156863,11,40,0.275,86,215,0.4,0.401960784314,74,104,0.711538461538,72,108,180,21,17,32,46,103,279
Brad Byerson,0.0,5,0,49,10,15,0.666666666667,0,0,0.0,10,15,0.667,0.666666666667,3,12,0.25,7,3,10,2,1,4,4,11,23
Brad Stricker,0.0,88,22,1130,88,154,0.571428571429,0,2,0.0,88,152,1.737,0.571428571429,60,118,0.508474576271,76,140,216,36,20,28,52,192,236
Brad Wanamaker,0.0,15,2,291,32,70,0.457142857143,0,3,0.0,32,67,0.478,0.457142857143,19,22,0.863636363636,9,23,32,33,8,3,21,16,83
Brady Heslip,50.0,68,46,1998,430,942,0.456475583864,295,690,0.427536231884,135,252,1.08,0.613057324841,105,127,0.826771653543,23,109,132,159,55,1,78,112,1260
Brady Morningstar,0.0,102,20,2148,264,649,0.406779661017,82,218,0.376146788991,182,431,1.625,0.469953775039,89,106,0.839622641509,37,151,188,182,84,7,133,136,699
Branden Dawson,111.0,91,13,2103,449,886,0.506772009029,8,22,0.363636363636,441,864,2.503,0.511286681716,116,208,0.557692307692,218,303,521,113,119,61,134,160,1022
Brandin Knight,45.0,60,59,1532,218,482,0.452282157676,11,41,0.268292682927,207,441,0.931,0.463692946058,87,133,0.654135338346,40,128,168,297,107,7,124,160,534
Brandis Raley-Ross,29.0,8,3,154,13,28,0.464285714286,4,12,0.333333333333,9,16,0.563,0.535714285714,3,3,1.0,3,13,16,9,3,0,4,19,33
Brandon Armstrong,104.0,48,0,886,146,350,0.417142857143,28,86,0.325581395349,118,264,1.51,0.457142857143,38,50,0.76,16,56,72,54,18,6,44,84,358
Brandon Ashley,21.0,33,33,1045,184,404,0.455445544554,46,117,0.393162393162,138,287,0.481,0.512376237624,73,96,0.760416666667,37,186,223,68,32,45,81,134,487
Brandon Bass,20.0,1,0,26,7,13,0.538461538462,0,0,0.0,7,13,0.538,0.538461538462,2,4,0.5,4,1,5,0,0,2,1,1,16
Brandon Bowdry,0.0,13,0,92,8,22,0.363636363636,1,6,0.166666666667,7,16,0.875,0.386363636364,14,19,0.736842105263,4,15,19,7,1,1,9,12,31
Brandon Bowman,45.0,61,46,1907,332,663,0.500754147813,30,78,0.384615384615,302,585,1.038,0.523378582202,142,228,0.622807017544,137,248,385,136,69,39,149,151,836
Brandon Brooks,0.0,37,4,549,56,128,0.4375,8,31,0.258064516129,48,97,0.711,0.46875,20,22,0.909090909091,13,41,54,103,18,7,48,39,140
Brandon Costner,0.0,124,99,3498,654,1499,0.436290860574,217,611,0.355155482815,437,888,1.474,0.508672448299,490,670,0.731343283582,154,559,713,253,68,81,268,391,2015
Brandon Cotton,0.0,2,0,40,8,24,0.333333333333,0,1,0.0,8,23,0.348,0.333333333333,6,6,1.0,1,1,2,2,3,0,0,3,22
Brandon Dean,81.0,75,52,2230,267,587,0.454855195911,84,209,0.401913875598,183,378,1.231,0.526405451448,111,153,0.725490196078,45,170,215,271,108,25,129,222,729
Brandon Ewing,0.0,37,17,910,103,245,0.420408163265,7,27,0.259259259259,96,218,0.44,0.434693877551,68,83,0.819277108434,17,107,124,173,19,7,65,72,281
Brandon Fields,159.0,194,98,5572,1060,2416,0.438741721854,160,556,0.287769784173,900,1860,2.962,0.471854304636,542,738,0.734417344173,108,558,666,840,150,6,502,398,2822
Brandon Freeman,23.0,4,0,48,12,22,0.545454545455,2,4,0.5,10,18,0.556,0.590909090909,6,7,0.857142857143,2,9,11,3,2,0,2,7,32
Brandon Hawkins,24.0,5,0,55,2,8,0.25,0,0,0.0,2,8,0.25,0.25,3,4,0.75,2,5,7,5,4,0,7,8,7
Brandon Heath,0.0,82,64,2612,441,1010,0.436633663366,128,365,0.350684931507,313,645,0.95,0.5,153,212,0.721698113208,68,245,313,392,121,8,212,151,1163
Brandon Jennings,26.0,1,1,27,4,9,0.444444444444,2,5,0.4,2,4,0.5,0.555555555556,1,2,0.5,0,3,3,12,0,0,5,2,11
Brandon Johnson,0.0,25,2,490,52,156,0.333333333333,11,54,0.203703703704,41,102,0.402,0.36858974359,37,45,0.822222222222,13,39,52,53,26,0,42,57,152
Brandon Kurtz,97.0,127,83,3016,513,1148,0.446864111498,3,12,0.25,510,1136,1.785,0.448170731707,401,531,0.755178907721,284,524,808,100,97,112,224,457,1430
Brandon Mason,24.0,24,4,412,52,154,0.337662337662,18,61,0.295081967213,34,93,0.366,0.396103896104,25,33,0.757575757576,15,24,39,20,13,2,17,41,147
Brandon Paul,45.0,45,24,1152,217,468,0.463675213675,90,232,0.387931034483,127,236,0.547,0.559829059829,133,168,0.791666666667,33,162,195,80,51,21,90,101,657
Brandon Provost,24.0,15,1,317,33,73,0.452054794521,12,37,0.324324324324,21,36,0.583,0.534246575342,18,21,0.857142857143,9,16,25,24,12,2,18,23,96
Brandon Robinson,97.0,130,73,3176,487,939,0.51863684771,2,29,0.0689655172414,485,910,2.077,0.519701810437,240,335,0.716417910448,322,336,658,167,184,101,167,382,1216
Brandon Smith,0.0,7,2,56,4,11,0.363636363636,0,2,0.0,4,9,0.444,0.363636363636,3,4,0.75,4,9,13,2,0,5,4,4,11
Brandon Triche,75.0,96,24,1852,238,556,0.428057553957,70,192,0.364583333333,168,364,1.421,0.491007194245,114,152,0.75,48,158,206,170,52,16,98,170,660
Brandon Wallace,0.0,151,72,4061,509,1141,0.446099912358,99,300,0.33,410,841,3.212,0.489482909728,159,266,0.597744360902,306,672,978,313,136,256,188,366,1276
Brandon Williams,27.0,41,41,1325,186,440,0.422727272727,39,99,0.393939393939,147,341,0.431,0.467045454545,118,153,0.771241830065,45,125,170,93,37,10,113,128,529
Brandon Young,23.0,19,4,353,34,87,0.390804597701,8,24,0.333333333333,26,63,0.413,0.436781609195,39,47,0.829787234043,8,42,50,42,24,4,21,27,115
Brannen Greene,66.0,48,0,486,66,144,0.458333333333,30,74,0.405405405405,36,70,1.575,0.5625,26,32,0.8125,6,86,92,18,6,2,38,42,188
Brayden Billbe,0.0,6,0,75,8,14,0.571428571429,0,0,0.0,8,14,0.571,0.571428571429,2,6,0.333333333333,2,14,16,4,1,0,4,14,18
Brendon Knox,0.0,5,1,65,7,16,0.4375,0,0,0.0,7,16,0.438,0.4375,1,3,0.333333333333,5,9,14,0,1,2,3,11,15
Brent Petway,0.0,93,72,2506,331,636,0.520440251572,50,160,0.3125,281,476,1.181,0.559748427673,106,173,0.612716763006,111,262,373,121,59,171,109,259,818
Brent Wright,23.0,27,1,320,37,80,0.4625,0,3,0.0,37,77,0.481,0.4625,31,37,0.837837837838,22,49,71,16,12,1,26,48,105
Brian Barkdoll,0.0,29,3,212,15,33,0.454545454545,0,0,0.0,15,33,0.455,0.454545454545,5,7,0.714285714286,14,30,44,5,4,3,6,37,35
Brian Brown,49.0,22,3,419,65,135,0.481481481481,4,24,0.166666666667,61,111,1.035,0.496296296296,47,60,0.783333333333,8,47,55,37,7,7,42,27,181
Brian Butch,0.0,171,150,5115,819,1812,0.451986754967,268,767,0.349413298566,551,1045,3.107,0.525938189845,380,564,0.673758865248,440,1229,1669,273,133,145,302,497,2286
Brian Chase,75.0,85,72,2923,491,1157,0.42437337943,207,513,0.40350877193,284,644,1.239,0.513828867761,191,210,0.909523809524,38,293,331,322,100,3,143,144,1380
Brian Collins,22.0,7,0,123,9,27,0.333333333333,0,5,0.0,9,22,0.409,0.333333333333,18,28,0.642857142857,5,9,14,17,2,1,9,11,36
Brian Cusworth,0.0,3,0,11,0,0,0.0,0,0,0.0,0,0,0.0,0.0,0,0,0.0,0,2,2,2,0,1,0,2,0
Brian Evans,0.0,40,6,790,110,232,0.474137931034,1,10,0.1,109,222,0.899,0.476293103448,92,112,0.821428571429,23,54,77,71,31,1,50,36,313
Brian Greene,0.0,23,7,606,94,213,0.441314553991,33,99,0.333333333333,61,114,0.535,0.518779342723,40,48,0.833333333333,26,88,114,27,20,11,43,69,261
Brian Hamilton,0.0,219,55,5485,690,1444,0.47783933518,26,108,0.240740740741,664,1336,2.946,0.486842105263,601,981,0.612640163099,361,660,1021,385,358,95,409,667,2007
Brian Harper,0.0,26,0,194,32,76,0.421052631579,2,10,0.2,30,66,1.273,0.434210526316,2,8,0.25,14,20,34,6,4,6,16,38,68
Brian Jackson,135.0,180,154,4857,628,1384,0.453757225434,1,8,0.125,627,1376,2.015,0.45411849711,506,637,0.794348508634,282,690,972,355,152,148,353,687,1763
Brian Laing,0.0,2,0,35,7,11,0.636363636364,0,0,0.0,7,11,0.636,0.636363636364,4,6,0.666666666667,3,5,8,3,1,1,1,3,18
Brian Leggett,0.0,24,6,421,41,105,0.390476190476,2,5,0.4,39,100,0.39,0.4,14,29,0.48275862069,33,52,85,11,8,9,18,31,98
Brian Morrison,0.0,57,2,581,89,237,0.37552742616,32,100,0.32,57,137,1.637,0.443037974684,24,31,0.774193548387,5,52,57,75,13,0,54,84,234
Brian Wardle,22.0,45,19,535,49,139,0.352517985612,3,15,0.2,46,124,0.371,0.363309352518,16,23,0.695652173913,25,49,74,38,11,4,37,80,117
Brian Wethers,0.0,2,0,43,7,19,0.368421052632,3,8,0.375,4,11,0.364,0.447368421053,2,2,1.0,1,5,6,1,1,0,3,4,19
Briante Weber,47.0,59,40,1946,316,687,0.459970887918,57,153,0.372549019608,259,534,0.969,0.501455604076,121,159,0.761006289308,71,309,380,344,160,9,147,152,810
Brice Johnson,0.0,6,0,116,31,63,0.492063492063,1,6,0.166666666667,30,57,0.526,0.5,10,14,0.714285714286,12,27,39,2,2,9,5,19,73
Britton Johnsen,52.0,42,34,1287,206,453,0.454746136865,19,63,0.301587301587,187,390,0.922,0.475717439294,142,190,0.747368421053,64,184,248,76,32,17,87,144,573
Brock Gillespie,51.0,46,13,865,121,275,0.44,44,109,0.403669724771,77,166,0.799,0.52,25,43,0.581395348837,19,50,69,78,30,2,89,62,311
Bruce Massey,126.0,81,16,1298,174,375,0.464,20,64,0.3125,154,311,2.487,0.490666666667,65,104,0.625,89,110,199,136,73,6,66,127,433
Bruce Price,0.0,5,0,36,3,8,0.375,2,3,0.666666666667,1,5,0.2,0.5,5,9,0.555555555556,3,3,6,5,2,0,3,6,13
Bruno Caboclo,60.0,78,68,2252,335,833,0.402160864346,141,423,0.333333333333,194,410,1.231,0.486794717887,93,130,0.715384615385,89,348,437,107,75,112,127,226,904
Bryan Bracey,48.0,7,2,77,7,27,0.259259259259,1,6,0.166666666667,6,21,0.286,0.277777777778,6,9,0.666666666667,2,8,10,2,2,1,3,7,21
Bryan Davis,0.0,50,8,1006,169,342,0.494152046784,0,3,0.0,169,339,0.499,0.494152046784,139,206,0.674757281553,134,171,305,57,42,27,113,162,477
Bryan Lucas,49.0,94,40,2419,398,774,0.514211886305,21,62,0.338709677419,377,712,1.065,0.527777777778,210,271,0.774907749077,180,443,623,57,57,22,138,259,1027
Bryant Austin,0.0,10,0,38,4,14,0.285714285714,0,4,0.0,4,10,0.4,0.285714285714,8,8,1.0,4,3,7,0,1,0,3,2,16
Bryant Matthews,95.0,100,38,2645,298,718,0.41504178273,26,95,0.273684210526,272,623,1.709,0.433147632312,444,618,0.718446601942,246,275,521,168,161,25,235,406,1066
Bryant Voiles,49.0,35,0,358,35,98,0.357142857143,22,66,0.333333333333,13,32,1.046,0.469387755102,10,17,0.588235294118,18,37,55,21,13,7,14,47,102
Bryce Cotton,45.0,40,40,1565,301,631,0.477020602219,105,232,0.452586206897,196,399,1.035,0.560221870048,171,189,0.904761904762,44,135,179,182,50,6,98,89,878
Bryce Dejean-Jones,23.0,9,7,282,56,131,0.427480916031,20,59,0.338983050847,36,72,0.5,0.503816793893,41,51,0.803921568627,15,31,46,20,18,2,20,29,173
Bryce Sheldon,0.0,6,0,58,3,14,0.214285714286,0,4,0.0,3,10,0.3,0.214285714286,2,2,1.0,0,2,2,3,1,0,1,5,8
Bryn Forbes,23.0,19,19,674,158,315,0.501587301587,56,122,0.459016393443,102,193,0.528,0.590476190476,73,84,0.869047619048,7,59,66,51,25,2,47,43,445
Bryson Fonville,22.0,49,7,797,98,229,0.427947598253,29,81,0.358024691358,69,148,0.466,0.491266375546,9,15,0.6,16,39,55,121,32,5,56,82,234
Bryson McKenzie,98.0,90,28,1215,162,292,0.554794520548,0,0,0.0,162,292,2.247,0.554794520548,55,108,0.509259259259,152,225,377,18,31,96,102,243,379
Bubu Palo,118.0,159,87,4027,444,1044,0.425287356322,72,201,0.358208955224,372,843,2.172,0.459770114943,599,785,0.763057324841,86,335,421,494,114,8,321,391,1559
Byron Eaton,0.0,2,0,18,1,7,0.142857142857,0,1,0.0,1,6,0.167,0.142857142857,0,0,0.0,0,4,4,1,0,0,5,4,2
Byron Mouton,26.0,46,23,1098,152,300,0.506666666667,2,7,0.285714285714,150,293,0.512,0.51,119,159,0.748427672956,65,68,133,71,37,5,74,99,425
Byron Mullens,92.0,79,65,2189,391,889,0.439820022497,71,210,0.338095238095,320,679,1.903,0.479752530934,159,229,0.694323144105,145,421,566,89,49,62,173,183,1012
Byron Wesley,23.0,13,0,102,16,26,0.615384615385,0,1,0.0,16,25,0.64,0.615384615385,4,5,0.8,5,17,22,2,1,1,6,9,36
C.J. Black,0.0,30,17,466,64,158,0.405063291139,0,3,0.0,64,155,0.413,0.405063291139,63,83,0.759036144578,49,68,117,9,15,16,33,68,191
C.J. Fair,47.0,100,63,3043,574,1188,0.483164983165,80,247,0.323886639676,494,941,1.05,0.516835016835,268,345,0.776811594203,145,487,632,136,105,65,189,206,1496
C.J. McCollum,22.0,2,0,41,17,36,0.472222222222,1,9,0.111111111111,16,27,0.593,0.486111111111,2,2,1.0,2,5,7,7,3,0,6,5,37
C.J. Miles,37.0,19,9,562,96,208,0.461538461538,30,78,0.384615384615,66,130,1.035,0.533653846154,56,78,0.717948717949,25,56,81,32,21,8,38,55,278
C.J. Watson,23.0,16,12,607,127,252,0.503968253968,18,45,0.4,109,207,0.527,0.539682539683,148,166,0.89156626506,19,68,87,92,29,3,56,53,420
C.J. Wilcox,125.0,51,37,1599,318,682,0.466275659824,154,367,0.41961852861,164,315,2.783,0.57917888563,108,133,0.812030075188,22,174,196,134,40,16,74,107,898
C.J. Williams,49.0,99,65,2913,506,1068,0.473782771536,204,497,0.41046277666,302,571,1.051,0.569288389513,129,161,0.801242236025,96,338,434,186,113,73,114,278,1345
CJ Aiken,0.0,6,1,102,12,23,0.521739130435,0,2,0.0,12,21,0.571,0.521739130435,4,6,0.666666666667,10,13,23,1,2,5,4,12,28
CJ Giles,99.0,54,18,1151,208,380,0.547368421053,0,8,0.0,208,372,1.688,0.547368421053,101,140,0.721428571429,115,227,342,24,32,75,69,184,517
CJ Leslie,91.0,133,43,3016,598,1220,0.490163934426,33,150,0.22,565,1070,2.079,0.50368852459,348,544,0.639705882353,225,552,777,175,106,87,258,267,1577
Cady Lallane,23.0,50,28,1305,246,524,0.469465648855,61,181,0.337016574586,185,343,0.539,0.527671755725,110,161,0.683229813665,129,250,379,46,24,64,98,151,663
Calvin Bowman,25.0,4,0,13,0,5,0.0,0,0,0.0,0,5,0.0,0.0,4,4,1.0,2,1,3,0,0,1,0,3,4
Cam Griffin,45.0,21,0,182,22,44,0.5,1,1,1.0,21,43,0.985,0.511363636364,11,19,0.578947368421,16,19,35,3,6,1,8,18,56
Cam Tatum,0.0,8,0,147,20,57,0.350877192982,8,28,0.285714285714,12,29,0.414,0.421052631579,7,10,0.7,2,12,14,28,14,3,12,12,55
Cameron Ayers,98.0,95,29,2119,205,565,0.362831858407,156,452,0.345132743363,49,113,1.526,0.500884955752,49,58,0.844827586207,52,155,207,111,58,6,49,88,615
Cameron Bairstow,25.0,5,4,133,28,59,0.474576271186,0,2,0.0,28,57,0.491,0.474576271186,14,17,0.823529411765,10,30,40,6,4,3,13,13,70
Cameron Bennerman,0.0,16,8,499,68,149,0.456375838926,18,47,0.382978723404,50,102,0.895,0.51677852349,19,26,0.730769230769,6,29,35,29,16,2,21,35,173
Cameron Jones,150.0,241,142,6994,1281,2800,0.4575,183,492,0.371951219512,1098,2308,2.844,0.490178571429,621,757,0.82034346103,189,604,793,623,256,24,435,513,3366
Cameron Moore,24.0,8,0,120,14,38,0.368421052632,1,4,0.25,13,34,0.382,0.381578947368,2,6,0.333333333333,9,24,33,10,3,6,4,18,31
Cameron Payne,87.0,12,8,330,86,207,0.415458937198,30,90,0.333333333333,56,117,1.86,0.487922705314,29,38,0.763157894737,3,44,47,72,22,1,19,25,231
Carl Edwards,0.0,3,0,62,10,23,0.434782608696,2,6,0.333333333333,8,17,0.471,0.478260869565,1,3,0.333333333333,7,3,10,7,3,2,1,6,23
Carl Elliott,0.0,142,105,4805,799,1818,0.439493949395,128,415,0.30843373494,671,1403,1.904,0.474697469747,294,398,0.738693467337,192,495,687,530,340,23,382,374,2020
Carl English,45.0,93,31,2273,404,936,0.431623931624,71,191,0.371727748691,333,745,0.868,0.469551282051,200,268,0.746268656716,67,228,295,189,89,13,156,205,1079
Carl Ona-Embo,27.0,6,0,53,4,12,0.333333333333,3,7,0.428571428571,1,5,0.2,0.458333333333,2,3,0.666666666667,0,6,6,7,0,0,3,6,13
Carldell Johnson,166.0,230,107,5758,640,1476,0.433604336043,218,551,0.395644283122,422,925,2.766,0.507452574526,263,345,0.76231884058,105,501,606,993,274,12,384,477,1761
Carleton Scott,0.0,48,35,1410,188,479,0.39248434238,109,295,0.369491525424,79,184,0.429,0.506263048017,70,83,0.843373493976,44,225,269,86,66,48,50,137,555
Carlon Brown,0.0,64,12,1450,252,624,0.403846153846,66,218,0.302752293578,186,406,1.251,0.456730769231,134,182,0.736263736264,48,168,216,120,44,18,114,110,704
Carlos Emory,0.0,5,0,18,2,9,0.222222222222,0,4,0.0,2,5,0.4,0.222222222222,2,2,1.0,1,2,3,1,2,0,3,5,6
Carlos English,0.0,81,1,944,85,274,0.310218978102,28,112,0.25,57,162,1.064,0.361313868613,56,79,0.708860759494,10,54,64,168,32,0,80,57,254
Carlos Hurt,22.0,11,10,346,27,102,0.264705882353,17,53,0.320754716981,10,49,0.204,0.348039215686,19,21,0.904761904762,7,39,46,48,6,1,17,25,90
Carlos Lopez-Sosa,26.0,38,2,567,90,143,0.629370629371,0,1,0.0,90,142,0.634,0.629370629371,41,64,0.640625,47,93,140,42,13,20,47,72,221
Carlos Medlock,0.0,2,0,12,2,8,0.25,0,4,0.0,2,4,0.5,0.25,0,0,0.0,0,0,0,1,1,0,1,1,4
Carlos Powell,0.0,81,75,3187,613,1255,0.488446215139,72,199,0.361809045226,541,1056,1.033,0.517131474104,514,666,0.771771771772,94,378,472,393,120,30,282,278,1812
Carlos Strong,0.0,5,2,58,3,14,0.214285714286,1,5,0.2,2,9,0.222,0.25,0,0,0.0,4,4,8,3,1,0,7,9,7
Carlos Wheeler,0.0,130,51,3373,541,1062,0.509416195857,18,81,0.222222222222,523,981,1.6,0.517890772128,363,502,0.723107569721,228,622,850,185,103,65,280,355,1463
Carrick Felix,73.0,48,34,1167,170,388,0.438144329897,30,119,0.252100840336,140,269,1.58,0.476804123711,81,135,0.6,53,154,207,79,55,22,83,135,451
Cartier Martin,203.0,128,103,3763,673,1547,0.435035552683,236,617,0.382495948136,437,930,3.298,0.511312217195,359,444,0.808558558559,110,446,556,201,118,39,251,346,1941
Casey Mitchell,0.0,29,10,830,169,379,0.445910290237,60,155,0.387096774194,109,224,0.878,0.525065963061,75,88,0.852272727273,29,53,82,48,29,5,61,54,473
Casey Prather,23.0,45,30,1132,213,454,0.469162995595,27,87,0.310344827586,186,367,0.507,0.498898678414,74,105,0.704761904762,36,133,169,76,54,15,76,123,527
Casey Sanders,25.0,31,1,543,44,120,0.366666666667,0,0,0.0,44,120,0.367,0.366666666667,30,51,0.588235294118,53,100,153,10,10,53,31,76,118
Cat Barber,66.0,80,78,2742,496,1156,0.429065743945,78,228,0.342105263158,418,928,1.351,0.462802768166,242,344,0.703488372093,32,224,256,372,88,6,248,204,1312
Cecil Brown,0.0,73,28,2037,340,715,0.475524475524,92,206,0.446601941748,248,509,0.975,0.53986013986,184,223,0.825112107623,20,170,190,152,55,9,101,116,956
Cedric Bozeman,132.0,106,89,4020,576,1266,0.454976303318,113,334,0.338323353293,463,932,2.448,0.499605055292,403,500,0.806,114,529,643,551,144,14,281,319,1668
Cedric Henderson,84.0,73,55,2144,375,932,0.402360515021,27,100,0.27,348,832,1.287,0.416845493562,222,295,0.752542372881,69,200,269,125,93,44,193,197,999
Cedric Jackson,95.0,134,124,4589,621,1399,0.44388849178,111,356,0.311797752809,510,1043,1.899,0.48355968549,518,789,0.656527249683,158,587,745,980,278,34,442,385,1871
Cedric Simmons,90.0,31,27,933,172,332,0.518072289157,0,0,0.0,172,332,2.033,0.518072289157,89,166,0.536144578313,70,136,206,18,23,90,65,115,433
Cedric Suitt,51.0,40,10,754,52,112,0.464285714286,0,0,0.0,52,112,1.043,0.464285714286,38,60,0.633333333333,42,101,143,4,9,79,47,149,142
Cezary Trybanski,112.0,152,46,2795,289,485,0.59587628866,0,1,0.0,289,484,2.364,0.59587628866,222,306,0.725490196078,224,386,610,73,44,322,153,345,800
Chace Stanback,0.0,12,2,196,27,71,0.380281690141,16,37,0.432432432432,11,34,0.324,0.492957746479,3,4,0.75,12,23,35,11,7,3,6,16,73
Chad Bell,120.0,72,2,600,42,100,0.42,0,0,0.0,42,100,1.734,0.42,36,66,0.545454545455,38,72,110,10,8,18,42,118,120
Chad Toppert,54.0,84,22,2138,282,615,0.458536585366,203,424,0.478773584906,79,191,0.727,0.623577235772,85,100,0.85,48,218,266,104,51,6,61,172,852
Chadrack Lufile,24.0,9,0,39,6,13,0.461538461538,0,2,0.0,6,11,0.545,0.461538461538,1,4,0.25,1,12,13,2,1,1,3,4,13
Chamberlain Oguchi,0.0,56,34,1382,176,448,0.392857142857,96,256,0.375,80,192,0.84,0.5,93,115,0.808695652174,23,133,156,82,30,13,78,88,541
Charles Gaines,0.0,23,21,838,138,261,0.528735632184,0,0,0.0,138,261,0.529,0.528735632184,71,102,0.696078431373,75,165,240,17,24,15,50,76,347
Charles Garcia,163.0,143,51,3297,652,1266,0.515007898894,1,14,0.0714285714286,651,1252,3.356,0.515402843602,479,830,0.577108433735,267,527,794,126,67,70,348,459,1784
Charles Hinkle,78.0,28,2,414,56,130,0.430769230769,28,72,0.388888888889,28,58,1.463,0.538461538462,20,30,0.666666666667,14,52,66,32,4,8,20,32,160
Charles Jackson,22.0,6,1,131,19,33,0.575757575758,0,0,0.0,19,33,0.576,0.575757575758,5,11,0.454545454545,22,25,47,5,6,7,5,20,43
Charles Okwandu,0.0,13,4,151,10,37,0.27027027027,0,0,0.0,10,37,0.27,0.27027027027,8,15,0.533333333333,14,30,44,5,3,13,10,38,28
Charlie Parker,0.0,35,12,638,87,181,0.480662983425,9,26,0.346153846154,78,155,1.003,0.505524861878,41,69,0.594202898551,31,43,74,57,33,7,29,37,224
Charlie Westbrook,0.0,74,4,1402,264,604,0.437086092715,34,118,0.28813559322,230,486,1.441,0.465231788079,120,160,0.75,40,120,160,138,56,18,90,122,682
Chas McFarland,0.0,64,29,984,157,324,0.484567901235,0,1,0.0,157,323,1.805,0.484567901235,89,127,0.700787401575,83,173,256,44,28,34,104,152,403
Chase Behanan,94.0,83,9,1276,259,503,0.514910536779,2,13,0.153846153846,257,490,2.085,0.51689860835,146,221,0.660633484163,185,210,395,53,66,9,112,184,666
Chase Tapley,0.0,12,0,179,28,60,0.466666666667,8,28,0.285714285714,20,32,0.625,0.533333333333,2,3,0.666666666667,2,12,14,11,9,1,6,12,66
Chasson Randle,69.0,42,42,1362,284,666,0.426426426426,110,264,0.416666666667,174,402,1.363,0.509009009009,184,226,0.814159292035,28,120,148,158,44,6,148,142,862
Chaz Crawford,0.0,1,0,5,0,0,0.0,0,0,0.0,0,0,0.0,0.0,0,0,0.0,0,0,0,0,1,0,1,1,0
Chaz McCrommon,0.0,11,6,276,35,74,0.472972972973,9,21,0.428571428571,26,53,0.491,0.533783783784,10,14,0.714285714286,9,32,41,12,10,7,12,23,89
Chaz Williams,69.0,12,0,194,18,66,0.272727272727,8,26,0.307692307692,10,40,0.544,0.333333333333,6,8,0.75,6,12,18,50,2,4,20,32,50
Cheick Diallo,80.0,52,42,1448,334,666,0.501501501502,0,8,0.0,334,658,2.164,0.501501501502,110,146,0.753424657534,92,348,440,36,28,126,86,180,778
Cheikh Samb,47.0,30,23,763,138,274,0.503649635036,3,9,0.333333333333,135,265,1.032,0.509124087591,52,71,0.732394366197,64,143,207,21,21,113,46,102,331
Chet Mason,52.0,63,9,1456,200,422,0.473933649289,6,19,0.315789473684,194,403,0.957,0.481042654028,135,187,0.72192513369,121,144,265,116,56,12,107,136,541
Cheyne Gadson,270.0,246,127,7185,1183,2556,0.462832550861,147,424,0.346698113208,1036,2132,4.843,0.491588419405,590,731,0.807113543092,125,591,716,1080,202,13,615,534,3103
Chinanu Onuaku,20.0,43,40,1202,236,376,0.627659574468,2,7,0.285714285714,234,369,0.634,0.630319148936,112,153,0.732026143791,153,304,457,92,51,68,115,172,586
Chris Alexander,0.0,51,37,1640,190,396,0.479797979798,0,1,0.0,190,395,0.873,0.479797979798,158,231,0.683982683983,263,280,543,49,25,102,110,206,538
Chris Allen,153.0,158,22,3476,624,1530,0.407843137255,266,678,0.392330383481,358,852,2.581,0.49477124183,222,272,0.816176470588,62,252,314,308,58,20,214,282,1736
Chris Andersen,23.0,3,1,42,4,9,0.444444444444,0,1,0.0,4,8,0.5,0.444444444444,6,8,0.75,2,9,11,1,3,5,3,6,14
Chris Anderson,52.0,42,19,711,86,157,0.547770700637,3,11,0.272727272727,83,146,0.981,0.557324840764,44,64,0.6875,86,109,195,25,28,37,39,146,219
Chris Babb,47.0,78,74,2801,359,870,0.412643678161,200,546,0.3663003663,159,324,0.955,0.527586206897,170,215,0.790697674419,68,383,451,233,79,21,88,162,1088
Chris Brooks,23.0,11,1,231,36,61,0.590163934426,1,2,0.5,35,59,0.593,0.598360655738,32,43,0.744186046512,13,17,30,5,7,4,19,31,105
Chris Carrawell,24.0,56,39,1283,157,390,0.402564102564,9,35,0.257142857143,148,355,0.417,0.414102564103,85,119,0.714285714286,68,136,204,103,21,16,70,81,408
Chris Childress,0.0,10,0,45,0,6,0.0,0,0,0.0,0,6,0.0,0.0,3,4,0.75,4,6,10,1,0,0,1,8,3
Chris Christoffersen,72.0,50,10,662,96,188,0.510638297872,0,2,0.0,96,186,1.536,0.510638297872,30,80,0.375,66,96,162,20,8,42,46,162,222
Chris Cooper,0.0,47,1,816,74,164,0.451219512195,0,0,0.0,74,164,0.451,0.451219512195,35,60,0.583333333333,110,161,271,19,24,34,33,139,183
Chris Copeland,22.0,19,0,368,61,141,0.432624113475,42,91,0.461538461538,19,50,0.38,0.581560283688,27,34,0.794117647059,21,70,91,16,14,13,24,48,191
Chris Crawford,69.0,67,19,1698,202,551,0.366606170599,100,317,0.315457413249,102,234,1.307,0.457350272232,41,58,0.706896551724,27,208,235,236,58,19,106,141,545
Chris Crosby,23.0,6,0,30,0,7,0.0,0,3,0.0,0,4,0.0,0.0,0,0,0.0,1,3,4,1,1,0,1,6,0
Chris Daniels,0.0,46,34,1134,211,402,0.524875621891,25,89,0.280898876404,186,313,2.313,0.555970149254,110,161,0.683229813665,82,196,278,55,16,96,117,169,557
Chris Davis,0.0,169,8,2481,347,782,0.443734015345,75,220,0.340909090909,272,562,2.961,0.49168797954,138,199,0.693467336683,70,234,304,230,98,13,151,187,907
Chris Douglas-Roberts,82.0,33,33,1206,231,463,0.498920086393,40,103,0.388349514563,191,360,1.553,0.54211663067,163,181,0.900552486188,25,131,156,99,48,18,89,75,665
Chris Ellis,117.0,151,72,3107,333,775,0.429677419355,1,9,0.111111111111,332,766,2.17,0.430322580645,325,431,0.754060324826,372,532,904,106,69,107,226,524,992
Chris Fowler,0.0,5,0,48,7,13,0.538461538462,1,2,0.5,6,11,0.545,0.576923076923,7,10,0.7,0,2,2,7,2,2,4,8,22
Chris Garner,26.0,48,45,1166,121,374,0.323529411765,25,96,0.260416666667,96,278,0.345,0.356951871658,53,68,0.779411764706,32,96,128,195,62,7,111,112,320
Chris Hayes,0.0,3,0,53,8,16,0.5,0,1,0.0,8,15,0.533,0.5,4,6,0.666666666667,1,6,7,6,1,1,8,3,20
Chris Hines,25.0,3,0,6,0,2,0.0,0,2,0.0,0,0,0.0,0.0,0,0,0.0,0,0,0,0,0,0,0,1,0
Chris Holm,0.0,3,0,57,8,19,0.421052631579,0,0,0.0,8,19,0.421,0.421052631579,8,10,0.8,11,14,25,3,2,1,5,7,24
Chris Horton,22.0,49,11,913,123,204,0.602941176471,0,1,0.0,123,203,0.606,0.602941176471,59,98,0.602040816327,135,136,271,15,38,46,61,132,305
Chris Hunter,106.0,62,54,1841,421,780,0.539743589744,3,17,0.176470588235,418,763,2.037,0.541666666667,237,295,0.803389830508,201,324,525,46,41,68,127,220,1082
Chris Johnson,147.0,157,114,4859,839,1696,0.494693396226,214,586,0.365187713311,625,1110,3.458,0.557783018868,402,527,0.762808349146,344,658,1002,235,191,192,244,423,2294
Chris Kramer,0.0,42,25,1242,184,342,0.538011695906,18,49,0.367346938776,166,293,0.567,0.56432748538,181,221,0.819004524887,27,135,162,114,77,22,60,121,567
Chris Lofton,0.0,34,20,1178,194,405,0.479012345679,94,221,0.425339366516,100,184,0.543,0.595061728395,50,60,0.833333333333,11,108,119,77,73,3,36,64,532
Chris Lowe,0.0,38,2,568,60,154,0.38961038961,0,10,0.0,60,144,1.229,0.38961038961,28,36,0.777777777778,12,70,82,90,26,0,44,38,148
Chris Matthews,0.0,5,0,71,7,25,0.28,5,17,0.294117647059,2,8,0.25,0.38,2,2,1.0,1,4,5,6,1,0,4,7,21
Chris McCray,73.0,99,61,2787,331,774,0.427648578811,68,206,0.330097087379,263,568,1.379,0.47157622739,233,261,0.892720306513,74,293,367,349,145,19,158,270,963
Chris McCullough,63.0,86,70,2534,514,1152,0.446180555556,96,274,0.350364963504,418,878,1.455,0.487847222222,262,390,0.671794871795,176,430,606,138,98,70,186,272,1386
Chris Obekpa,23.0,31,0,468,68,127,0.535433070866,0,1,0.0,68,126,0.54,0.535433070866,23,43,0.53488372093,64,103,167,23,18,71,27,89,159
Chris Porter,105.0,126,32,2244,311,581,0.535283993115,2,8,0.25,309,573,1.606,0.537005163511,145,242,0.599173553719,241,334,575,109,143,28,93,288,769
Chris Quinn,29.0,25,23,810,123,259,0.474903474903,29,78,0.371794871795,94,181,0.519,0.530888030888,43,48,0.895833333333,9,55,64,152,33,6,42,61,318
Chris Richard,72.0,38,34,1133,175,332,0.527108433735,0,0,0.0,175,332,1.555,0.527108433735,57,101,0.564356435644,108,222,330,49,31,26,86,144,407
Chris Roberts,0.0,141,94,4270,628,1435,0.437630662021,150,478,0.313807531381,478,957,3.527,0.489895470383,383,470,0.814893617021,222,382,604,294,165,75,208,291,1789
Chris Robinson,81.0,108,54,2198,316,854,0.370023419204,94,272,0.345588235294,222,582,1.151,0.425058548009,134,174,0.770114942529,116,182,298,174,70,18,154,224,860
Chris Rodgers,69.0,62,2,1196,136,360,0.377777777778,10,46,0.217391304348,126,314,1.164,0.391666666667,210,260,0.807692307692,26,102,128,138,50,2,130,148,492
Chris Shumate,49.0,66,0,753,95,259,0.366795366795,35,95,0.368421052632,60,164,0.725,0.434362934363,43,52,0.826923076923,34,82,116,45,19,5,36,47,268
Chris Singleton,25.0,17,0,423,52,151,0.344370860927,19,64,0.296875,33,87,0.379,0.407284768212,33,47,0.702127659574,28,75,103,22,22,16,40,59,156
Chris Smith,26.0,23,8,478,62,175,0.354285714286,16,64,0.25,46,111,0.414,0.4,47,60,0.783333333333,20,57,77,42,8,1,38,38,187
Chris Taft,22.0,8,0,107,13,25,0.52,0,0,0.0,13,25,0.52,0.52,6,10,0.6,7,13,20,3,2,2,4,10,32
Chris Tang,20.0,9,1,68,4,18,0.222222222222,1,5,0.2,3,13,0.231,0.25,5,6,0.833333333333,1,5,6,2,2,0,3,2,14
Chris Udofia,23.0,45,24,1149,112,234,0.478632478632,0,1,0.0,112,233,0.481,0.478632478632,43,88,0.488636363636,99,149,248,67,44,43,58,145,267
Chris Walker,43.0,94,6,1600,285,479,0.594989561587,3,11,0.272727272727,282,468,1.201,0.598121085595,141,225,0.626666666667,215,296,511,66,51,105,109,222,714
Chris Wright,194.0,182,158,5995,1186,2416,0.490894039735,92,306,0.300653594771,1094,2110,4.243,0.509933774834,577,862,0.669373549884,396,831,1227,590,242,187,458,517,3041
Christian Eyenga,110.0,81,51,2318,411,877,0.468643101482,40,150,0.266666666667,371,727,2.674,0.491448118586,148,253,0.584980237154,91,312,403,100,62,110,171,170,1010
Christian Kabongo,0.0,8,3,184,32,67,0.477611940299,4,12,0.333333333333,28,55,0.509,0.507462686567,14,25,0.56,5,28,33,15,3,1,21,20,82
Christian Polk,0.0,32,8,755,108,289,0.373702422145,56,150,0.373333333333,52,139,0.374,0.470588235294,30,33,0.909090909091,8,58,66,51,17,0,42,70,302
Christian Watford,144.0,144,60,2946,356,954,0.373165618449,172,494,0.348178137652,184,460,2.008,0.463312368973,222,280,0.792857142857,142,442,584,162,84,52,162,218,1106
Christian Wood,41.0,50,38,1462,340,654,0.519877675841,34,138,0.246376811594,306,516,1.18,0.545871559633,192,269,0.71375464684,131,352,483,39,37,82,86,124,906
Christopher Ayer,0.0,215,39,3174,506,1059,0.477809254013,7,42,0.166666666667,499,1017,4.306,0.481114258735,368,514,0.715953307393,281,439,720,38,60,172,224,645,1387
Christopher Evans,26.0,33,28,1137,203,451,0.450110864745,56,156,0.358974358974,147,295,0.498,0.512195121951,121,171,0.707602339181,63,108,171,78,64,20,78,103,583
Chuck Davis,0.0,3,0,21,2,9,0.222222222222,1,2,0.5,1,7,0.143,0.277777777778,0,0,0.0,1,1,2,0,1,0,1,3,5
Chuck Eidson,23.0,32,7,707,84,193,0.435233160622,12,32,0.375,72,161,0.447,0.466321243523,56,73,0.767123287671,44,67,111,55,47,9,33,53,236
Chuck Hayes,22.0,15,13,483,65,120,0.541666666667,0,0,0.0,65,120,0.542,0.541666666667,32,47,0.68085106383,57,114,171,36,21,11,39,53,162
Chudney Gray,0.0,25,4,368,35,94,0.372340425532,8,23,0.347826086957,27,71,0.964,0.414893617021,27,35,0.771428571429,10,38,48,66,13,0,34,39,105
Chukwudiebere Maduabum,62.0,8,3,92,10,21,0.47619047619,0,0,0.0,10,21,0.813,0.47619047619,1,5,0.2,8,9,17,1,0,10,8,15,21
Clay Tucker,51.0,93,81,3316,565,1365,0.413919413919,192,507,0.378698224852,373,858,0.861,0.484249084249,246,311,0.790996784566,41,287,328,365,162,22,211,257,1568
Cleanthony Early,72.0,24,10,604,118,253,0.466403162055,27,74,0.364864864865,91,179,1.52,0.51976284585,47,76,0.618421052632,29,111,140,24,23,22,40,61,310
Cleveland Melvin,0.0,10,0,213,49,90,0.544444444444,1,3,0.333333333333,48,87,0.552,0.55,13,19,0.684210526316,13,28,41,13,2,3,12,20,112
Cliff Alexander,83.0,84,30,2272,539,1042,0.517274472169,16,66,0.242424242424,523,976,2.129,0.524952015355,230,314,0.732484076433,157,582,739,110,38,88,221,201,1324
Cliff Clinkscales,0.0,137,32,3498,387,865,0.447398843931,7,37,0.189189189189,380,828,1.852,0.451445086705,117,189,0.619047619048,62,227,289,715,111,26,181,170,898
Cliff Hammonds,30.0,46,9,1386,147,332,0.442771084337,54,171,0.315789473684,93,161,0.578,0.524096385542,34,57,0.59649122807,37,146,183,241,60,10,71,113,382
Cliff Hawkins,24.0,14,9,387,51,119,0.428571428571,5,21,0.238095238095,46,98,0.469,0.449579831933,26,42,0.619047619048,14,16,30,85,28,1,44,58,133
Cliff Tucker,0.0,13,1,236,35,83,0.421686746988,12,29,0.413793103448,23,54,0.426,0.493975903614,3,9,0.333333333333,10,35,45,20,8,7,12,22,85
Clifton Terry,27.0,12,1,61,6,20,0.3,1,1,1.0,5,19,0.263,0.325,6,10,0.6,5,8,13,3,3,2,4,11,19
Clint Capela,20.0,38,32,928,253,421,0.600950118765,0,3,0.0,253,418,0.605,0.600950118765,102,171,0.59649122807,151,217,368,29,29,113,70,98,608
Coby Karl,135.0,122,122,4525,624,1432,0.435754189944,223,613,0.363784665579,401,819,2.42,0.513617318436,520,653,0.796324655436,115,483,598,697,166,45,379,405,1991
Cody Toppert,23.0,16,2,228,22,65,0.338461538462,12,34,0.352941176471,10,31,0.323,0.430769230769,3,4,0.75,5,13,18,21,9,0,8,32,59
Cole Aldrich,22.0,21,21,615,86,158,0.544303797468,0,0,0.0,86,158,0.544,0.544303797468,45,56,0.803571428571,54,127,181,27,10,55,37,82,217
Coleman Collins,0.0,46,16,1142,186,384,0.484375,0,3,0.0,186,381,0.488,0.484375,145,193,0.751295336788,83,164,247,56,33,37,75,81,517
Collin Mangrum,0.0,4,0,47,4,8,0.5,2,5,0.4,2,3,0.667,0.625,0,0,0.0,0,2,2,1,3,0,5,6,10
Connor Atchley,0.0,172,54,3068,420,868,0.483870967742,78,206,0.378640776699,342,662,3.092,0.528801843318,206,262,0.786259541985,256,398,654,108,70,202,214,554,1124
Coreontae DeBerry,22.0,12,0,113,13,28,0.464285714286,0,0,0.0,13,28,0.464,0.464285714286,7,12,0.583333333333,9,18,27,5,4,4,8,20,33
Corey Allmond,0.0,80,14,1455,203,585,0.347008547009,136,401,0.339152119701,67,184,0.841,0.463247863248,62,83,0.746987951807,27,114,141,77,27,1,41,69,604
Corey Benjamin,24.0,38,29,1064,231,502,0.46015936255,36,84,0.428571428571,195,418,0.467,0.496015936255,134,177,0.757062146893,45,112,157,64,30,18,91,131,632
Corey Hawkins,72.0,78,52,1986,306,680,0.45,132,338,0.390532544379,174,342,1.364,0.547058823529,114,142,0.802816901408,32,200,232,158,70,16,84,136,858
Corey Minnifield,0.0,58,29,1748,293,655,0.447328244275,17,52,0.326923076923,276,603,0.855,0.460305343511,183,247,0.740890688259,62,206,268,81,34,36,124,170,786
Corey Sanders,49.0,8,0,141,9,24,0.375,0,0,0.0,9,24,0.864,0.375,4,8,0.5,11,23,34,6,4,5,9,20,22
Corey Santee,23.0,50,2,1270,222,553,0.401446654611,108,296,0.364864864865,114,257,0.444,0.499095840868,38,61,0.622950819672,15,60,75,87,36,2,44,64,590
Corey Stokes,0.0,1,0,21,0,3,0.0,0,2,0.0,0,1,0.0,0.0,2,2,1.0,1,2,3,0,0,0,0,3,2
Corey Walden,23.0,41,21,1068,164,316,0.518987341772,44,117,0.376068376068,120,199,0.603,0.588607594937,130,155,0.838709677419,18,111,129,164,49,3,95,97,502
Corey Williams,0.0,70,50,1846,350,676,0.51775147929,20,44,0.454545454545,330,632,1.56,0.532544378698,216,348,0.620689655172,54,208,262,262,86,10,216,172,936
Coron Williams,53.0,89,24,1580,195,457,0.426695842451,136,349,0.389684813754,59,108,1.12,0.575492341357,35,39,0.897435897436,32,99,131,113,26,9,54,103,561
Corsley Edwards,57.0,40,23,1119,196,444,0.441441441441,0,2,0.0,196,442,0.893,0.441441441441,159,192,0.828125,87,198,285,19,32,34,86,139,551
Cory Alexander,60.0,82,82,2901,462,1098,0.420765027322,88,268,0.328358208955,374,830,0.898,0.460837887067,340,416,0.817307692308,54,266,320,573,168,15,323,228,1352
Cory Higgins,45.0,35,33,1266,223,496,0.449596774194,51,137,0.372262773723,172,359,0.836,0.501008064516,120,139,0.863309352518,31,119,150,83,43,13,72,76,617
Cory Jefferson,75.0,63,55,1871,365,750,0.486666666667,53,133,0.398496240602,312,617,1.567,0.522,230,289,0.795847750865,154,405,559,68,42,57,86,200,1013
Cory Joseph,41.0,40,38,1463,242,528,0.458333333333,46,103,0.446601941748,196,425,0.936,0.501893939394,167,200,0.835,47,151,198,214,68,18,95,90,697
Cory Underwood,0.0,118,33,2143,348,750,0.464,1,9,0.111111111111,347,741,3.352,0.464666666667,159,242,0.657024793388,127,269,396,83,56,43,102,283,856
Cory Violette,0.0,50,40,1443,259,508,0.509842519685,3,12,0.25,256,496,0.516,0.512795275591,150,208,0.721153846154,129,224,353,92,51,36,104,135,671
Coty Clarke,23.0,44,16,1152,254,495,0.513131313131,76,187,0.406417112299,178,308,0.578,0.589898989899,133,168,0.791666666667,86,243,329,115,50,29,85,105,717
Courtney Eldridge,0.0,16,5,196,8,31,0.258064516129,0,9,0.0,8,22,0.364,0.258064516129,0,0,0.0,2,13,15,26,6,1,15,18,16
Courtney Fells,117.0,127,109,4086,679,1508,0.450265251989,231,655,0.352671755725,448,853,2.08,0.526856763926,161,202,0.79702970297,86,453,539,356,233,98,255,267,1750
Courtney Fortson,115.0,114,79,3953,647,1485,0.43569023569,149,395,0.377215189873,498,1090,2.243,0.485858585859,452,580,0.779310344828,115,397,512,716,226,9,324,282,1895
Courtney James,27.0,46,46,1567,162,348,0.465517241379,0,3,0.0,162,345,0.47,0.465517241379,99,170,0.582352941176,107,270,377,106,22,26,98,131,423
Courtney Pigram,0.0,36,15,938,161,368,0.4375,60,162,0.37037037037,101,206,0.49,0.51902173913,54,70,0.771428571429,10,67,77,89,34,5,56,74,436
Courtney Sims,102.0,103,75,3191,683,1174,0.581771720613,4,14,0.285714285714,679,1160,2.329,0.583475298126,464,627,0.740031897927,336,610,946,113,46,141,260,333,1834
Craig Austrie,0.0,5,0,95,14,36,0.388888888889,4,11,0.363636363636,10,25,0.4,0.444444444444,6,6,1.0,1,9,10,8,1,0,6,4,38
Craig Brackins,72.0,34,21,1071,212,474,0.447257383966,34,130,0.261538461538,178,344,1.583,0.483122362869,76,103,0.73786407767,47,199,246,67,21,30,46,82,534
Craig Smith,0.0,8,4,226,52,87,0.597701149425,0,0,0.0,52,87,0.598,0.597701149425,30,39,0.769230769231,14,40,54,12,9,4,16,26,134
Craig Winder,0.0,128,13,2438,454,1044,0.434865900383,109,327,0.333333333333,345,717,1.88,0.487068965517,260,342,0.760233918129,116,253,369,238,121,34,193,315,1277
Cristiano Felicio,47.0,5,5,133,33,55,0.6,4,10,0.4,29,45,1.224,0.636363636364,7,9,0.777777777778,13,21,34,5,3,8,14,17,77
Curtis Haywood,26.0,17,0,286,25,68,0.367647058824,0,4,0.0,25,64,0.391,0.367647058824,9,13,0.692307692308,22,36,58,18,4,1,16,33,59
Curtis Jerrells,0.0,60,59,2387,415,886,0.468397291196,94,241,0.390041493776,321,645,0.989,0.52144469526,254,331,0.767371601208,34,226,260,341,112,14,185,147,1178
Curtis Millage,23.0,1,0,6,0,2,0.0,0,0,0.0,0,2,0.0,0.0,0,0,0.0,0,1,1,0,0,0,2,2,0
Curtis Staples,53.0,54,14,1043,142,360,0.394444444444,58,161,0.360248447205,84,199,0.86,0.475,80,98,0.816326530612,10,50,60,40,27,0,38,89,422
Curtis Stinson,301.0,304,244,10964,1689,3716,0.454520990312,73,327,0.223241590214,1616,3389,5.411,0.464343379978,745,955,0.780104712042,328,1200,1528,2260,461,61,982,760,4196
Curtis Sumpter,0.0,27,15,545,61,157,0.388535031847,15,49,0.30612244898,46,108,0.426,0.436305732484,14,17,0.823529411765,36,76,112,29,19,22,49,69,151
Curtis Terry,0.0,17,1,249,22,69,0.31884057971,10,37,0.27027027027,12,32,0.712,0.391304347826,8,13,0.615384615385,5,23,28,13,2,0,17,25,62
Curtis Withers,0.0,130,67,3120,507,961,0.527575442248,1,12,0.0833333333333,506,949,2.21,0.528095733611,308,464,0.663793103448,311,538,849,129,125,82,264,380,1323
Cypheus Bunton,30.0,14,0,274,32,66,0.484848484848,2,8,0.25,30,58,0.517,0.5,3,16,0.1875,27,35,62,8,5,4,19,32,69
D'Andre Bell,0.0,42,13,648,79,173,0.456647398844,20,47,0.425531914894,59,126,0.48,0.514450867052,37,47,0.787234042553,28,77,105,27,24,4,45,86,215
D'Aundray Brown,0.0,24,0,272,26,66,0.393939393939,10,26,0.384615384615,16,40,0.4,0.469696969697,23,27,0.851851851852,12,19,31,13,8,1,12,22,85
D'Lancy Carter,0.0,2,0,13,2,4,0.5,0,0,0.0,2,4,0.5,0.5,0,0,0.0,0,5,5,0,0,0,2,3,4
D'Vauntes Smith-Rivera,72.0,14,0,138,14,52,0.269230769231,2,22,0.0909090909091,12,30,0.8,0.288461538462,6,10,0.6,4,16,20,10,4,0,14,6,36
D'or Fischer,24.0,26,0,513,65,112,0.580357142857,0,0,0.0,65,112,0.58,0.580357142857,24,29,0.827586206897,39,92,131,16,6,34,23,74,154
D.J. Kennedy,91.0,142,122,5309,764,1732,0.441108545035,165,455,0.362637362637,599,1277,1.853,0.488741339492,627,755,0.830463576159,190,884,1074,697,228,30,411,354,2320
D.J. Seeley,25.0,47,46,1646,307,631,0.486529318542,103,235,0.43829787234,204,396,0.515,0.568145800317,196,226,0.867256637168,44,150,194,242,73,7,141,112,913
D.J. Shumpert,51.0,23,1,334,25,48,0.520833333333,0,2,0.0,25,46,0.543,0.520833333333,11,28,0.392857142857,40,70,110,18,16,21,24,63,61
D.J. Stephens,75.0,76,58,1826,308,570,0.540350877193,70,210,0.333333333333,238,360,1.973,0.601754385965,110,150,0.733333333333,114,314,428,56,78,96,62,140,796
D.J. Strawberry,71.0,51,11,1521,270,588,0.459183673469,58,158,0.367088607595,212,430,1.515,0.508503401361,180,251,0.717131474104,39,117,156,213,69,14,128,144,778
D.J. White,45.0,16,15,582,130,220,0.590909090909,0,1,0.0,130,219,1.174,0.590909090909,52,60,0.866666666667,45,109,154,19,11,23,36,48,312
Da'Sean Butler,0.0,37,29,1098,146,339,0.430678466077,42,111,0.378378378378,104,228,0.456,0.492625368732,75,91,0.824175824176,54,118,172,73,34,11,35,70,409
Da'Shonte Riley,51.0,62,17,987,89,200,0.445,0,5,0.0,89,195,0.911,0.445,19,28,0.678571428571,54,167,221,50,21,89,61,184,197
DaJuan Summers,53.0,32,19,1078,230,521,0.441458733205,43,134,0.320895522388,187,387,1.056,0.482725527831,96,120,0.8,72,178,250,43,39,23,74,90,599
Dabo Kabov,0.0,10,0,61,4,22,0.181818181818,1,6,0.166666666667,3,16,0.188,0.204545454545,2,5,0.4,0,5,5,1,0,0,4,1,11
Daequan Cook,20.0,3,3,118,21,57,0.368421052632,9,22,0.409090909091,12,35,0.343,0.447368421053,7,10,0.7,6,15,21,11,4,1,7,11,58
Dahntay Jones,96.0,72,64,2462,399,740,0.539189189189,51,128,0.3984375,348,612,1.695,0.573648648649,345,433,0.796766743649,51,240,291,162,59,27,135,231,1194
Dainmon Gonner,0.0,6,0,57,2,7,0.285714285714,0,1,0.0,2,6,0.333,0.285714285714,9,14,0.642857142857,2,4,6,6,4,0,1,5,13
Dairese Gary,0.0,11,0,102,4,28,0.142857142857,2,12,0.166666666667,2,16,0.125,0.178571428571,8,12,0.666666666667,1,3,4,16,8,1,10,5,18
Dakarai Tucker,22.0,1,0,35,2,9,0.222222222222,0,4,0.0,2,5,0.4,0.222222222222,2,4,0.5,1,0,1,0,2,0,1,1,6
Dakari Johnson,41.0,99,96,2802,595,1093,0.544373284538,2,14,0.142857142857,593,1079,1.095,0.545288197621,331,514,0.643968871595,286,506,792,211,73,121,202,308,1523
Dallas Lauderdale,53.0,76,63,1779,200,302,0.662251655629,0,1,0.0,200,301,1.319,0.662251655629,44,73,0.602739726027,160,353,513,44,28,175,72,197,444
Dallin Bachynski,24.0,13,0,102,9,24,0.375,2,2,1.0,7,22,0.318,0.416666666667,4,6,0.666666666667,11,17,28,2,2,1,3,19,24
Dalron Johnson,25.0,2,0,29,6,12,0.5,0,1,0.0,6,11,0.545,0.5,1,1,1.0,5,3,8,0,0,1,0,4,13
Damen Bell-Holter,0.0,48,16,885,156,338,0.461538461538,19,68,0.279411764706,137,270,0.507,0.489644970414,81,115,0.704347826087,78,154,232,43,8,14,76,114,412
Damian Johnson,0.0,94,34,2118,204,450,0.453333333333,18,92,0.195652173913,186,358,1.367,0.473333333333,70,120,0.583333333333,200,232,432,132,100,86,58,284,496
Damian Jones,21.0,31,21,819,148,255,0.580392156863,0,1,0.0,148,254,0.583,0.580392156863,55,111,0.495495495495,81,143,224,33,13,65,42,95,351
Damian Reid,25.0,3,0,69,14,28,0.5,1,1,1.0,13,27,0.481,0.517857142857,2,4,0.5,1,3,4,16,1,0,3,5,31
Damian Saunders,147.0,149,86,3880,536,1209,0.443341604632,164,530,0.309433962264,372,679,3.272,0.511166253102,217,383,0.566579634465,232,599,831,213,245,236,250,343,1453
Damien Inglis,81.0,71,39,1844,309,692,0.446531791908,44,147,0.299319727891,265,545,1.925,0.478323699422,162,233,0.695278969957,67,358,425,188,81,28,143,210,824
Damien Lolar,0.0,50,0,699,97,240,0.404166666667,20,76,0.263157894737,77,164,0.839,0.445833333333,66,108,0.611111111111,35,78,113,65,31,4,71,60,280
Damien Wilkins,72.0,98,72,3401,573,1223,0.468520032706,102,297,0.343434343434,471,926,1.035,0.510220768602,472,577,0.818024263432,113,424,537,359,117,58,209,255,1720
Damion James,130.0,155,134,5095,961,2177,0.441433164906,132,440,0.3,829,1737,2.411,0.471750114837,514,711,0.722925457103,305,1026,1331,343,166,159,453,431,2568
Damion Lee,24.0,16,16,544,93,197,0.472081218274,41,88,0.465909090909,52,109,0.477,0.57614213198,58,71,0.816901408451,14,86,100,54,17,6,31,38,285
Damir Markota,21.0,10,6,282,39,85,0.458823529412,12,31,0.387096774194,27,54,0.5,0.529411764706,14,18,0.777777777778,7,41,48,18,7,6,25,18,104
Damon Jones,35.0,7,0,63,3,14,0.214285714286,3,14,0.214285714286,0,0,0.321,0.321428571429,2,3,0.666666666667,0,3,3,5,1,0,5,1,11
Damon Thornton,27.0,8,0,121,13,26,0.5,0,0,0.0,13,26,0.5,0.5,7,9,0.777777777778,17,23,40,2,5,10,11,21,33
Damond Edwards,27.0,3,1,30,0,5,0.0,0,1,0.0,0,4,0.0,0.0,0,0,0.0,0,1,1,2,0,0,7,3,0
Damone Brown,204.0,189,123,5803,997,2288,0.435751748252,127,359,0.353760445682,870,1929,3.613,0.463505244755,596,799,0.745932415519,310,802,1112,366,202,158,448,588,2717
Dan Dickau,31.0,13,12,440,76,171,0.444444444444,17,51,0.333333333333,59,120,0.492,0.494152046784,25,30,0.833333333333,6,29,35,92,14,3,40,39,194
Dan Gadzuric,33.0,12,10,308,60,113,0.530973451327,0,0,0.0,60,113,0.531,0.530973451327,24,40,0.6,54,82,136,12,7,12,27,49,144
Dan Vandervieren,0.0,36,14,646,64,116,0.551724137931,0,0,0.0,64,116,1.631,0.551724137931,20,36,0.555555555556,60,120,180,32,20,22,54,104,148
Dane Miller,49.0,48,0,753,107,218,0.490825688073,5,24,0.208333333333,102,194,1.057,0.502293577982,45,92,0.489130434783,54,81,135,74,27,25,75,67,264
Daniel Alexander,25.0,15,4,193,22,56,0.392857142857,9,27,0.333333333333,13,29,0.448,0.473214285714,3,4,0.75,6,35,41,13,8,3,10,33,56
Daniel Coleman,0.0,6,6,116,14,41,0.341463414634,0,0,0.0,14,41,0.341,0.341463414634,8,10,0.8,13,17,30,2,3,3,1,10,36
Daniel Coursey,91.0,138,66,2478,388,734,0.528610354223,1,5,0.2,387,729,2.09,0.529291553134,79,100,0.79,185,368,553,76,66,123,133,384,856
Daniel Hamilton,21.0,49,47,1528,262,615,0.426016260163,96,257,0.373540856031,166,358,0.464,0.50406504065,112,146,0.767123287671,58,336,394,226,63,16,142,96,732
Daniel Horton,45.0,40,20,1132,171,378,0.452380952381,57,136,0.419117647059,114,242,0.905,0.527777777778,84,107,0.785046728972,17,89,106,156,47,12,72,89,483
Daniel Nwaelele,120.0,124,60,3174,436,988,0.441295546559,240,568,0.422535211268,196,420,1.814,0.562753036437,182,222,0.81981981982,90,371,461,208,84,27,183,251,1294
Daniel Orton,114.0,81,63,2030,328,644,0.509316770186,7,21,0.333333333333,321,623,2.618,0.514751552795,295,416,0.709134615385,148,402,550,137,70,176,233,322,958
Daniel Stewart,25.0,35,20,509,44,81,0.543209876543,0,0,0.0,44,81,0.543,0.543209876543,33,48,0.6875,41,81,122,20,15,6,37,86,121
Danny Earl,27.0,29,19,617,67,157,0.426751592357,31,77,0.402597402597,36,80,0.45,0.525477707006,36,46,0.782608695652,8,40,48,75,23,2,45,59,201
Danny Green,91.0,36,31,1331,259,575,0.450434782609,89,200,0.445,170,375,1.789,0.527826086957,126,159,0.792452830189,90,175,265,91,54,36,102,99,733
Danny Johnson,25.0,26,14,681,117,288,0.40625,8,32,0.25,109,256,0.426,0.420138888889,44,61,0.72131147541,15,42,57,47,30,2,36,65,286
Danny Sumner,0.0,1,0,4,0,1,0.0,0,0,0.0,0,1,0.0,0.0,0,0,0.0,0,2,2,0,0,0,0,1,0
Dante Milligan,0.0,90,64,2219,295,592,0.498310810811,1,11,0.0909090909091,294,581,1.011,0.499155405405,115,236,0.487288135593,246,434,680,97,78,116,191,299,706
Danuel House,23.0,7,1,187,31,69,0.449275362319,13,32,0.40625,18,37,0.486,0.54347826087,18,27,0.666666666667,8,32,40,14,8,6,8,12,93
Dar Tucker,137.0,195,93,5699,1157,2531,0.45713156855,218,687,0.317321688501,939,1844,3.391,0.500197550375,616,933,0.660235798499,292,727,1019,421,231,57,414,457,3148
Darian Townes,0.0,59,4,636,97,214,0.453271028037,0,1,0.0,97,213,1.421,0.453271028037,54,81,0.666666666667,74,89,163,14,11,67,35,103,248
Darin Mency,0.0,3,2,79,10,31,0.322580645161,8,22,0.363636363636,2,9,0.222,0.451612903226,4,5,0.8,2,5,7,6,0,0,6,10,32
Darington Hobson,104.0,113,63,3412,569,1366,0.41654465593,177,491,0.360488798371,392,875,1.823,0.481332357247,188,275,0.683636363636,167,613,780,521,124,51,303,289,1503
Dario Hunt,0.0,41,19,872,139,267,0.520599250936,0,0,0.0,139,267,0.521,0.520599250936,48,88,0.545454545455,135,152,287,30,19,42,49,120,326
Darion Atkins,23.0,50,37,1472,208,450,0.462222222222,1,6,0.166666666667,207,444,0.466,0.463333333333,18,32,0.5625,84,282,366,89,49,67,93,138,435
Darius Johnson-Odom,47.0,40,39,1488,296,660,0.448484848485,66,179,0.368715083799,230,481,0.946,0.498484848485,208,255,0.81568627451,30,157,187,231,55,8,139,94,866
Darius Miller,22.0,11,8,299,39,84,0.464285714286,21,41,0.512195121951,18,43,0.419,0.589285714286,10,13,0.769230769231,7,31,38,18,6,7,15,32,109
Darius Morris,117.0,62,48,2032,405,897,0.451505016722,111,351,0.316239316239,294,546,2.472,0.513377926421,266,337,0.789317507418,58,209,267,390,73,2,181,122,1187
Darius Rice,76.0,85,63,2486,399,987,0.404255319149,130,382,0.340314136126,269,605,1.393,0.470111448835,151,185,0.816216216216,115,311,426,139,67,38,140,190,1079
Darius Washington,22.0,6,5,226,52,110,0.472727272727,9,23,0.391304347826,43,87,0.494,0.513636363636,37,49,0.755102040816,16,32,48,31,10,1,34,20,150
Darnell Dodson,0.0,6,0,35,2,12,0.166666666667,1,6,0.166666666667,1,6,0.167,0.208333333333,0,0,0.0,1,5,6,2,1,0,2,2,5
Darnell Jackson,103.0,68,55,2054,427,887,0.481397970688,4,26,0.153846153846,423,861,2.284,0.48365276212,232,330,0.70303030303,159,350,509,123,73,27,142,257,1090
Darnell Lazare,0.0,214,148,6050,1022,2213,0.461816538635,0,14,0.0,1022,2199,2.736,0.461816538635,455,616,0.738636363636,405,793,1198,259,176,80,381,476,2499
Darnell Miller,23.0,45,18,889,87,206,0.422330097087,1,6,0.166666666667,86,200,0.43,0.424757281553,83,118,0.703389830508,47,81,128,118,29,4,81,119,258
Darrell Johns,132.0,146,48,2682,410,792,0.517676767677,0,1,0.0,410,791,2.578,0.517676767677,139,211,0.658767772512,226,511,737,56,61,133,173,342,959
Darren Brooks,23.0,23,2,385,48,116,0.413793103448,2,5,0.4,46,111,0.414,0.422413793103,7,13,0.538461538462,28,47,75,23,18,2,11,34,105
Darren Cooper,0.0,161,51,3912,384,978,0.39263803681,135,381,0.354330708661,249,597,1.994,0.461656441718,273,342,0.798245614035,43,299,342,444,141,10,234,220,1176
Darren White,45.0,48,0,681,124,245,0.50612244898,11,44,0.25,113,201,0.574,0.528571428571,33,55,0.6,54,77,131,25,31,12,38,59,292
Darrin Govens,0.0,2,0,4,0,1,0.0,0,0,0.0,0,1,0.0,0.0,0,0,0.0,0,1,1,1,1,0,0,2,0
Darrun Hilliard,45.0,7,7,236,59,125,0.472,24,57,0.421052631579,35,68,1.038,0.568,29,37,0.783783783784,6,28,34,18,10,2,12,13,171
Darryl Partin,0.0,33,16,554,83,227,0.36563876652,33,112,0.294642857143,50,115,0.435,0.438325991189,14,19,0.736842105263,8,44,52,37,24,3,25,41,213
Darryl Watkins,69.0,80,52,1606,224,428,0.523364485981,0,0,0.0,224,428,1.551,0.523364485981,106,162,0.654320987654,170,294,464,60,54,76,112,238,554
Darvin Ham,102.0,94,66,2944,394,738,0.533875338753,0,2,0.0,394,736,1.631,0.533875338753,164,320,0.5125,148,368,516,154,82,66,180,366,952
Dave Noel,0.0,60,25,1154,160,351,0.45584045584,39,112,0.348214285714,121,239,1.013,0.511396011396,115,139,0.827338129496,53,98,151,94,38,7,55,123,474
David Akinyooye,0.0,20,0,285,36,84,0.428571428571,3,14,0.214285714286,33,70,0.471,0.446428571429,14,20,0.7,24,34,58,4,3,6,13,34,89
David Bailey,0.0,242,206,7728,1070,2498,0.428342674139,291,791,0.36788874842,779,1707,3.101,0.486589271417,702,884,0.794117647059,201,611,812,1331,322,15,663,676,3133
David Bell,0.0,106,47,2854,402,997,0.403209628887,213,501,0.425149700599,189,496,1.13,0.510030090271,269,308,0.873376623377,38,231,269,271,91,3,166,185,1286
David Berghoefer,0.0,23,1,331,45,64,0.703125,0,0,0.0,45,64,0.703,0.703125,22,31,0.709677419355,37,56,93,5,5,8,14,57,112
David Crouse,81.0,82,50,1590,224,516,0.434108527132,0,0,0.0,224,516,1.409,0.434108527132,172,206,0.834951456311,140,238,378,54,40,38,88,182,620
David Dixon,24.0,8,0,70,3,11,0.272727272727,0,0,0.0,3,11,0.273,0.272727272727,9,11,0.818181818182,8,7,15,2,2,2,3,12,15
David Evans,0.0,4,0,63,3,11,0.272727272727,0,2,0.0,3,9,0.333,0.272727272727,8,12,0.666666666667,12,6,18,1,3,0,3,14,14
David Foster,28.0,30,8,335,38,77,0.493506493506,1,1,1.0,37,76,0.487,0.5,5,7,0.714285714286,31,63,94,5,5,50,13,59,82
David Harrison,29.0,8,8,162,41,55,0.745454545455,0,0,0.0,41,55,0.745,0.745454545455,12,30,0.4,22,17,39,5,3,10,16,33,94
David Jackson,0.0,9,9,293,48,107,0.448598130841,10,23,0.434782608696,38,84,0.452,0.495327102804,31,34,0.911764705882,4,22,26,28,6,2,31,29,137
David Laury,103.0,120,27,2703,489,1054,0.46394686907,50,179,0.279329608939,439,875,1.973,0.487666034156,272,439,0.619589977221,241,588,829,196,65,68,186,250,1300
David Logan,24.0,7,1,63,10,26,0.384615384615,3,14,0.214285714286,7,12,0.583,0.442307692308,2,3,0.666666666667,2,3,5,5,1,1,9,2,25
David McClure,0.0,40,9,552,41,99,0.414141414141,4,8,0.5,37,91,0.407,0.434343434343,7,14,0.5,34,77,111,20,12,15,19,51,93
David Monds,0.0,76,68,2474,406,738,0.550135501355,0,6,0.0,406,732,1.589,0.550135501355,146,216,0.675925925926,230,460,690,78,62,78,158,250,958
David Noel,95.0,115,109,4732,846,1627,0.519975414874,204,466,0.437768240343,642,1161,2.226,0.582667486171,322,456,0.706140350877,142,554,696,592,229,74,347,366,2218
David Nwaba,24.0,40,31,1150,229,354,0.646892655367,4,17,0.235294117647,225,337,0.668,0.652542372881,101,165,0.612121212121,107,168,275,42,54,46,30,108,563
David Palmer,101.0,124,35,2444,348,718,0.484679665738,47,145,0.324137931034,301,573,2.092,0.517409470752,168,222,0.756756756757,182,408,590,79,30,61,158,336,911
David Stockton,72.0,103,91,3249,685,1524,0.449475065617,212,563,0.376554174067,473,961,1.443,0.519028871391,335,416,0.805288461538,93,297,390,805,178,16,299,329,1917
David Teague,31.0,5,0,21,0,6,0.0,0,3,0.0,0,3,0.0,0.0,0,0,0.0,0,2,2,0,1,0,2,2,0
David Wear,24.0,43,31,1289,264,552,0.478260869565,117,297,0.393939393939,147,255,0.576,0.584239130435,56,69,0.811594202899,77,242,319,110,36,8,66,96,701
David Young,23.0,45,45,1391,303,664,0.456325301205,21,66,0.318181818182,282,598,0.472,0.472138554217,204,250,0.816,27,72,99,79,38,7,112,123,831
Davin White,103.0,115,35,2934,374,823,0.454434993925,37,150,0.246666666667,337,673,1.97,0.476913730255,412,526,0.783269961977,67,256,323,405,149,20,213,257,1197
Davion Berry,95.0,97,49,2382,326,693,0.470418470418,109,265,0.411320754717,217,428,2.086,0.549062049062,182,233,0.781115879828,17,194,211,287,61,11,147,192,943
Davis Bertans,24.0,4,4,124,16,42,0.380952380952,13,33,0.393939393939,3,9,0.333,0.535714285714,14,14,1.0,3,11,14,9,7,7,10,11,59
Davon Usher,69.0,18,4,214,24,80,0.3,14,40,0.35,10,40,0.563,0.3875,18,28,0.642857142857,6,20,26,12,0,0,6,18,80
Dawan Robinson,0.0,18,4,400,80,166,0.481927710843,4,17,0.235294117647,76,149,0.51,0.493975903614,53,70,0.757142857143,12,29,41,71,18,0,39,49,217
DeAndre Daniels,23.0,8,5,110,8,35,0.228571428571,4,15,0.266666666667,4,20,0.2,0.285714285714,3,6,0.5,7,19,26,4,2,2,6,9,23
DeAndre Liggins,76.0,95,93,3627,410,993,0.412890231621,169,445,0.379775280899,241,548,1.317,0.497985901309,272,369,0.737127371274,86,559,645,521,212,51,329,298,1261
DeAndre Mathieu,24.0,7,0,77,11,18,0.611111111111,2,5,0.4,9,13,0.692,0.666666666667,5,7,0.714285714286,1,8,9,10,8,0,7,12,29
DeAndre' Bembry,22.0,6,5,189,40,74,0.540540540541,6,16,0.375,34,58,0.586,0.581081081081,11,20,0.55,9,29,38,21,9,6,15,10,97
DeAngelo Collins,24.0,12,0,156,11,34,0.323529411765,0,1,0.0,11,33,0.333,0.323529411765,5,17,0.294117647059,18,34,52,8,3,11,9,26,27
DeAngelo Riley,28.0,24,3,296,35,69,0.507246376812,0,2,0.0,35,67,0.522,0.507246376812,23,34,0.676470588235,25,45,70,20,10,29,28,50,93
DeAnthony Bowden,26.0,3,0,37,2,7,0.285714285714,0,1,0.0,2,6,0.333,0.285714285714,2,5,0.4,1,2,3,17,4,0,7,8,6
DeJuan Blair,81.0,38,6,728,182,370,0.491891891892,0,2,0.0,182,368,1.483,0.491891891892,56,96,0.583333333333,100,124,224,28,22,10,56,140,420
DeMarcus Nelson,69.0,40,38,1508,308,570,0.540350877193,42,100,0.42,266,470,1.699,0.577192982456,138,190,0.726315789474,52,162,214,164,66,14,114,86,796
DeMario Jones,24.0,6,0,68,8,25,0.32,0,3,0.0,8,22,0.364,0.32,13,19,0.684210526316,3,3,6,1,2,0,8,12,29
DeMarre Carroll,24.0,6,6,215,38,91,0.417582417582,0,2,0.0,38,89,0.427,0.417582417582,34,42,0.809523809524,21,20,41,12,7,3,21,27,110
DeQuan Jones,0.0,49,38,1464,242,474,0.510548523207,43,106,0.405660377358,199,368,0.541,0.555907172996,142,201,0.706467661692,67,168,235,81,64,33,121,128,669
DeSean Hadley,120.0,96,29,1896,137,424,0.323113207547,34,154,0.220779220779,103,270,1.599,0.36320754717,140,182,0.769230769231,55,172,227,181,70,8,130,203,448
DeShawn Sims,0.0,53,45,1752,415,835,0.497005988024,51,134,0.380597014925,364,701,0.932,0.52754491018,136,205,0.663414634146,109,294,403,78,54,37,107,137,1017
DeVon Hardin,0.0,46,33,868,101,201,0.502487562189,0,1,0.0,101,200,1.049,0.502487562189,62,97,0.639175257732,63,146,209,24,15,47,56,124,264
Dean Oliver,72.0,32,16,586,78,198,0.393939393939,22,66,0.333333333333,56,132,1.223,0.449494949495,50,62,0.806451612903,6,46,52,94,36,0,32,78,228
Dee Bost,0.0,50,50,2027,262,724,0.361878453039,110,376,0.292553191489,152,348,0.437,0.437845303867,124,171,0.72514619883,57,246,303,418,104,12,162,147,758
DeeAndre Hulett,21.0,34,27,869,155,316,0.490506329114,4,20,0.2,151,296,0.51,0.496835443038,65,88,0.738636363636,65,66,131,32,22,20,51,66,379
Deji Akindele,69.0,103,32,2123,298,555,0.536936936937,0,1,0.0,298,554,1.673,0.536936936937,252,389,0.647814910026,226,379,605,54,35,111,165,349,848
Dejounte Murray,20.0,15,15,527,103,233,0.442060085837,7,45,0.155555555556,96,188,0.511,0.457081545064,45,64,0.703125,19,99,118,93,30,2,76,43,258
Delon Wright,47.0,20,20,686,119,232,0.512931034483,18,58,0.310344827586,101,174,1.115,0.551724137931,73,91,0.802197802198,16,73,89,123,33,17,50,32,329
Delonte Holland,0.0,2,0,38,8,25,0.32,1,5,0.2,7,20,0.35,0.34,2,2,1.0,1,2,3,1,0,0,2,2,19
Delonte West,60.0,12,8,328,47,137,0.343065693431,5,15,0.333333333333,42,122,0.682,0.361313868613,42,51,0.823529411765,11,38,49,50,27,2,31,31,141
Delroy James,0.0,26,1,534,90,209,0.430622009569,5,20,0.25,85,189,0.45,0.442583732057,44,62,0.709677419355,48,77,125,34,27,14,34,48,229
Demetri McCamey,145.0,176,30,3458,401,1093,0.366880146386,189,576,0.328125,212,517,2.331,0.453339432754,162,198,0.818181818182,29,294,323,368,114,14,198,284,1153
Demetric Shaw,24.0,50,9,815,119,274,0.434306569343,10,31,0.322580645161,109,243,0.449,0.452554744526,86,114,0.754385964912,75,108,183,78,39,4,41,83,334
Demetris Nichols,75.0,81,77,2966,579,1260,0.459523809524,137,361,0.379501385042,442,899,1.443,0.513888888889,283,346,0.817919075145,96,322,418,209,106,74,249,218,1578
Demetrius Jackson,22.0,32,23,1071,176,419,0.420047732697,38,138,0.275362318841,138,281,0.491,0.465393794749,85,107,0.794392523364,42,121,163,191,41,14,82,94,475
Demetrius Porter,23.0,20,0,192,25,59,0.423728813559,5,16,0.3125,20,43,0.465,0.466101694915,19,29,0.655172413793,7,23,30,46,15,0,18,28,74
Demonte Harper,0.0,50,1,1126,167,431,0.38747099768,48,133,0.360902255639,119,298,0.399,0.443155452436,70,103,0.679611650485,38,85,123,107,42,11,79,84,452
Deng Deng,49.0,19,0,237,22,60,0.366666666667,0,5,0.0,22,55,0.772,0.366666666667,12,20,0.6,27,49,76,9,10,13,18,36,56
Denham Brown,102.0,86,50,2625,547,1187,0.460825610783,39,104,0.375,508,1083,1.889,0.477253580455,231,286,0.807692307692,122,290,412,162,98,16,172,170,1364
Dennis Clifford,24.0,38,34,990,171,289,0.59169550173,0,0,0.0,171,289,0.592,0.59169550173,111,172,0.645348837209,79,230,309,77,23,39,101,120,453
Dennis Horner,122.0,150,133,4733,755,1597,0.472761427677,121,340,0.355882352941,634,1257,2.513,0.510644959299,486,614,0.791530944625,338,719,1057,196,109,84,268,354,2117
Dennis Schrder,20.0,6,6,204,35,73,0.479452054795,5,17,0.294117647059,30,56,0.536,0.513698630137,27,38,0.710526315789,3,22,25,40,5,1,22,11,102
Denzel Livington,22.0,48,26,1195,140,341,0.410557184751,61,184,0.33152173913,79,157,0.503,0.5,105,129,0.813953488372,21,177,198,74,58,27,30,111,446
Denzel Valentine,23.0,3,3,118,28,56,0.5,21,39,0.538461538462,7,17,0.412,0.6875,8,9,0.888888888889,6,25,31,22,5,1,19,11,85
Deonte Burton,24.0,43,29,1126,142,314,0.452229299363,29,81,0.358024691358,113,233,0.485,0.498407643312,88,122,0.72131147541,29,79,108,96,41,12,53,127,401
DerMarr Johnson,55.0,52,32,1734,277,639,0.433489827856,118,311,0.379421221865,159,328,0.893,0.525821596244,145,178,0.814606741573,30,197,227,85,64,29,139,132,817
Derek Cooke Jr.,49.0,97,31,2168,259,464,0.558189655172,0,3,0.0,259,461,1.124,0.558189655172,83,175,0.474285714286,313,395,708,90,78,64,109,241,601
Derek Hood,51.0,102,95,2688,394,745,0.528859060403,1,5,0.2,393,740,1.065,0.529530201342,246,350,0.702857142857,310,557,867,140,65,28,189,382,1035
Derek Raivio,0.0,76,28,1536,188,418,0.44976076555,42,110,0.381818181818,146,308,1.412,0.5,28,32,0.875,32,66,98,244,66,0,78,72,446
Derek Strong,34.0,18,15,482,57,129,0.441860465116,0,1,0.0,57,128,0.445,0.441860465116,50,64,0.78125,30,77,107,11,11,3,37,39,164
Derek Williams,0.0,11,0,170,19,57,0.333333333333,5,17,0.294117647059,14,40,0.35,0.377192982456,7,9,0.777777777778,1,16,17,28,9,1,16,17,50
Deron Washington,0.0,98,48,2560,350,864,0.405092592593,64,214,0.299065420561,286,650,1.3,0.44212962963,326,450,0.724444444444,96,344,440,176,78,64,196,332,1090
Derrick Bird,23.0,33,8,426,41,125,0.328,11,42,0.261904761905,30,83,0.361,0.372,27,34,0.794117647059,6,25,31,22,14,6,19,44,120
Derrick Byars,138.0,132,99,4338,743,1626,0.456949569496,226,617,0.366288492707,517,1009,2.632,0.526445264453,291,394,0.738578680203,156,475,631,286,122,22,240,281,2003
Derrick Caracter,166.0,79,24,1448,326,605,0.538842975207,4,6,0.666666666667,322,599,3.759,0.542148760331,112,171,0.654970760234,160,291,451,67,32,48,159,225,768
Derrick Davenport,0.0,2,0,39,5,7,0.714285714286,0,0,0.0,5,7,0.714,0.714285714286,8,10,0.8,1,6,7,1,1,4,2,10,18
Derrick Dial,129.0,63,21,1762,289,648,0.445987654321,80,233,0.343347639485,209,415,1.738,0.507716049383,105,153,0.686274509804,71,231,302,195,47,32,94,144,763
Derrick Hines,0.0,35,5,404,52,114,0.456140350877,6,20,0.3,46,94,0.489,0.482456140351,57,71,0.802816901408,14,28,42,41,8,1,32,42,167
Derrick Jones Jr.,19.0,19,17,602,103,206,0.5,12,47,0.255319148936,91,159,0.572,0.529126213592,58,95,0.610526315789,38,69,107,19,23,28,28,69,276
Derrick Nix,25.0,3,0,8,1,2,0.5,0,0,0.0,1,2,0.5,0.5,0,0,0.0,0,0,0,0,0,0,0,1,2
Derrick O'Neil,0.0,2,0,33,3,9,0.333333333333,0,1,0.0,3,8,0.375,0.333333333333,3,3,1.0,4,0,4,2,0,0,5,6,9
Derrick Stevens,0.0,2,0,28,1,5,0.2,1,2,0.5,0,3,0.0,0.3,0,0,0.0,0,2,2,5,1,0,3,4,3
Derrick Zimmerman,69.0,138,129,4327,447,960,0.465625,9,49,0.183673469388,438,911,1.442,0.4703125,207,366,0.565573770492,156,480,636,799,234,60,315,349,1110
Deshaun Thomas,24.0,47,35,1360,295,569,0.518453427065,27,92,0.29347826087,268,477,0.562,0.542179261863,73,93,0.784946236559,106,186,292,104,27,17,77,105,690
Deshawn Stephens,0.0,10,1,189,35,58,0.603448275862,0,3,0.0,35,55,0.636,0.603448275862,10,17,0.588235294118,29,26,55,5,3,7,6,20,80
Desmon Farmer,134.0,191,132,6499,1232,2752,0.447674418605,479,1234,0.388168557536,753,1518,2.492,0.534702034884,815,1018,0.800589390963,134,567,701,624,183,21,457,475,3758
Desmond Penigar,22.0,38,33,1109,308,608,0.506578947368,32,86,0.372093023256,276,522,0.529,0.532894736842,98,125,0.784,63,182,245,54,52,20,69,129,746
Devan Downey,0.0,8,1,181,36,75,0.48,5,12,0.416666666667,31,63,0.492,0.513333333333,9,11,0.818181818182,2,10,12,31,12,1,15,11,86
Devin Brooks,72.0,30,2,556,62,188,0.329787234043,8,44,0.181818181818,54,144,0.994,0.351063829787,40,50,0.8,18,52,70,100,28,6,40,68,172
Devin Brown,57.0,48,40,1160,278,561,0.495543672014,21,58,0.362068965517,257,503,0.956,0.514260249554,190,231,0.822510822511,67,123,190,92,39,8,74,114,767
Devin Ebanks,141.0,147,124,5302,1167,2572,0.453732503888,283,859,0.329452852154,884,1713,3.17,0.508748055988,659,818,0.805623471883,274,821,1095,299,200,71,325,330,3276
Devin Green,136.0,79,61,2518,435,937,0.464247598719,48,171,0.280701754386,387,766,2.497,0.489861259338,222,276,0.804347826087,93,302,395,227,111,48,207,205,1140
Devin Williams,0.0,8,0,67,10,14,0.714285714286,0,0,0.0,10,14,0.714,0.714285714286,3,6,0.5,8,18,26,1,2,0,5,12,23
Devondrick Walker,117.0,155,34,3300,476,1047,0.454632282713,228,583,0.391080617496,248,464,2.64,0.563514804202,192,211,0.909952606635,51,318,369,179,95,24,163,285,1372
Devyn Marble,45.0,20,3,617,102,268,0.380597014925,33,96,0.34375,69,172,0.776,0.442164179104,48,66,0.727272727273,24,80,104,44,29,3,43,45,285
Dewayne Dedmon,50.0,16,16,539,109,202,0.539603960396,0,1,0.0,109,201,1.081,0.539603960396,27,38,0.710526315789,75,150,225,19,23,38,33,73,245
Dewitt Scott,0.0,115,18,2461,271,667,0.406296851574,157,375,0.418666666667,114,292,1.587,0.523988005997,41,50,0.82,63,174,237,60,48,1,36,237,740
Dexter Pittman,71.0,65,54,1562,322,611,0.527004909984,0,0,0.0,322,611,1.562,0.527004909984,176,270,0.651851851852,207,296,503,45,38,126,131,230,820
Dexter Strickland,47.0,32,1,417,65,129,0.503875968992,5,11,0.454545454545,60,118,1.024,0.523255813953,28,37,0.756756756757,14,32,46,46,23,5,22,42,163
Deyonta Davis,0.0,11,10,306,55,100,0.55,0,0,0.0,55,100,0.55,0.55,6,9,0.666666666667,33,62,95,5,10,26,9,28,116
Dez Wells,47.0,47,22,1291,217,486,0.446502057613,60,179,0.335195530726,157,307,1.018,0.508230452675,104,155,0.670967741935,19,117,136,93,50,16,85,116,598
Diamon Simpson,0.0,30,30,957,175,394,0.444162436548,0,1,0.0,175,393,0.445,0.444162436548,116,163,0.711656441718,113,176,289,65,54,42,45,89,466
Diamond Stone,57.0,26,4,564,162,330,0.490909090909,20,54,0.37037037037,142,276,1.526,0.521212121212,76,92,0.826086956522,56,126,182,22,12,24,70,90,420
Diante Garrett,102.0,96,72,3149,502,1184,0.423986486486,173,417,0.414868105516,329,767,1.745,0.497043918919,149,187,0.79679144385,65,343,408,414,129,35,191,205,1326
Dijon Thompson,45.0,35,34,1401,269,533,0.50469043152,45,108,0.416666666667,224,425,0.873,0.546904315197,136,180,0.755555555556,88,221,309,139,60,34,129,106,719
Dionte Christmas,30.0,31,31,980,157,360,0.436111111111,62,169,0.366863905325,95,191,0.497,0.522222222222,86,107,0.803738317757,18,89,107,99,27,7,81,75,462
Dominic Calegari,0.0,88,18,1386,186,436,0.426605504587,72,208,0.346153846154,114,228,1.4,0.509174311927,50,82,0.609756097561,94,216,310,42,44,44,60,188,494
Dominic McGuire,0.0,62,50,2012,344,754,0.456233421751,34,116,0.293103448276,310,638,1.445,0.478779840849,138,190,0.726315789474,130,512,642,216,52,52,132,148,860
Dominic Waters,28.0,2,0,34,2,7,0.285714285714,0,0,0.0,2,7,0.286,0.285714285714,3,4,0.75,0,6,6,5,1,0,6,3,7
Dominique Coleman,0.0,233,157,6835,895,1990,0.449748743719,221,610,0.362295081967,674,1380,3.71,0.50527638191,223,337,0.661721068249,336,928,1264,820,438,98,395,516,2234
Dominique Johnson,0.0,144,47,3507,573,1294,0.442812982998,143,442,0.323529411765,430,852,2.538,0.498068006182,293,363,0.807162534435,109,341,450,238,116,18,215,232,1582
Dominique Jones,69.0,22,18,722,119,284,0.419014084507,22,70,0.314285714286,97,214,1.306,0.457746478873,109,133,0.81954887218,21,76,97,101,39,12,72,65,369
Dominique Morrison,0.0,12,5,224,20,69,0.289855072464,8,26,0.307692307692,12,43,0.279,0.347826086957,20,26,0.769230769231,6,23,29,7,7,0,16,18,68
Dominique Scales,0.0,62,17,761,72,174,0.413793103448,0,1,0.0,72,173,1.678,0.413793103448,30,43,0.697674418605,59,71,130,3,16,25,25,147,174
Dominique Sutton,54.0,89,34,2349,401,718,0.558495821727,13,44,0.295454545455,388,674,1.155,0.567548746518,204,360,0.566666666667,215,346,561,152,131,26,169,309,1019
Donald Hand,69.0,78,50,1676,175,501,0.349301397206,57,196,0.290816326531,118,305,1.078,0.40618762475,230,283,0.812720848057,51,159,210,301,94,2,187,195,637
Donald Sims,0.0,8,1,182,17,55,0.309090909091,5,24,0.208333333333,12,31,0.387,0.354545454545,16,18,0.888888888889,2,7,9,23,7,0,10,4,55
Donald Sloan,72.0,68,52,2038,358,735,0.487074829932,31,100,0.31,327,635,1.555,0.508163265306,187,250,0.748,49,223,272,348,66,2,132,98,934
Donald Watts,24.0,26,3,339,37,99,0.373737373737,8,23,0.347826086957,29,76,0.382,0.414141414141,19,34,0.558823529412,14,22,36,25,7,1,20,37,101
Donatas Motiejunas,47.0,11,7,341,80,154,0.519480519481,11,38,0.289473684211,69,116,1.164,0.555194805195,23,38,0.605263157895,20,71,91,33,10,7,31,26,194
Donell Taylor,81.0,96,88,3402,816,1688,0.483412322275,104,280,0.371428571429,712,1408,1.491,0.514218009479,286,392,0.729591836735,206,460,666,410,152,28,324,324,2022
Donell Williams,0.0,18,0,78,14,31,0.451612903226,1,7,0.142857142857,13,24,0.542,0.467741935484,9,16,0.5625,11,10,21,3,3,0,4,9,38
Donnell Knight,24.0,5,0,56,3,13,0.230769230769,0,2,0.0,3,11,0.273,0.230769230769,2,4,0.5,4,3,7,3,1,0,6,6,8
Donnie McGrath,32.0,12,12,435,39,99,0.393939393939,16,51,0.313725490196,23,48,0.479,0.474747474747,10,13,0.769230769231,1,28,29,107,11,3,38,30,104
Donta Smith,22.0,29,22,965,158,278,0.568345323741,10,31,0.322580645161,148,247,0.599,0.586330935252,76,104,0.730769230769,33,91,124,86,47,19,68,92,402
Donte Greene,20.0,5,0,160,37,83,0.44578313253,8,29,0.275862068966,29,54,0.537,0.493975903614,20,29,0.689655172414,2,18,20,10,6,6,8,17,102
Dontell Jefferson,350.0,247,114,6642,875,2061,0.424551188743,139,474,0.293248945148,736,1587,5.937,0.458272683164,845,1079,0.78313253012,147,656,803,970,310,47,600,655,2734
Dorell Wright,20.0,6,0,124,33,64,0.515625,1,3,0.333333333333,32,61,0.525,0.5234375,6,6,1.0,9,14,23,11,3,2,14,7,73
Doron Lamb,115.0,118,92,3821,610,1371,0.444930707513,160,444,0.36036036036,450,927,2.31,0.503282275711,380,438,0.867579908676,80,310,390,270,96,12,187,336,1760
Doug Thomas,0.0,204,89,4188,564,1092,0.516483516484,0,2,0.0,564,1090,3.556,0.516483516484,261,407,0.641277641278,351,708,1059,145,131,109,213,482,1389
Drew Crawford,24.0,50,50,1683,313,651,0.480798771121,66,186,0.354838709677,247,465,0.531,0.531490015361,109,157,0.694267515924,50,254,304,91,45,12,98,149,801
Drew Gordon,24.0,41,40,1347,216,405,0.533333333333,25,85,0.294117647059,191,320,0.597,0.564197530864,77,122,0.631147540984,145,291,436,72,42,23,79,112,534
Drew Naymick,0.0,48,33,1364,161,296,0.543918918919,0,0,0.0,161,296,0.544,0.543918918919,90,110,0.818181818182,114,250,364,38,36,106,60,158,412
Drew Neitzel,0.0,30,7,614,61,167,0.365269461078,11,41,0.268292682927,50,126,0.397,0.398203592814,28,34,0.823529411765,6,43,49,120,18,0,51,62,161
Duane Erwin,167.0,166,120,4402,545,1155,0.471861471861,10,53,0.188679245283,535,1102,3.121,0.47619047619,245,312,0.785256410256,329,826,1155,236,108,199,302,619,1345
Duje Dukan,49.0,52,34,1310,219,527,0.415559772296,113,290,0.389655172414,106,237,0.895,0.522770398482,82,121,0.677685950413,43,158,201,52,27,14,69,141,633
Durrell Summers,120.0,146,58,3610,682,1498,0.455273698264,87,274,0.317518248175,595,1224,2.507,0.484312416555,351,454,0.773127753304,201,302,503,194,151,30,256,277,1802
Dustin Salisbery,0.0,12,0,249,39,100,0.39,9,37,0.243243243243,30,63,0.476,0.435,15,20,0.75,7,40,47,27,16,1,25,22,102
Dwayne Jones,200.0,165,155,5684,799,1425,0.560701754386,0,2,0.0,799,1423,3.685,0.560701754386,722,1095,0.659360730594,871,1305,2176,210,102,256,387,513,2320
Dwayne Lathan,0.0,3,0,8,1,5,0.2,0,2,0.0,1,3,0.333,0.2,0,0,0.0,2,1,3,3,1,0,1,1,2
Dwayne Mitchell,83.0,82,72,3092,533,1077,0.494893221913,30,107,0.280373831776,503,970,1.527,0.508820798514,444,665,0.667669172932,141,400,541,311,142,27,274,232,1540
Dwayne Polee Jr.,49.0,45,0,378,58,133,0.436090225564,12,33,0.363636363636,46,100,0.967,0.481203007519,45,57,0.789473684211,15,50,65,5,23,10,35,39,173
Dwayne Schintzius,33.0,35,21,539,55,162,0.33950617284,0,0,0.0,55,162,0.34,0.33950617284,13,29,0.448275862069,26,105,131,28,7,34,23,51,123
Dwight Brewington,0.0,58,0,930,174,348,0.5,14,44,0.318181818182,160,304,1.57,0.520114942529,96,130,0.738461538462,72,94,166,66,18,16,78,92,458
Dwight Buycks,97.0,61,27,1821,398,858,0.463869463869,84,242,0.347107438017,314,616,2.035,0.512820512821,139,182,0.763736263736,57,175,232,236,95,9,171,98,1019
Dwight Jones,0.0,10,1,98,18,30,0.6,0,1,0.0,18,29,0.621,0.6,6,9,0.666666666667,6,4,10,10,3,0,3,9,42
Dwight Powell,69.0,24,24,860,250,418,0.598086124402,22,56,0.392857142857,228,362,1.887,0.624401913876,102,144,0.708333333333,72,162,234,64,22,26,68,84,624
Dwuan Rice,0.0,2,0,3,0,1,0.0,0,0,0.0,0,1,0.0,0.0,0,0,0.0,0,0,0,0,0,0,0,0,0
E. Victor Nickerson,24.0,14,0,131,4,20,0.2,0,5,0.0,4,15,0.267,0.2,7,12,0.583333333333,5,15,20,5,7,1,10,26,15
E.J. Rowland,25.0,44,7,756,100,211,0.473933649289,3,12,0.25,97,199,0.487,0.481042654028,41,67,0.611940298507,14,95,109,131,42,8,52,66,244
EJ Singler,124.0,162,55,4183,537,1251,0.429256594724,306,753,0.406374501992,231,498,2.322,0.551558752998,173,208,0.831730769231,123,558,681,306,109,45,207,325,1553
Earl Barron,157.0,147,105,4266,840,1739,0.483036227717,34,104,0.326923076923,806,1635,2.969,0.492811960897,445,574,0.775261324042,458,772,1230,181,95,94,285,479,2159
Earl Calloway,0.0,50,46,1783,331,667,0.496251874063,50,123,0.406504065041,281,544,0.517,0.533733133433,234,264,0.886363636364,53,202,255,289,101,11,133,110,946
Earl Clark,133.0,75,62,2473,543,1289,0.421256788208,128,330,0.387878787879,415,959,2.312,0.470907680372,227,309,0.734627831715,97,494,591,149,50,98,184,152,1441
Ed Daniels,0.0,5,1,80,8,32,0.25,3,14,0.214285714286,5,18,0.278,0.296875,15,17,0.882352941176,1,5,6,12,10,0,13,8,34
Ed Davis,21.0,2,0,35,7,12,0.583333333333,0,0,0.0,7,12,0.583,0.583333333333,6,6,1.0,2,8,10,1,0,6,4,1,20
Ed Scott,23.0,8,8,201,15,48,0.3125,0,1,0.0,15,47,0.319,0.3125,7,10,0.7,6,7,13,14,7,0,24,21,37
Eddie Ard,0.0,25,4,338,41,91,0.450549450549,0,3,0.0,41,88,0.466,0.450549450549,24,37,0.648648648649,18,39,57,14,5,3,23,29,106
Eddie Basden,48.0,52,30,1638,231,503,0.459244532803,69,178,0.387640449438,162,325,1.009,0.527833001988,94,139,0.676258992806,61,171,232,111,98,11,94,130,625
Eddie Elisma,27.0,50,27,1047,115,303,0.379537953795,7,21,0.333333333333,108,282,0.383,0.391089108911,69,104,0.663461538462,77,136,213,53,26,25,72,119,306
Eddie Gill,83.0,112,108,3890,487,1169,0.416595380667,134,388,0.345360824742,353,781,1.358,0.473909324209,586,701,0.835948644793,69,400,469,831,190,49,341,326,1694
Eddie Robinson,30.0,27,21,917,184,356,0.516853932584,1,8,0.125,183,348,0.526,0.518258426966,51,62,0.822580645161,30,66,96,62,38,16,28,63,420
Eddy Fobbs,78.0,88,54,1958,202,314,0.643312101911,0,2,0.0,202,312,1.918,0.643312101911,122,200,0.61,160,288,448,26,32,120,98,308,526
Edmund Saunders,0.0,5,1,58,5,13,0.384615384615,0,0,0.0,5,13,0.385,0.384615384615,3,4,0.75,7,9,16,3,3,1,5,6,13
Edwin Ubiles,103.0,91,45,2389,494,1046,0.472275334608,72,238,0.302521008403,422,808,1.989,0.506692160612,160,208,0.769230769231,73,225,298,200,63,30,149,54,1220
Egidijus Mockevicius,24.0,35,24,741,117,233,0.502145922747,2,18,0.111111111111,115,215,0.535,0.50643776824,37,69,0.536231884058,100,178,278,54,31,29,64,103,273
Ejike Ugboaja,0.0,90,10,1314,194,402,0.482587064677,0,2,0.0,194,400,1.436,0.482587064677,50,92,0.54347826087,172,276,448,24,42,20,78,216,438
Elgin Cook,24.0,20,1,465,116,207,0.56038647343,8,24,0.333333333333,108,183,0.59,0.579710144928,84,108,0.777777777778,40,65,105,19,20,9,31,63,324
Elgrace Wilborn,0.0,8,0,98,8,16,0.5,0,0,0.0,8,16,0.5,0.5,3,9,0.333333333333,7,9,16,1,0,6,7,19,19
Elias Harris,24.0,1,1,28,6,10,0.6,0,1,0.0,6,9,0.667,0.6,6,7,0.857142857143,1,1,2,2,0,1,2,6,18
Elijah Ingram,0.0,14,3,275,31,72,0.430555555556,9,16,0.5625,22,56,0.393,0.493055555556,15,22,0.681818181818,4,27,31,41,8,1,30,15,86
Elijah Millsap,154.0,205,180,6845,1208,2786,0.4335965542,203,600,0.338333333333,1005,2186,3.301,0.470028715004,1086,1440,0.754166666667,276,1070,1346,721,369,70,587,676,3705
Elijah Pittman,0.0,8,0,165,31,64,0.484375,9,26,0.346153846154,22,38,0.579,0.5546875,9,20,0.45,7,22,29,9,6,1,12,21,80
Ella Ellis,25.0,3,0,5,0,2,0.0,0,2,0.0,0,0,0.0,0.0,2,2,1.0,0,0,0,0,0,1,0,0,2
Elliot Williams,75.0,51,47,1947,445,927,0.480043149946,82,229,0.35807860262,363,698,1.445,0.52427184466,263,344,0.764534883721,36,249,285,344,59,6,156,100,1235
Eloy Vargas,26.0,30,15,693,113,228,0.495614035088,1,4,0.25,112,224,0.5,0.497807017544,35,54,0.648148148148,59,123,182,20,19,48,23,94,262
Elton Brown,69.0,91,84,3093,640,1245,0.5140562249,1,3,0.333333333333,639,1242,1.559,0.514457831325,444,673,0.659732540862,309,649,958,188,48,48,260,266,1725
Elton Mashack,0.0,9,0,79,5,17,0.294117647059,0,2,0.0,5,15,0.333,0.294117647059,0,2,0.0,3,7,10,3,5,2,5,6,10
Elton Nesbitt,53.0,87,36,2214,360,904,0.398230088496,160,419,0.381861575179,200,485,0.851,0.486725663717,171,217,0.78801843318,48,175,223,267,109,8,165,199,1051
Emmanuel Jones,0.0,26,0,419,51,140,0.364285714286,4,29,0.137931034483,47,111,0.423,0.378571428571,36,48,0.75,30,61,91,22,13,11,20,31,142
Eniel Polynice,0.0,18,5,256,44,91,0.483516483516,6,21,0.285714285714,38,70,0.559,0.516483516484,8,14,0.571428571429,12,29,41,34,9,4,25,13,102
Erek Hansen,0.0,6,0,78,4,18,0.222222222222,0,0,0.0,4,18,0.222,0.222222222222,0,3,0.0,6,15,21,2,2,15,10,14,8
Eric Atkins,24.0,24,8,582,57,139,0.410071942446,18,50,0.36,39,89,0.438,0.474820143885,23,28,0.821428571429,12,31,43,72,23,3,33,55,155
Eric Bledsoe,22.0,2,0,43,9,18,0.5,1,2,0.5,8,16,0.5,0.527777777778,6,10,0.6,0,3,3,17,1,0,6,5,25
Eric Boateng,0.0,80,32,1298,166,326,0.509202453988,0,2,0.0,166,324,1.531,0.509202453988,58,114,0.508771929825,140,242,382,34,14,70,112,220,390
Eric Chenowith,117.0,154,112,3080,490,1082,0.452865064695,2,8,0.25,488,1074,2.283,0.453789279113,413,518,0.797297297297,300,585,885,113,40,132,243,524,1395
Eric Coley,24.0,4,0,46,2,8,0.25,0,2,0.0,2,6,0.333,0.25,1,2,0.5,1,4,5,2,1,1,1,6,5
Eric Dawson,186.0,104,71,2623,525,979,0.536261491318,7,22,0.318181818182,518,957,3.746,0.539836567926,200,278,0.719424460432,281,543,824,183,117,125,177,304,1257
Eric Devendorf,0.0,81,0,1389,297,564,0.526595744681,60,135,0.444444444444,237,429,2.169,0.579787234043,164,224,0.732142857143,24,100,124,86,50,10,85,157,818
Eric Griffin,24.0,49,48,1723,310,681,0.455212922173,98,266,0.368421052632,212,415,0.511,0.527165932452,215,279,0.770609318996,82,243,325,93,63,118,120,192,933
Eric Harris,25.0,41,6,695,68,168,0.404761904762,17,47,0.36170212766,51,121,0.421,0.455357142857,54,63,0.857142857143,9,45,54,78,42,3,39,51,207
Eric Hayes,0.0,6,0,69,3,20,0.15,2,11,0.181818181818,1,9,0.111,0.2,2,2,1.0,1,0,1,6,3,0,2,2,10
Eric Moreland,72.0,56,51,1805,310,549,0.564663023679,1,3,0.333333333333,309,546,1.708,0.565573770492,87,236,0.368644067797,195,502,697,139,90,142,126,199,708
Eric Murphy,24.0,49,26,1113,229,478,0.479079497908,70,185,0.378378378378,159,293,0.543,0.55230125523,52,75,0.693333333333,57,215,272,76,28,44,74,168,580
Eric Osmundson,72.0,76,27,1672,199,474,0.419831223629,67,202,0.331683168317,132,272,0.981,0.490506329114,91,128,0.7109375,25,123,148,141,36,8,86,195,556
Eric Smith,0.0,50,7,888,138,269,0.513011152416,4,15,0.266666666667,134,254,1.083,0.520446096654,55,91,0.604395604396,65,81,146,27,15,25,54,105,335
Eric Weary Jr.,23.0,4,0,17,5,7,0.714285714286,3,5,0.6,2,2,1.0,0.928571428571,2,3,0.666666666667,0,5,5,0,0,0,2,1,15
Eric Williams,124.0,54,4,556,81,191,0.424083769634,0,4,0.0,81,187,1.995,0.424083769634,43,51,0.843137254902,70,103,173,37,5,7,39,101,205
Eric Wise,0.0,2,0,8,0,1,0.0,0,0,0.0,0,1,0.0,0.0,0,0,0.0,1,1,2,0,0,0,1,3,0
Erick Barkley,25.0,42,20,1275,201,491,0.409368635438,14,66,0.212121212121,187,425,0.44,0.423625254582,127,157,0.808917197452,31,121,152,151,64,5,82,114,543
Erick Green,47.0,42,39,1560,365,713,0.511921458626,120,275,0.436363636364,245,438,1.222,0.596072931276,220,259,0.849420849421,25,156,181,168,56,12,73,72,1070
Erik Daniels,107.0,150,109,4744,960,2022,0.474777448071,127,435,0.291954022989,833,1587,2.191,0.506181998022,306,427,0.71662763466,314,813,1127,465,146,86,326,481,2353
Ernest Brown,72.0,83,72,2307,385,780,0.49358974359,0,1,0.0,385,779,1.52,0.49358974359,232,351,0.660968660969,167,380,547,72,44,122,175,259,1002
Ernest Scott,0.0,192,26,4042,562,1382,0.406657018813,374,966,0.387163561077,188,416,2.614,0.541968162084,90,129,0.697674418605,150,440,590,217,114,86,169,417,1588
Errick Craven,0.0,40,17,773,133,261,0.509578544061,3,12,0.25,130,249,0.522,0.515325670498,49,66,0.742424242424,30,94,124,101,63,6,81,103,318
Erron Maxey,25.0,45,36,1331,199,466,0.427038626609,29,88,0.329545454545,170,378,0.45,0.458154506438,129,179,0.720670391061,69,128,197,67,34,5,83,112,556
Ersan Ilyasova,18.0,46,19,1297,218,536,0.40671641791,68,195,0.348717948718,150,341,0.44,0.470149253731,70,99,0.707070707071,60,264,324,46,33,38,90,151,574
Esian Henderson,0.0,2,0,6,0,0,0.0,0,0,0.0,0,0,0.0,0.0,0,0,0.0,1,1,2,0,0,0,2,1,0
Eugene Edgerson,47.0,106,33,2258,168,321,0.523364485981,0,1,0.0,168,320,1.045,0.523364485981,212,282,0.751773049645,220,371,591,80,73,17,125,286,548
Eugene Spates,0.0,138,15,2399,335,846,0.39598108747,99,313,0.316293929712,236,533,1.773,0.454491725768,177,245,0.722448979592,167,391,558,106,76,40,106,348,946
Evan Burns,0.0,1,0,4,1,2,0.5,0,1,0.0,1,1,1.0,0.5,1,2,0.5,2,2,4,0,0,0,1,3,3
Evan Fjeld,0.0,3,0,25,2,6,0.333333333333,0,0,0.0,2,6,0.333,0.333333333333,2,2,1.0,2,3,5,2,0,1,0,4,6
Evrik Gary,75.0,14,0,216,32,76,0.421052631579,14,32,0.4375,18,44,1.466,0.513157894737,2,4,0.5,2,30,32,20,2,0,14,18,80
Ezra Williams,76.0,95,52,2514,407,904,0.450221238938,128,309,0.414239482201,279,595,1.38,0.521017699115,158,189,0.835978835979,106,249,355,163,107,31,163,244,1100
Fab Melo,45.0,54,35,1144,183,361,0.506925207756,0,0,0.0,183,361,0.999,0.506925207756,68,107,0.635514018692,105,169,274,38,22,119,74,169,434
Fabrico Vay,0.0,42,2,480,54,123,0.439024390244,24,54,0.444444444444,30,69,0.435,0.536585365854,21,23,0.913043478261,21,39,60,31,14,7,28,42,153
Ferrakohn Hall,102.0,135,38,2484,313,769,0.407022106632,74,239,0.309623430962,239,530,1.696,0.455136540962,85,136,0.625,112,315,427,96,57,45,127,340,785
Festus Ezeli,25.0,2,0,42,9,19,0.473684210526,0,0,0.0,9,19,0.474,0.473684210526,2,2,1.0,6,4,10,0,2,6,5,7,20
Frank Gaines,47.0,62,37,2116,449,971,0.462409886715,150,382,0.392670157068,299,589,1.025,0.53964984552,318,433,0.73441108545,45,178,223,111,83,14,153,184,1366
Frank Hassell,0.0,39,6,805,166,303,0.547854785479,0,0,0.0,166,303,0.548,0.547854785479,81,97,0.835051546392,127,143,270,12,30,23,56,114,413
Frank Robinson,0.0,38,25,1170,172,400,0.43,26,107,0.242990654206,146,293,0.498,0.4625,101,146,0.691780821918,42,113,155,141,73,13,115,110,471
Frank Rogers,23.0,3,0,20,4,6,0.666666666667,0,1,0.0,4,5,0.8,0.666666666667,2,3,0.666666666667,1,2,3,0,1,1,1,8,10
Frank Tolbert,0.0,18,7,398,31,103,0.300970873786,6,29,0.206896551724,25,74,0.338,0.330097087379,41,48,0.854166666667,13,29,42,22,9,5,37,53,109
Frank Williams,54.0,91,87,3257,458,1240,0.36935483871,239,687,0.34788937409,219,553,0.798,0.465725806452,353,416,0.848557692308,50,263,313,374,145,38,213,176,1508
Franklin Session,0.0,2,0,2,0,0,0.0,0,0,0.0,0,0,0.0,0.0,0,0,0.0,0,0,0,0,0,0,0,1,0
Frans Steyn,24.0,49,18,831,114,202,0.564356435644,0,1,0.0,114,201,0.567,0.564356435644,70,140,0.5,75,122,197,5,12,33,72,185,298
Fred Gibson,0.0,64,2,810,120,232,0.51724137931,14,42,0.333333333333,106,190,1.147,0.547413793103,48,70,0.685714285714,50,66,116,46,44,14,50,102,302
Fred House,0.0,100,65,2472,387,926,0.417926565875,91,299,0.304347826087,296,627,0.88,0.467062634989,237,317,0.747634069401,168,233,401,161,210,30,154,282,1102
Fred VanVleet,22.0,16,16,518,89,219,0.406392694064,22,54,0.407407407407,67,165,0.406,0.456621004566,70,83,0.843373493976,11,45,56,122,24,2,45,31,270
Fred Williams,28.0,40,7,787,148,322,0.459627329193,11,34,0.323529411765,137,288,0.476,0.476708074534,71,98,0.724489795918,42,144,186,30,25,9,76,66,378
Freddy Robinson,0.0,6,0,28,2,9,0.222222222222,0,1,0.0,2,8,0.25,0.222222222222,3,3,1.0,1,7,8,0,1,0,1,3,7
Fuquan Edwin,23.0,49,33,1443,253,542,0.466789667897,100,250,0.4,153,292,0.524,0.559040590406,70,93,0.752688172043,37,175,212,74,88,18,60,117,676
Gabe Muoneke,76.0,67,55,2144,435,922,0.471800433839,34,109,0.311926605505,401,813,1.496,0.490238611714,383,534,0.717228464419,131,284,415,126,50,32,167,207,1287
Gabe Pruitt,193.0,209,77,5440,725,1759,0.412166003411,207,669,0.309417040359,518,1090,3.715,0.471006253553,400,609,0.656814449918,118,426,544,600,297,27,396,402,2057
Gabe York,23.0,44,35,1436,250,574,0.435540069686,107,296,0.361486486486,143,278,0.514,0.528745644599,87,104,0.836538461538,23,162,185,164,59,7,78,89,694
Gabriel Hughes,0.0,63,30,1200,182,333,0.546546546547,0,0,0.0,182,333,1.088,0.546546546547,140,199,0.70351758794,174,242,416,50,24,46,96,218,504
Gage Daye,0.0,4,0,58,7,23,0.304347826087,3,9,0.333333333333,4,14,0.286,0.369565217391,14,18,0.777777777778,4,7,11,10,2,0,7,6,31
Gal Mekel,25.0,4,1,121,16,49,0.326530612245,2,8,0.25,14,41,0.341,0.34693877551,8,14,0.571428571429,3,10,13,25,6,0,12,5,42
Galen Young,26.0,56,2,1337,229,609,0.376026272578,35,103,0.339805825243,194,506,0.383,0.404761904762,154,227,0.678414096916,84,224,308,139,63,16,141,211,647
Gani Lawal,130.0,82,4,1325,241,441,0.546485260771,0,1,0.0,241,440,2.705,0.546485260771,140,250,0.56,158,342,500,24,16,68,161,225,622
Garret Siler,24.0,4,1,65,7,12,0.583333333333,0,0,0.0,7,12,0.583,0.583333333333,4,8,0.5,6,14,20,1,0,3,8,19,18
Garrett Green,0.0,50,8,390,46,118,0.389830508475,0,2,0.0,46,116,1.115,0.389830508475,22,46,0.478260869565,48,74,122,2,4,6,16,48,114
Garrett Richardson,0.0,10,0,59,2,14,0.142857142857,1,3,0.333333333333,1,11,0.091,0.178571428571,0,0,0.0,1,6,7,9,4,0,2,8,5
Garrett Stutz,0.0,17,3,219,40,73,0.547945205479,1,2,0.5,39,71,0.549,0.554794520548,13,20,0.65,27,44,71,8,1,11,11,46,94
Garrett Temple,121.0,87,71,2986,422,1004,0.4203187251,185,494,0.374493927126,237,510,2.348,0.512450199203,220,292,0.753424657534,92,324,416,296,105,53,207,265,1249
Garrett Williamson,0.0,60,14,1020,94,216,0.435185185185,6,34,0.176470588235,88,182,1.452,0.449074074074,84,134,0.626865671642,32,58,90,112,38,32,82,106,278
Garry Hill-Thomas,0.0,75,3,1297,191,363,0.526170798898,1,1,1.0,190,362,1.603,0.527548209366,152,236,0.64406779661,79,103,182,104,55,7,83,112,535
Gary Ervin,0.0,88,2,1580,268,553,0.484629294756,14,76,0.184210526316,254,477,1.615,0.497287522604,154,210,0.733333333333,83,120,203,227,84,4,100,136,704
Gary Flowers,0.0,62,42,1720,305,645,0.472868217054,47,145,0.324137931034,258,500,0.925,0.509302325581,75,110,0.681818181818,77,249,326,129,68,86,112,150,732
Gary Forbes,158.0,138,79,3976,780,1659,0.470162748644,169,460,0.367391304348,611,1199,2.818,0.521097046414,423,559,0.756708407871,174,490,664,379,125,50,371,359,2152
Gary Hamilton,22.0,9,8,217,17,44,0.386363636364,0,0,0.0,17,44,0.386,0.386363636364,8,12,0.666666666667,19,28,47,18,14,5,18,39,42
Gary Neal,128.0,18,10,510,120,262,0.458015267176,26,76,0.342105263158,94,186,1.867,0.507633587786,82,92,0.891304347826,6,52,58,34,20,0,26,30,348
Gary Payton II,24.0,49,49,1603,274,550,0.498181818182,73,238,0.306722689076,201,312,0.644,0.564545454545,72,103,0.699029126214,88,232,320,162,98,33,77,129,693
Gary Talton,170.0,242,161,7008,897,2289,0.391874180865,287,823,0.34872417983,610,1466,2.941,0.454565312363,412,503,0.819085487078,180,659,839,1495,248,10,539,478,2493
Gary Williams,0.0,45,37,1092,140,301,0.46511627907,17,56,0.303571428571,123,245,0.999,0.493355481728,72,87,0.827586206897,38,97,135,60,24,9,82,128,369
Gavin Edwards,0.0,39,13,995,167,324,0.515432098765,0,3,0.0,167,321,0.52,0.515432098765,96,130,0.738461538462,70,148,218,36,30,37,77,110,430
Gavin Grant,0.0,45,6,863,126,290,0.434482758621,3,19,0.157894736842,123,271,0.987,0.439655172414,142,185,0.767567567568,38,87,125,57,20,10,71,67,397
Geary Claxton,0.0,14,0,216,20,48,0.416666666667,0,2,0.0,20,46,0.435,0.416666666667,3,13,0.230769230769,15,31,46,14,9,7,12,33,43
Geno Carlisle,58.0,20,4,403,64,138,0.463768115942,12,33,0.363636363636,52,105,0.955,0.507246376812,39,50,0.78,6,31,37,24,14,0,27,24,179
Geoff Husted,23.0,8,0,116,15,41,0.365853658537,0,1,0.0,15,40,0.375,0.365853658537,3,6,0.5,12,15,27,3,5,1,5,21,33
Geoff Owens,49.0,89,67,1875,218,427,0.510538641686,0,0,0.0,218,427,1.036,0.510538641686,170,304,0.559210526316,178,336,514,60,41,71,112,342,606
George Beamon,69.0,36,0,424,34,90,0.377777777778,8,42,0.190476190476,26,48,1.585,0.422222222222,28,36,0.777777777778,24,52,76,28,22,0,22,46,104
George Leach,24.0,47,18,990,164,300,0.546666666667,0,0,0.0,164,300,0.547,0.546666666667,64,99,0.646464646465,79,170,249,35,22,65,63,163,392
George Odufuwa,0.0,42,4,706,61,117,0.521367521368,0,0,0.0,61,117,0.521,0.521367521368,41,68,0.602941176471,78,119,197,26,17,31,32,83,163
George Reese,72.0,100,42,1560,236,586,0.402730375427,10,44,0.227272727273,226,542,1.284,0.411262798635,90,116,0.775862068966,98,148,246,96,28,18,84,180,572
George Williams,144.0,200,73,4224,518,1053,0.491927825261,6,21,0.285714285714,512,1032,2.908,0.49477682811,201,292,0.688356164384,184,434,618,200,103,68,268,414,1243
Georges Niang,23.0,6,6,198,47,105,0.447619047619,10,33,0.30303030303,37,72,0.514,0.495238095238,10,13,0.769230769231,11,32,43,20,7,2,14,19,114
Georgios Papagiannis,19.0,23,20,739,142,279,0.508960573477,3,6,0.5,139,273,0.509,0.514336917563,29,38,0.763157894737,55,131,186,11,13,59,44,69,316
Gerald Beverly,23.0,40,1,464,74,125,0.592,2,5,0.4,72,120,0.6,0.6,40,59,0.677966101695,66,70,136,4,8,17,10,63,190
Gerald Fitch,23.0,3,1,69,11,39,0.282051282051,2,11,0.181818181818,9,28,0.321,0.307692307692,11,11,1.0,5,8,13,6,2,1,6,5,35
Gerald Green,86.0,40,23,1125,243,525,0.462857142857,70,153,0.457516339869,173,372,1.854,0.529523809524,79,100,0.79,44,145,189,64,49,13,107,95,635
Gerald Walker,29.0,30,21,575,65,161,0.403726708075,1,11,0.0909090909091,64,150,0.427,0.406832298137,36,41,0.878048780488,36,73,109,85,38,3,58,44,167
Gerard Anderson,0.0,54,14,641,73,154,0.474025974026,6,29,0.206896551724,67,125,2.612,0.493506493506,36,47,0.765957446809,44,59,103,26,22,1,50,50,188
Geron Johnson,22.0,33,0,422,66,173,0.381502890173,15,65,0.230769230769,51,108,0.472,0.424855491329,24,35,0.685714285714,22,52,74,47,20,6,44,64,171
Gerry McNamara,48.0,58,34,1468,194,488,0.397540983607,65,204,0.31862745098,129,284,0.905,0.464139344262,117,128,0.9140625,11,97,108,276,48,2,129,142,570
Giannis Giannoulis,26.0,2,0,7,0,1,0.0,0,0,0.0,0,1,0.0,0.0,0,0,0.0,1,0,1,0,0,0,1,1,0
Gideon Gamble,120.0,69,6,1083,169,398,0.424623115578,88,227,0.387665198238,81,171,1.802,0.535175879397,14,21,0.666666666667,25,117,142,50,42,20,51,136,440
Gigi Datome,27.0,2,0,53,11,24,0.458333333333,6,10,0.6,5,14,0.357,0.583333333333,4,5,0.8,3,10,13,1,0,1,6,3,32
Gilbert Brown,0.0,59,40,1682,245,519,0.472061657033,59,172,0.343023255814,186,347,1.048,0.528901734104,174,234,0.74358974359,57,162,219,126,62,19,95,141,723
Glen McGowan,0.0,69,35,1842,334,634,0.526813880126,27,64,0.421875,307,570,2.208,0.548107255521,263,342,0.769005847953,135,270,405,79,38,14,135,204,958
Glen Rice,117.0,135,72,3545,735,1650,0.445454545455,246,733,0.335607094134,489,917,2.693,0.52,456,596,0.765100671141,209,544,753,365,181,81,268,303,2172
Glenn Robinson,22.0,1,1,41,4,13,0.307692307692,0,2,0.0,4,11,0.364,0.307692307692,3,4,0.75,3,8,11,2,2,0,0,1,11
Goodluck Okonoboh,22.0,7,0,51,7,9,0.777777777778,0,0,0.0,7,9,0.778,0.777777777778,0,2,0.0,8,6,14,2,2,2,6,10,14
Gracin Bakumanya,19.0,40,13,416,48,102,0.470588235294,0,0,0.0,48,102,0.471,0.470588235294,13,18,0.722222222222,52,78,130,13,12,10,21,72,109
Grant Jerrett,106.0,75,64,2240,389,880,0.442045454545,141,368,0.383152173913,248,512,2.456,0.522159090909,130,176,0.738636363636,120,375,495,94,56,59,101,217,1049
Greg Clausen,81.0,92,8,1274,114,300,0.38,0,8,0.0,114,292,1.216,0.38,50,80,0.625,102,152,254,46,14,18,52,174,278
Greg Davis,22.0,42,6,619,68,153,0.444444444444,7,14,0.5,61,139,0.439,0.467320261438,14,19,0.736842105263,10,37,47,108,25,0,34,60,157
Greg Foster,25.0,1,0,1,0,0,0.0,0,0,0.0,0,0,0.0,0.0,0,0,0.0,0,0,0,0,1,0,1,2,0
Greg Gantt,45.0,26,2,407,49,122,0.401639344262,29,86,0.337209302326,20,36,1.077,0.520491803279,16,21,0.761904761905,5,32,37,15,9,1,7,31,143
Greg Gray,0.0,48,38,981,126,287,0.439024390244,2,28,0.0714285714286,124,259,0.479,0.442508710801,65,100,0.65,49,87,136,45,63,8,69,64,319
Greg Jones,28.0,48,1,936,189,449,0.420935412027,77,186,0.413978494624,112,263,0.426,0.506681514477,41,55,0.745454545455,21,62,83,79,37,3,75,60,496
Greg Mays,24.0,5,0,21,5,9,0.555555555556,0,0,0.0,5,9,0.556,0.555555555556,4,4,1.0,4,2,6,0,1,0,1,1,14
Greg Ostertag,38.0,10,1,134,18,33,0.545454545455,0,0,0.0,18,33,0.545,0.545454545455,7,14,0.5,20,30,50,6,1,5,10,16,43
Greg Smith,68.0,46,33,1279,282,465,0.606451612903,0,6,0.0,282,459,1.731,0.606451612903,118,201,0.587064676617,106,261,367,89,47,35,88,134,682
Greg Stempin,91.0,138,57,3571,582,1341,0.434004474273,98,299,0.327759197324,484,1042,1.755,0.470544369873,314,479,0.655532359081,209,486,695,208,84,49,265,351,1576
Greg Stevenson,75.0,88,62,2492,378,664,0.569277108434,16,42,0.380952380952,362,622,1.666,0.581325301205,182,248,0.733870967742,132,286,418,170,126,22,98,170,954
Greg Stiemsma,73.0,50,48,1416,179,334,0.535928143713,0,1,0.0,179,333,1.376,0.535928143713,78,97,0.80412371134,78,291,369,60,35,181,68,187,436
Greg Stolt,0.0,51,1,557,68,171,0.397660818713,26,65,0.4,42,106,0.396,0.473684210526,25,31,0.806451612903,26,80,106,21,9,10,30,37,187
Greg Washington,0.0,7,0,88,6,20,0.3,0,1,0.0,6,19,0.316,0.3,0,0,0.0,7,3,10,3,4,10,6,14,12
Greg Whittington,45.0,36,32,1234,186,421,0.441805225653,71,190,0.373684210526,115,231,1.006,0.526128266033,52,69,0.753623188406,33,233,266,90,65,33,78,115,495
Guerschon Yabusele,0.0,2,1,54,11,17,0.647058823529,4,6,0.666666666667,7,11,0.636,0.764705882353,11,12,0.916666666667,9,11,20,2,1,0,9,4,37
Guillermo Diaz,22.0,22,13,761,131,292,0.448630136986,22,68,0.323529411765,109,224,0.487,0.486301369863,114,135,0.844444444444,20,68,88,69,20,4,44,41,398
Ha Seung-Jin,41.0,31,16,398,34,84,0.404761904762,0,0,0.0,34,84,0.771,0.404761904762,13,26,0.5,29,62,91,7,5,11,26,64,81
Hamady N'Diaye,180.0,91,44,1871,186,342,0.543859649123,0,1,0.0,186,341,3.631,0.543859649123,80,168,0.47619047619,126,240,366,54,25,219,94,237,452
Hamed Haddadi,23.0,18,9,315,40,91,0.43956043956,0,3,0.0,40,88,0.455,0.43956043956,26,41,0.634146341463,50,70,120,16,8,30,36,41,106
Hank Thorns,0.0,12,0,154,11,51,0.21568627451,5,18,0.277777777778,6,33,0.182,0.264705882353,3,6,0.5,1,14,15,32,8,0,17,13,30
Harold Arceneaux,24.0,5,0,56,5,15,0.333333333333,0,0,0.0,5,15,0.333,0.333333333333,16,18,0.888888888889,1,4,5,0,1,1,6,7,26
Harry Good,0.0,2,0,3,0,0,0.0,0,0,0.0,0,0,0.0,0.0,0,0,0.0,0,0,0,0,0,0,0,1,0
Harry Marshall,0.0,6,0,114,12,31,0.387096774194,1,9,0.111111111111,11,22,0.5,0.403225806452,8,10,0.8,0,9,9,13,6,3,7,9,33
Harvey Thomas,69.0,30,0,288,24,70,0.342857142857,0,4,0.0,24,66,1.092,0.342857142857,34,56,0.607142857143,14,28,42,14,12,12,26,60,82
Hasheem Thabeet,72.0,60,51,1424,213,366,0.581967213115,0,0,0.0,213,366,1.708,0.581967213115,130,199,0.653266331658,119,295,414,25,29,152,116,214,556
Hassan Whiteside,187.0,105,22,1426,328,540,0.607407407407,0,2,0.0,328,538,5.442,0.607407407407,137,230,0.595652173913,210,399,609,25,41,241,119,175,793
Henry Domercant,35.0,12,0,201,21,60,0.35,9,32,0.28125,12,28,0.429,0.425,22,26,0.846153846154,5,16,21,8,4,2,7,18,73
Henry Ellenson,20.0,21,21,740,127,305,0.416393442623,38,116,0.327586206897,89,189,0.471,0.47868852459,83,103,0.805825242718,33,154,187,28,12,18,40,55,375
Henry Sims,96.0,109,101,3334,655,1299,0.504234026174,14,44,0.318181818182,641,1255,1.99,0.509622786759,443,572,0.774475524476,295,667,962,175,96,119,267,428,1767
Henry Walker,150.0,117,70,3219,618,1361,0.454077883909,259,670,0.386567164179,359,691,2.89,0.54922850845,257,337,0.762611275964,100,488,588,190,126,97,177,382,1752
Herbert Hill,0.0,32,12,698,140,254,0.551181102362,0,0,0.0,140,254,1.643,0.551181102362,16,38,0.421052631579,56,130,186,22,12,54,66,70,296
Hilton Armstrong,57.0,61,47,1603,277,468,0.59188034188,1,3,0.333333333333,276,465,1.19,0.592948717949,219,305,0.718032786885,150,285,435,86,51,121,162,226,774
Hiram Fuller,69.0,105,67,2890,425,913,0.465498357065,0,2,0.0,425,911,1.387,0.465498357065,323,480,0.672916666667,282,562,844,98,62,166,256,422,1173
Hollis Thompson,46.0,64,17,1392,243,528,0.460227272727,46,130,0.353846153846,197,398,0.997,0.503787878788,85,114,0.745614035088,72,189,261,63,41,14,76,116,617
Horace Wormely,0.0,43,19,1232,97,233,0.416309012876,27,77,0.350649350649,70,156,0.449,0.474248927039,75,92,0.815217391304,13,108,121,165,44,1,79,104,296
Ian Chiles,75.0,20,0,158,36,68,0.529411764706,0,0,0.0,36,68,1.058,0.529411764706,10,10,1.0,24,32,56,4,0,10,14,30,82
Ian Clark,45.0,15,14,481,76,182,0.417582417582,29,72,0.402777777778,47,110,0.848,0.497252747253,16,24,0.666666666667,3,39,42,61,21,4,32,36,197
Ian Mahinmi,43.0,47,41,1381,277,454,0.61013215859,0,0,0.0,277,454,0.815,0.61013215859,221,288,0.767361111111,118,250,368,64,66,79,127,196,775
Ibrahima Thomas,0.0,29,7,442,72,157,0.458598726115,0,4,0.0,72,153,0.932,0.458598726115,27,50,0.54,43,79,122,14,15,15,20,69,171
Idong Ibok,0.0,13,4,127,7,16,0.4375,0,0,0.0,7,16,0.438,0.4375,3,4,0.75,12,13,25,1,2,6,19,29,17
Ike Diogu,0.0,42,33,1310,297,537,0.553072625698,29,87,0.333333333333,268,450,0.596,0.580074487896,158,193,0.818652849741,124,287,411,61,19,38,109,125,781
Ike Nwamu,23.0,47,13,1152,144,363,0.396694214876,83,243,0.341563786008,61,120,0.508,0.511019283747,58,72,0.805555555556,30,119,149,48,45,7,46,108,429
Ike Nwankwo,0.0,26,12,566,43,109,0.394495412844,0,1,0.0,43,108,0.773,0.394495412844,27,55,0.490909090909,62,111,173,13,13,27,38,109,113
Ime Udoka,79.0,136,107,3942,707,1563,0.452335252719,107,311,0.344051446945,600,1252,1.446,0.486564299424,458,630,0.726984126984,232,609,841,325,212,44,331,440,1979
Isaac Fontaine,81.0,108,98,2977,525,1188,0.441919191919,133,320,0.415625,392,868,1.322,0.497895622896,364,415,0.877108433735,81,219,300,228,87,17,225,285,1547
Isaiah Canaan,45.0,22,21,757,149,352,0.423295454545,73,200,0.365,76,152,0.92,0.526988636364,105,136,0.772058823529,20,66,86,181,16,3,73,42,476
Isaiah Cousins,22.0,50,50,1744,332,730,0.454794520548,41,141,0.290780141844,291,589,0.494,0.482876712329,144,182,0.791208791209,52,236,288,201,92,10,116,150,849
Isaiah Swann,0.0,3,0,45,4,17,0.235294117647,4,14,0.285714285714,0,3,0.0,0.352941176471,10,11,0.909090909091,1,5,6,5,1,1,5,8,22
Isaiah Taylor,22.0,25,19,872,176,342,0.514619883041,43,94,0.457446808511,133,248,0.536,0.577485380117,129,158,0.816455696203,15,59,74,150,18,3,61,70,524
Isaiah Wilkerson,0.0,78,8,1304,184,495,0.371717171717,41,148,0.277027027027,143,347,0.792,0.413131313131,77,95,0.810526315789,35,96,131,117,31,3,101,119,486
Ishmael Smith,22.0,8,5,264,44,98,0.448979591837,4,16,0.25,40,82,0.488,0.469387755102,8,16,0.5,7,27,34,63,12,10,29,24,100
Isiah Victor,53.0,86,63,2933,599,1197,0.500417710944,5,24,0.208333333333,594,1173,1.013,0.502506265664,442,587,0.752981260647,185,467,652,172,82,37,244,269,1645
Isma'il Muhammad,0.0,11,0,205,35,72,0.486111111111,2,6,0.333333333333,33,66,0.5,0.5,11,28,0.392857142857,29,26,55,29,6,4,13,33,83
Ismael Romero,49.0,45,3,637,101,174,0.580459770115,0,2,0.0,101,172,1.167,0.580459770115,38,88,0.431818181818,45,139,184,19,15,11,35,104,240
Ivan Harris,0.0,99,78,3451,576,1271,0.453186467349,105,274,0.383211678832,471,997,0.936,0.49449252557,133,154,0.863636363636,141,304,445,70,71,38,69,257,1390
Ivan Johnson,125.0,146,87,4301,932,1853,0.502968159741,29,119,0.243697478992,903,1734,2.587,0.510793308149,528,769,0.686605981795,273,746,1019,253,210,120,376,564,2421
Ivica Zubac,19.0,14,14,421,94,161,0.583850931677,4,11,0.363636363636,90,150,0.6,0.596273291925,29,35,0.828571428571,29,107,136,18,3,14,45,48,221
J.C. Mathis,0.0,57,9,809,88,204,0.43137254902,0,0,0.0,88,204,0.847,0.43137254902,41,63,0.650793650794,82,90,172,21,11,16,56,131,217
J.J. Avila,75.0,82,36,1714,282,616,0.457792207792,60,186,0.322580645161,222,430,1.578,0.506493506494,70,88,0.795454545455,120,304,424,152,78,40,78,222,694
J.J. Moore,25.0,46,23,1219,257,517,0.497098646035,49,152,0.322368421053,208,365,0.57,0.544487427466,105,142,0.739436619718,72,89,161,55,41,16,49,93,668
J.J. O'Brien,47.0,93,88,3204,440,990,0.444444444444,87,275,0.316363636364,353,715,0.974,0.488383838384,162,222,0.72972972973,71,344,415,254,109,28,153,177,1129
J.J. Panoske,24.0,11,0,123,15,30,0.5,12,26,0.461538461538,3,4,0.75,0.7,1,2,0.5,7,11,18,4,3,7,12,15,43
J.P. Tokoto,45.0,91,58,2712,422,888,0.475225225225,74,236,0.313559322034,348,652,1.082,0.516891891892,201,288,0.697916666667,120,320,440,216,176,48,155,268,1119
J.R. Giddens,72.0,47,38,1686,312,566,0.551236749117,25,75,0.333333333333,287,491,1.79,0.57332155477,90,129,0.697674418605,77,198,275,126,46,49,100,99,739
J.R. Reynolds,0.0,3,2,108,11,30,0.366666666667,5,12,0.416666666667,6,18,0.333,0.45,9,10,0.9,4,9,13,6,5,0,6,8,36
J.T. Tiller,0.0,5,2,81,11,21,0.52380952381,1,2,0.5,10,19,0.526,0.547619047619,3,4,0.75,10,7,17,9,4,0,4,11,26
JJ Sullinger,24.0,2,0,13,1,2,0.5,0,1,0.0,1,1,1.0,0.5,0,0,0.0,0,1,1,1,0,0,2,2,2
JR Inman,81.0,25,14,510,74,156,0.474358974359,5,13,0.384615384615,69,143,1.587,0.490384615385,35,59,0.593220338983,44,85,129,23,10,13,26,53,188
JR Pinnock,23.0,21,15,653,96,200,0.48,6,32,0.1875,90,168,0.536,0.495,34,44,0.772727272727,38,105,143,96,30,12,65,51,232
JT Terrell,25.0,1,0,9,0,2,0.0,0,1,0.0,0,1,0.0,0.0,2,2,1.0,0,0,0,1,0,0,2,2,2
JaJuan Johnson,92.0,84,34,1960,324,742,0.436657681941,0,10,0.0,324,732,1.844,0.436657681941,138,176,0.784090909091,132,312,444,42,78,114,96,186,786
JaJuan Smith,0.0,4,0,65,8,24,0.333333333333,5,17,0.294117647059,3,7,0.429,0.4375,0,0,0.0,5,6,11,15,5,0,5,9,21
JaKarr Sampson,44.0,17,8,425,110,232,0.474137931034,10,37,0.27027027027,100,195,0.935,0.495689655172,36,49,0.734693877551,21,67,88,21,12,11,22,33,266
JaMychal Green,46.0,60,45,1598,375,705,0.531914893617,6,22,0.272727272727,369,683,1.09,0.536170212766,194,239,0.811715481172,187,351,538,103,56,62,144,200,950
JaRon Rush,22.0,14,0,106,6,28,0.214285714286,0,12,0.0,6,16,0.375,0.214285714286,13,18,0.722222222222,6,15,21,3,2,4,16,16,25
Jabari Brown,69.0,56,29,1824,415,916,0.453056768559,127,316,0.401898734177,288,600,1.401,0.522379912664,329,388,0.84793814433,64,148,212,120,47,11,137,122,1286
Jabril Banks,0.0,6,0,84,10,19,0.526315789474,0,0,0.0,10,19,0.526,0.526315789474,0,0,0.0,6,0,6,3,0,2,4,8,20
Jabril Trawick,47.0,84,23,1899,311,654,0.475535168196,70,211,0.331753554502,241,443,1.089,0.529051987768,231,316,0.731012658228,57,173,230,166,86,30,137,257,923
Jack Cooley,47.0,26,23,784,166,293,0.566552901024,4,22,0.181818181818,162,271,1.179,0.57337883959,86,127,0.677165354331,134,186,320,29,25,26,44,88,422
Jack Marlow,24.0,1,0,1,0,0,0.0,0,0,0.0,0,0,0.0,0.0,0,0,0.0,0,0,0,0,0,1,0,1,0
Jack McClinton,0.0,3,2,38,0,13,0.0,0,5,0.0,0,8,0.0,0.0,2,3,0.666666666667,0,4,4,2,0,0,1,6,2
Jackie Carmichael,0.0,37,28,854,132,263,0.501901140684,0,1,0.0,132,262,0.504,0.501901140684,89,127,0.700787401575,71,160,231,30,32,52,52,103,353
Jackie Manuel,98.0,167,145,5705,712,1588,0.448362720403,27,107,0.252336448598,685,1481,1.87,0.456863979849,346,561,0.616755793226,224,610,834,340,213,121,342,563,1797
Jae Crowder,23.0,2,2,87,18,41,0.439024390244,1,7,0.142857142857,17,34,0.5,0.451219512195,8,12,0.666666666667,13,19,32,20,7,4,12,3,45
Jahmar Thorpe,0.0,2,0,11,2,4,0.5,1,3,0.333333333333,1,1,1.0,0.625,2,2,1.0,1,0,1,1,1,0,2,3,7
Jahsha Bluntt,0.0,66,0,712,110,294,0.374149659864,54,144,0.375,56,150,0.751,0.465986394558,50,64,0.78125,30,72,102,22,24,8,44,78,324
Jai Lucas,0.0,38,0,730,110,270,0.407407407407,10,48,0.208333333333,100,222,1.951,0.425925925926,32,36,0.888888888889,4,54,58,92,6,4,48,60,262
Jake Anderson,0.0,44,6,866,140,296,0.472972972973,10,26,0.384615384615,130,270,1.487,0.489864864865,104,134,0.776119402985,16,98,114,124,12,8,112,62,394
Jake Layman,22.0,8,8,267,53,125,0.424,12,53,0.22641509434,41,72,0.569,0.472,25,30,0.833333333333,10,38,48,16,13,6,17,16,143
Jake O'Brien,0.0,6,0,55,7,15,0.466666666667,4,9,0.444444444444,3,6,0.5,0.6,2,2,1.0,2,3,5,0,0,1,1,4,20
Jakob Poeltl,21.0,2,2,67,14,25,0.56,0,1,0.0,14,24,0.583,0.56,4,10,0.4,9,17,26,2,2,6,3,8,32
Jaleel Cousins,69.0,62,24,766,98,214,0.457943925234,0,0,0.0,98,214,1.369,0.457943925234,122,184,0.663043478261,66,118,184,6,20,40,60,180,318
Jaleel Roberts,72.0,42,0,406,44,86,0.511627906977,0,0,0.0,44,86,1.528,0.511627906977,16,18,0.888888888889,40,70,110,14,8,26,40,78,104
Jalen Jones,23.0,46,46,1654,316,709,0.445698166432,90,261,0.344827586207,226,448,0.504,0.509167842031,244,327,0.746177370031,90,323,413,102,45,26,143,138,966
Jalil Abdul-Bassit,23.0,2,0,26,4,11,0.363636363636,1,4,0.25,3,7,0.429,0.409090909091,2,2,1.0,0,2,2,1,0,0,0,5,11
Jamaal Brown,0.0,44,14,1010,138,270,0.511111111111,0,2,0.0,138,268,1.653,0.511111111111,54,90,0.6,76,106,182,50,16,14,44,116,330
Jamaal Franklin,69.0,41,10,1270,216,466,0.463519313305,69,197,0.350253807107,147,269,1.601,0.537553648069,201,248,0.810483870968,51,245,296,220,62,12,134,130,702
Jamaal Moore,25.0,8,0,80,10,21,0.47619047619,0,0,0.0,10,21,0.476,0.47619047619,2,9,0.222222222222,5,5,10,5,0,0,3,11,22
Jamaal Tatum,0.0,49,5,1299,204,519,0.393063583815,41,126,0.325396825397,163,393,0.415,0.432562620424,127,160,0.79375,28,90,118,194,51,2,86,105,576
Jamaal Thomas,243.0,240,32,5040,770,1712,0.44976635514,164,606,0.270627062706,606,1106,5.01,0.497663551402,366,526,0.695817490494,234,456,690,342,210,130,254,358,2070
Jamaal Tinsley,33.0,8,8,272,27,86,0.313953488372,6,23,0.260869565217,21,63,0.333,0.348837209302,19,25,0.76,6,19,25,61,19,1,23,27,79
Jamaal Williams,24.0,5,0,41,6,19,0.315789473684,0,1,0.0,6,18,0.333,0.315789473684,4,4,1.0,3,4,7,0,3,0,1,7,16
Jamal Abu-Shamala,0.0,1,0,4,1,2,0.5,0,0,0.0,1,2,0.5,0.5,0,0,0.0,0,1,1,0,0,0,0,1,2
Jamal Branch,47.0,35,1,406,48,125,0.384,5,20,0.25,43,105,0.704,0.404,22,25,0.88,6,37,43,61,18,3,45,47,123
Jamal Jones,43.0,59,19,1172,158,385,0.41038961039,61,180,0.338888888889,97,205,0.88,0.48961038961,53,79,0.670886075949,42,110,152,53,36,21,53,127,430
Jamal Kendrick,26.0,10,7,189,31,68,0.455882352941,0,4,0.0,31,64,0.484,0.455882352941,15,19,0.789473684211,14,21,35,6,7,0,8,21,77
Jamal Robinson,29.0,50,49,1449,225,556,0.404676258993,49,146,0.335616438356,176,410,0.429,0.448741007194,100,134,0.746268656716,42,115,157,67,48,20,99,152,599
Jamal Sampson,61.0,34,18,907,193,391,0.493606138107,19,66,0.287878787879,174,325,1.139,0.517902813299,98,148,0.662162162162,62,165,227,47,31,30,77,108,503
Jamar Abrams,0.0,9,3,99,18,38,0.473684210526,6,17,0.352941176471,12,21,0.571,0.552631578947,5,6,0.833333333333,5,9,14,5,2,1,3,14,47
Jamar Brown,0.0,117,36,2014,268,574,0.466898954704,1,3,0.333333333333,267,571,1.367,0.467770034843,95,155,0.612903225806,234,279,513,62,39,58,114,325,632
Jamar Smith,51.0,146,100,4712,752,1675,0.448955223881,113,274,0.412408759124,639,1401,1.39,0.482686567164,287,407,0.70515970516,201,649,850,391,119,67,359,301,1904
Jamario Moon,221.0,111,47,2509,346,817,0.423500611995,112,319,0.351097178683,234,498,4.69,0.492044063647,125,160,0.78125,66,413,479,195,141,138,115,167,929
Jamarr Sanders,0.0,92,65,2657,344,740,0.464864864865,112,289,0.387543252595,232,451,1.031,0.540540540541,80,103,0.776699029126,101,248,349,233,99,16,135,185,880
Jameel Pugh,24.0,2,0,6,0,2,0.0,0,0,0.0,0,2,0.0,0.0,0,0,0.0,0,2,2,0,0,0,0,1,0
Jameel Warney,23.0,44,34,1286,322,560,0.575,0,1,0.0,322,559,0.576,0.575,118,168,0.702380952381,146,207,353,61,44,51,55,138,762
Jameel Watkins,49.0,66,60,1461,232,448,0.517857142857,1,1,1.0,231,447,1.025,0.518973214286,106,186,0.569892473118,149,291,440,33,44,83,103,254,571
Jamelle Cornley,0.0,9,0,121,19,44,0.431818181818,1,2,0.5,18,42,0.429,0.443181818182,4,11,0.363636363636,6,3,9,6,3,0,5,9,43
Jamelle Hagins,0.0,16,7,249,32,54,0.592592592593,0,0,0.0,32,54,0.593,0.592592592593,10,13,0.769230769231,22,34,56,3,9,17,26,45,74
Jamelle Horne,0.0,18,2,362,51,119,0.428571428571,8,27,0.296296296296,43,92,0.467,0.46218487395,15,17,0.882352941176,16,37,53,15,6,12,22,42,125
James Anderson,21.0,7,7,176,42,94,0.446808510638,9,26,0.346153846154,33,68,0.485,0.494680851064,10,14,0.714285714286,13,21,34,14,7,4,25,19,103
James Augustine,22.0,8,4,218,36,53,0.679245283019,0,0,0.0,36,53,0.679,0.679245283019,9,11,0.818181818182,25,46,71,7,8,6,11,24,81
James Booyer,0.0,2,0,9,0,4,0.0,0,0,0.0,0,4,0.0,0.0,0,4,0.0,1,1,2,0,1,0,1,2,0
James Carlton,23.0,7,0,22,4,13,0.307692307692,3,11,0.272727272727,1,2,0.5,0.423076923077,0,0,0.0,3,4,7,0,0,3,0,1,11
James Cripe,0.0,60,18,801,69,147,0.469387755102,0,2,0.0,69,145,1.677,0.469387755102,20,26,0.769230769231,52,59,111,27,11,25,44,134,158
James Ennis,25.0,24,21,799,158,348,0.454022988506,42,131,0.320610687023,116,217,0.535,0.514367816092,92,132,0.69696969697,45,100,145,62,24,11,64,66,450
James Johnson,49.0,18,18,556,122,238,0.512605042017,16,62,0.258064516129,106,176,1.206,0.546218487395,79,93,0.849462365591,43,119,162,82,27,54,64,65,339
James Lang,114.0,123,51,2309,469,837,0.560334528076,0,2,0.0,469,835,2.534,0.560334528076,223,337,0.661721068249,226,455,681,98,36,107,223,410,1161
James Maye,26.0,33,33,1046,187,407,0.459459459459,27,78,0.346153846154,160,329,0.486,0.492628992629,119,127,0.937007874016,24,118,142,75,18,7,76,89,520
James Mays,0.0,106,102,3571,647,1467,0.441036128153,18,70,0.257142857143,629,1397,2.266,0.447171097478,352,589,0.597623089983,411,632,1043,152,143,118,303,332,1664
James Michael McAdoo,22.0,33,31,1081,248,431,0.575406032483,1,4,0.25,247,427,0.578,0.57656612529,148,216,0.685185185185,97,189,286,76,66,67,77,104,645
James Nunnally,91.0,119,76,3320,602,1321,0.455715367146,265,645,0.410852713178,337,676,2.062,0.556018168055,305,360,0.847222222222,85,372,457,338,105,21,235,235,1774
James Peters,0.0,114,81,3253,645,1286,0.501555209953,1,13,0.0769230769231,644,1273,2.044,0.501944012442,275,438,0.627853881279,189,380,569,112,117,117,270,381,1566
James Siakam,23.0,5,0,81,7,13,0.538461538462,0,0,0.0,7,13,0.538,0.538461538462,8,10,0.8,16,13,29,5,5,3,3,19,22
James Singleton,33.0,21,8,657,86,193,0.445595854922,18,52,0.346153846154,68,141,0.482,0.492227979275,39,51,0.764705882353,48,110,158,35,10,22,43,56,229
James Smith,0.0,28,2,418,30,116,0.258620689655,4,42,0.0952380952381,26,74,1.037,0.275862068966,32,40,0.8,18,56,74,8,8,12,24,100,96
James Southerland,49.0,77,42,2145,425,878,0.484054669704,158,438,0.360730593607,267,440,1.205,0.574031890661,89,130,0.684615384615,108,384,492,72,72,79,69,214,1097
James Taylor,23.0,3,0,35,6,13,0.461538461538,1,2,0.5,5,11,0.455,0.5,4,4,1.0,0,2,2,0,2,1,1,6,17
James Thomas,24.0,36,35,1276,165,312,0.528846153846,0,1,0.0,165,311,0.531,0.528846153846,118,172,0.686046511628,178,302,480,24,17,13,66,108,448
James Tyler,26.0,4,0,50,3,12,0.25,0,0,0.0,3,12,0.25,0.25,2,2,1.0,9,12,21,1,0,9,5,8,8
James Webb III,23.0,39,39,1357,186,416,0.447115384615,71,198,0.358585858586,115,218,0.528,0.532451923077,68,90,0.755555555556,80,281,361,46,50,30,61,122,511
James White,50.0,49,44,1915,375,706,0.531161473088,62,172,0.360465116279,313,534,1.128,0.57507082153,313,376,0.832446808511,57,174,231,133,65,25,144,153,1125
James Wright,0.0,52,26,1174,220,433,0.508083140878,20,59,0.338983050847,200,374,1.51,0.531177829099,56,80,0.7,13,55,68,116,24,4,67,54,516
James Young,39.0,31,23,955,196,444,0.441441441441,103,254,0.405511811024,93,190,0.978,0.557432432432,84,107,0.785046728972,29,138,167,60,40,18,63,59,579
JamesOn Curry,204.0,188,154,6399,954,2238,0.426273458445,255,676,0.377218934911,699,1562,3.599,0.483243967828,444,554,0.801444043321,123,554,677,913,259,40,499,488,2607
Jamie Vanderbeken,0.0,28,12,565,54,154,0.350649350649,42,118,0.35593220339,12,36,0.333,0.487012987013,0,0,0.0,19,75,94,36,14,23,22,71,150
Jamil Wilson,49.0,88,59,2638,426,946,0.450317124736,152,407,0.373464373464,274,539,1.006,0.530655391121,154,202,0.762376237624,98,383,481,175,66,66,149,250,1158
Jamine Peterson,0.0,48,10,1074,220,505,0.435643564356,45,137,0.328467153285,175,368,1.301,0.480198019802,79,121,0.652892561983,122,150,272,36,28,16,77,105,564
Jamison Brewer,27.0,4,3,111,4,17,0.235294117647,0,6,0.0,4,11,0.364,0.235294117647,5,8,0.625,2,6,8,18,9,0,5,15,13
Jannero Pargo,73.0,27,0,614,119,301,0.395348837209,75,189,0.396825396825,44,112,1.018,0.519933554817,26,29,0.896551724138,3,48,51,86,22,0,63,42,339
Jared Carter,0.0,4,0,15,1,3,0.333333333333,0,0,0.0,1,3,0.333,0.333333333333,0,0,0.0,1,3,4,1,0,0,3,2,2
Jared Cunningham,136.0,98,79,3285,496,1251,0.396482813749,162,512,0.31640625,334,739,2.525,0.461231015188,576,732,0.786885245902,90,220,310,348,117,23,295,212,1730
Jared Jordan,0.0,37,30,1150,166,366,0.453551912568,14,50,0.28,152,316,0.481,0.472677595628,45,64,0.703125,33,104,137,326,71,4,99,64,391
Jared Newson,0.0,90,42,2110,326,690,0.472463768116,30,100,0.3,296,590,1.505,0.494202898551,168,262,0.641221374046,94,262,356,108,78,26,106,154,850
Jared Reiner,51.0,46,42,1422,244,519,0.470134874759,0,1,0.0,244,518,0.938,0.470134874759,130,184,0.70652173913,113,301,414,63,29,48,95,174,618
Jared Sullinger,24.0,2,2,55,12,30,0.4,4,9,0.444444444444,8,21,0.381,0.466666666667,6,8,0.75,6,19,25,5,0,0,3,7,34
Jarell Martin,43.0,32,25,908,186,427,0.435597189696,14,47,0.297872340426,172,380,0.934,0.451990632319,113,149,0.758389261745,69,157,226,32,23,29,70,110,499
Jarelle Reischel,0.0,2,0,37,3,8,0.375,0,3,0.0,3,5,0.6,0.375,1,2,0.5,0,6,6,2,3,0,1,5,7
Jarnell Stokes,43.0,51,42,1597,390,603,0.646766169154,4,9,0.444444444444,386,594,1.287,0.65008291874,141,207,0.68115942029,193,326,519,58,46,38,88,124,925
Jaron Johnson,69.0,113,88,3620,627,1378,0.455007256894,232,623,0.372391653291,395,755,1.535,0.539187227866,343,460,0.745652173913,179,351,530,255,102,57,225,263,1829
Jarred Axon,0.0,14,0,171,19,55,0.345454545455,8,26,0.307692307692,11,29,0.379,0.418181818182,5,8,0.625,4,16,20,14,5,0,8,17,51
Jarred Merrill,0.0,10,0,196,32,65,0.492307692308,9,24,0.375,23,41,0.561,0.561538461538,22,30,0.733333333333,10,27,37,7,4,3,20,26,95
Jarred Shaw,25.0,17,3,329,63,111,0.567567567568,0,1,0.0,63,110,0.573,0.567567567568,26,33,0.787878787879,18,58,76,15,9,13,28,41,152
Jarrell Eddie,122.0,145,81,4012,679,1478,0.459404600812,387,892,0.433856502242,292,586,2.519,0.590324763194,245,281,0.871886120996,68,480,548,190,87,48,228,269,1990
Jarrid Famous,219.0,178,140,5060,872,1714,0.508751458576,2,8,0.25,870,1706,4.564,0.509334889148,444,606,0.732673267327,732,1056,1788,92,82,144,328,452,2190
Jarrod Gee,28.0,26,0,384,47,108,0.435185185185,0,2,0.0,47,106,0.443,0.435185185185,12,17,0.705882352941,28,52,80,21,5,9,19,55,106
Jarrod Uthoff,92.0,74,18,1804,308,636,0.48427672956,60,130,0.461538461538,248,506,2.012,0.531446540881,142,166,0.855421686747,140,330,470,120,62,68,118,112,818
Jarvis Gunter,0.0,156,32,2338,236,457,0.516411378556,0,0,0.0,236,457,2.696,0.516411378556,80,126,0.634920634921,229,364,593,81,43,88,108,287,552
Jarvis Summers,22.0,3,0,23,0,2,0.0,0,1,0.0,0,1,0.0,0.0,0,0,0.0,0,1,1,0,0,1,0,3,0
Jarvis Threatt,66.0,119,19,2385,444,1029,0.431486880466,54,202,0.267326732673,390,827,1.414,0.457725947522,411,593,0.693086003373,105,244,349,380,123,15,207,174,1353
Jarvis Varnado,75.0,53,48,1584,294,545,0.539449541284,0,0,0.0,294,545,1.616,0.539449541284,149,239,0.623430962343,150,372,522,48,39,196,146,217,737
Jarvis Williams,28.0,42,14,880,124,261,0.475095785441,7,21,0.333333333333,117,240,0.488,0.488505747126,58,78,0.74358974359,76,116,192,36,22,0,39,112,313
Jason Bohannon,23.0,12,0,58,6,9,0.666666666667,2,2,1.0,4,7,0.571,0.777777777778,3,4,0.75,0,7,7,2,5,1,5,9,17
Jason Calliste,52.0,59,3,1131,140,319,0.438871473354,85,195,0.435897435897,55,124,0.85,0.57210031348,65,86,0.755813953488,18,125,143,90,30,2,59,104,430
Jason Capel,47.0,73,66,2102,285,595,0.478991596639,50,145,0.344827586207,235,450,1.045,0.521008403361,261,303,0.861386138614,96,199,295,167,73,24,141,206,881
Jason Clark,23.0,32,2,425,44,77,0.571428571429,0,0,0.0,44,77,0.571,0.571428571429,25,46,0.54347826087,43,79,122,11,14,2,29,76,113
Jason Collier,26.0,30,21,845,159,348,0.456896551724,2,13,0.153846153846,157,335,0.469,0.459770114943,142,175,0.811428571429,76,140,216,24,15,24,80,95,462
Jason Dixon,0.0,7,0,91,7,24,0.291666666667,0,0,0.0,7,24,0.292,0.291666666667,7,10,0.7,14,21,35,4,4,1,6,13,21
Jason Ellis,0.0,179,63,3640,343,701,0.489300998573,0,7,0.0,343,694,2.269,0.489300998573,196,241,0.813278008299,549,633,1182,150,130,73,152,476,882
Jason Fontenet,49.0,46,19,1173,152,328,0.463414634146,34,77,0.441558441558,118,251,0.81,0.515243902439,78,93,0.838709677419,13,97,110,195,39,0,86,79,416
Jason Hart,23.0,12,9,304,58,130,0.446153846154,5,14,0.357142857143,53,116,0.457,0.465384615385,31,39,0.794871794872,14,38,52,47,14,1,25,32,152
Jason Heide,0.0,43,5,530,70,179,0.391061452514,1,1,1.0,69,178,0.388,0.393854748603,43,61,0.704918032787,45,95,140,11,10,12,38,66,184
Jason Horton,0.0,74,33,1666,98,309,0.31715210356,17,72,0.236111111111,81,237,1.37,0.344660194175,71,114,0.622807017544,26,138,164,305,58,2,127,184,284
Jason Klotz,0.0,33,22,580,76,157,0.484076433121,0,2,0.0,76,155,0.49,0.484076433121,33,45,0.733333333333,58,79,137,13,11,28,39,132,185
Jason Lawson,30.0,4,3,65,7,13,0.538461538462,0,0,0.0,7,13,0.538,0.538461538462,5,8,0.625,6,7,13,0,1,4,3,11,19
Jason McCutcheon,0.0,56,47,1271,119,274,0.434306569343,3,18,0.166666666667,116,256,0.453,0.439781021898,45,56,0.803571428571,32,106,138,72,36,31,57,116,286
Jason McKrieth,0.0,32,0,416,38,100,0.38,4,8,0.5,34,92,1.103,0.4,20,30,0.666666666667,6,44,50,40,22,6,30,50,100
Jason Miskiri,83.0,88,46,2188,299,710,0.421126760563,62,170,0.364705882353,237,540,1.225,0.464788732394,183,229,0.799126637555,40,171,211,386,120,2,157,241,843
Jason Parker,0.0,4,0,57,6,16,0.375,4,9,0.444444444444,2,7,0.286,0.5,2,2,1.0,2,4,6,3,3,0,1,4,18
Jason Richards,0.0,18,0,312,18,55,0.327272727273,3,17,0.176470588235,15,38,0.395,0.354545454545,14,17,0.823529411765,8,14,22,41,16,0,26,25,53
Jason Skaer,0.0,4,2,50,2,12,0.166666666667,0,3,0.0,2,9,0.222,0.166666666667,4,7,0.571428571429,4,3,7,1,0,0,6,10,8
Jason Smith,0.0,14,0,202,36,87,0.413793103448,2,6,0.333333333333,34,81,0.42,0.425287356322,10,14,0.714285714286,12,15,27,10,12,0,10,15,84
Jason Straight,0.0,54,2,982,170,376,0.452127659574,48,120,0.4,122,256,1.43,0.515957446809,110,138,0.797101449275,26,70,96,124,30,4,102,92,498
Jason Warren,0.0,2,0,16,1,3,0.333333333333,1,1,1.0,0,2,0.0,0.5,0,0,0.0,0,3,3,0,0,0,0,5,3
Jason Williams,0.0,8,0,44,5,12,0.416666666667,0,2,0.0,5,10,0.5,0.416666666667,4,6,0.666666666667,4,8,12,3,1,0,1,3,14
Jasper Johnson,0.0,98,74,3188,640,1318,0.485584218513,68,154,0.441558441558,572,1164,1.364,0.511380880121,336,376,0.893617021277,224,580,804,272,158,72,250,240,1684
Javaris Crittenton,23.0,21,5,598,109,258,0.422480620155,4,22,0.181818181818,105,236,0.445,0.43023255814,83,138,0.601449275362,19,74,93,141,52,2,93,59,305
Javier Carter,24.0,41,0,484,57,128,0.4453125,6,17,0.352941176471,51,111,0.459,0.46875,32,41,0.780487804878,53,66,119,19,12,27,28,72,152
Jawad Williams,70.0,73,68,2775,547,1242,0.440418679549,137,381,0.359580052493,410,861,1.412,0.495571658615,271,343,0.790087463557,88,239,327,136,59,32,153,163,1502
Jawann McClellan,0.0,28,3,465,53,120,0.441666666667,2,16,0.125,51,104,0.49,0.45,18,27,0.666666666667,26,39,65,22,17,5,20,47,126
Jay Bowie,22.0,2,0,29,2,6,0.333333333333,1,4,0.25,1,2,0.5,0.416666666667,0,0,0.0,1,3,4,2,3,0,0,1,5
Jay Harris,69.0,58,4,956,116,326,0.355828220859,42,122,0.344262295082,74,204,1.022,0.420245398773,56,68,0.823529411765,24,80,104,132,26,2,98,56,330
Jay Williams,25.0,3,1,84,6,23,0.260869565217,3,9,0.333333333333,3,14,0.214,0.326086956522,3,4,0.75,1,7,8,16,2,0,15,8,18
Jay-R Strowbridge,0.0,14,4,282,44,114,0.385964912281,16,43,0.372093023256,28,71,0.394,0.456140350877,19,25,0.76,6,22,28,49,11,1,27,28,123
Jaylen Bland,23.0,39,10,736,72,230,0.313043478261,63,198,0.318181818182,9,32,0.281,0.45,13,19,0.684210526316,6,74,80,31,25,2,21,62,220
Jaylen Bond,23.0,45,4,837,149,314,0.474522292994,14,36,0.388888888889,135,278,0.486,0.496815286624,26,56,0.464285714286,114,171,285,59,31,9,37,122,338
Jazwyn Cowan,0.0,52,15,921,139,265,0.524528301887,1,9,0.111111111111,138,256,1.058,0.52641509434,41,61,0.672131147541,107,175,282,33,18,17,60,77,320
Jean Nguidjol,21.0,4,0,10,0,4,0.0,0,2,0.0,0,2,0.0,0.0,0,0,0.0,0,1,1,0,0,0,4,4,0
Jean-Felix Moupegnou,24.0,50,28,1150,128,327,0.391437308869,62,170,0.364705882353,66,157,0.42,0.48623853211,64,83,0.771084337349,60,163,223,67,59,10,54,124,382
Jeff Adrien,98.0,59,47,1933,390,712,0.547752808989,1,6,0.166666666667,389,706,2.193,0.54845505618,295,414,0.712560386473,200,472,672,91,60,87,164,164,1076
Jeff Aubry,76.0,121,87,2945,312,611,0.510638297872,0,0,0.0,312,611,1.533,0.510638297872,193,346,0.557803468208,236,470,706,82,58,187,161,391,817
Jeff Ayres,113.0,76,58,2254,408,704,0.579545454545,8,25,0.32,400,679,2.333,0.585227272727,334,375,0.890666666667,164,508,672,136,45,75,154,290,1158
Jeff Boese,0.0,50,22,1019,104,265,0.392452830189,26,90,0.288888888889,78,175,0.446,0.441509433962,65,87,0.747126436782,53,102,155,57,36,11,68,125,299
Jeff Foote,50.0,89,72,2714,422,808,0.522277227723,0,2,0.0,422,806,1.044,0.522277227723,195,365,0.534246575342,302,452,754,125,73,110,196,249,1039
Jeff Graves,83.0,34,30,817,168,293,0.57337883959,0,0,0.0,168,293,1.105,0.57337883959,96,132,0.727272727273,82,179,261,33,20,29,80,121,432
Jeff Hagen,48.0,59,7,887,81,185,0.437837837838,0,0,0.0,81,185,0.883,0.437837837838,60,77,0.779220779221,99,120,219,49,25,46,65,160,222
Jeff Horner,0.0,50,39,1969,196,503,0.389662027833,90,266,0.338345864662,106,237,0.447,0.479125248509,94,118,0.796610169492,38,185,223,315,99,15,112,92,576
Jeff Ledbetter,28.0,38,0,732,129,250,0.516,74,153,0.483660130719,55,97,0.567,0.664,31,36,0.861111111111,9,63,72,83,41,7,56,89,363
Jeff Myers,114.0,145,63,3556,460,1019,0.45142296369,68,195,0.348717948718,392,824,1.959,0.484789008832,367,458,0.801310043668,144,402,546,502,235,19,313,318,1355
Jeff Newberry,24.0,25,0,285,30,83,0.361445783133,4,13,0.307692307692,26,70,0.371,0.385542168675,11,17,0.647058823529,9,34,43,22,17,2,18,16,75
Jeff Trepagnier,140.0,186,95,4746,821,1968,0.417174796748,288,818,0.352078239609,533,1150,2.307,0.490345528455,464,575,0.806956521739,122,426,548,268,308,111,253,376,2394
Jeff Varem,69.0,86,44,2492,292,688,0.424418604651,52,152,0.342105263158,240,536,1.385,0.462209302326,194,302,0.64238410596,168,368,536,190,110,32,174,244,830
Jefferson Mason,0.0,1,0,13,1,2,0.5,0,0,0.0,1,2,0.5,0.5,0,2,0.0,0,2,2,0,0,0,0,1,2
Jefferson Sobral,22.0,5,0,35,0,7,0.0,0,2,0.0,0,5,0.0,0.0,3,4,0.75,1,8,9,1,0,0,3,5,3
Jeffery Taylor,25.0,4,1,105,15,45,0.333333333333,5,16,0.3125,10,29,0.345,0.388888888889,12,16,0.75,2,12,14,6,3,1,4,10,47
Jelani McCoy,30.0,36,25,1090,174,253,0.687747035573,0,1,0.0,174,252,0.69,0.687747035573,55,108,0.509259259259,75,208,283,118,27,74,92,105,403
Jemeil Rich,32.0,4,0,34,3,5,0.6,0,0,0.0,3,5,0.6,0.6,0,1,0.0,0,2,2,8,0,0,3,4,6
JerShon Cobb,24.0,8,0,117,13,35,0.371428571429,7,24,0.291666666667,6,11,0.545,0.471428571429,4,4,1.0,2,9,11,12,5,2,4,16,37
Jerel McNeal,101.0,135,122,4380,852,1937,0.439855446567,192,537,0.357541899441,660,1400,1.876,0.489416623645,628,781,0.80409731114,91,396,487,684,218,52,461,419,2524
Jeremee McGuire,25.0,6,0,49,4,9,0.444444444444,0,0,0.0,4,9,0.444,0.444444444444,2,4,0.5,4,10,14,3,1,3,6,9,10
Jeremiah Rivers,0.0,14,4,234,17,57,0.298245614035,0,8,0.0,17,49,0.347,0.298245614035,8,10,0.8,4,20,24,20,16,6,12,33,42
Jeremy Atkinson,47.0,47,7,664,67,135,0.496296296296,11,31,0.354838709677,56,104,0.891,0.537037037037,30,50,0.6,52,118,170,40,29,3,30,83,175
Jeremy Evans,51.0,6,6,207,35,69,0.507246376812,7,18,0.388888888889,28,51,1.088,0.557971014493,11,16,0.6875,18,35,53,11,7,9,8,22,88
Jeremy Green,0.0,44,0,828,108,276,0.391304347826,32,108,0.296296296296,76,168,0.915,0.449275362319,20,26,0.769230769231,18,80,98,38,32,8,28,78,268
Jeremy Hazell,0.0,9,0,164,27,63,0.428571428571,17,39,0.435897435897,10,24,0.417,0.563492063492,24,29,0.827586206897,2,21,23,16,7,0,10,12,95
Jeremy Kelly,75.0,116,59,2921,318,769,0.413524057217,72,234,0.307692307692,246,535,1.433,0.46033810143,161,227,0.709251101322,57,245,302,423,125,24,238,377,869
Jeremy Lamb,20.0,21,21,689,169,345,0.489855072464,37,105,0.352380952381,132,240,0.55,0.54347826087,66,75,0.88,32,79,111,64,26,17,52,42,441
Jeremy Lin,45.0,21,11,680,135,281,0.480427046263,14,39,0.358974358974,121,242,1.134,0.505338078292,104,142,0.732394366197,29,97,126,99,43,7,59,55,388
Jeremy McNeil,51.0,11,0,87,9,13,0.692307692308,0,0,0.0,9,13,1.556,0.692307692308,3,8,0.375,6,8,14,2,2,4,3,25,21
Jeremy Richardson,45.0,46,42,1518,344,764,0.450261780105,62,166,0.373493975904,282,598,0.939,0.490837696335,147,177,0.830508474576,39,137,176,78,42,15,98,136,897
Jeremy Tyler,63.0,23,16,663,165,308,0.535714285714,0,4,0.0,165,304,1.639,0.535714285714,65,104,0.625,79,126,205,15,13,15,87,100,395
Jeremy Veal,153.0,150,42,3010,430,994,0.432595573441,20,86,0.232558139535,410,908,2.717,0.442655935614,230,270,0.851851851852,82,250,332,382,124,14,244,264,1110
Jeremy Williams,57.0,62,32,1267,163,444,0.367117117117,57,179,0.31843575419,106,265,0.798,0.431306306306,94,125,0.752,74,176,250,77,44,36,66,167,477
Jeremy Wise,0.0,153,113,4533,733,1517,0.483190507581,122,333,0.366366366366,611,1184,1.969,0.523401450231,591,726,0.814049586777,76,435,511,799,178,64,388,442,2179
Jerian Grant,24.0,2,2,83,19,42,0.452380952381,3,11,0.272727272727,16,31,0.516,0.488095238095,13,16,0.8125,2,6,8,16,5,1,7,4,54
Jermaine Beal,0.0,88,14,2002,250,586,0.42662116041,72,196,0.367346938776,178,390,1.371,0.488054607509,126,156,0.807692307692,38,122,160,224,44,16,120,124,698
Jermaine Blackburn,0.0,36,20,829,114,216,0.527777777778,12,46,0.260869565217,102,170,0.6,0.555555555556,35,51,0.686274509804,24,82,106,64,34,10,55,69,275
Jermaine Tate,53.0,53,33,1181,125,308,0.405844155844,1,8,0.125,124,300,1.411,0.407467532468,66,117,0.564102564103,101,189,290,45,31,43,74,139,317
Jermaine Taylor,215.0,155,88,4223,841,1929,0.435977190254,205,681,0.301027900147,636,1248,4.181,0.489113530327,295,426,0.692488262911,125,347,472,343,154,41,326,304,2182
Jermaine Walker,75.0,94,32,2258,360,908,0.396475770925,56,162,0.345679012346,304,746,1.205,0.42731277533,222,286,0.776223776224,102,200,302,174,46,16,130,142,998
Jermaine Williams,23.0,12,0,71,8,13,0.615384615385,1,2,0.5,7,11,0.636,0.653846153846,5,5,1.0,8,8,16,1,1,2,4,18,22
Jermareo Davidson,73.0,51,40,1598,328,639,0.513302034429,0,4,0.0,328,635,1.53,0.513302034429,154,202,0.762376237624,122,403,525,57,31,73,102,129,810
Jerome Beasley,26.0,18,7,384,63,142,0.443661971831,0,3,0.0,63,139,0.453,0.443661971831,36,63,0.571428571429,15,65,80,13,9,4,33,48,162
Jerome Dyson,47.0,91,54,2763,496,1167,0.425021422451,120,389,0.308483290488,376,778,0.968,0.476435304199,400,518,0.772200772201,78,223,301,280,147,26,279,266,1512
Jerome Jordan,103.0,89,77,2635,449,746,0.601876675603,2,3,0.666666666667,447,743,2.341,0.603217158177,232,321,0.722741433022,224,455,679,74,42,182,165,279,1132
Jerome Randle,0.0,30,20,802,150,300,0.5,38,110,0.345454545455,112,190,1.529,0.563333333333,92,102,0.901960784314,10,66,76,126,24,0,112,62,430
Jerrell Sanders,26.0,1,0,1,0,0,0.0,0,0,0.0,0,0,0.0,0.0,0,0,0.0,0,0,0,0,0,0,0,0,0
Jerrelle Benimon,23.0,44,38,1533,366,596,0.614093959732,6,30,0.2,360,566,0.636,0.619127516779,134,213,0.629107981221,140,344,484,192,47,45,152,132,872
Jerry Dupree,25.0,11,0,162,23,46,0.5,0,0,0.0,23,46,0.5,0.5,1,6,0.166666666667,14,22,36,3,4,6,8,22,47
Jerry Smith,47.0,85,41,2473,444,979,0.453524004086,142,375,0.378666666667,302,604,1.008,0.526046986721,305,383,0.79634464752,62,260,322,276,138,41,201,249,1335
Jesse Smith,0.0,144,95,3442,528,1133,0.466019417476,1,6,0.166666666667,527,1127,1.885,0.466460723742,231,331,0.697885196375,316,625,941,87,59,72,223,379,1288
Jimmer Fredette,26.0,40,39,1431,290,633,0.458135860979,83,202,0.410891089109,207,431,0.48,0.523696682464,179,198,0.90404040404,24,153,177,200,70,6,100,76,842
Jimmie Hunter,24.0,56,28,1419,261,633,0.412322274882,40,126,0.31746031746,221,507,0.436,0.443917851501,154,197,0.781725888325,60,120,180,111,72,33,100,110,716
Jimmy Binnie,0.0,18,0,264,41,106,0.38679245283,13,37,0.351351351351,28,69,0.406,0.448113207547,16,27,0.592592592593,11,20,31,14,15,2,8,25,111
Jimmy King,28.0,52,23,1194,168,397,0.423173803526,20,69,0.289855072464,148,328,0.451,0.448362720403,131,178,0.73595505618,46,117,163,134,59,14,95,110,487
Joe Alexander,102.0,80,68,2865,601,1194,0.503350083752,19,64,0.296875,582,1130,1.994,0.511306532663,267,338,0.789940828402,192,457,649,186,61,107,213,246,1488
Joe Brown,0.0,2,0,20,2,4,0.5,0,1,0.0,2,3,0.667,0.5,1,2,0.5,2,4,6,0,1,0,2,1,5
Joe Crawford,73.0,93,62,3109,568,1249,0.454763811049,137,404,0.339108910891,431,845,1.51,0.509607686149,294,377,0.779840848806,97,228,325,237,81,19,181,179,1567
Joe Dabbert,109.0,112,67,2103,403,791,0.509481668774,2,10,0.2,401,781,2.086,0.510745891277,303,426,0.711267605634,285,342,627,67,60,132,187,418,1111
Joe Darger,0.0,3,0,11,0,2,0.0,0,1,0.0,0,1,0.0,0.0,0,0,0.0,0,0,0,0,0,0,0,2,0
Joe Harden,0.0,13,0,110,8,19,0.421052631579,0,0,0.0,8,19,0.421,0.421052631579,3,5,0.6,14,10,24,4,2,0,3,13,19
Joe Harris,47.0,21,21,678,110,279,0.394265232975,39,134,0.291044776119,71,145,0.988,0.464157706093,60,79,0.759493670886,28,83,111,64,18,4,48,66,319
Joe Jackson,46.0,41,19,972,189,380,0.497368421053,22,64,0.34375,167,316,1.072,0.526315789474,141,171,0.824561403509,27,113,140,192,57,7,98,93,541
Joe Krabbenhoft,0.0,18,10,519,95,184,0.516304347826,12,32,0.375,83,152,0.546,0.548913043478,46,58,0.793103448276,38,92,130,45,21,6,20,61,248
Joe Marshall,23.0,19,1,138,13,37,0.351351351351,1,5,0.2,12,32,0.375,0.364864864865,11,14,0.785714285714,2,3,5,9,0,0,17,10,38
Joe Shipp,72.0,84,69,2738,535,1166,0.458833619211,59,219,0.269406392694,476,947,1.514,0.484133790738,264,362,0.729281767956,105,246,351,184,74,29,161,182,1393
Joe Thomasson,0.0,3,0,65,8,14,0.571428571429,3,5,0.6,5,9,0.556,0.678571428571,0,0,0.0,3,7,10,8,2,2,4,4,19
Joe Trapani,0.0,6,0,93,8,29,0.275862068966,2,12,0.166666666667,6,17,0.353,0.310344827586,1,2,0.5,8,14,22,2,1,2,7,10,19
Joe White,23.0,24,0,209,17,41,0.414634146341,0,0,0.0,17,41,0.415,0.414634146341,6,11,0.545454545455,14,46,60,8,8,8,14,40,40
Joe Young,47.0,5,4,154,34,82,0.414634146341,10,20,0.5,24,62,0.773,0.475609756098,16,17,0.941176470588,0,14,14,15,8,2,15,6,94
Joel Anthony,25.0,3,3,73,9,20,0.45,0,0,0.0,9,20,0.45,0.45,6,12,0.5,8,12,20,0,1,12,3,12,24
Joel Bolomboy,23.0,24,22,826,137,252,0.543650793651,22,47,0.468085106383,115,205,0.561,0.587301587302,103,146,0.705479452055,112,207,319,43,16,30,53,59,399
Joel Freeland,25.0,2,2,74,18,36,0.5,0,0,0.0,18,36,0.5,0.5,5,6,0.833333333333,4,17,21,7,0,0,2,7,41
Joel Wright,153.0,170,72,4578,874,1888,0.462923728814,18,104,0.173076923077,856,1784,2.655,0.467690677966,678,888,0.763513513514,376,668,1044,316,190,106,410,528,2444
Joey Dorsey,51.0,23,21,709,124,193,0.642487046632,0,0,0.0,124,193,1.275,0.642487046632,58,124,0.467741935484,97,178,275,34,25,33,81,88,306
Joey Graham,29.0,9,8,301,72,131,0.549618320611,0,4,0.0,72,127,0.567,0.549618320611,43,49,0.877551020408,9,52,61,28,7,1,25,32,187
Joey Miller,24.0,25,1,389,18,68,0.264705882353,9,34,0.264705882353,9,34,0.265,0.330882352941,18,21,0.857142857143,6,23,29,35,13,2,29,39,63
Johan Petro,0.0,2,0,10,1,4,0.25,0,0,0.0,1,4,0.25,0.25,0,0,0.0,0,1,1,1,1,0,0,2,2
John Allen,0.0,21,2,257,42,94,0.446808510638,10,21,0.47619047619,32,73,0.438,0.5,28,32,0.875,9,31,40,39,10,1,26,40,122
John Barber,0.0,5,0,24,0,1,0.0,0,0,0.0,0,1,0.0,0.0,0,0,0.0,0,2,2,0,0,0,0,2,0
John Bohannon,95.0,137,52,3222,411,827,0.496977025393,10,52,0.192307692308,401,775,2.061,0.503022974607,213,324,0.657407407407,334,654,988,195,100,116,191,401,1045
John Bryant,0.0,61,46,1695,291,586,0.496587030717,0,1,0.0,291,585,0.997,0.496587030717,114,154,0.74025974026,126,413,539,93,28,86,114,223,696
John Coker,30.0,20,19,476,80,160,0.5,0,0,0.0,80,160,0.5,0.5,38,49,0.775510204082,53,88,141,15,12,18,27,55,198
John Edwards,184.0,111,72,2274,432,826,0.523002421308,0,2,0.0,432,824,3.728,0.523002421308,183,246,0.743902439024,165,417,582,66,36,85,212,410,1047
John Flippen,25.0,3,0,17,0,1,0.0,0,0,0.0,0,1,0.0,0.0,0,0,0.0,3,1,4,0,1,2,4,4,0
John Gilchrist,66.0,26,0,392,40,106,0.377358490566,6,30,0.2,34,76,1.655,0.405660377358,18,26,0.692307692308,6,32,38,38,28,0,40,20,104
John Holland,55.0,74,67,2556,505,1017,0.496558505408,149,420,0.354761904762,356,597,1.199,0.569813176008,280,322,0.869565217391,72,219,291,186,103,13,142,193,1439
John Jackson,0.0,112,32,1554,132,314,0.420382165605,0,0,0.0,132,314,1.25,0.420382165605,64,96,0.666666666667,124,214,338,42,54,38,78,252,328
John Jenkins,137.0,44,29,1387,313,640,0.4890625,80,216,0.37037037037,233,424,3.427,0.5515625,162,177,0.915254237288,30,152,182,83,41,12,97,53,868
John Jordan,116.0,106,6,1715,225,486,0.462962962963,28,85,0.329411764706,197,401,2.51,0.491769547325,120,183,0.655737704918,51,161,212,279,101,11,141,215,598
John Linehan,24.0,19,0,216,13,61,0.213114754098,5,17,0.294117647059,8,44,0.182,0.254098360656,8,15,0.533333333333,7,22,29,23,11,0,20,20,39
John Locklier,0.0,9,0,78,7,18,0.388888888889,0,0,0.0,7,18,0.389,0.388888888889,4,11,0.363636363636,6,5,11,4,0,0,4,15,18
John Lucas,82.0,74,56,2483,484,987,0.490374873354,145,353,0.410764872521,339,634,1.599,0.563829787234,113,135,0.837037037037,60,157,217,317,79,3,104,149,1226
John Millsap,0.0,42,0,428,67,147,0.455782312925,0,1,0.0,67,146,0.459,0.455782312925,36,53,0.679245283019,39,59,98,21,12,6,40,58,170
John Petrucelli,24.0,32,12,673,64,144,0.444444444444,9,28,0.321428571429,55,116,0.474,0.475694444444,41,56,0.732142857143,24,75,99,42,27,9,31,81,178
John Strickland,0.0,82,58,2234,446,928,0.480603448276,0,0,0.0,446,928,1.833,0.480603448276,284,482,0.589211618257,196,254,450,176,36,10,208,234,1176
John Thomas,32.0,16,14,508,84,144,0.583333333333,0,1,0.0,84,143,0.587,0.583333333333,37,60,0.616666666667,49,80,129,20,16,10,32,58,205
John Williams,0.0,37,9,767,103,243,0.423868312757,58,136,0.426470588235,45,107,0.421,0.543209876543,54,67,0.805970149254,10,34,44,113,28,1,51,62,318
Johnny Dukes,0.0,2,2,26,2,11,0.181818181818,0,0,0.0,2,11,0.182,0.181818181818,0,2,0.0,2,2,4,3,1,0,2,7,4
Johnny Goodman,0.0,1,0,12,0,1,0.0,0,0,0.0,0,1,0.0,0.0,0,0,0.0,0,2,2,1,0,0,1,2,0
Johnny Hemsley,24.0,46,31,1069,163,430,0.379069767442,33,130,0.253846153846,130,300,0.433,0.417441860465,73,83,0.879518072289,29,90,119,78,41,11,71,81,432
Johnny O'Bryant III,23.0,25,25,807,175,384,0.455729166667,28,75,0.373333333333,147,309,0.476,0.4921875,82,105,0.780952380952,60,157,217,40,25,16,53,96,460
Johnny Phillips,22.0,43,11,431,40,71,0.56338028169,0,0,0.0,40,71,0.563,0.56338028169,25,42,0.595238095238,43,58,101,7,9,14,23,67,105
Johnny Taylor,27.0,12,10,382,45,150,0.3,16,44,0.363636363636,29,106,0.274,0.353333333333,52,69,0.753623188406,13,53,66,18,18,5,37,37,158
Jon Horford,49.0,38,18,664,63,153,0.411764705882,11,43,0.255813953488,52,110,1.086,0.447712418301,16,22,0.727272727273,74,170,244,34,7,13,25,85,153
Jon Kreft,0.0,40,8,447,50,103,0.485436893204,0,0,0.0,50,103,0.485,0.485436893204,37,44,0.840909090909,42,70,112,14,11,23,44,78,137
Jon Leuer,23.0,8,7,292,62,121,0.512396694215,7,15,0.466666666667,55,106,0.519,0.54132231405,25,40,0.625,13,85,98,14,10,4,22,23,156
Jon Octeus,0.0,41,10,657,80,200,0.4,19,51,0.372549019608,61,149,0.409,0.4475,52,73,0.712328767123,28,83,111,87,21,4,33,77,231
Jon Scheyer,0.0,16,11,544,79,180,0.438888888889,33,97,0.340206185567,46,83,0.554,0.530555555556,30,44,0.681818181818,20,42,62,65,19,6,38,27,221
Jon Smith,22.0,46,19,1110,136,320,0.425,1,5,0.2,135,315,0.429,0.4265625,93,138,0.673913043478,93,112,205,23,21,26,47,118,366
Jonathan Blake,0.0,11,7,227,30,61,0.491803278689,4,9,0.444444444444,26,52,0.5,0.524590163934,14,25,0.56,17,26,43,4,4,7,8,24,78
Jonathan Holmes,24.0,30,20,852,139,316,0.439873417722,54,145,0.372413793103,85,171,0.497,0.525316455696,51,60,0.85,53,141,194,28,31,19,48,88,383
Jonathan Kerner,84.0,34,6,766,88,228,0.385964912281,0,0,0.0,88,228,1.109,0.385964912281,38,44,0.863636363636,50,102,152,18,32,6,36,116,214
Jonathan Moore,47.0,63,1,986,139,305,0.455737704918,1,10,0.1,138,295,0.931,0.45737704918,78,115,0.678260869565,62,127,189,52,44,22,59,94,357
Jonathan Thomas,0.0,15,9,354,46,109,0.422018348624,2,15,0.133333333333,44,94,0.874,0.43119266055,14,21,0.666666666667,26,31,57,7,5,14,21,24,108
Jonathan Wallace,0.0,50,28,1382,158,358,0.441340782123,84,201,0.417910447761,74,157,0.471,0.558659217877,86,97,0.886597938144,34,72,106,156,47,0,71,124,486
Jonathon Simmons,75.0,98,44,2841,468,933,0.501607717042,79,229,0.344978165939,389,704,1.638,0.543944265809,240,325,0.738461538462,121,304,425,258,97,41,210,267,1255
Jonny Flynn,21.0,2,2,56,5,15,0.333333333333,2,8,0.25,3,7,0.429,0.4,4,7,0.571428571429,3,3,6,21,2,0,13,3,16
Joonas Caven,66.0,72,2,792,84,276,0.304347826087,62,232,0.26724137931,22,44,1.446,0.416666666667,42,60,0.7,24,106,130,16,22,28,32,132,272
Jordan Adams,20.0,11,3,351,73,158,0.462025316456,18,47,0.382978723404,55,111,0.495,0.518987341772,35,44,0.795454545455,27,50,77,21,21,5,20,21,199
Jordan Bachynski,51.0,67,57,1681,307,544,0.564338235294,0,1,0.0,307,543,1.08,0.564338235294,148,224,0.660714285714,136,304,440,48,24,155,110,220,762
Jordan Brady,0.0,148,19,2288,314,610,0.514754098361,58,159,0.364779874214,256,451,2.832,0.562295081967,102,153,0.666666666667,161,367,528,120,72,30,108,280,788
Jordan Burris,22.0,3,0,20,1,8,0.125,1,7,0.142857142857,0,1,0.0,0.1875,0,0,0.0,1,4,5,0,0,0,0,3,3
Jordan Clarkson,22.0,5,5,180,46,92,0.5,4,18,0.222222222222,42,74,0.568,0.521739130435,17,21,0.809523809524,7,18,25,39,4,1,17,10,113
Jordan Crawford,54.0,45,25,1389,380,842,0.451306413302,118,341,0.346041055718,262,501,0.96,0.521377672209,172,197,0.873096446701,22,146,168,165,54,6,90,86,1050
Jordan Demercy,0.0,5,0,34,1,5,0.2,0,2,0.0,1,3,0.333,0.2,0,2,0.0,3,5,8,2,3,2,3,2,2
Jordan Downing,24.0,10,0,82,12,39,0.307692307692,5,17,0.294117647059,7,22,0.318,0.371794871795,0,0,0.0,0,4,4,3,0,0,2,5,29
Jordan Eglseder,0.0,2,0,20,2,7,0.285714285714,0,0,0.0,2,7,0.286,0.285714285714,0,0,0.0,0,2,2,0,0,0,0,5,4
Jordan Farmar,20.0,3,2,95,14,36,0.388888888889,2,12,0.166666666667,12,24,0.5,0.416666666667,14,14,1.0,1,7,8,17,5,1,5,4,44
Jordan Hamilton,118.0,82,46,2275,480,1067,0.449859418932,129,386,0.334196891192,351,681,2.506,0.510309278351,220,285,0.771929824561,178,443,621,281,92,72,152,224,1309
Jordan Henriquez,0.0,29,3,262,35,88,0.397727272727,0,9,0.0,35,79,0.443,0.397727272727,18,37,0.486486486486,30,41,71,13,5,25,25,51,88
Jordan Loyd,23.0,49,19,1391,253,580,0.436206896552,66,193,0.341968911917,187,387,0.483,0.493103448276,169,194,0.871134020619,51,154,205,195,46,14,84,158,741
Jordan McRae,47.0,42,42,1475,320,699,0.457796852647,78,231,0.337662337662,242,468,1.025,0.513590844063,196,251,0.780876494024,34,151,185,202,64,28,138,101,914
Jordan Mickey,43.0,35,34,1158,264,503,0.524850894632,21,52,0.403846153846,243,451,1.074,0.545725646123,101,135,0.748148148148,88,253,341,48,28,134,79,91,650
Jordan Morgan,24.0,3,0,45,3,7,0.428571428571,0,0,0.0,3,7,0.429,0.428571428571,1,2,0.5,4,10,14,5,1,0,5,8,7
Jordan Railey,47.0,34,18,638,51,103,0.495145631068,1,2,0.5,50,101,1.223,0.5,13,32,0.40625,47,90,137,32,21,29,34,105,116
Jordan Sibert,23.0,44,21,1132,217,532,0.407894736842,90,262,0.343511450382,127,270,0.47,0.492481203008,54,62,0.870967741935,13,99,112,55,55,8,67,116,578
Jordan Swing,24.0,11,0,152,15,33,0.454545454545,6,12,0.5,9,21,0.429,0.545454545455,8,12,0.666666666667,4,16,20,9,9,0,12,18,44
Jordan Vandenberg,24.0,9,0,69,3,10,0.3,0,0,0.0,3,10,0.3,0.3,2,2,1.0,8,12,20,4,2,2,3,10,8
Jordan Williams,21.0,6,6,194,23,51,0.450980392157,0,0,0.0,23,51,0.451,0.450980392157,17,32,0.53125,16,31,47,6,6,10,11,18,63
Jordon Crawford,103.0,139,30,2903,460,1095,0.420091324201,101,292,0.345890410959,359,803,1.725,0.466210045662,233,290,0.803448275862,37,204,241,361,152,5,213,259,1254
Jorge Gutierrez,102.0,122,103,3767,517,1168,0.442636986301,31,131,0.236641221374,486,1037,1.896,0.455907534247,398,523,0.760994263862,102,501,603,679,206,31,344,421,1463
Jose Barea,22.0,8,6,293,79,151,0.523178807947,21,48,0.4375,58,103,0.563,0.592715231788,39,50,0.78,10,30,40,62,10,0,25,15,218
Joseph Forte,23.0,39,6,880,194,404,0.480198019802,7,22,0.318181818182,187,382,0.49,0.488861386139,70,94,0.744680851064,36,92,128,87,47,6,58,62,465
Joseph Harris,27.0,9,0,82,7,12,0.583333333333,3,6,0.5,4,6,0.667,0.708333333333,1,2,0.5,4,5,9,1,5,0,3,5,18
Joseph Works,23.0,5,0,25,6,10,0.6,0,0,0.0,6,10,0.6,0.6,1,2,0.5,5,4,9,1,2,0,2,6,13
Josh Akognon,52.0,18,9,490,103,236,0.436440677966,47,112,0.419642857143,56,124,0.908,0.536016949153,29,33,0.878787878788,14,40,54,70,28,1,37,37,282
Josh Asselin,25.0,46,36,1329,238,452,0.526548672566,1,8,0.125,237,444,0.534,0.527654867257,187,242,0.772727272727,78,196,274,37,30,45,91,180,664
Josh Boone,57.0,9,2,142,31,57,0.543859649123,0,0,0.0,31,57,1.11,0.543859649123,7,20,0.35,26,19,45,4,6,4,8,17,69
Josh Bostic,50.0,63,24,1605,216,507,0.426035502959,60,167,0.359281437126,156,340,0.89,0.485207100592,205,250,0.82,81,190,271,141,53,11,110,166,697
Josh Childress,32.0,8,1,242,39,79,0.493670886076,4,11,0.363636363636,35,68,0.515,0.518987341772,14,20,0.7,12,40,52,13,8,5,3,17,96
Josh Davis,83.0,76,64,2329,445,918,0.484749455338,110,298,0.369127516779,335,620,1.538,0.544662309368,214,286,0.748251748252,203,393,596,141,114,47,143,228,1214
Josh Gray,23.0,50,9,1254,268,603,0.444444444444,39,109,0.357798165138,229,494,0.464,0.476782752902,96,144,0.666666666667,56,122,178,227,72,4,109,101,671
Josh Hagins,0.0,20,3,324,36,84,0.428571428571,16,43,0.372093023256,20,41,0.488,0.52380952381,12,12,1.0,7,46,53,51,11,4,20,22,100
Josh Howard,0.0,24,21,708,140,319,0.438871473354,23,83,0.277108433735,117,236,0.496,0.474921630094,50,59,0.847457627119,35,105,140,32,27,16,32,69,353
Josh Huestis,72.0,101,100,3284,461,1139,0.404741000878,200,595,0.336134453782,261,544,1.434,0.492537313433,115,199,0.577889447236,132,447,579,113,65,160,112,195,1237
Josh Lomers,0.0,5,1,51,8,13,0.615384615385,0,0,0.0,8,13,0.615,0.615384615385,3,4,0.75,5,6,11,1,0,0,2,15,19
Josh Magette,77.0,145,142,4989,641,1577,0.406467977172,279,795,0.350943396226,362,782,1.392,0.494927076728,263,323,0.814241486068,116,486,602,1227,280,10,342,431,1824
Josh McRoberts,20.0,15,2,399,46,111,0.414414414414,2,13,0.153846153846,44,98,0.449,0.423423423423,21,30,0.7,25,71,96,38,9,14,31,24,115
Josh Owens,0.0,42,23,752,95,204,0.46568627451,0,0,0.0,95,204,0.466,0.46568627451,35,56,0.625,73,119,192,18,19,21,43,55,225
Josh Powell,23.0,3,2,89,22,31,0.709677419355,0,0,0.0,22,31,0.71,0.709677419355,9,11,0.818181818182,10,11,21,1,2,2,6,7,53
Josh Richardson,22.0,4,4,153,35,74,0.472972972973,11,28,0.392857142857,24,46,0.522,0.547297297297,12,17,0.705882352941,6,12,18,15,10,5,8,11,93
Josh Selby,104.0,54,20,1561,306,751,0.407456724368,66,214,0.308411214953,240,537,2.327,0.451398135819,173,225,0.768888888889,44,222,266,215,55,7,122,81,851
Josh Simmons,0.0,5,1,62,7,17,0.411764705882,0,2,0.0,7,15,0.467,0.411764705882,5,12,0.416666666667,2,5,7,3,1,1,6,8,19
Josh Tarver,0.0,17,11,379,35,89,0.393258426966,11,44,0.25,24,45,0.533,0.455056179775,13,22,0.590909090909,8,46,54,54,18,5,25,43,94
Josh Warren,26.0,9,0,42,3,6,0.5,0,0,0.0,3,6,0.5,0.5,0,0,0.0,4,4,8,0,2,0,1,8,6
Joshua Gross,141.0,110,53,3026,521,1090,0.477981651376,99,271,0.365313653137,422,819,3.165,0.523394495413,305,382,0.798429319372,137,333,470,116,74,40,190,233,1446
Joshua Smith,47.0,86,42,1334,297,477,0.622641509434,0,3,0.0,297,474,1.254,0.622641509434,135,201,0.671641791045,203,208,411,94,53,43,116,242,729
Josiah Turner,43.0,73,18,1567,265,530,0.5,9,35,0.257142857143,256,495,1.023,0.508490566038,143,214,0.668224299065,62,144,206,286,95,24,133,132,682
Jovan Harris,0.0,118,5,2016,265,597,0.443886097152,59,152,0.388157894737,206,445,1.78,0.493299832496,108,121,0.892561983471,25,145,170,207,37,18,124,156,697
Juan Hernangomez,21.0,1,0,26,6,14,0.428571428571,1,5,0.2,5,9,0.556,0.464285714286,4,7,0.571428571429,3,8,11,1,0,2,4,5,17
Juan Pattillo,0.0,49,8,1258,276,525,0.525714285714,0,6,0.0,276,519,0.532,0.525714285714,157,214,0.733644859813,111,243,354,81,64,42,106,102,709
Julian Allen,0.0,1,0,19,2,8,0.25,0,0,0.0,2,8,0.25,0.25,3,4,0.75,3,0,3,1,0,1,1,0,7
Julian Jacobs,22.0,34,0,591,76,165,0.460606060606,18,52,0.346153846154,58,113,0.513,0.515151515152,35,48,0.729166666667,18,72,90,89,24,5,68,45,205
Julian Sensley,0.0,107,56,2761,476,1024,0.46484375,119,315,0.377777777778,357,709,4.05,0.52294921875,141,214,0.658878504673,152,409,561,205,87,73,156,265,1212
Julian Terrell,22.0,20,0,277,35,60,0.583333333333,0,0,0.0,35,60,0.583,0.583333333333,19,34,0.558823529412,14,43,57,15,6,6,22,48,89
Julian Washburn,24.0,48,15,906,76,182,0.417582417582,37,93,0.397849462366,39,89,0.438,0.519230769231,17,28,0.607142857143,15,133,148,30,18,11,30,77,206
Julian Wright,24.0,16,14,450,109,173,0.630057803468,1,5,0.2,108,168,0.643,0.632947976879,23,40,0.575,52,76,128,30,18,13,21,44,242
Julien Lewis,24.0,14,0,192,22,60,0.366666666667,14,40,0.35,8,20,0.4,0.483333333333,6,6,1.0,4,21,25,11,9,3,4,20,64
Julien Mills,0.0,2,0,4,0,1,0.0,0,1,0.0,0,0,0.0,0.0,0,0,0.0,0,0,0,0,0,0,0,0,0
Julius Hodge,138.0,71,39,2254,478,913,0.523548740416,9,25,0.36,469,888,3.28,0.52847754655,297,421,0.705463182898,153,314,467,447,60,34,270,189,1262
Julyan Stone,75.0,42,34,1315,103,266,0.387218045113,42,122,0.344262295082,61,144,1.07,0.466165413534,56,82,0.682926829268,29,208,237,323,52,36,108,106,304
Junie Sanders,61.0,93,34,2252,445,1001,0.444555444555,43,136,0.316176470588,402,865,0.925,0.466033966034,243,307,0.791530944625,131,169,300,179,69,12,190,192,1176
Justin Anderson,22.0,7,7,268,63,137,0.459854014599,16,48,0.333333333333,47,89,0.528,0.518248175182,19,24,0.791666666667,4,28,32,24,3,4,13,15,161
Justin Bowen,125.0,172,71,4252,750,1519,0.493745885451,32,115,0.278260869565,718,1404,2.523,0.504279131007,249,373,0.667560321716,333,554,887,220,141,82,210,374,1781
Justin Brownlee,0.0,96,50,2428,404,840,0.480952380952,98,284,0.345070422535,306,556,1.095,0.539285714286,132,178,0.741573033708,98,411,509,179,110,47,121,208,1038
Justin Cage,0.0,43,24,1317,178,295,0.603389830508,12,24,0.5,166,271,0.613,0.623728813559,149,187,0.79679144385,135,119,254,79,36,39,55,103,517
Justin Dentmon,161.0,187,170,6850,1316,2958,0.444895199459,453,1154,0.392547660312,863,1804,2.78,0.521467207573,918,1093,0.83989021043,159,546,705,822,263,17,595,533,4003
Justin Graham,0.0,5,0,89,12,20,0.6,0,0,0.0,12,20,0.6,0.6,2,3,0.666666666667,3,7,10,13,6,1,11,14,26
Justin Hamilton,23.0,51,41,1612,308,635,0.485039370079,33,96,0.34375,275,539,1.021,0.511023622047,161,202,0.79702970297,140,248,388,82,48,79,104,105,810
Justin Harper,76.0,135,91,3795,717,1569,0.456978967495,240,627,0.382775119617,477,942,1.537,0.533460803059,270,341,0.791788856305,271,583,854,177,80,72,168,363,1944
Justin Hawkins,102.0,119,87,3633,604,1404,0.430199430199,119,387,0.307493540052,485,1017,1.905,0.472578347578,394,479,0.82254697286,121,405,526,238,110,29,228,319,1721
Justin Holiday,48.0,48,43,1665,299,709,0.421720733427,82,198,0.414141414141,217,511,0.868,0.479548660085,158,195,0.810256410256,58,196,254,122,115,57,97,98,838
Justin Hurtt,0.0,43,28,1126,184,461,0.399132321041,60,174,0.344827586207,124,287,0.432,0.46420824295,99,123,0.80487804878,18,92,110,56,34,9,55,72,527
Justin Jackson,24.0,38,13,626,105,171,0.614035087719,0,2,0.0,105,169,0.621,0.614035087719,40,85,0.470588235294,76,96,172,22,32,72,48,122,250
Justin Johnson,244.0,239,24,4774,746,1696,0.439858490566,90,250,0.36,656,1446,4.179,0.466391509434,363,434,0.836405529954,94,499,593,511,123,13,368,394,1945
Justin Manns,78.0,70,6,702,70,138,0.507246376812,0,0,0.0,70,138,1.541,0.507246376812,28,60,0.466666666667,88,78,166,16,18,30,52,124,168
Justin Martin,25.0,12,1,170,19,50,0.38,10,24,0.416666666667,9,26,0.346,0.48,9,16,0.5625,10,27,37,5,5,4,8,28,57
Justin Neuhaus,0.0,7,1,93,10,20,0.5,0,0,0.0,10,20,0.5,0.5,2,5,0.4,12,10,22,2,2,4,5,13,22
Justin Reed,105.0,88,65,2995,541,1257,0.430389817025,16,56,0.285714285714,525,1201,1.751,0.436754176611,298,401,0.743142144638,181,431,612,199,69,36,174,259,1396
Justin Reynolds,27.0,14,0,169,25,62,0.403225806452,1,11,0.0909090909091,24,51,0.471,0.411290322581,7,14,0.5,15,23,38,4,6,1,11,27,58
Justin Rowe,25.0,4,1,65,3,9,0.333333333333,0,0,0.0,3,9,0.333,0.333333333333,0,0,0.0,8,10,18,1,0,0,0,8,6
Justin Williams,49.0,13,12,386,62,113,0.548672566372,0,1,0.0,62,112,0.554,0.548672566372,27,47,0.574468085106,62,92,154,8,8,40,20,44,151
Juvonte Reddic,23.0,43,22,932,153,284,0.538732394366,1,2,0.5,152,282,0.539,0.540492957746,79,118,0.669491525424,90,139,229,33,15,17,56,98,386
Juwan Staten,69.0,56,36,1506,174,382,0.455497382199,8,24,0.333333333333,166,358,1.391,0.465968586387,78,108,0.722222222222,14,104,118,220,52,0,94,102,434
K.C. Rivers,0.0,45,19,1374,260,586,0.443686006826,86,245,0.351020408163,174,341,0.51,0.517064846416,101,120,0.841666666667,39,145,184,97,56,4,71,99,707
KJ McDaniels,22.0,16,15,577,92,196,0.469387755102,30,85,0.352941176471,62,111,0.559,0.545918367347,32,41,0.780487804878,38,95,133,48,15,32,47,54,246
Kadeem Batts,23.0,43,33,996,166,379,0.437994722955,1,2,0.5,165,377,0.438,0.439313984169,82,118,0.694915254237,84,154,238,23,16,19,42,112,415
Kadeem Jack,141.0,150,20,2080,476,906,0.525386313466,38,120,0.316666666667,438,786,3.583,0.546357615894,268,388,0.690721649485,192,372,564,40,56,80,124,310,1258
Kaleb Tarczewski,23.0,43,1,1097,152,242,0.628099173554,0,0,0.0,152,242,0.628,0.628099173554,125,172,0.726744186047,105,208,313,23,12,30,54,110,429
Kalin Lucas,130.0,160,103,5129,1010,2263,0.446310207689,241,610,0.395081967213,769,1653,2.3,0.499558108705,587,689,0.851959361393,96,512,608,792,172,8,356,292,2848
Kam Taylor,0.0,9,4,155,18,52,0.346153846154,9,27,0.333333333333,9,25,0.36,0.432692307692,11,12,0.916666666667,0,9,9,20,8,0,17,8,56
Kameron Woods,45.0,99,43,2343,175,401,0.436408977556,42,141,0.297872340426,133,260,1.025,0.488778054863,68,103,0.660194174757,79,406,485,120,66,64,107,120,460
Kammeon Holsey,49.0,92,19,1719,260,495,0.525252525253,0,7,0.0,260,488,1.061,0.525252525253,104,150,0.693333333333,170,214,384,62,35,22,110,254,624
Kaniel Dickens,125.0,118,48,2527,429,997,0.430290872618,149,399,0.37343358396,280,598,2.185,0.505015045135,268,369,0.726287262873,111,308,419,83,70,53,185,323,1275
Kareem Poole,55.0,64,44,1358,92,247,0.372469635628,1,2,0.5,91,245,0.933,0.374493927126,51,77,0.662337662338,129,305,434,34,21,72,52,146,236
Kareem Reid,58.0,91,52,3003,410,912,0.449561403509,25,99,0.252525252525,385,813,0.95,0.46326754386,298,371,0.803234501348,65,182,247,681,123,3,220,204,1143
Kareem Rush,64.0,19,9,436,58,145,0.4,26,65,0.4,32,80,0.766,0.489655172414,18,26,0.692307692308,17,39,56,29,21,7,22,48,160
Karim Shabazz,49.0,65,57,1761,152,282,0.539007092199,0,0,0.0,152,282,1.062,0.539007092199,100,155,0.645161290323,158,308,466,54,55,130,82,226,404
Karl Cochran,23.0,17,0,198,27,59,0.457627118644,10,33,0.30303030303,17,26,0.654,0.542372881356,5,6,0.833333333333,4,16,20,10,13,7,9,20,69
Karrington Ward,45.0,28,1,134,12,38,0.315789473684,7,24,0.291666666667,5,14,0.733,0.407894736842,2,4,0.5,1,19,20,2,1,2,2,19,33
Kasib Powell,53.0,60,53,2196,491,979,0.501532175689,81,213,0.380281690141,410,766,1.077,0.542900919305,196,283,0.6925795053,70,250,320,201,85,35,127,179,1259
Kay Felder,21.0,11,11,396,119,255,0.466666666667,20,55,0.363636363636,99,200,0.495,0.505882352941,71,86,0.825581395349,8,29,37,66,17,4,46,33,329
Keanau Post,23.0,36,10,413,46,79,0.582278481013,0,0,0.0,46,79,0.582,0.582278481013,8,13,0.615384615385,33,54,87,6,3,12,29,59,100
Keaton Grant,0.0,50,34,1422,185,422,0.438388625592,49,127,0.385826771654,136,295,0.461,0.49644549763,46,64,0.71875,47,198,245,80,59,11,60,122,465
Kedrick Brown,53.0,91,84,3407,548,1208,0.453642384106,95,317,0.299684542587,453,891,1.017,0.492963576159,295,382,0.772251308901,164,404,568,198,125,44,175,252,1486
Keifer Sykes,22.0,50,37,1549,239,536,0.445895522388,29,92,0.315217391304,210,444,0.473,0.472947761194,114,145,0.786206896552,19,162,181,157,38,5,100,138,621
Keil Zepernick,0.0,2,0,8,0,2,0.0,0,0,0.0,0,2,0.0,0.0,0,0,0.0,1,0,1,0,0,0,2,4,0
Keith Appling,89.0,111,76,2983,502,1159,0.433132010354,47,178,0.26404494382,455,981,1.853,0.45340811044,415,522,0.795019157088,40,337,377,472,130,15,227,315,1466
Keith Benson,102.0,143,110,3911,915,1634,0.559975520196,4,15,0.266666666667,911,1619,2.147,0.561199510404,409,552,0.740942028986,387,822,1209,107,83,258,253,489,2243
Keith Bogans,35.0,7,0,106,3,12,0.25,2,7,0.285714285714,1,5,0.2,0.333333333333,1,2,0.5,5,12,17,2,3,0,6,11,9
Keith Brumbaugh,0.0,109,53,2803,497,1052,0.472433460076,118,320,0.36875,379,732,2.074,0.528517110266,246,307,0.801302931596,145,372,517,188,121,46,275,354,1358
Keith Chamberlain,27.0,5,2,76,4,7,0.571428571429,0,1,0.0,4,6,0.667,0.571428571429,4,8,0.5,5,9,14,3,5,0,4,14,12
Keith Clark,0.0,128,41,2658,381,755,0.504635761589,30,114,0.263157894737,351,641,3.666,0.524503311258,163,272,0.599264705882,179,440,619,129,83,76,156,384,955
Keith Closs,31.0,49,11,914,120,200,0.6,1,3,0.333333333333,119,197,0.604,0.6025,61,89,0.685393258427,65,150,215,32,17,133,50,77,302
Keith Gayden,0.0,3,0,12,1,4,0.25,0,0,0.0,1,4,0.25,0.25,0,0,0.0,0,0,0,1,0,0,1,0,2
Keith Hornsby,25.0,37,1,452,66,137,0.481751824818,11,32,0.34375,55,105,0.524,0.521897810219,25,33,0.757575757576,19,56,75,38,16,4,13,25,168
Keith Langford,46.0,71,27,2135,416,822,0.506082725061,55,138,0.398550724638,361,684,1.062,0.539537712895,254,371,0.684636118598,72,211,283,204,80,21,130,161,1141
Keith McLeod,155.0,130,118,4333,637,1615,0.394427244582,173,503,0.34393638171,464,1112,2.083,0.447987616099,601,787,0.763659466328,56,321,377,638,193,44,336,367,2048
Keith Steffeck,27.0,1,0,15,2,5,0.4,2,4,0.5,0,1,0.0,0.6,0,0,0.0,1,0,1,2,2,0,2,4,6
Keith Wright,130.0,163,72,3318,415,784,0.529336734694,3,18,0.166666666667,412,766,2.532,0.53125,118,194,0.60824742268,393,513,906,145,113,121,151,376,951
Kelenna Azubuike,73.0,60,29,1643,323,638,0.506269592476,65,151,0.430463576159,258,487,1.477,0.557210031348,162,208,0.778846153846,61,188,249,103,45,18,106,114,873
Kellen Dunham,23.0,35,16,598,60,144,0.416666666667,30,83,0.361445783133,30,61,0.492,0.520833333333,20,21,0.952380952381,11,59,70,21,17,6,30,28,170
Kellen Thornton,0.0,25,7,354,82,150,0.546666666667,1,1,1.0,81,149,0.544,0.55,31,43,0.720930232558,44,79,123,5,9,6,17,40,196
Kelsey Barlow,47.0,92,59,2484,333,811,0.410604192355,128,355,0.360563380282,205,456,0.893,0.489519112207,116,142,0.816901408451,39,304,343,174,91,19,104,233,910
Kelvin Lewis,0.0,148,78,3440,472,1199,0.393661384487,223,625,0.3568,249,574,1.562,0.486655546289,198,256,0.7734375,78,251,329,211,141,6,188,300,1365
Kelvin Price,0.0,47,37,1270,132,325,0.406153846154,1,2,0.5,131,323,0.406,0.407692307692,133,215,0.618604651163,125,211,336,43,43,32,85,168,398
Ken Johnson,52.0,66,43,1821,235,473,0.496828752643,0,1,0.0,235,472,1.0,0.496828752643,143,183,0.781420765027,94,262,356,52,11,157,123,205,613
Kendall Dartez,108.0,55,23,1239,162,348,0.465517241379,3,6,0.5,159,342,1.387,0.469827586207,89,131,0.679389312977,105,144,249,42,28,59,88,163,416
Kendall Marshall,68.0,37,34,1302,194,465,0.417204301075,44,127,0.346456692913,150,338,1.242,0.464516129032,107,133,0.804511278195,20,120,140,325,50,2,128,71,539
Kendrick Perry,22.0,9,3,189,24,51,0.470588235294,12,24,0.5,12,27,0.444,0.588235294118,1,1,1.0,2,16,18,10,7,1,7,26,61
Kenneth Smith,47.0,78,6,1471,135,410,0.329268292683,42,159,0.264150943396,93,251,0.727,0.380487804878,83,114,0.728070175439,37,163,200,261,84,5,122,120,395
Kenny Adeleke,0.0,31,14,526,62,117,0.529914529915,0,0,0.0,62,117,0.53,0.529914529915,34,48,0.708333333333,94,117,211,8,12,11,47,83,158
Kenny Dawkins,0.0,8,0,85,7,30,0.233333333333,0,2,0.0,7,28,0.25,0.233333333333,9,10,0.9,2,13,15,8,3,0,14,4,23
Kenny Gregory,23.0,24,1,298,48,115,0.417391304348,0,6,0.0,48,109,0.44,0.417391304348,16,31,0.516129032258,23,27,50,19,7,4,17,24,112
Kenny Hall,72.0,88,2,1526,240,426,0.56338028169,2,6,0.333333333333,238,420,1.662,0.565727699531,120,180,0.666666666667,142,256,398,40,56,44,140,236,602
Kenny Hasbrouck,0.0,10,9,325,64,127,0.503937007874,16,42,0.380952380952,48,85,0.565,0.566929133858,25,31,0.806451612903,4,20,24,29,16,0,19,29,169
Kenny Hayes,0.0,87,36,2271,376,867,0.433679354095,56,155,0.361290322581,320,712,0.889,0.465974625144,256,295,0.867796610169,33,219,252,327,58,11,152,79,1064
Kenny Kadji,0.0,19,2,274,41,109,0.376146788991,12,53,0.22641509434,29,56,0.518,0.43119266055,29,39,0.74358974359,18,51,69,13,8,14,24,35,123
Kenny Lawson,0.0,17,5,267,38,87,0.436781609195,4,18,0.222222222222,34,69,0.493,0.459770114943,23,36,0.638888888889,24,32,56,5,3,13,12,41,103
Kenny Satterfield,22.0,18,17,692,111,293,0.378839590444,29,78,0.371794871795,82,215,0.381,0.428327645051,83,107,0.775700934579,23,55,78,124,36,1,76,53,334
Kenny Taylor,0.0,105,12,2210,314,840,0.37380952381,209,559,0.373881932021,105,281,1.439,0.498214285714,71,85,0.835294117647,56,185,241,148,63,7,80,130,908
Kent Bazemore,47.0,7,7,235,51,118,0.432203389831,14,46,0.304347826087,37,72,0.993,0.491525423729,30,37,0.810810810811,8,38,46,21,26,7,20,22,146
Kent Williams,22.0,46,1,661,80,190,0.421052631579,45,100,0.45,35,90,0.389,0.539473684211,56,72,0.777777777778,8,34,42,59,24,3,31,47,261
Kenton Paulino,0.0,34,3,494,60,141,0.425531914894,31,84,0.369047619048,29,57,0.509,0.535460992908,38,46,0.826086956522,7,32,39,34,21,1,22,39,189
Kentrell Gransberry,77.0,70,8,1023,133,242,0.54958677686,0,6,0.0,133,236,1.118,0.54958677686,66,157,0.420382165605,135,181,316,65,31,29,72,171,332
Keoni Watson,0.0,8,0,76,5,19,0.263157894737,0,3,0.0,5,16,0.313,0.263157894737,5,8,0.625,2,6,8,11,4,0,12,9,15
Kevin Anderson,0.0,10,1,218,30,87,0.344827586207,7,27,0.259259259259,23,60,0.383,0.385057471264,14,15,0.933333333333,6,18,24,33,10,0,22,17,81
Kevin Bookout,0.0,9,5,166,17,30,0.566666666667,0,1,0.0,17,29,0.586,0.566666666667,7,12,0.583333333333,17,25,42,4,1,1,5,13,41
Kevin Braswell,78.0,54,20,1422,242,608,0.398026315789,18,80,0.225,224,528,1.269,0.412828947368,108,124,0.870967741935,28,104,132,274,64,8,138,108,610
Kevin Burleson,56.0,73,68,2093,270,670,0.402985074627,147,368,0.399456521739,123,302,0.87,0.512686567164,173,213,0.81220657277,44,185,229,333,72,10,146,233,860
Kevin Capers,45.0,83,16,1426,188,470,0.4,35,121,0.289256198347,153,349,0.956,0.437234042553,187,247,0.757085020243,26,103,129,139,86,9,103,215,598
Kevin Coble,0.0,5,0,35,2,7,0.285714285714,0,1,0.0,2,6,0.333,0.285714285714,3,5,0.6,3,5,8,1,1,0,1,6,7
Kevin Foster,0.0,15,0,127,16,42,0.380952380952,4,13,0.307692307692,12,29,0.414,0.428571428571,9,14,0.642857142857,13,18,31,7,6,5,14,25,45
Kevin Frey,25.0,3,0,25,4,12,0.333333333333,0,0,0.0,4,12,0.333,0.333333333333,1,5,0.2,2,4,6,1,1,0,1,4,9
Kevin Galloway,0.0,14,5,270,25,65,0.384615384615,0,5,0.0,25,60,0.417,0.384615384615,10,17,0.588235294118,7,40,47,57,15,10,36,25,60
Kevin Johnson,51.0,54,18,1134,184,370,0.497297297297,25,69,0.36231884058,159,301,1.074,0.531081081081,124,190,0.652631578947,59,105,164,66,32,5,95,135,517
Kevin Jones,47.0,50,49,1609,391,764,0.511780104712,5,18,0.277777777778,386,746,1.049,0.515052356021,124,165,0.751515151515,177,261,438,42,43,21,71,130,911
Kevin Kotzur,0.0,37,12,699,122,205,0.59512195122,0,1,0.0,122,204,0.598,0.59512195122,29,47,0.617021276596,84,124,208,28,9,13,28,50,273
Kevin Kruger,0.0,133,111,4525,491,1122,0.4376114082,256,627,0.408293460925,235,495,2.563,0.551693404635,447,520,0.859615384615,33,306,339,693,146,9,294,219,1685
Kevin Lyde,213.0,225,176,5451,896,1689,0.530491415038,3,7,0.428571428571,893,1682,4.633,0.531379514506,310,555,0.558558558559,435,892,1327,317,80,307,324,867,2105
Kevin Morris,0.0,39,3,531,55,143,0.384615384615,14,50,0.28,41,93,0.441,0.433566433566,40,48,0.833333333333,10,55,65,96,29,2,50,39,164
Kevin Murphy,143.0,157,106,5169,1139,2422,0.470272502064,301,801,0.375780274657,838,1621,3.133,0.532411230388,709,871,0.814006888634,122,624,746,333,161,31,435,419,3288
Kevin Olekaibe,69.0,56,5,768,107,277,0.386281588448,52,157,0.331210191083,55,120,1.414,0.480144404332,13,21,0.619047619048,20,52,72,41,32,4,38,66,279
Kevin Owens,72.0,136,57,2309,295,610,0.483606557377,0,1,0.0,295,609,1.458,0.483606557377,200,371,0.539083557951,236,468,704,65,51,104,160,444,790
Kevin Palmer,0.0,50,18,1268,199,434,0.458525345622,40,148,0.27027027027,159,286,0.556,0.504608294931,198,234,0.846153846154,78,174,252,67,69,28,91,117,636
Kevin Parrom,0.0,46,6,1011,161,360,0.447222222222,54,160,0.3375,107,200,0.535,0.522222222222,85,110,0.772727272727,70,129,199,96,30,9,49,102,461
Kevin Pittsnogle,0.0,126,85,3421,558,1332,0.418918918919,272,736,0.369565217391,286,596,1.867,0.521021021021,205,238,0.861344537815,101,545,646,178,71,50,230,447,1593
Kevin Rogers,0.0,8,5,126,25,52,0.480769230769,0,0,0.0,25,52,0.481,0.480769230769,6,8,0.75,5,17,22,4,0,1,8,24,56
Kevin Sweetwyne,0.0,12,0,48,5,20,0.25,1,6,0.166666666667,4,14,0.286,0.275,3,5,0.6,3,4,7,6,3,0,1,8,14
Kevin Young,25.0,14,0,70,7,19,0.368421052632,0,3,0.0,7,16,0.438,0.368421052632,4,6,0.666666666667,10,15,25,6,3,1,6,14,18
Kevinn Pinkney,23.0,47,47,1628,333,650,0.512307692308,5,19,0.263157894737,328,631,0.52,0.516153846154,204,261,0.781609195402,101,237,338,88,62,29,91,171,875
Kevon Looney,39.0,16,1,309,67,152,0.440789473684,9,32,0.28125,58,120,1.032,0.470394736842,25,40,0.625,56,78,134,11,12,15,12,44,168
Keyon Dooling,32.0,1,1,26,3,8,0.375,0,2,0.0,3,6,0.5,0.375,0,1,0.0,0,0,0,1,2,0,4,4,6
Khalif Wyatt,0.0,20,10,570,105,235,0.446808510638,49,119,0.411764705882,56,116,0.483,0.551063829787,65,80,0.8125,7,41,48,71,33,1,42,32,324
Khem Birch,22.0,49,33,1292,218,310,0.703225806452,0,0,0.0,218,310,0.703,0.703225806452,114,170,0.670588235294,171,299,470,61,31,87,61,109,550
Khris Middleton,21.0,3,3,79,16,47,0.340425531915,1,7,0.142857142857,15,40,0.375,0.351063829787,0,0,0.0,4,19,23,9,2,1,7,8,33
Khyle Marshall,22.0,16,0,148,24,50,0.48,1,6,0.166666666667,23,44,0.523,0.49,5,11,0.454545454545,12,30,42,3,4,1,6,11,54
Kibwe Trim,0.0,36,0,277,37,73,0.506849315068,0,0,0.0,37,73,0.507,0.506849315068,20,36,0.555555555556,18,34,52,6,5,6,16,46,94
Kim English,24.0,3,3,110,18,42,0.428571428571,5,13,0.384615384615,13,29,0.448,0.488095238095,13,15,0.866666666667,5,10,15,17,3,4,10,9,54
Kimani Ffriend,24.0,23,7,368,50,103,0.485436893204,0,0,0.0,50,103,0.485,0.485436893204,47,83,0.566265060241,50,83,133,8,4,10,39,57,147
Kipp Christianson,29.0,9,0,135,11,17,0.647058823529,0,0,0.0,11,17,0.647,0.647058823529,3,5,0.6,8,16,24,0,1,2,12,35,25
Kirk Haston,25.0,46,46,1672,314,689,0.455732946299,4,9,0.444444444444,310,680,0.456,0.458635703919,122,173,0.705202312139,102,261,363,74,49,74,72,156,754
Kirk Penney,53.0,50,43,1425,247,505,0.489108910891,20,48,0.416666666667,227,457,1.091,0.508910891089,135,158,0.854430379747,31,135,166,75,31,3,78,96,649
Kirk Walters,0.0,45,6,460,35,70,0.5,1,1,1.0,34,69,0.493,0.507142857143,14,26,0.538461538462,15,51,66,13,9,12,17,66,85
Kitwana Rhymer,50.0,54,5,1005,79,191,0.413612565445,0,0,0.0,79,191,0.83,0.413612565445,74,112,0.660714285714,84,158,242,18,10,60,49,157,232
Kiwi Gardner,41.0,64,0,792,139,323,0.430340557276,25,79,0.316455696203,114,244,0.905,0.469040247678,73,96,0.760416666667,36,68,104,162,69,5,94,93,376
Kodi Augustus,27.0,4,2,73,9,26,0.346153846154,3,13,0.230769230769,6,13,0.462,0.403846153846,11,11,1.0,3,4,7,2,0,4,2,5,32
Kosta Koufos,39.0,15,14,453,117,203,0.576354679803,0,1,0.0,117,202,1.169,0.576354679803,30,51,0.588235294118,51,82,133,27,13,34,33,38,264
Kosta Perovic,22.0,21,11,490,75,150,0.5,0,2,0.0,75,148,0.507,0.5,47,63,0.746031746032,42,107,149,8,7,33,46,71,197
Kris Clack,60.0,52,25,1372,155,345,0.449275362319,20,60,0.333333333333,135,285,1.007,0.478260869565,102,153,0.666666666667,65,173,238,95,69,22,94,177,432
Kris Clark,29.0,16,0,202,16,68,0.235294117647,8,38,0.210526315789,8,30,0.267,0.294117647059,0,3,0.0,5,13,18,19,14,0,9,18,40
Kris Collins,0.0,46,7,1084,198,442,0.447963800905,5,30,0.166666666667,193,412,1.17,0.453619909502,152,209,0.727272727273,33,90,123,136,46,1,82,94,553
Kris Hunter,24.0,20,3,245,19,44,0.431818181818,0,0,0.0,19,44,0.432,0.431818181818,7,12,0.583333333333,18,44,62,5,3,22,8,35,45
Kris Joseph,72.0,54,46,1838,352,844,0.417061611374,88,234,0.376068376068,264,610,1.301,0.469194312796,214,262,0.81679389313,102,148,250,98,94,26,130,94,1006
Kris Lang,52.0,53,48,1452,252,420,0.6,0,0,0.0,252,420,1.161,0.6,98,167,0.586826347305,97,223,320,85,25,72,101,152,602
Kueth Duany,23.0,3,0,38,4,10,0.4,0,1,0.0,4,9,0.444,0.4,2,6,0.333333333333,1,3,4,0,0,1,3,4,10
Kurt Looby,0.0,150,85,3805,362,618,0.585760517799,0,1,0.0,362,617,2.906,0.585760517799,156,286,0.545454545455,422,772,1194,63,102,459,171,424,880
Kyle Anderson,21.0,26,26,1042,213,476,0.447478991597,17,48,0.354166666667,196,428,0.458,0.465336134454,112,142,0.788732394366,40,185,225,125,51,38,86,63,555
Kyle Casey,26.0,50,27,1215,143,332,0.430722891566,25,83,0.301204819277,118,249,0.474,0.468373493976,91,119,0.764705882353,67,180,247,85,24,30,90,161,402
Kyle Collinsworth,25.0,36,16,983,97,225,0.431111111111,12,41,0.292682926829,85,184,0.462,0.457777777778,28,51,0.549019607843,97,156,253,139,63,32,46,92,234
Kyle Cuffe,0.0,10,0,170,26,60,0.433333333333,0,0,0.0,26,60,0.433,0.433333333333,25,31,0.806451612903,13,20,33,4,1,4,14,21,77
Kyle Davis,73.0,27,0,490,55,122,0.450819672131,0,6,0.0,55,116,1.409,0.450819672131,29,55,0.527272727273,43,85,128,16,14,44,28,91,139
Kyle Fogg,0.0,37,10,664,70,190,0.368421052632,36,107,0.336448598131,34,83,0.41,0.463157894737,62,77,0.805194805195,16,79,95,58,29,5,37,71,238
Kyle Gibson,0.0,88,72,2505,397,956,0.415271966527,124,322,0.385093167702,273,634,0.862,0.480125523013,249,300,0.83,39,262,301,223,56,9,157,172,1167
Kyle Goldcamp,0.0,159,82,3465,557,1005,0.554228855721,0,7,0.0,557,998,2.196,0.554228855721,209,304,0.6875,357,560,917,175,90,108,180,362,1323
Kyle Hunt,0.0,10,1,111,15,36,0.416666666667,0,0,0.0,15,36,0.417,0.416666666667,8,13,0.615384615385,11,12,23,5,5,2,9,16,38
Kyle McAlarney,0.0,86,60,2718,352,750,0.469333333333,134,318,0.421383647799,218,432,1.518,0.558666666667,94,102,0.921568627451,42,184,226,348,80,0,188,144,932
Kyle Randall,0.0,56,2,848,76,226,0.336283185841,12,42,0.285714285714,64,184,1.136,0.362831858407,68,90,0.755555555556,8,60,68,118,34,6,68,70,232
Kyle Shiloh,0.0,5,0,36,2,11,0.181818181818,1,5,0.2,1,6,0.167,0.227272727273,0,0,0.0,1,3,4,6,3,0,2,6,5
Kyle Spain,0.0,93,46,2306,344,795,0.432704402516,134,353,0.379603399433,210,442,0.947,0.516981132075,134,166,0.807228915663,97,321,418,130,78,32,110,258,956
Kyle Weaver,195.0,141,79,4491,622,1424,0.436797752809,184,491,0.374745417515,438,933,3.84,0.501404494382,420,507,0.828402366864,154,542,696,476,179,107,323,374,1848
Kyle Wiltjer,24.0,22,22,789,156,375,0.416,81,215,0.376744186047,75,160,0.469,0.524,57,66,0.863636363636,30,111,141,38,12,18,44,50,450
Kyrylo Fesenko,124.0,101,59,2373,380,703,0.540540540541,0,4,0.0,380,699,2.797,0.540540540541,239,382,0.625654450262,258,457,715,183,40,157,235,321,999
L.D. Williams,123.0,143,86,4093,570,1412,0.403682719547,156,507,0.307692307692,414,905,2.403,0.458923512748,267,404,0.660891089109,156,386,542,206,159,28,190,352,1563
LaDontae Henton,0.0,37,18,1069,181,450,0.402222222222,90,235,0.382978723404,91,215,0.423,0.502222222222,50,68,0.735294117647,40,156,196,62,29,20,48,72,502
LaDustin Williams,0.0,25,5,329,42,107,0.392523364486,5,12,0.416666666667,37,95,0.389,0.415887850467,11,21,0.52380952381,15,21,36,25,19,3,17,20,100
LaQuentin Miles,47.0,13,1,215,34,78,0.435897435897,1,4,0.25,33,74,0.458,0.442307692308,22,43,0.511627906977,10,22,32,27,6,1,23,16,91
LaVall Jordan,23.0,25,0,203,12,58,0.206896551724,2,11,0.181818181818,10,47,0.213,0.224137931034,3,3,1.0,2,16,18,16,4,2,8,16,29
Ladarius White,69.0,6,4,132,20,52,0.384615384615,8,22,0.363636363636,12,30,1.221,0.461538461538,2,4,0.5,0,12,12,2,4,2,6,6,50
Lamar Butler,0.0,84,0,1192,194,414,0.468599033816,114,232,0.491379310345,80,182,1.34,0.606280193237,38,48,0.791666666667,22,78,100,136,38,2,112,78,540
Lamar Patterson,97.0,66,57,2027,386,894,0.431767337808,99,326,0.303680981595,287,568,2.078,0.487136465324,291,372,0.782258064516,65,260,325,293,92,14,216,192,1162
Lamar Rice,0.0,49,2,751,110,227,0.484581497797,1,5,0.2,109,222,0.491,0.486784140969,35,45,0.777777777778,60,111,171,31,12,10,36,113,256
Lamonte Ulmer,0.0,2,0,22,2,10,0.2,0,0,0.0,2,10,0.2,0.2,3,4,0.75,1,2,3,0,2,1,2,3,7
Lance Allred,135.0,163,126,4461,883,1745,0.506017191977,2,5,0.4,881,1740,2.522,0.50659025788,419,556,0.753597122302,388,967,1355,182,72,68,240,387,2187
Lance Goulbourne,0.0,49,7,988,134,298,0.44966442953,3,29,0.103448275862,131,269,0.976,0.454697986577,103,133,0.774436090226,89,209,298,47,20,26,60,80,374
Lance Hurdle,0.0,258,66,6210,855,2118,0.403682719547,422,1082,0.390018484288,433,1036,3.26,0.503305004721,436,536,0.813432835821,75,470,545,524,254,21,248,548,2568
Lance Thomas,45.0,65,65,1987,333,647,0.514683153014,1,12,0.0833333333333,332,635,1.059,0.515455950541,201,282,0.712765957447,188,212,400,83,45,20,103,197,868
Langston Galloway,23.0,19,19,699,115,257,0.447470817121,39,109,0.357798165138,76,148,0.514,0.523346303502,44,53,0.830188679245,21,91,112,46,51,8,29,56,313
Lanny Smith,0.0,64,25,1455,139,364,0.381868131868,41,127,0.322834645669,98,237,0.803,0.438186813187,104,151,0.688741721854,23,135,158,238,49,2,125,162,423
Larry Abney,25.0,50,48,1293,163,357,0.456582633053,3,8,0.375,160,349,0.458,0.460784313725,108,157,0.687898089172,92,188,280,60,38,6,85,119,437
Larry Anderson,0.0,36,23,1080,167,345,0.484057971014,30,98,0.30612244898,137,247,0.555,0.527536231884,146,199,0.733668341709,37,163,200,84,57,4,81,82,510
Larry Ayuso,0.0,14,14,490,62,162,0.382716049383,27,84,0.321428571429,35,78,0.449,0.466049382716,34,38,0.894736842105,4,35,39,27,9,2,34,36,185
Larry Cunningham,0.0,5,0,27,1,6,0.166666666667,0,4,0.0,1,2,0.5,0.166666666667,1,2,0.5,1,4,5,2,1,0,5,5,3
Larry Drew,98.0,96,78,3220,387,813,0.476014760148,119,286,0.416083916084,268,527,2.574,0.549200492005,140,196,0.714285714286,38,284,322,752,142,5,258,219,1033
Larry Owens,209.0,253,168,7633,1152,2485,0.463581488934,253,743,0.340511440108,899,1742,3.583,0.514486921529,462,626,0.738019169329,362,892,1254,682,340,149,498,675,3019
Larry Reid,116.0,66,0,1059,149,376,0.396276595745,26,60,0.433333333333,123,316,1.236,0.43085106383,46,60,0.766666666667,18,105,123,146,52,2,71,113,370
Larry Sanders,50.0,6,2,131,17,46,0.369565217391,0,1,0.0,17,45,0.759,0.369565217391,11,20,0.55,17,35,52,4,4,15,10,21,45
Larry Turner,0.0,47,28,1058,149,303,0.491749174917,0,0,0.0,149,303,0.492,0.491749174917,68,124,0.548387096774,117,188,305,16,17,53,84,206,366
Lasan Kromah,25.0,2,0,28,4,8,0.5,1,2,0.5,3,6,0.5,0.5625,7,9,0.777777777778,0,5,5,2,2,0,1,1,16
Latavious Williams,0.0,88,35,2071,377,640,0.5890625,1,13,0.0769230769231,376,627,1.188,0.58984375,151,224,0.674107142857,254,458,712,52,56,75,106,210,906
Lavor Postell,25.0,45,44,1445,202,475,0.425263157895,33,98,0.336734693878,169,377,0.448,0.46,149,182,0.818681318681,49,149,198,132,37,14,80,115,586
Lavoris Jerry,0.0,5,0,31,4,12,0.333333333333,1,4,0.25,3,8,0.375,0.375,0,0,0.0,0,4,4,1,1,0,2,1,9
Lawrence Hill,0.0,76,68,2424,390,804,0.485074626866,68,166,0.409638554217,322,638,1.511,0.52736318408,130,184,0.70652173913,168,386,554,166,86,132,96,188,978
Lawrence McKenzie,0.0,20,1,307,30,80,0.375,11,30,0.366666666667,19,50,0.76,0.44375,7,10,0.7,6,20,26,37,6,2,29,24,78
Lawrence Moten,29.0,8,0,131,26,61,0.426229508197,2,10,0.2,24,51,0.471,0.44262295082,18,18,1.0,6,11,17,8,5,1,9,9,72
Lawrence Roberts,23.0,10,6,369,80,154,0.519480519481,0,1,0.0,80,153,0.523,0.519480519481,38,58,0.655172413793,36,66,102,8,15,10,20,27,198
Lawrence Westbrook,0.0,41,4,630,97,246,0.394308943089,28,63,0.444444444444,69,183,1.53,0.451219512195,69,74,0.932432432432,8,60,68,42,14,1,39,59,291
Lazar Hayward,110.0,49,13,1196,224,469,0.477611940299,34,115,0.295652173913,190,354,2.118,0.513859275053,120,152,0.789473684211,95,181,276,64,46,20,71,117,602
Lazeric Jones,25.0,21,20,767,125,278,0.44964028777,28,74,0.378378378378,97,204,0.475,0.5,61,76,0.802631578947,14,74,88,101,36,9,61,64,339
Le'Bryan Nash,24.0,27,4,517,72,193,0.373056994819,20,62,0.322580645161,52,131,0.397,0.424870466321,65,90,0.722222222222,17,68,85,32,15,7,44,57,229
Lee Cummard,0.0,22,7,366,42,87,0.48275862069,16,34,0.470588235294,26,53,0.491,0.574712643678,10,11,0.909090909091,8,34,42,26,13,2,21,49,110
Lee Humphrey,0.0,50,15,1299,166,406,0.408866995074,127,306,0.415032679739,39,100,0.39,0.565270935961,64,82,0.780487804878,24,68,92,92,42,1,55,63,523
Lee Scruggs,45.0,103,32,2151,406,900,0.451111111111,57,183,0.311475409836,349,717,0.974,0.482777777778,202,251,0.804780876494,154,429,583,59,52,174,133,288,1071
Leemire Goldwire,0.0,60,7,1553,263,631,0.416798732171,89,259,0.343629343629,174,372,0.912,0.487321711569,166,199,0.834170854271,45,142,187,200,77,4,149,131,781
Lenzelle Smith,23.0,47,6,1145,136,292,0.465753424658,46,116,0.396551724138,90,176,0.511,0.544520547945,27,42,0.642857142857,39,121,160,104,47,1,49,73,345
Leo Lyons,0.0,114,59,3135,591,1178,0.501697792869,111,316,0.351265822785,480,862,2.21,0.548811544992,325,433,0.750577367206,216,607,823,166,91,44,202,292,1618
Leon Sutton,27.0,7,1,106,9,26,0.346153846154,6,16,0.375,3,10,0.3,0.461538461538,0,0,0.0,1,7,8,15,5,0,12,7,24
Leonard Houston,0.0,8,0,58,2,13,0.153846153846,2,10,0.2,0,3,0.0,0.230769230769,3,4,0.75,1,7,8,2,1,0,2,4,9
Leonard Stokes,0.0,78,55,2311,333,688,0.484011627907,2,12,0.166666666667,331,676,1.464,0.485465116279,217,352,0.616477272727,81,194,275,308,124,31,176,130,885
Leroy Hurd,24.0,26,0,559,94,217,0.433179723502,12,32,0.375,82,185,0.443,0.460829493088,60,82,0.731707317073,28,69,97,36,7,3,46,70,260
Leslie McDonald,23.0,12,1,194,23,75,0.306666666667,12,33,0.363636363636,11,42,0.262,0.386666666667,9,10,0.9,0,7,7,7,6,2,11,26,67
Lester Hudson,130.0,56,20,1632,315,709,0.444287729196,130,306,0.424836601307,185,403,2.394,0.535966149506,168,194,0.865979381443,63,261,324,229,89,22,146,153,928
Levi Randolph,23.0,50,10,1539,273,524,0.520992366412,59,149,0.395973154362,214,375,0.571,0.577290076336,137,166,0.825301204819,47,197,244,130,55,4,83,108,742
Lewis Clinch,0.0,119,26,2332,376,996,0.377510040161,128,400,0.32,248,596,1.616,0.441767068273,128,173,0.739884393064,51,165,216,171,83,19,191,207,1008
Lewis Jackson,126.0,104,33,2573,312,695,0.448920863309,7,58,0.120689655172,305,637,2.464,0.453956834532,115,156,0.737179487179,41,316,357,601,79,5,238,216,746
Liam McMorrow,0.0,4,0,26,2,6,0.333333333333,0,0,0.0,2,6,0.333,0.333333333333,6,11,0.545454545455,4,4,8,1,0,0,3,8,10
Livan Pyfrom,23.0,17,3,153,6,19,0.315789473684,0,0,0.0,6,19,0.316,0.315789473684,7,10,0.7,14,28,42,0,2,13,4,24,19
Livio Jean-Charles,23.0,45,28,1138,200,365,0.547945205479,1,3,0.333333333333,199,362,0.55,0.549315068493,50,66,0.757575757576,85,165,250,69,31,63,78,95,451
Lodrick Stewart,0.0,8,0,33,4,11,0.363636363636,0,0,0.0,4,11,0.364,0.363636363636,5,7,0.714285714286,0,2,2,0,0,0,1,3,13
Longar Longar,0.0,39,12,813,94,213,0.441314553991,0,0,0.0,94,213,2.429,0.441314553991,60,107,0.560747663551,67,149,216,30,13,45,56,113,248
Lonnie Harrell,90.0,117,107,3253,510,1320,0.386363636364,155,440,0.352272727273,355,880,1.184,0.445075757576,264,363,0.727272727273,77,343,420,291,108,70,306,320,1439
Lonnie Jones,23.0,8,8,123,7,26,0.269230769231,0,0,0.0,7,26,0.269,0.269230769231,2,4,0.5,11,19,30,2,0,6,5,13,16
Loren Stokes,0.0,37,6,693,76,147,0.517006802721,1,12,0.0833333333333,75,135,1.11,0.520408163265,45,80,0.5625,13,90,103,68,19,4,57,61,198
Loren Woods,28.0,15,0,419,70,126,0.555555555556,0,0,0.0,70,126,0.556,0.555555555556,46,58,0.793103448276,56,120,176,32,13,33,40,43,186
Lorenzo Brown,144.0,94,73,3037,651,1357,0.479734708917,112,308,0.363636363636,539,1049,3.054,0.521002210759,298,360,0.827777777778,126,363,489,507,160,31,275,220,1712
Lorenzo Coleman,0.0,46,32,704,126,208,0.605769230769,0,0,0.0,126,208,0.606,0.605769230769,57,95,0.6,61,146,207,24,4,67,82,153,309
Lorrenzo Wade,31.0,15,10,422,72,148,0.486486486486,7,22,0.318181818182,65,126,0.516,0.510135135135,24,38,0.631578947368,23,38,61,19,18,5,21,42,175
Louis Amundson,24.0,25,25,631,117,208,0.5625,0,2,0.0,117,206,0.568,0.5625,43,88,0.488636363636,82,107,189,18,19,62,39,79,277
Louis Graham,0.0,4,0,16,0,3,0.0,0,0,0.0,0,3,0.0,0.0,3,4,0.75,0,4,4,1,0,2,1,9,3
Louis Truscott,26.0,8,0,106,6,14,0.428571428571,0,0,0.0,6,14,0.429,0.428571428571,4,7,0.571428571429,6,13,19,1,3,1,7,11,16
Louis White,0.0,18,1,316,45,82,0.548780487805,9,16,0.5625,36,66,0.545,0.603658536585,47,54,0.87037037037,11,30,41,49,11,10,29,48,146
Louis Williams,20.0,3,2,108,27,38,0.710526315789,5,8,0.625,22,30,0.733,0.776315789474,19,27,0.703703703704,1,13,14,24,5,2,11,9,78
Lucas Nogueira,45.0,15,6,357,57,107,0.532710280374,3,13,0.230769230769,54,94,1.071,0.546728971963,25,39,0.641025641026,41,72,113,35,11,27,27,42,142
Luis Fernando,0.0,11,3,149,20,49,0.408163265306,0,0,0.0,20,49,0.408,0.408163265306,11,19,0.578947368421,10,20,30,5,3,3,14,27,51
Luis Montero,91.0,102,34,2473,327,805,0.406211180124,127,385,0.32987012987,200,420,1.847,0.485093167702,144,187,0.770053475936,92,542,634,221,108,73,184,282,925
Lukasz Obrzut,0.0,76,24,904,94,218,0.43119266055,0,0,0.0,94,218,1.25,0.43119266055,48,76,0.631578947368,66,116,182,14,6,38,38,152,236
Luke Anderson,0.0,32,0,316,32,114,0.280701754386,22,68,0.323529411765,10,46,0.667,0.377192982456,12,14,0.857142857143,4,16,20,10,4,0,14,24,98
Luke Babbitt,43.0,17,12,512,120,240,0.5,24,59,0.406779661017,96,181,0.992,0.55,80,92,0.869565217391,38,92,130,30,15,9,31,41,344
Luke Bonner,0.0,26,2,223,30,75,0.4,17,45,0.377777777778,13,30,0.856,0.513333333333,6,9,0.666666666667,17,30,47,8,8,5,9,53,83
Luke Harangody,49.0,33,32,1177,246,529,0.465028355388,49,120,0.408333333333,197,409,0.969,0.511342155009,108,139,0.776978417266,97,305,402,51,23,27,68,93,649
Luke Jackson,107.0,96,74,3004,482,1082,0.445471349353,137,326,0.420245398773,345,756,1.816,0.508780036969,379,452,0.838495575221,109,351,460,384,113,20,263,175,1480
Luke Loucks,72.0,38,0,540,40,106,0.377358490566,24,54,0.444444444444,16,52,0.89,0.490566037736,18,22,0.818181818182,8,60,68,108,16,6,70,52,122
Luke Martinez,25.0,11,1,156,22,54,0.407407407407,17,43,0.395348837209,5,11,0.455,0.564814814815,6,6,1.0,5,25,30,9,5,3,6,19,67
Luke Nevill,0.0,45,40,1112,224,410,0.546341463415,0,1,0.0,224,409,0.548,0.546341463415,87,119,0.731092436975,78,168,246,61,12,54,68,131,535
Luke Recker,24.0,34,4,635,98,219,0.447488584475,43,112,0.383928571429,55,107,0.514,0.545662100457,62,75,0.826666666667,12,47,59,30,18,4,47,48,301
Luke Schenscher,47.0,70,67,1710,255,490,0.520408163265,0,0,0.0,255,490,1.042,0.520408163265,110,168,0.654761904762,181,273,454,69,47,89,120,249,620
Luke Whitehead,51.0,18,1,324,46,123,0.373983739837,9,24,0.375,37,99,0.731,0.410569105691,39,57,0.684210526316,21,44,65,20,14,5,21,33,140
Luke Zeller,73.0,109,56,2465,297,733,0.405184174625,117,328,0.356707317073,180,405,1.341,0.484993178718,36,47,0.765957446809,126,380,506,136,41,73,72,309,747
Luther Head,0.0,22,2,518,106,232,0.456896551724,28,78,0.358974358974,78,154,1.532,0.51724137931,36,46,0.782608695652,8,40,48,20,32,2,36,34,276
Lynn Greer,23.0,13,0,243,44,92,0.478260869565,8,25,0.32,36,67,0.537,0.521739130435,25,34,0.735294117647,8,13,21,27,4,1,21,18,121
Maalik Wayns,66.0,39,9,893,175,418,0.418660287081,40,131,0.30534351145,135,287,1.41,0.466507177033,68,85,0.8,13,80,93,171,24,4,84,79,458
Mac Koshwal,137.0,163,121,4220,579,1091,0.530705774519,0,0,0.0,579,1091,2.582,0.530705774519,123,325,0.378461538462,527,779,1306,240,193,58,266,420,1281
Magnum Rolle,0.0,15,7,390,90,177,0.508474576271,0,4,0.0,90,173,0.52,0.508474576271,31,53,0.584905660377,35,48,83,20,22,18,30,57,211
Majic Dorsey,236.0,216,105,4691,750,1745,0.429799426934,21,139,0.151079136691,729,1606,3.734,0.435816618911,397,482,0.823651452282,115,296,411,692,147,12,401,389,1918
Major Wingate,0.0,18,5,468,49,109,0.449541284404,0,0,0.0,49,109,0.45,0.449541284404,38,57,0.666666666667,19,79,98,30,6,21,44,56,136
Makhtar N'Diaye,28.0,48,43,1020,124,309,0.401294498382,6,17,0.352941176471,118,292,0.404,0.411003236246,36,47,0.765957446809,110,199,309,60,30,61,104,172,290
Malachi Richardson,21.0,11,10,385,69,162,0.425925925926,22,50,0.44,47,112,0.42,0.493827160494,71,93,0.763440860215,4,43,47,16,10,0,39,36,231
Malcolm Lee,93.0,71,53,1799,259,650,0.398461538462,88,243,0.362139917695,171,407,1.69,0.466153846154,117,152,0.769736842105,45,202,247,347,71,1,161,171,723
Malcolm Miller,47.0,69,43,1774,221,465,0.475268817204,93,249,0.373493975904,128,216,1.106,0.575268817204,113,142,0.795774647887,68,186,254,68,40,62,69,134,648
Malcolm Thomas,266.0,85,67,2824,512,863,0.593279258401,46,110,0.418181818182,466,753,6.381,0.619930475087,206,319,0.645768025078,290,562,852,172,74,191,160,228,1276
Malick Badiane,0.0,19,8,376,39,96,0.40625,0,1,0.0,39,95,0.411,0.40625,16,24,0.666666666667,30,72,102,9,7,7,21,54,94
Malik Beasley,20.0,16,12,497,108,236,0.457627118644,30,81,0.37037037037,78,155,0.503,0.521186440678,56,63,0.888888888889,23,98,121,41,17,2,34,31,302
Malik Hairston,43.0,45,45,1851,390,768,0.5078125,50,117,0.42735042735,340,651,1.031,0.540364583333,292,351,0.831908831909,88,146,234,157,49,44,112,164,1122
Malik Moore,29.0,47,4,682,61,176,0.346590909091,5,28,0.178571428571,56,148,0.378,0.360795454545,58,93,0.623655913978,20,54,74,69,19,3,60,50,185
Malik Smith,24.0,23,2,248,27,79,0.341772151899,26,70,0.371428571429,1,9,0.111,0.506329113924,1,3,0.333333333333,4,19,23,11,5,3,7,25,81
Mamadou N'Diaye,28.0,6,0,126,16,34,0.470588235294,0,0,0.0,16,34,0.471,0.470588235294,21,30,0.7,10,28,38,1,4,11,7,22,53
Manny Atkins,72.0,90,48,2158,314,704,0.446022727273,108,318,0.339622641509,206,386,1.073,0.522727272727,104,124,0.838709677419,112,274,386,88,90,12,98,166,840
Manny Harris,176.0,132,117,4825,1134,2493,0.454873646209,212,586,0.361774744027,922,1907,3.304,0.497392699559,760,916,0.829694323144,206,738,944,500,226,46,413,253,3240
Manual Narvaez,75.0,34,14,574,52,104,0.5,0,2,0.0,52,102,1.253,0.5,34,42,0.809523809524,62,114,176,14,12,4,38,80,138
MarShon Brooks,75.0,14,14,446,130,276,0.471014492754,18,52,0.346153846154,112,224,1.481,0.503623188406,44,56,0.785714285714,16,52,68,54,18,10,38,42,322
Marc Mazur,175.0,124,5,1774,153,346,0.442196531792,0,0,0.0,153,346,3.196,0.442196531792,69,122,0.565573770492,108,256,364,46,21,46,65,212,375
Marcel Anderson,0.0,62,24,1254,166,488,0.340163934426,38,178,0.213483146067,128,310,1.258,0.379098360656,54,86,0.627906976744,16,138,154,216,74,6,134,144,424
Marcel Jones,0.0,2,0,20,2,9,0.222222222222,0,4,0.0,2,5,0.4,0.222222222222,0,2,0.0,3,0,3,0,1,1,1,5,4
Marcin Gortat,23.0,5,4,139,21,43,0.488372093023,0,0,0.0,21,43,0.488,0.488372093023,7,10,0.7,6,28,34,6,3,3,7,24,49
Marcus Banks,30.0,19,4,492,102,197,0.517766497462,24,52,0.461538461538,78,145,0.538,0.578680203046,112,132,0.848484848485,2,31,33,95,23,2,61,61,340
Marcus Campbell,223.0,282,179,5913,1251,2376,0.526515151515,2,3,0.666666666667,1249,2373,4.772,0.526936026936,395,693,0.569985569986,682,1278,1960,231,114,313,576,892,2899
Marcus Cousin,24.0,46,45,1406,251,482,0.520746887967,0,1,0.0,251,481,0.522,0.520746887967,183,220,0.831818181818,145,251,396,38,17,52,80,145,685
Marcus Douthit,51.0,53,42,1619,245,480,0.510416666667,0,1,0.0,245,479,1.003,0.510416666667,141,202,0.69801980198,119,277,396,74,69,62,151,178,631
Marcus Dove,0.0,84,58,2410,378,664,0.569277108434,1,4,0.25,377,660,1.127,0.570030120482,216,318,0.679245283019,200,327,527,88,123,103,122,273,973
Marcus Evans,0.0,6,0,56,5,13,0.384615384615,0,0,0.0,5,13,0.385,0.384615384615,2,5,0.4,4,4,8,0,0,0,6,9,12
Marcus Fizer,27.0,35,35,1210,286,557,0.513464991023,17,53,0.320754716981,269,504,0.534,0.528725314183,207,279,0.741935483871,70,202,272,116,29,17,93,121,796
Marcus Fleming,49.0,39,8,862,99,223,0.443946188341,1,5,0.2,98,218,0.894,0.446188340807,116,165,0.70303030303,72,155,227,25,23,12,54,86,315
Marcus Georges-Hunt,22.0,45,40,1639,240,520,0.461538461538,74,189,0.391534391534,166,331,0.502,0.532692307692,159,179,0.888268156425,48,233,281,200,46,15,90,118,713
Marcus Ginyard,27.0,18,6,383,55,108,0.509259259259,7,19,0.368421052632,48,89,0.539,0.541666666667,18,25,0.72,26,53,79,36,16,2,33,27,135
Marcus Goode,26.0,1,0,2,0,0,0.0,0,0,0.0,0,0,0.0,0.0,0,0,0.0,0,0,0,0,0,0,0,1,0
Marcus Hall,87.0,80,12,1574,206,524,0.393129770992,64,196,0.326530612245,142,328,1.308,0.454198473282,44,58,0.758620689655,10,204,214,232,46,4,108,108,520
Marcus Hill,57.0,26,0,268,28,82,0.341463414634,6,24,0.25,22,58,1.1,0.378048780488,8,9,0.888888888889,9,26,35,24,7,4,18,35,70
Marcus Hubbard,0.0,326,140,7154,1134,2530,0.448221343874,156,484,0.322314049587,978,2046,5.642,0.479051383399,446,662,0.673716012085,514,1302,1816,332,268,232,408,888,2870
Marcus Landry,104.0,98,85,3369,564,1315,0.428897338403,257,634,0.405362776025,307,681,1.832,0.526615969582,193,269,0.717472118959,102,347,449,153,100,74,160,281,1578
Marcus Lewis,0.0,137,51,3512,528,964,0.547717842324,0,3,0.0,528,961,1.629,0.547717842324,193,387,0.498708010336,327,662,989,266,103,67,237,315,1249
Marcus Moore,24.0,45,19,1048,120,313,0.38338658147,17,57,0.298245614035,103,256,0.402,0.41054313099,39,53,0.735849056604,31,87,118,211,45,8,100,87,296
Marcus Morris,22.0,11,9,333,85,186,0.456989247312,12,47,0.255319148936,73,139,0.525,0.489247311828,46,63,0.730158730159,29,62,91,12,14,5,26,25,228
Marcus Paige,23.0,46,40,1505,192,481,0.399168399168,97,273,0.355311355311,95,208,0.457,0.5,77,92,0.836956521739,21,81,102,102,41,14,78,89,558
Marcus Posley,22.0,47,17,1169,156,445,0.350561797753,98,275,0.356363636364,58,170,0.341,0.460674157303,48,66,0.727272727273,10,84,94,97,44,4,68,70,458
Marcus Relphorde,0.0,9,6,250,41,95,0.431578947368,7,28,0.25,34,67,0.507,0.468421052632,16,29,0.551724137931,13,34,47,12,9,0,16,24,105
Marcus Simmons,84.0,115,37,2570,242,561,0.43137254902,48,155,0.309677419355,194,406,1.429,0.474153297683,87,145,0.6,150,253,403,137,77,42,102,319,619
Marcus Smart,20.0,1,1,29,1,12,0.0833333333333,0,8,0.0,1,4,0.25,0.0833333333333,4,6,0.666666666667,0,5,5,7,4,1,4,2,6
Marcus Taylor,124.0,53,17,780,131,279,0.469534050179,3,38,0.0789473684211,128,241,2.626,0.474910394265,45,52,0.865384615385,34,30,64,62,12,2,61,59,310
Marcus Thornton,22.0,12,6,325,59,129,0.457364341085,23,64,0.359375,36,65,0.554,0.546511627907,22,31,0.709677419355,4,21,25,30,6,4,15,13,163
Marcus Vinicius,22.0,13,6,430,85,176,0.482954545455,27,71,0.380281690141,58,105,0.552,0.559659090909,24,31,0.774193548387,11,76,87,31,16,3,31,24,221
Marcus White,0.0,10,3,194,22,52,0.423076923077,0,0,0.0,22,52,0.44,0.423076923077,13,17,0.764705882353,23,37,60,6,11,3,9,28,57
Marcus Williams,66.0,89,72,3513,725,1500,0.483333333333,84,253,0.332015810277,641,1247,1.647,0.511333333333,389,469,0.829424307036,111,496,607,390,136,55,315,237,1923
Mardracus Wade,99.0,63,5,1318,108,247,0.437246963563,36,84,0.428571428571,72,163,1.736,0.51012145749,95,129,0.736434108527,16,67,83,100,63,9,67,164,347
Mardy Collins,27.0,28,12,791,112,243,0.460905349794,4,20,0.2,108,223,0.484,0.469135802469,53,89,0.595505617978,31,69,100,129,28,10,51,49,281
Mario Boggan,0.0,6,0,35,3,7,0.428571428571,0,0,0.0,3,7,0.429,0.428571428571,1,2,0.5,2,5,7,1,0,0,3,10,7
Mario Little,78.0,87,67,2695,455,1102,0.412885662432,182,511,0.356164383562,273,591,1.458,0.495462794918,202,237,0.852320675105,70,253,323,211,83,18,186,237,1294
Mario West,51.0,53,48,1763,262,505,0.518811881188,41,120,0.341666666667,221,385,1.141,0.559405940594,162,248,0.653225806452,34,221,255,166,87,31,151,159,727
Mark Jones,31.0,6,3,112,13,41,0.317073170732,0,2,0.0,13,39,0.333,0.317073170732,8,14,0.571428571429,7,12,19,7,1,2,4,12,34
Mark Karcher,27.0,10,1,238,38,102,0.372549019608,13,26,0.5,25,76,0.329,0.436274509804,12,18,0.666666666667,14,25,39,18,7,0,23,23,101
Mark McLaughlin,24.0,4,0,58,10,29,0.344827586207,2,4,0.5,8,25,0.32,0.379310344828,5,9,0.555555555556,3,4,7,5,3,0,6,3,27
Mark Simmons,0.0,1,0,1,0,0,0.0,0,0,0.0,0,0,0.0,0.0,0,0,0.0,0,0,0,0,0,0,0,0,0
Mark Tyndale,189.0,247,73,6525,711,1487,0.478143913921,85,249,0.341365461847,626,1238,3.482,0.506724949563,576,891,0.646464646465,325,897,1222,778,383,69,470,466,2083
Mark Walters,0.0,43,10,628,79,170,0.464705882353,11,39,0.282051282051,68,131,0.519,0.497058823529,39,62,0.629032258065,45,66,111,40,39,6,22,71,208
Markeith Cummings,157.0,93,2,1433,190,433,0.438799076212,29,120,0.241666666667,161,313,3.047,0.472286374134,146,197,0.741116751269,61,108,169,76,70,5,99,183,555
Markel Brown,23.0,1,1,8,2,4,0.5,1,2,0.5,1,2,0.5,0.625,2,2,1.0,0,1,1,0,1,0,0,0,7
Markus Kennedy,25.0,14,1,56,6,22,0.272727272727,0,9,0.0,6,13,0.462,0.272727272727,6,9,0.666666666667,3,8,11,4,1,1,5,10,18
Marlon Parmer,0.0,17,4,309,44,104,0.423076923077,0,7,0.0,44,97,0.454,0.423076923077,48,60,0.8,8,20,28,62,13,2,44,24,136
Marque Perry,23.0,44,44,1728,242,539,0.448979591837,19,54,0.351851851852,223,485,0.46,0.466604823748,175,218,0.802752293578,28,163,191,295,67,4,170,89,678
Marquis Gilstrap,0.0,5,0,41,7,16,0.4375,2,7,0.285714285714,5,9,0.556,0.5,2,3,0.666666666667,3,9,12,2,0,1,6,5,18
Marquis Teague,86.0,114,78,3438,624,1497,0.416833667335,99,287,0.344947735192,525,1210,1.76,0.449899799599,332,455,0.72967032967,41,236,277,638,88,28,326,269,1679
Marquis Webb,0.0,26,11,472,28,73,0.383561643836,13,37,0.351351351351,15,36,0.417,0.472602739726,14,19,0.736842105263,11,18,29,20,15,0,13,39,83
Marqus Blakely,0.0,168,92,4644,982,1700,0.577647058824,12,62,0.193548387097,970,1638,3.508,0.581176470588,550,910,0.604395604396,474,598,1072,312,272,168,408,574,2526
Marshall Brown,0.0,42,12,1000,154,320,0.48125,47,136,0.345588235294,107,184,1.139,0.5546875,75,109,0.688073394495,59,138,197,51,27,25,66,102,430
Marshall Henderson,25.0,4,0,44,9,25,0.36,9,22,0.409090909091,0,3,0.0,0.54,0,0,0.0,2,3,5,2,3,0,1,4,27
Marshall Phillips,26.0,55,54,1716,223,583,0.382504288165,27,84,0.321428571429,196,499,0.393,0.405660377358,240,329,0.729483282675,90,227,317,120,70,25,167,186,713
Marshall Plumlee,24.0,15,15,461,68,121,0.561983471074,0,0,0.0,68,121,0.562,0.561983471074,49,79,0.620253164557,43,94,137,11,9,19,36,40,185
Martell Webster,19.0,8,0,203,32,85,0.376470588235,7,22,0.318181818182,25,63,0.397,0.417647058824,15,19,0.789473684211,3,24,27,5,3,2,17,14,86
Martin Lewis,78.0,64,16,1426,240,552,0.434782608696,16,58,0.275862068966,224,494,1.47,0.449275362319,186,248,0.75,106,110,216,32,76,14,100,150,682
Martin Zeno,0.0,12,0,232,25,69,0.36231884058,0,7,0.0,25,62,0.403,0.36231884058,9,22,0.409090909091,7,21,28,20,10,1,9,18,59
Martynas Andriuskevicius,39.0,18,4,342,44,91,0.483516483516,1,9,0.111111111111,43,82,0.966,0.489010989011,31,46,0.673913043478,18,52,70,9,3,20,24,44,120
Marvin Phillips,0.0,211,50,4453,671,1369,0.490138787436,34,152,0.223684210526,637,1217,3.095,0.502556610665,299,424,0.705188679245,519,807,1326,137,227,148,211,539,1675
Marvin Roberts,0.0,4,0,28,1,7,0.142857142857,0,0,0.0,1,7,0.143,0.142857142857,2,5,0.4,1,4,5,0,1,0,0,5,4
Mateen Cleaves,144.0,126,98,4124,688,1423,0.483485593816,77,200,0.385,611,1223,2.566,0.51054111033,432,557,0.775583482944,79,391,470,970,157,8,371,401,1885
Matt Barnes,22.0,50,12,932,172,442,0.389140271493,61,175,0.348571428571,111,267,0.416,0.45814479638,79,113,0.699115044248,47,117,164,56,44,13,86,87,484
Matt Bouldin,154.0,113,74,3434,506,1190,0.425210084034,178,509,0.349705304519,328,681,2.532,0.5,231,300,0.77,76,367,443,406,136,18,267,222,1421
Matt Carlino,23.0,27,2,382,33,111,0.297297297297,26,84,0.309523809524,7,27,0.259,0.414414414414,11,15,0.733333333333,7,37,44,43,23,1,15,49,103
Matt Carroll,47.0,35,20,1117,239,498,0.479919678715,35,71,0.492957746479,204,427,0.932,0.515060240964,141,162,0.87037037037,20,78,98,63,32,13,57,75,654
Matt Costello,23.0,23,14,582,85,166,0.512048192771,7,38,0.184210526316,78,128,0.609,0.53313253012,41,53,0.77358490566,80,154,234,43,13,38,38,72,218
Matt Dickey,0.0,16,2,292,38,74,0.513513513514,4,18,0.222222222222,34,56,1.831,0.540540540541,14,22,0.636363636364,2,10,12,26,14,0,28,22,94
Matt Gatens,27.0,2,2,31,2,7,0.285714285714,2,6,0.333333333333,0,1,0.0,0.428571428571,0,0,0.0,2,3,5,0,3,0,2,1,6
Matt Haryasz,22.0,30,27,865,121,239,0.506276150628,0,0,0.0,121,239,0.506,0.506276150628,77,99,0.777777777778,60,154,214,23,9,41,64,103,319
Matt Janning,0.0,82,20,2216,278,642,0.433021806854,128,308,0.415584415584,150,334,1.36,0.532710280374,108,138,0.782608695652,96,208,304,218,94,22,142,166,792
Matt Laur,23.0,9,0,73,11,18,0.611111111111,0,0,0.0,11,18,0.611,0.611111111111,2,2,1.0,5,12,17,4,2,1,4,11,24
Matt Rogers,0.0,78,20,1394,218,460,0.473913043478,1,16,0.0625,217,444,0.964,0.475,131,172,0.761627906977,127,212,339,27,46,88,107,206,568
Matt Walsh,23.0,11,1,230,30,78,0.384615384615,16,46,0.347826086957,14,32,0.438,0.487179487179,16,19,0.842105263158,3,28,31,23,5,2,15,25,92
Maureece Rice,0.0,71,48,2374,473,1009,0.468780971259,73,181,0.403314917127,400,828,0.946,0.504955401388,156,187,0.83422459893,70,197,267,243,77,5,133,96,1175
Maurice Ager,70.0,39,28,1299,206,466,0.442060085837,59,146,0.404109589041,147,320,1.332,0.505364806867,137,197,0.695431472081,17,123,140,117,30,6,105,87,608
Maurice Baker,315.0,357,267,10420,1334,3074,0.433962264151,220,659,0.333839150228,1114,2415,4.652,0.469746258946,691,805,0.858385093168,409,1292,1701,1499,457,23,724,963,3579
Maurice Bolden,27.0,26,0,227,32,79,0.405063291139,5,21,0.238095238095,27,58,0.466,0.436708860759,16,20,0.8,17,40,57,14,8,7,11,26,85
Maurice Carter,32.0,14,0,198,17,63,0.269841269841,5,21,0.238095238095,12,42,0.286,0.309523809524,11,19,0.578947368421,5,17,22,28,7,0,14,13,50
Maurice Jeffers,22.0,2,0,40,2,8,0.25,0,0,0.0,2,8,0.25,0.25,3,6,0.5,0,11,11,5,1,0,3,4,7
Maurice Kemp,23.0,21,1,358,59,113,0.522123893805,9,23,0.391304347826,50,90,0.556,0.561946902655,18,30,0.6,23,29,52,14,14,7,16,40,145
Maurice Maxwell,0.0,26,11,674,77,186,0.413978494624,4,17,0.235294117647,73,169,0.432,0.424731182796,37,47,0.787234042553,13,45,58,54,22,10,43,40,195
Maurice Ndour,24.0,18,18,507,98,209,0.468899521531,8,29,0.275862068966,90,180,0.5,0.488038277512,60,77,0.779220779221,34,89,123,21,20,26,35,51,264
Maurice Sutton,49.0,91,40,1692,300,516,0.581395348837,0,2,0.0,300,514,1.165,0.581395348837,119,175,0.68,166,372,538,39,44,109,92,231,719
Max Hooper,21.0,2,0,18,1,6,0.166666666667,1,6,0.166666666667,0,0,0.25,0.25,0,0,0.0,0,0,0,1,2,0,1,1,3
Maxie Esho,24.0,35,0,554,82,186,0.440860215054,9,34,0.264705882353,73,152,0.48,0.465053763441,33,45,0.733333333333,30,91,121,15,21,14,40,72,206
Maze Stallworth,0.0,3,0,33,2,10,0.2,0,8,0.0,2,2,1.0,0.2,0,2,0.0,0,2,2,2,1,0,1,3,4
Melvin Ejim,24.0,39,39,1275,208,440,0.472727272727,35,106,0.330188679245,173,334,0.518,0.5125,117,148,0.790540540541,77,223,300,121,61,15,115,153,568
Melvin Ely,69.0,78,74,2164,409,729,0.561042524005,0,1,0.0,409,728,1.109,0.561042524005,227,307,0.739413680782,142,327,469,84,46,87,144,200,1045
Melvin Johnson,197.0,144,8,2592,464,1162,0.399311531842,252,666,0.378378378378,212,496,3.112,0.507745266781,170,228,0.745614035088,54,358,412,120,82,16,162,208,1350
Melvin Sanders,25.0,19,15,601,111,238,0.466386554622,3,23,0.130434782609,108,215,0.502,0.47268907563,49,65,0.753846153846,34,41,75,41,26,5,33,70,274
Melvin Scott,24.0,6,1,125,7,25,0.28,5,9,0.555555555556,2,16,0.125,0.38,8,15,0.533333333333,0,7,7,10,2,0,13,17,27
Mengke Bateer,29.0,24,24,636,100,186,0.537634408602,1,1,1.0,99,185,0.535,0.540322580645,86,120,0.716666666667,56,71,127,40,5,10,63,93,287
Merl Code,27.0,23,1,224,30,62,0.483870967742,14,31,0.451612903226,16,31,0.516,0.596774193548,16,18,0.888888888889,2,17,19,24,9,0,23,29,90
Mfon Udofia,72.0,75,14,1094,106,269,0.39405204461,38,117,0.324786324786,68,152,1.202,0.46468401487,64,95,0.673684210526,29,73,102,84,23,4,77,113,314
Miah Davis,23.0,46,14,955,85,255,0.333333333333,5,18,0.277777777778,80,237,0.338,0.343137254902,74,100,0.74,10,107,117,160,36,3,71,101,249
Micah Downs,0.0,73,64,2520,414,954,0.433962264151,164,437,0.37528604119,250,517,0.993,0.519916142558,171,207,0.826086956522,73,312,385,199,103,62,175,197,1163
Michael Bryson,22.0,46,2,824,82,215,0.381395348837,50,132,0.378787878788,32,83,0.386,0.497674418605,20,27,0.740740740741,20,92,112,37,19,39,20,85,234
Michael Cuffee,0.0,92,54,2770,366,808,0.45297029703,40,122,0.327868852459,326,686,1.441,0.477722772277,224,288,0.777777777778,152,298,450,172,64,6,160,308,996
Michael Dunigan,72.0,96,48,2068,309,626,0.493610223642,0,3,0.0,309,623,1.503,0.493610223642,213,306,0.696078431373,172,328,500,70,77,108,123,306,831
Michael Fey,0.0,50,47,1285,263,463,0.568034557235,1,2,0.5,262,461,0.568,0.569114470842,113,138,0.81884057971,117,202,319,67,25,35,86,143,640
Michael Frazier,84.0,72,4,1210,172,398,0.43216080402,52,146,0.356164383562,120,252,1.724,0.497487437186,84,118,0.71186440678,20,148,168,92,46,8,60,88,480
Michael Gbinije,24.0,16,16,560,69,164,0.420731707317,31,93,0.333333333333,38,71,0.535,0.515243902439,23,32,0.71875,13,56,69,28,30,4,19,24,192
Michael Haynes,0.0,48,17,996,174,410,0.424390243902,80,202,0.39603960396,94,208,0.452,0.521951219512,77,111,0.693693693694,60,112,172,48,22,21,60,114,505
Michael Holyfield,69.0,80,6,1052,120,218,0.550458715596,0,0,0.0,120,218,1.656,0.550458715596,74,122,0.606557377049,150,202,352,14,14,64,86,202,314
Michael Jenkins,28.0,14,5,394,62,131,0.473282442748,32,71,0.450704225352,30,60,0.5,0.595419847328,39,46,0.847826086957,11,49,60,44,16,0,28,40,195
Michael Joiner,0.0,223,132,5893,716,1788,0.400447427293,266,764,0.348167539267,450,1024,2.608,0.474832214765,177,232,0.762931034483,248,638,886,292,163,116,229,716,1875
Michael Lee,0.0,90,0,1504,222,478,0.464435146444,30,114,0.263157894737,192,364,1.584,0.495815899582,60,88,0.681818181818,82,188,270,68,46,34,90,110,534
Michael Lyons,26.0,41,20,831,76,199,0.381909547739,39,114,0.342105263158,37,85,0.435,0.479899497487,22,31,0.709677419355,35,61,96,37,34,4,18,78,213
Michael Peeples,0.0,2,0,16,2,5,0.4,0,0,0.0,2,5,0.4,0.4,0,0,0.0,1,3,4,0,1,0,2,3,4
Michael Schachtner,84.0,48,0,686,104,260,0.4,8,48,0.166666666667,96,212,1.327,0.415384615385,20,30,0.666666666667,48,54,102,14,8,0,30,76,236
Michael Stockton,26.0,50,18,1148,153,348,0.439655172414,28,101,0.277227722772,125,247,0.506,0.479885057471,84,100,0.84,18,121,139,236,48,1,81,161,418
Michael Sturns,0.0,1,0,4,0,3,0.0,0,1,0.0,0,2,0.0,0.0,0,0,0.0,1,0,1,0,1,0,2,1,0
Michael Tveidt,0.0,44,23,967,109,238,0.457983193277,33,82,0.40243902439,76,156,0.487,0.52731092437,39,52,0.75,33,86,119,44,20,13,35,74,290
Michael Williams,48.0,82,5,1377,156,421,0.37054631829,71,182,0.39010989011,85,239,0.717,0.45486935867,41,67,0.611940298507,12,118,130,181,41,6,77,103,424
Michale Kyser,49.0,69,6,1012,110,241,0.45643153527,0,10,0.0,110,231,0.942,0.45643153527,32,53,0.603773584906,102,152,254,26,22,44,37,96,252
Micheal Eric,76.0,95,54,2282,401,727,0.551581843191,0,0,0.0,401,727,1.679,0.551581843191,116,173,0.670520231214,269,508,777,80,46,176,181,293,918
Mickael Gelabale,49.0,12,1,381,82,150,0.546666666667,15,39,0.384615384615,67,111,1.217,0.596666666667,24,30,0.8,17,35,52,24,12,5,12,31,203
Mickell Gladness,173.0,204,90,3637,487,883,0.551528878822,0,2,0.0,487,881,4.038,0.551528878822,201,350,0.574285714286,347,658,1005,68,65,358,202,435,1175
Mickey McConnell,0.0,50,29,1626,169,407,0.415233415233,54,168,0.321428571429,115,239,0.481,0.481572481572,120,143,0.839160839161,34,104,138,322,68,2,111,146,512
Mike Anderson,49.0,143,55,3341,487,1037,0.46962391514,35,133,0.263157894737,452,904,1.853,0.48649951784,253,364,0.695054945055,198,416,614,165,124,128,198,374,1262
Mike Benton,24.0,48,45,1259,159,305,0.52131147541,0,0,0.0,159,305,0.521,0.52131147541,74,125,0.592,100,218,318,26,22,98,55,141,392
Mike Cobbins,23.0,29,0,209,19,38,0.5,0,1,0.0,19,37,0.514,0.5,9,20,0.45,10,28,38,4,6,4,14,38,47
Mike Cook,0.0,10,0,130,25,63,0.396825396825,3,12,0.25,22,51,0.431,0.420634920635,33,46,0.717391304348,3,12,15,8,1,1,9,7,86
Mike Davis,52.0,89,33,1598,216,407,0.530712530713,1,3,0.333333333333,215,404,2.071,0.531941031941,56,91,0.615384615385,120,289,409,73,48,40,83,166,489
Mike Dean,24.0,7,7,199,35,91,0.384615384615,3,7,0.428571428571,32,84,0.381,0.401098901099,24,32,0.75,4,5,9,14,1,0,19,13,97
Mike Efevberha,142.0,148,53,3854,822,1892,0.434460887949,127,419,0.303102625298,695,1473,2.536,0.468023255814,513,622,0.824758842444,137,452,589,292,169,69,293,412,2284
Mike Gansey,0.0,95,54,2985,476,1044,0.455938697318,151,467,0.323340471092,325,577,2.327,0.528256704981,157,191,0.821989528796,176,379,555,209,109,17,142,140,1260
Mike Gerrity,0.0,79,11,1381,148,346,0.42774566474,0,15,0.0,148,331,1.662,0.42774566474,78,125,0.624,18,122,140,257,54,6,98,121,374
Mike Hall,71.0,97,81,3513,524,1178,0.444821731749,141,398,0.354271356784,383,780,1.472,0.50466893039,258,303,0.851485148515,291,468,759,225,108,26,134,220,1447
Mike Harris,49.0,82,47,2328,599,1007,0.594836146971,33,111,0.297297297297,566,896,1.272,0.611221449851,256,322,0.795031055901,258,427,685,130,78,94,163,261,1487
Mike James,112.0,53,48,1874,362,807,0.448574969021,113,280,0.403571428571,249,527,1.451,0.518587360595,106,137,0.773722627737,24,182,206,343,47,6,164,175,943
Mike King,154.0,203,51,4500,824,1827,0.451012588944,68,206,0.330097087379,756,1621,2.834,0.469622331691,486,633,0.767772511848,150,363,513,298,213,15,266,407,2202
Mike McCall,23.0,30,3,319,35,91,0.384615384615,9,34,0.264705882353,26,57,0.456,0.434065934066,8,9,0.888888888889,4,23,27,35,8,1,19,31,87
Mike Muscala,23.0,6,2,179,29,61,0.475409836066,1,2,0.5,28,59,0.475,0.483606557377,18,21,0.857142857143,20,32,52,10,4,6,11,17,77
Mike Nelson,0.0,34,2,655,79,167,0.473053892216,40,94,0.425531914894,39,73,0.534,0.592814371257,12,18,0.666666666667,15,45,60,36,15,1,28,47,210
Mike Scott,108.0,19,15,510,119,267,0.445692883895,20,62,0.322580645161,99,205,1.874,0.483146067416,35,47,0.744680851064,48,62,110,30,11,14,31,52,293
Mike Singletary,0.0,98,44,2462,344,798,0.431077694236,116,286,0.405594405594,228,512,1.335,0.503759398496,184,228,0.80701754386,142,336,478,188,72,24,142,144,988
Mike Smith,25.0,14,8,253,38,101,0.376237623762,8,29,0.275862068966,30,72,0.417,0.415841584158,16,22,0.727272727273,14,29,43,9,8,5,15,24,100
Mike Sweetney,27.0,9,2,230,49,77,0.636363636364,0,1,0.0,49,76,0.645,0.636363636364,22,44,0.5,21,41,62,8,2,8,26,30,120
Mike Taylor,74.0,78,17,1934,346,731,0.473324213406,96,273,0.351648351648,250,458,1.596,0.538987688098,166,240,0.691666666667,57,168,225,259,106,13,210,208,954
Mike Tisdale,0.0,40,20,810,106,228,0.464912280702,4,10,0.4,102,218,1.373,0.473684210526,22,32,0.6875,60,136,196,20,8,58,60,126,238
Mike Tobey,22.0,35,25,936,173,335,0.516417910448,11,56,0.196428571429,162,279,0.581,0.532835820896,62,85,0.729411764706,113,203,316,35,28,46,60,104,419
Mike Wilks,89.0,104,92,2906,310,747,0.41499330656,57,152,0.375,253,595,1.563,0.453145917001,298,382,0.780104712042,133,245,378,408,149,15,179,248,975
Mike Williams,0.0,12,0,136,8,16,0.5,1,1,1.0,7,15,0.889,0.53125,6,15,0.4,12,30,42,7,2,7,13,27,23
Mikh McKinney,25.0,31,8,601,64,163,0.39263803681,15,56,0.267857142857,49,107,0.458,0.438650306748,25,34,0.735294117647,10,47,57,78,15,3,39,53,168
Mikki Moore,129.0,100,93,3187,526,981,0.53618756371,8,34,0.235294117647,518,947,2.153,0.540265035678,373,480,0.777083333333,193,586,779,196,56,132,284,380,1433
Mildon Ambres,0.0,113,36,2524,481,1119,0.429848078642,97,272,0.356617647059,384,847,1.342,0.473190348525,148,206,0.718446601942,238,436,674,131,66,56,155,325,1207
Mile Ilic,22.0,9,6,152,19,37,0.513513513514,0,0,0.0,19,37,0.514,0.513513513514,9,11,0.818181818182,9,27,36,6,1,15,22,21,47
Miles Plumlee,24.0,15,12,457,75,164,0.457317073171,0,0,0.0,75,164,0.457,0.457317073171,18,36,0.5,54,99,153,18,12,28,37,36,168
Milone Clark,120.0,77,8,1053,126,275,0.458181818182,5,18,0.277777777778,121,257,2.971,0.467272727273,53,66,0.80303030303,50,106,156,40,22,7,87,90,310
Milos Milisavljevic,21.0,21,1,270,34,86,0.395348837209,11,40,0.275,23,46,0.5,0.459302325581,23,25,0.92,7,23,30,30,5,2,28,29,102
Mitch Johnson,0.0,7,0,60,2,13,0.153846153846,0,1,0.0,2,12,0.167,0.153846153846,6,8,0.75,0,6,6,7,1,0,5,9,10
Mitch McGary,45.0,34,15,841,213,457,0.466083150985,11,49,0.224489795918,202,408,0.996,0.478118161926,75,107,0.700934579439,106,183,289,44,43,30,100,108,512
Mitchell Watt,25.0,9,0,130,17,45,0.377777777778,0,2,0.0,17,43,0.395,0.377777777778,8,18,0.444444444444,19,19,38,6,1,11,10,18,42
Mo Charlo,281.0,285,174,8171,1104,2416,0.456953642384,147,526,0.279467680608,957,1890,5.774,0.487375827815,766,992,0.772177419355,524,1093,1617,586,339,236,493,684,3121
Mohammed Abukar,0.0,62,4,1228,226,504,0.448412698413,74,182,0.406593406593,152,322,1.41,0.521825396825,120,148,0.810810810811,38,164,202,24,16,16,66,92,646
Montrezl Harrell,22.0,12,12,467,114,214,0.532710280374,12,50,0.24,102,164,0.622,0.560747663551,51,78,0.653846153846,38,73,111,40,12,29,34,43,291
Morris Almond,224.0,249,220,8957,1863,3740,0.498128342246,335,878,0.381548974943,1528,2862,4.85,0.542914438503,1451,1800,0.806111111111,271,804,1075,352,202,66,680,571,5512
Morro Dos Santos,66.0,26,8,334,30,80,0.375,0,0,0.0,30,80,0.804,0.375,8,8,1.0,14,44,58,16,10,20,18,52,68
Moses Ehambe,0.0,234,94,5899,1033,2391,0.432036804684,587,1337,0.43904263276,446,1054,2.714,0.554788791301,285,340,0.838235294118,81,538,619,211,135,22,227,346,2938
Mouhamed Sene,120.0,60,15,1483,246,466,0.527896995708,0,0,0.0,246,466,2.44,0.527896995708,133,233,0.570815450644,181,306,487,24,41,115,88,161,625
Mouhammad Faye,0.0,47,40,1194,171,380,0.45,83,214,0.38785046729,88,166,0.53,0.559210526316,61,82,0.743902439024,78,190,268,64,48,38,72,112,486
Moussa Seck,0.0,18,0,65,9,14,0.642857142857,0,0,0.0,9,14,0.643,0.642857142857,3,4,0.75,5,12,17,1,1,5,7,21,21
Mustafa Al-Sayyad,99.0,29,9,449,68,114,0.59649122807,2,4,0.5,66,110,2.521,0.605263157895,47,84,0.559523809524,36,56,92,16,6,12,45,57,185
Mustafa Shakur,166.0,157,155,5652,988,2059,0.47984458475,160,475,0.336842105263,828,1584,3.107,0.51869839728,639,824,0.775485436893,160,542,702,973,310,44,459,438,2775
Mustapha Farrakhan,146.0,124,29,2234,338,891,0.379349046016,92,282,0.326241134752,246,609,2.471,0.430976430976,195,282,0.691489361702,49,190,239,256,66,19,188,164,963
Mychal Ammons,24.0,14,0,187,13,41,0.317073170732,0,3,0.0,13,38,0.342,0.317073170732,5,6,0.833333333333,21,30,51,12,7,1,15,35,31
Mychel Thompson,201.0,254,152,7081,963,2444,0.394026186579,403,1161,0.347114556417,560,1283,3.233,0.47647299509,383,541,0.707948243993,157,657,814,463,280,140,317,529,2712
Myck Kabongo,115.0,124,83,3199,354,839,0.421930870083,51,187,0.272727272727,303,652,2.244,0.452324195471,264,407,0.648648648649,68,366,434,471,132,6,232,265,1023
Myke Henry,24.0,38,0,461,46,121,0.380165289256,12,52,0.230769230769,34,69,0.493,0.429752066116,30,37,0.810810810811,15,52,67,22,26,8,27,59,134
Myles McKay,0.0,10,8,262,34,93,0.365591397849,4,17,0.235294117647,30,76,0.395,0.387096774194,26,31,0.838709677419,12,23,35,22,10,2,18,18,98
Myron Allen,53.0,76,17,1762,269,554,0.485559566787,44,123,0.357723577236,225,431,1.039,0.525270758123,221,288,0.767361111111,56,113,169,208,83,8,216,198,803
Naadir Tharpe,48.0,15,6,277,34,85,0.4,10,33,0.30303030303,24,52,0.689,0.458823529412,7,10,0.7,2,25,27,53,7,1,35,25,85
Nando De Colo,51.0,11,11,403,86,178,0.483146067416,16,58,0.275862068966,70,120,1.087,0.52808988764,44,48,0.916666666667,14,52,66,69,28,2,43,31,232
Nate Brown,0.0,13,4,316,36,88,0.409090909091,11,40,0.275,25,48,0.521,0.471590909091,14,19,0.736842105263,7,30,37,62,10,0,31,22,97
Nate Burton,0.0,10,0,177,16,40,0.4,0,0,0.0,16,40,0.4,0.4,14,16,0.875,3,9,12,9,4,1,9,19,46
Nate Daniels,22.0,16,0,181,20,64,0.3125,11,40,0.275,9,24,0.375,0.3984375,7,9,0.777777777778,5,14,19,12,3,2,8,30,58
Nate Gerwig,0.0,40,15,698,58,119,0.487394957983,0,2,0.0,58,117,0.496,0.487394957983,27,55,0.490909090909,88,147,235,24,13,7,43,114,143
Nate Green,49.0,72,66,1917,205,547,0.374771480804,54,168,0.321428571429,151,379,0.8,0.424131627057,157,226,0.694690265487,26,235,261,332,83,22,133,155,621
Nate Johnson,49.0,100,68,2794,605,1326,0.456259426848,43,126,0.34126984127,562,1200,0.932,0.472473604827,401,534,0.750936329588,136,345,481,236,126,58,253,275,1654
Nate Linhart,0.0,47,41,1566,189,410,0.460975609756,56,152,0.368421052632,133,258,0.516,0.529268292683,61,82,0.743902439024,66,205,271,136,80,28,94,121,495
Nate Robinson,0.0,17,2,440,72,168,0.428571428571,26,62,0.41935483871,46,106,0.434,0.505952380952,37,48,0.770833333333,10,29,39,72,30,3,32,44,207
Nate Wolters,23.0,12,8,378,79,158,0.5,5,17,0.294117647059,74,141,0.525,0.51582278481,20,29,0.689655172414,17,47,64,86,12,4,23,23,183
Nathan Jawai,45.0,18,9,421,64,126,0.507936507937,0,0,0.0,64,126,0.978,0.507936507937,61,82,0.743902439024,36,71,107,26,5,15,42,62,189
Ndudi Ebi,43.0,36,26,872,188,396,0.474747474747,2,13,0.153846153846,186,383,0.99,0.477272727273,61,86,0.709302325581,93,133,226,26,27,65,54,125,439
Negus Webster-Chan,24.0,23,6,281,25,75,0.333333333333,14,50,0.28,11,25,0.44,0.426666666667,6,8,0.75,4,45,49,26,11,5,14,24,70
Neil Edwards,0.0,55,25,1017,93,241,0.385892116183,0,2,0.0,93,239,0.389,0.385892116183,46,77,0.597402597403,84,168,252,18,13,103,43,153,232
Neil Yanke,26.0,33,0,547,53,122,0.434426229508,0,0,0.0,53,122,0.434,0.434426229508,26,46,0.565217391304,37,101,138,12,6,11,21,84,132
Nemanja Nedovic,22.0,15,11,427,78,195,0.4,26,87,0.298850574713,52,108,0.481,0.466666666667,42,49,0.857142857143,4,34,38,63,14,4,43,39,224
Nick Billings,96.0,62,0,532,48,120,0.4,0,0,0.0,48,120,1.858,0.4,24,50,0.48,46,74,120,6,10,50,40,128,120
Nick Covington,220.0,127,57,2892,372,937,0.397011739594,159,439,0.362186788155,213,498,3.503,0.481856990395,150,184,0.815217391304,50,255,305,349,115,8,220,263,1053
Nick Fazekas,73.0,46,38,1340,343,621,0.552334943639,4,22,0.181818181818,339,599,1.703,0.555555555556,132,182,0.725274725275,130,286,416,66,40,38,93,103,822
Nick Johnson,45.0,54,43,1659,257,624,0.411858974359,56,185,0.302702702703,201,439,0.922,0.456730769231,149,194,0.768041237113,43,191,234,202,60,24,161,169,719
Nick Lewis,120.0,167,106,4608,746,1568,0.475765306122,104,317,0.328075709779,642,1251,2.515,0.508928571429,459,572,0.802447552448,315,748,1063,187,54,107,279,425,2055
Nick Minnerath,27.0,49,10,1459,320,630,0.507936507937,84,209,0.401913875598,236,421,0.561,0.574603174603,182,205,0.887804878049,73,264,337,37,29,8,87,153,906
Nick Murphy,0.0,98,28,2149,303,648,0.467592592593,11,38,0.289473684211,292,610,1.401,0.476080246914,215,285,0.754385964912,109,280,389,173,121,20,138,216,832
Nick Neumann,0.0,1,0,1,1,1,1.0,0,0,0.0,1,1,1.0,1.0,0,0,0.0,0,0,0,0,0,0,0,0,2
Nick Sheppard,135.0,147,23,2426,311,751,0.414114513981,0,1,0.0,311,750,2.038,0.414114513981,151,282,0.535460992908,169,428,597,117,46,21,237,437,773
Nick Vander Laan,27.0,5,4,156,25,42,0.595238095238,0,0,0.0,25,42,0.595,0.595238095238,13,18,0.722222222222,20,42,62,7,4,3,15,24,63
Nick Wiggins,47.0,38,17,771,120,294,0.408163265306,33,111,0.297297297297,87,183,0.864,0.464285714286,40,59,0.677966101695,19,55,74,30,13,4,34,37,313
Nick Zeisloft,24.0,47,1,694,112,282,0.397163120567,90,228,0.394736842105,22,54,0.407,0.556737588652,32,39,0.820512820513,14,44,58,18,15,7,17,43,346
Nicolas Brussino,23.0,5,5,179,27,43,0.627906976744,13,25,0.52,14,18,0.778,0.779069767442,16,19,0.842105263158,8,30,38,24,8,6,9,12,83
Nigel Dixon,51.0,7,4,122,14,34,0.411764705882,1,3,0.333333333333,13,31,0.841,0.426470588235,17,36,0.472222222222,9,26,35,2,3,2,23,31,46
Nigel Spikes,26.0,39,0,431,67,111,0.603603603604,1,2,0.5,66,109,0.606,0.608108108108,42,90,0.466666666667,46,74,120,20,11,42,27,69,177
Nik Caner-Medley,0.0,6,6,253,49,115,0.426086956522,6,19,0.315789473684,43,96,0.448,0.452173913043,28,38,0.736842105263,24,45,69,19,18,6,18,16,132
Nik Raivio,0.0,21,10,382,36,92,0.391304347826,15,33,0.454545454545,21,59,0.356,0.472826086957,22,34,0.647058823529,20,38,58,44,15,1,26,40,109
Nikola Jovanovic,69.0,72,28,1242,246,514,0.47859922179,10,22,0.454545454545,236,492,1.437,0.488326848249,160,240,0.666666666667,174,300,474,42,20,20,76,150,662
Nkem Ojougboh,0.0,66,9,1206,133,277,0.480144404332,0,3,0.0,133,274,0.966,0.480144404332,70,104,0.673076923077,87,218,305,57,30,88,77,146,336
Nnanna Egwu,23.0,50,50,1588,212,438,0.48401826484,0,0,0.0,212,438,0.484,0.48401826484,34,45,0.755555555556,121,238,359,71,38,66,81,154,458
Noah Vonleh,19.0,2,0,27,6,17,0.352941176471,2,3,0.666666666667,4,14,0.286,0.411764705882,0,0,0.0,4,5,9,1,3,2,4,6,14
Noel Felix,137.0,118,77,2944,453,1010,0.448514851485,11,26,0.423076923077,442,984,2.27,0.45396039604,278,331,0.839879154079,221,422,643,139,63,115,275,422,1195
Nolan Richardson,0.0,2,0,6,0,1,0.0,0,0,0.0,0,1,0.0,0.0,0,0,0.0,0,0,0,0,0,0,0,0,0
Nolan Smith,50.0,11,8,309,60,136,0.441176470588,7,25,0.28,53,111,0.932,0.466911764706,17,23,0.739130434783,10,29,39,41,12,0,26,25,144
Norm Richardson,49.0,30,5,655,97,245,0.395918367347,33,78,0.423076923077,64,167,0.795,0.463265306122,76,104,0.730769230769,19,65,84,37,10,6,39,54,303
Norman Powell,22.0,8,8,317,76,152,0.5,8,24,0.333333333333,68,128,0.531,0.526315789474,39,49,0.795918367347,6,35,41,37,17,2,33,30,199
Norvel Pelle,41.0,39,6,499,87,164,0.530487804878,0,3,0.0,87,161,1.273,0.530487804878,41,65,0.630769230769,38,81,119,7,15,58,44,110,215
O'Neal Mims,0.0,12,0,181,14,32,0.4375,1,1,1.0,13,31,0.419,0.453125,4,9,0.444444444444,18,30,48,11,3,11,15,26,33
Obi Muonelo,0.0,22,0,264,35,98,0.357142857143,13,38,0.342105263158,22,60,0.852,0.423469387755,14,18,0.777777777778,12,27,39,13,5,2,8,20,97
Obinna Ekezie,29.0,11,0,278,47,105,0.447619047619,0,1,0.0,47,104,0.452,0.447619047619,45,67,0.671641791045,22,52,74,19,7,4,29,38,139
Ognjen Kuzmic,47.0,57,48,1607,228,461,0.494577006508,0,2,0.0,228,459,0.994,0.494577006508,104,147,0.707482993197,245,431,676,72,38,102,89,181,560
Okaro White,24.0,23,23,759,144,328,0.439024390244,38,126,0.301587301587,106,202,0.525,0.496951219512,98,114,0.859649122807,58,143,201,40,25,13,72,93,424
Oliver Lafayette,75.0,105,82,3528,568,1370,0.414598540146,173,496,0.348790322581,395,874,1.336,0.477737226277,346,431,0.802784222738,86,373,459,526,187,12,268,297,1655
Olu Famutimi,43.0,92,40,1923,319,656,0.486280487805,6,29,0.206896551724,313,627,1.012,0.490853658537,199,249,0.799196787149,114,256,370,114,88,40,134,201,843
Omar Cook,86.0,153,89,4862,552,1455,0.379381443299,90,278,0.323741007194,462,1177,1.556,0.410309278351,356,479,0.743215031315,97,371,468,1135,286,12,443,409,1550
Omar Reed,76.0,68,1,1108,150,299,0.501672240803,40,120,0.333333333333,110,179,1.67,0.56856187291,45,71,0.633802816901,114,177,291,71,54,11,61,75,385
Omar Samhan,26.0,18,6,219,18,56,0.321428571429,2,9,0.222222222222,16,47,0.34,0.339285714286,4,6,0.666666666667,28,20,48,7,9,6,12,38,42
Omar Thomas,23.0,10,0,183,30,64,0.46875,2,6,0.333333333333,28,58,0.483,0.484375,25,32,0.78125,16,13,29,4,4,4,10,20,87
Omari Johnson,51.0,99,62,2805,571,1281,0.445745511319,296,752,0.393617021277,275,529,1.04,0.561280249805,107,164,0.65243902439,158,497,655,134,68,78,121,244,1545
Orien Greene,174.0,212,169,6681,949,2208,0.429800724638,291,838,0.347255369928,658,1370,2.792,0.495697463768,538,761,0.706964520368,207,697,904,790,431,80,618,789,2727
Orion Outerbridge,0.0,32,0,318,46,80,0.575,0,2,0.0,46,78,1.911,0.575,22,38,0.578947368421,28,52,80,12,4,16,20,32,114
Orlando Johnson,125.0,93,79,3084,535,1167,0.458440445587,116,317,0.365930599369,419,850,2.275,0.508140531277,385,490,0.785714285714,111,381,492,265,85,36,210,201,1571
Orlando Sanchez,26.0,33,26,822,121,290,0.41724137931,15,49,0.30612244898,106,241,0.44,0.443103448276,44,69,0.63768115942,68,139,207,38,25,23,59,108,301
Oscar Bellfield,0.0,10,0,186,27,70,0.385714285714,10,24,0.416666666667,17,46,0.37,0.457142857143,7,8,0.875,5,15,20,24,9,2,17,15,71
Osiris Eldridge,0.0,42,20,1072,231,521,0.443378119002,57,190,0.3,174,331,0.526,0.498080614203,116,154,0.753246753247,40,108,148,131,56,12,100,91,635
Osiris Ricardo,24.0,22,14,249,19,47,0.404255319149,0,0,0.0,19,47,0.404,0.404255319149,9,18,0.5,14,36,50,8,9,7,28,49,47
Othella Harrington,35.0,3,0,42,2,7,0.285714285714,0,0,0.0,2,7,0.286,0.285714285714,2,3,0.666666666667,4,6,10,3,1,2,8,9,6
Othello Hunter,22.0,3,2,98,12,37,0.324324324324,0,0,0.0,12,37,0.324,0.324324324324,1,6,0.166666666667,14,16,30,2,4,4,5,10,25
Othyus Jeffers,127.0,185,160,6621,1272,2535,0.501775147929,59,195,0.302564102564,1213,2340,2.578,0.513412228797,906,1243,0.728881737731,453,1077,1530,572,359,44,505,450,3509
Otis George,52.0,96,41,2170,337,642,0.52492211838,1,4,0.25,336,638,1.057,0.525700934579,183,264,0.693181818182,230,329,559,77,76,37,113,310,858
Ousmane Cisse,22.0,48,33,1238,136,286,0.475524475524,0,0,0.0,136,286,0.476,0.475524475524,90,143,0.629370629371,141,203,344,18,25,85,65,165,362
P.J. Tucker,21.0,19,12,459,84,178,0.47191011236,2,7,0.285714285714,82,171,0.48,0.477528089888,33,39,0.846153846154,26,38,64,39,13,4,30,38,203
PJ Hairston,45.0,36,19,1071,219,516,0.424418604651,90,277,0.324909747292,129,239,1.037,0.511627906977,156,180,0.866666666667,34,79,113,37,53,12,63,100,684
Pape Sow,24.0,18,14,607,117,224,0.522321428571,0,0,0.0,117,224,0.522,0.522321428571,120,151,0.794701986755,65,143,208,12,25,21,63,83,354
Pape Sy,22.0,23,11,506,56,132,0.424242424242,3,20,0.15,53,112,0.473,0.435606060606,70,95,0.736842105263,20,59,79,29,7,1,42,54,185
Paris Bass,0.0,15,0,178,23,68,0.338235294118,6,15,0.4,17,53,0.321,0.382352941176,6,14,0.428571428571,16,25,41,12,3,10,16,25,58
Parrish Petty,0.0,2,0,7,0,2,0.0,0,2,0.0,0,0,0.0,0.0,0,0,0.0,0,0,0,0,0,0,2,2,0
Pascal Siakam,0.0,5,5,145,36,66,0.545454545455,6,12,0.5,30,54,0.556,0.590909090909,13,20,0.65,14,29,43,13,11,8,10,12,91
Pat Carroll,0.0,50,50,1465,205,451,0.454545454545,75,177,0.423728813559,130,274,0.474,0.537694013304,60,73,0.821917808219,43,116,159,65,46,9,54,119,545
Patricio Garino,23.0,49,46,1429,202,432,0.467592592593,58,135,0.42962962963,144,297,0.485,0.534722222222,86,112,0.767857142857,19,149,168,101,73,34,115,131,548
Patrick Beverley,24.0,3,3,112,14,41,0.341463414634,7,19,0.368421052632,7,22,0.318,0.426829268293,6,6,1.0,4,16,20,21,6,1,11,10,41
Patrick Christopher,78.0,77,73,2566,401,811,0.494451294698,131,315,0.415873015873,270,496,1.563,0.575215782984,155,182,0.851648351648,60,216,276,173,66,9,115,183,1088
Patrick Doctor,23.0,3,0,65,8,20,0.4,0,0,0.0,8,20,0.4,0.4,15,19,0.789473684211,7,7,14,0,2,0,5,14,31
Patrick Ewing,183.0,188,135,5927,936,2128,0.43984962406,132,433,0.304849884527,804,1695,3.31,0.470864661654,759,947,0.801478352693,364,1089,1453,530,254,176,460,646,2763
Patrick Fields,0.0,1,0,7,0,1,0.0,0,0,0.0,0,1,0.0,0.0,0,2,0.0,0,0,0,0,2,0,0,1,0
Patrick McCaw,21.0,2,2,71,9,26,0.346153846154,2,10,0.2,7,16,0.438,0.384615384615,5,6,0.833333333333,0,8,8,9,2,2,5,4,25
Patrick Miller,95.0,141,67,4184,735,1540,0.477272727273,86,248,0.346774193548,649,1292,2.013,0.505194805195,505,672,0.751488095238,132,326,458,653,184,48,279,297,2061
Patrick Mills,21.0,5,2,176,42,96,0.4375,21,42,0.5,21,54,0.389,0.546875,23,27,0.851851851852,3,6,9,27,8,0,13,20,128
Patrick Mutombo,0.0,29,6,642,65,155,0.41935483871,21,59,0.35593220339,44,96,1.429,0.487096774194,9,11,0.818181818182,17,59,76,24,13,3,16,53,160
Patrick O'Bryant,91.0,68,56,1807,329,628,0.523885350318,3,11,0.272727272727,326,617,2.229,0.52627388535,127,168,0.755952380952,140,430,570,95,47,161,144,233,788
Patrick Patterson,21.0,9,9,315,61,110,0.554545454545,1,7,0.142857142857,60,103,0.583,0.559090909091,42,56,0.75,28,65,93,10,14,14,17,29,165
Patrick Sanders,0.0,46,36,1301,197,488,0.40368852459,61,149,0.409395973154,136,339,0.628,0.46618852459,123,159,0.77358490566,38,112,150,60,29,31,78,105,578
Patrick Simon,24.0,2,0,9,1,8,0.125,1,7,0.142857142857,0,1,0.0,0.1875,0,0,0.0,0,0,0,0,0,0,0,2,3
Patrick Sullivan,0.0,97,23,2169,375,701,0.534950071327,5,10,0.5,370,691,1.079,0.538516405136,117,174,0.672413793103,164,360,524,106,48,113,158,272,872
Paul Butorac,0.0,3,0,17,1,3,0.333333333333,0,0,0.0,1,3,0.333,0.333333333333,0,0,0.0,0,0,0,2,0,0,2,5,2
Paul Carter,0.0,98,25,1803,230,588,0.391156462585,46,156,0.294871794872,184,432,1.503,0.430272108844,168,216,0.777777777778,118,284,402,120,58,46,107,227,674
Paul Davis,25.0,16,14,456,92,198,0.464646464646,0,2,0.0,92,196,0.469,0.464646464646,56,62,0.903225806452,53,88,141,31,19,26,32,61,240
Paul Graham,31.0,1,0,6,0,2,0.0,0,1,0.0,0,1,0.0,0.0,1,2,0.5,0,1,1,3,0,0,0,0,1
Paul Grant,57.0,75,52,1770,335,735,0.455782312925,2,15,0.133333333333,333,720,0.925,0.457142857143,136,191,0.712041884817,132,269,401,47,22,61,123,207,808
Paul Harris,0.0,121,54,3348,631,1320,0.47803030303,34,127,0.267716535433,597,1193,2.555,0.490909090909,389,559,0.695885509839,246,631,877,234,134,87,223,327,1685
Paul Jesperson,24.0,1,0,2,0,1,0.0,0,1,0.0,0,0,0.0,0.0,0,0,0.0,0,0,0,0,0,0,0,0,0
Paul Sturgess,0.0,13,0,41,3,8,0.375,0,0,0.0,3,8,0.375,0.375,5,8,0.625,3,8,11,1,0,0,4,5,11
Paul Zipser,22.0,3,3,106,14,40,0.35,4,11,0.363636363636,10,29,0.345,0.4,14,17,0.823529411765,11,18,29,7,1,4,11,10,46
Pavel Podkolzin,21.0,11,9,207,28,55,0.509090909091,0,0,0.0,28,55,0.509,0.509090909091,17,26,0.653846153846,28,36,64,6,4,8,17,41,73
Pe'Shon Howard,26.0,40,6,736,115,276,0.416666666667,49,130,0.376923076923,66,146,0.452,0.505434782609,67,79,0.848101265823,9,72,81,51,35,4,40,47,346
Pendarvis Williams,25.0,10,0,63,3,9,0.333333333333,0,5,0.0,3,4,0.75,0.333333333333,0,0,0.0,3,8,11,6,3,1,2,7,6
Perrin Johnson,0.0,47,2,681,72,163,0.441717791411,6,27,0.222222222222,66,136,1.031,0.460122699387,21,37,0.567567567568,35,60,95,38,10,23,54,109,171
Perry Ellis,23.0,50,12,1122,179,395,0.453164556962,41,109,0.376146788991,138,286,0.483,0.505063291139,90,117,0.769230769231,80,157,237,46,29,8,38,74,489
Perry Jones,70.0,44,33,1175,176,458,0.384279475983,30,124,0.241935483871,146,334,1.268,0.417030567686,64,94,0.68085106383,38,179,217,76,29,21,64,77,446
Perry Stevenson,0.0,2,0,33,1,2,0.5,0,0,0.0,1,2,0.5,0.5,1,1,1.0,2,5,7,1,0,1,3,5,3
Pete Campbell,0.0,7,0,99,19,45,0.422222222222,8,23,0.347826086957,11,22,0.5,0.511111111111,1,2,0.5,1,9,10,7,3,0,4,9,47
Peter Cornell,26.0,35,26,877,123,207,0.594202898551,0,0,0.0,123,207,0.594,0.594202898551,61,122,0.5,74,135,209,25,21,44,98,132,307
Peter John Ramos,41.0,76,73,2218,450,784,0.573979591837,0,1,0.0,450,783,1.144,0.573979591837,175,289,0.60553633218,139,402,541,80,23,123,236,283,1075
Peyton Siva,47.0,48,45,1416,214,488,0.438524590164,76,200,0.38,138,288,0.875,0.516393442623,138,177,0.779661016949,16,133,149,299,78,4,129,154,642
Phil Jones,0.0,11,0,99,11,18,0.611111111111,0,0,0.0,11,18,0.611,0.611111111111,5,8,0.625,7,10,17,4,0,6,6,21,27
Phil Pressey,72.0,78,71,2678,449,1103,0.407071622847,159,479,0.331941544885,290,624,1.444,0.479147778785,231,308,0.75,61,328,389,593,163,17,275,170,1288
Philip Ricci,23.0,45,44,1243,247,470,0.525531914894,1,7,0.142857142857,246,463,0.531,0.526595744681,137,190,0.721052631579,92,151,243,59,28,29,90,119,632
Pierce Caldwell,0.0,8,0,53,5,15,0.333333333333,2,10,0.2,3,5,0.6,0.4,5,5,1.0,1,6,7,11,3,0,6,5,17
Pierre Henderson-Niles,55.0,47,8,603,75,133,0.563909774436,0,0,0.0,75,133,1.07,0.563909774436,16,34,0.470588235294,46,96,142,11,21,15,35,106,166
Pierre Jackson,71.0,67,55,2454,549,1194,0.459798994975,169,479,0.352818371608,380,715,1.534,0.530569514238,340,435,0.781609195402,46,207,253,429,116,10,234,170,1607
Pooh Jeter,23.0,50,50,1655,259,533,0.485928705441,10,38,0.263157894737,249,495,0.503,0.49530956848,193,218,0.885321100917,37,115,152,355,67,1,137,112,721
Pops Mensah-Bonsu,48.0,34,31,1115,230,400,0.575,0,2,0.0,230,398,1.178,0.575,165,260,0.634615384615,155,220,375,34,32,53,104,137,625
Preston Knowles,0.0,31,0,519,87,230,0.378260869565,39,130,0.3,48,100,0.48,0.463043478261,13,17,0.764705882353,21,50,71,34,34,3,21,58,226
Prince Ibeh,0.0,10,0,101,4,19,0.210526315789,0,0,0.0,4,19,0.211,0.210526315789,3,5,0.6,11,9,20,1,1,9,8,23,11
Prince Williams,24.0,24,1,200,28,63,0.444444444444,11,29,0.379310344828,17,34,0.5,0.531746031746,5,9,0.555555555556,4,10,14,12,6,0,17,11,72
Quan Prowell,30.0,15,7,350,50,100,0.5,8,35,0.228571428571,42,65,0.646,0.54,5,6,0.833333333333,17,59,76,19,8,7,13,50,113
Quannas White,52.0,53,26,1240,100,231,0.4329004329,11,43,0.255813953488,89,188,1.041,0.45670995671,36,58,0.620689655172,47,93,140,185,46,5,82,148,247
Quemont Greer,76.0,72,45,1844,396,847,0.467532467532,24,77,0.311688311688,372,770,1.439,0.481700118064,193,262,0.736641221374,123,267,390,114,57,17,140,164,1009
Quin Humphrey,0.0,99,49,2385,273,658,0.414893617021,76,222,0.342342342342,197,436,1.183,0.4726443769,91,121,0.752066115702,132,263,395,150,69,10,108,158,713
Quincy Acy,48.0,25,22,752,135,251,0.537848605578,17,49,0.34693877551,118,202,1.164,0.57171314741,89,120,0.741666666667,50,148,198,29,26,33,65,85,376
Quincy Douby,85.0,9,6,246,46,109,0.422018348624,13,42,0.309523809524,33,67,1.246,0.481651376147,35,40,0.875,3,18,21,17,18,6,9,25,140
Quincy Ford,24.0,26,15,505,41,120,0.341666666667,18,64,0.28125,23,56,0.411,0.416666666667,20,24,0.833333333333,21,96,117,38,24,10,24,46,120
Quincy Miller,86.0,59,34,1577,372,807,0.460966542751,99,282,0.351063829787,273,525,1.98,0.522304832714,274,320,0.85625,137,314,451,94,68,146,113,200,1117
Quinn Cook,45.0,82,75,2953,661,1403,0.471133285816,183,486,0.376543209877,478,917,1.041,0.53635067712,351,398,0.881909547739,51,276,327,493,95,4,241,183,1856
Quinn McDowell,0.0,22,4,288,27,68,0.397058823529,9,27,0.333333333333,18,41,0.439,0.463235294118,14,18,0.777777777778,14,32,46,11,10,1,12,32,77
Quinton Chievous,24.0,48,17,1165,167,310,0.538709677419,21,60,0.35,146,250,0.584,0.572580645161,62,122,0.508196721311,65,175,240,83,24,18,69,135,417
Quinton Doggett,24.0,8,7,146,23,44,0.522727272727,0,0,0.0,23,44,0.523,0.522727272727,11,19,0.578947368421,14,29,43,5,2,2,5,13,57
Quinton Ross,30.0,10,7,270,27,67,0.402985074627,7,13,0.538461538462,20,54,0.37,0.455223880597,16,21,0.761904761905,10,29,39,13,7,2,8,24,77
Qyntel Woods,25.0,7,0,106,25,52,0.480769230769,2,7,0.285714285714,23,45,0.511,0.5,9,12,0.75,4,11,15,4,1,2,14,13,61
R.J. Hunter,91.0,66,41,2036,363,947,0.383315733897,170,538,0.315985130112,193,409,1.858,0.473072861668,264,343,0.769679300292,35,148,183,216,85,37,137,211,1160
Ra'shad James,75.0,108,48,2518,580,1260,0.460317460317,127,413,0.307506053269,453,847,1.595,0.510714285714,272,386,0.704663212435,115,278,393,253,73,8,187,190,1559
Rafer Alston,61.0,10,5,248,40,90,0.444444444444,8,18,0.444444444444,32,72,0.451,0.488888888889,13,19,0.684210526316,6,20,26,64,10,0,23,20,101
Rahim Lockhart,24.0,56,29,1292,270,524,0.515267175573,0,4,0.0,270,520,0.519,0.515267175573,84,168,0.5,144,257,401,48,52,36,114,195,624
Rahlir Hollis-Jefferson,23.0,35,4,584,72,154,0.467532467532,9,32,0.28125,63,122,0.516,0.496753246753,30,54,0.555555555556,37,64,101,54,40,14,43,60,183
Rakeem Christmas,49.0,57,54,1650,277,586,0.472696245734,1,4,0.25,276,582,0.946,0.473549488055,196,272,0.720588235294,128,267,395,42,31,93,122,226,751
Ralph Sampson,74.0,103,48,1491,196,375,0.522666666667,6,19,0.315789473684,190,356,1.551,0.530666666667,65,99,0.656565656566,188,243,431,54,27,133,69,213,463
Ralston Turner,49.0,58,5,807,83,205,0.40487804878,60,144,0.416666666667,23,61,0.73,0.551219512195,23,35,0.657142857143,14,77,91,24,17,5,33,101,249
Ramel Curry,49.0,69,64,2288,446,946,0.471458773784,72,173,0.416184971098,374,773,0.972,0.509513742072,151,181,0.834254143646,72,169,241,194,72,9,153,104,1115
Ramel Lloyd,23.0,4,0,20,1,7,0.142857142857,0,2,0.0,1,5,0.2,0.142857142857,2,4,0.5,0,2,2,0,0,0,2,3,4
Ramon Dyer,0.0,116,53,2456,325,741,0.438596491228,38,141,0.269503546099,287,600,1.368,0.464237516869,90,152,0.592105263158,258,405,663,55,92,82,91,264,778
Ramon Galloway,25.0,21,9,555,75,193,0.388601036269,16,67,0.238805970149,59,126,0.468,0.430051813472,38,49,0.775510204082,11,48,59,68,23,2,47,39,204
Ramon Harris,239.0,323,125,7207,805,2132,0.377579737336,534,1450,0.368275862069,271,682,3.563,0.502814258912,296,503,0.588469184891,165,1253,1418,378,299,143,285,686,2440
Ramon Sessions,21.0,24,13,869,165,356,0.463483146067,4,12,0.333333333333,161,344,0.468,0.469101123596,168,220,0.763636363636,52,106,158,182,38,2,83,44,502
Ramone Moore,0.0,37,13,884,132,312,0.423076923077,51,132,0.386363636364,81,180,0.45,0.504807692308,24,29,0.827586206897,12,73,85,87,35,4,60,87,339
Randall Orr,89.0,101,16,1751,234,572,0.409090909091,2,10,0.2,232,562,1.699,0.410839160839,69,78,0.884615384615,118,292,410,44,35,80,87,140,539
Randy Livingston,63.0,89,85,3549,407,1000,0.407,141,424,0.332547169811,266,576,0.92,0.4775,319,367,0.869209809264,62,333,395,939,132,17,340,250,1274
Raphiael Putney,49.0,72,42,1741,357,789,0.45247148289,143,389,0.367609254499,214,400,1.072,0.54309252218,116,168,0.690476190476,102,349,451,101,63,131,141,216,973
Rashad Anderson,0.0,57,11,1324,235,554,0.424187725632,85,236,0.360169491525,150,318,1.925,0.500902527076,65,97,0.670103092784,30,153,183,44,44,9,78,92,620
Rashad McCants,54.0,14,5,343,85,161,0.527950310559,28,62,0.451612903226,57,99,1.12,0.614906832298,25,40,0.625,6,37,43,28,15,2,27,44,223
Rashad Phillips,23.0,53,27,1334,223,574,0.38850174216,89,249,0.357429718876,134,325,0.412,0.466027874564,128,148,0.864864864865,16,66,82,195,44,1,118,87,663
Rashad Vaughn,39.0,7,2,134,28,76,0.368421052632,8,33,0.242424242424,20,43,0.971,0.421052631579,5,11,0.454545454545,2,21,23,10,5,1,10,9,69
Rasheed Sulaimon,22.0,49,34,1649,234,534,0.438202247191,77,219,0.351598173516,157,315,0.498,0.510299625468,109,142,0.767605633803,31,158,189,158,63,5,93,138,654
Rashid Byrd,0.0,44,0,660,90,214,0.420560747664,0,0,0.0,90,214,1.402,0.420560747664,26,70,0.371428571429,70,90,160,12,10,50,60,124,206
Rasual Butler,33.0,31,23,1014,201,475,0.423157894737,60,173,0.346820809249,141,302,0.467,0.486315789474,90,107,0.841121495327,31,128,159,47,21,43,62,44,552
Rasul Salahuddin,27.0,9,2,203,27,72,0.375,6,18,0.333333333333,21,54,0.389,0.416666666667,32,41,0.780487804878,6,26,32,9,10,4,19,18,92
Raul Neto,24.0,1,1,34,6,11,0.545454545455,1,4,0.25,5,7,0.714,0.590909090909,1,1,1.0,1,8,9,12,1,0,0,5,14
Ravern Johnson,0.0,3,0,37,8,17,0.470588235294,0,2,0.0,8,15,0.533,0.470588235294,0,1,0.0,1,3,4,1,3,2,1,3,16
Rawle Marshall,23.0,21,17,637,116,251,0.462151394422,10,26,0.384615384615,106,225,0.471,0.482071713147,123,166,0.740963855422,29,60,89,29,29,22,41,48,365
Ray McCallum,71.0,59,58,2184,400,900,0.444444444444,63,186,0.338709677419,337,714,1.411,0.479444444444,187,245,0.763265306122,70,239,309,376,122,17,155,144,1050
Ray Reed,0.0,15,2,363,33,81,0.407407407407,0,2,0.0,33,79,0.418,0.407407407407,24,49,0.489795918367,7,29,36,60,18,7,31,30,90
Ray Reese,0.0,3,1,85,7,22,0.318181818182,3,7,0.428571428571,4,15,0.267,0.386363636364,1,2,0.5,2,8,10,7,2,0,3,6,18
Ray Tutt,0.0,47,38,1131,229,476,0.481092436975,21,63,0.333333333333,208,413,0.504,0.503151260504,81,109,0.743119266055,71,96,167,54,26,7,55,55,560
Raymond Sykes,0.0,96,61,2685,451,833,0.541416566627,0,1,0.0,451,832,1.098,0.541416566627,270,376,0.718085106383,228,294,522,83,55,137,181,287,1172
Raynell Brewer,0.0,1,0,8,0,1,0.0,0,0,0.0,0,1,0.0,0.0,1,2,0.5,0,0,0,0,1,1,0,1,1
Reece Gaines,59.0,51,35,1617,236,491,0.480651731161,62,149,0.41610738255,174,342,0.845,0.543788187373,143,179,0.798882681564,13,119,132,190,36,7,114,139,677
Reece Hampton,0.0,19,7,365,48,91,0.527472527473,5,19,0.263157894737,43,72,0.597,0.554945054945,0,3,0.0,24,59,83,15,12,12,18,58,101
Reed Rawlings,128.0,80,47,2080,361,738,0.489159891599,63,162,0.388888888889,298,576,2.596,0.531842818428,156,185,0.843243243243,48,156,204,111,92,30,81,170,941
Reeves Nelson,0.0,10,3,178,35,68,0.514705882353,1,3,0.333333333333,34,65,0.523,0.522058823529,15,23,0.652173913043,16,43,59,13,7,2,20,10,86
Reggie Buckner,0.0,4,0,49,8,12,0.666666666667,0,0,0.0,8,12,0.667,0.666666666667,2,3,0.666666666667,9,16,25,3,1,2,2,10,18
Reggie Bullock,47.0,5,5,177,45,81,0.555555555556,18,34,0.529411764706,27,47,1.535,0.666666666667,16,20,0.8,9,35,44,16,10,6,7,10,124
Reggie Elliott,30.0,8,0,146,19,41,0.463414634146,3,10,0.3,16,31,0.516,0.5,13,15,0.866666666667,5,17,22,14,9,1,24,22,54
Reggie Hamilton,0.0,24,3,434,64,172,0.372093023256,26,76,0.342105263158,38,96,0.804,0.447674418605,51,64,0.796875,13,27,40,55,25,1,51,59,205
Reggie Hearn,140.0,191,104,4777,629,1481,0.424713031735,368,926,0.397408207343,261,555,2.755,0.548953409858,234,301,0.777408637874,105,660,765,194,128,55,221,594,1860
Reggie Holmes,0.0,2,0,9,1,1,1.0,1,1,1.0,0,0,1.5,1.5,3,4,0.75,0,1,1,0,0,0,0,2,6
Reggie Jackson,43.0,4,4,155,43,82,0.524390243902,5,19,0.263157894737,38,63,1.138,0.55487804878,15,16,0.9375,3,26,29,33,1,0,10,9,106
Reggie Johnson,0.0,7,5,131,14,33,0.424242424242,0,0,0.0,14,33,0.424,0.424242424242,9,12,0.75,10,21,31,3,3,3,10,25,37
Reggie Moore,25.0,7,2,144,17,49,0.34693877551,7,21,0.333333333333,10,28,0.357,0.418367346939,13,15,0.866666666667,8,5,13,17,8,1,8,8,54
Reggie Williams,108.0,105,96,3793,811,1575,0.514920634921,235,580,0.405172413793,576,995,2.26,0.589523809524,343,440,0.779545454545,107,447,554,385,133,15,240,182,2200
Reggis Onwukamuche,24.0,36,16,571,29,64,0.453125,0,1,0.0,29,63,0.46,0.453125,20,43,0.46511627907,52,81,133,14,6,28,36,115,78
Reginald Larry,0.0,50,19,1059,151,279,0.541218637993,4,16,0.25,147,263,0.96,0.548387096774,53,86,0.616279069767,91,173,264,30,25,22,58,102,359
Remon Nelson,0.0,31,0,324,29,82,0.353658536585,11,36,0.305555555556,18,46,0.391,0.420731707317,17,28,0.607142857143,7,16,23,35,9,0,25,34,86
Renaldo Balkman,30.0,32,7,962,210,344,0.610465116279,8,29,0.275862068966,202,315,0.641,0.622093023256,83,129,0.643410852713,108,186,294,39,67,29,63,112,511
Renaldo Major,294.0,400,245,11555,1702,3392,0.501768867925,168,519,0.323699421965,1534,2873,5.246,0.526533018868,1486,1847,0.804547915539,538,1090,1628,761,502,292,452,969,5058
Renaldo Woolridge,24.0,37,10,513,45,121,0.371900826446,3,22,0.136363636364,42,99,0.424,0.384297520661,13,24,0.541666666667,37,98,135,7,10,5,17,50,106
Reuben Clayton,0.0,4,0,41,1,5,0.2,0,1,0.0,1,4,0.25,0.2,4,6,0.666666666667,0,3,3,1,1,0,2,5,6
Rich Melzer,56.0,16,0,365,52,128,0.40625,17,36,0.472222222222,35,92,1.156,0.47265625,25,37,0.675675675676,19,28,47,21,9,3,16,48,146
Richard Andrews,0.0,34,2,290,21,46,0.45652173913,1,7,0.142857142857,20,39,0.513,0.467391304348,21,34,0.617647058824,8,36,44,11,12,2,13,58,64
Richard Hendrix,0.0,92,92,2850,538,954,0.56394129979,14,28,0.5,524,926,1.651,0.571278825996,244,396,0.616161616162,280,770,1050,134,94,142,192,372,1334
Richard Howell,47.0,28,21,879,190,343,0.553935860058,1,5,0.2,189,338,1.071,0.555393586006,49,76,0.644736842105,97,153,250,60,35,18,62,77,430
Richard Roby,0.0,50,31,1392,290,617,0.470016207455,66,206,0.320388349515,224,411,0.545,0.523500810373,129,194,0.664948453608,67,160,227,102,65,31,137,131,775
Richard Solomon,22.0,28,1,503,94,152,0.618421052632,0,1,0.0,94,151,0.623,0.618421052632,50,80,0.625,71,122,193,4,17,15,35,86,238
Richaun Holmes,23.0,6,6,147,29,49,0.591836734694,1,6,0.166666666667,28,43,0.651,0.602040816327,14,19,0.736842105263,16,24,40,6,2,9,9,23,73
Richie Dalmau,87.0,28,0,402,54,128,0.421875,4,16,0.25,50,112,1.158,0.4375,38,52,0.730769230769,4,46,50,70,18,0,46,58,150
Richie Frahm,63.0,37,21,1294,213,436,0.488532110092,133,283,0.469964664311,80,153,1.136,0.641055045872,49,61,0.803278688525,16,115,131,99,42,11,43,69,608
Rick Apodaca,23.0,25,7,640,91,221,0.411764705882,23,59,0.389830508475,68,162,0.42,0.463800904977,62,73,0.849315068493,9,28,37,42,19,5,33,47,267
Rick Jackson,101.0,108,56,2545,436,810,0.538271604938,1,1,1.0,435,809,2.44,0.538888888889,94,172,0.546511627907,282,555,837,108,81,128,137,239,967
Rick Rickert,66.0,88,31,2009,332,683,0.486090775988,2,12,0.166666666667,330,671,1.451,0.487554904832,196,244,0.803278688525,218,300,518,73,50,31,112,224,862
Ricky Davis,66.0,51,38,1480,229,519,0.441233140655,53,140,0.378571428571,176,379,0.906,0.492292870906,106,129,0.821705426357,26,194,220,132,44,21,103,126,617
Ricky Ledo,66.0,115,98,3536,715,1638,0.436507936508,200,557,0.359066427289,515,1081,1.445,0.497557997558,345,444,0.777027027027,156,501,657,362,128,27,258,270,1975
Ricky Minard,22.0,17,17,514,108,270,0.4,3,6,0.5,105,264,0.398,0.405555555556,63,91,0.692307692308,13,60,73,53,19,9,37,32,282
Ricky Moore,25.0,26,0,316,25,78,0.320512820513,5,24,0.208333333333,20,54,0.37,0.352564102564,5,10,0.5,6,26,32,22,16,0,18,22,60
Ricky Sanchez,39.0,75,22,1884,261,631,0.413629160063,139,360,0.386111111111,122,271,0.894,0.523771790808,100,139,0.719424460432,37,235,272,109,51,46,108,234,761
Ricky Shields,23.0,12,0,127,17,47,0.36170212766,5,11,0.454545454545,12,36,0.333,0.414893617021,3,6,0.5,5,5,10,8,2,0,5,8,42
Rico Cunningham,0.0,2,0,4,0,1,0.0,0,0,0.0,0,1,0.0,0.0,0,0,0.0,0,2,2,0,0,0,0,0,0
Rico Hill,26.0,13,9,319,49,104,0.471153846154,4,16,0.25,45,88,0.511,0.490384615385,18,22,0.818181818182,18,45,63,12,6,3,28,35,120
Rineo Vlijter,0.0,3,0,5,0,1,0.0,0,0,0.0,0,1,0.0,0.0,0,0,0.0,0,0,0,0,0,0,0,3,0
Rob Diggs,0.0,9,0,109,11,30,0.366666666667,0,3,0.0,11,27,0.407,0.366666666667,11,15,0.733333333333,6,23,29,1,1,6,12,12,33
Rob Griffin,0.0,9,1,129,29,59,0.491525423729,14,27,0.518518518519,15,32,0.469,0.610169491525,1,2,0.5,8,5,13,7,8,0,3,16,73
Rob Kurz,24.0,39,35,1447,234,474,0.493670886076,50,115,0.434782608696,184,359,0.513,0.54641350211,164,203,0.807881773399,126,269,395,89,32,57,90,138,682
Robert Conley,0.0,2,0,32,4,11,0.363636363636,1,4,0.25,3,7,0.429,0.409090909091,5,8,0.625,0,3,3,1,0,0,3,4,14
Robert Covington,23.0,42,41,1434,335,762,0.439632545932,133,359,0.370473537604,202,403,0.501,0.526902887139,172,204,0.843137254902,116,269,385,72,101,57,105,143,975
Robert Dryden,111.0,20,5,285,33,76,0.434210526316,0,0,0.0,33,76,1.762,0.434210526316,7,12,0.583333333333,17,41,58,17,4,17,24,54,73
Robert Hite,82.0,70,2,1609,239,584,0.409246575342,89,253,0.351778656126,150,331,1.347,0.485445205479,111,144,0.770833333333,58,165,223,126,72,14,83,150,678
Robert McKiver,0.0,12,0,62,4,22,0.181818181818,2,13,0.153846153846,2,9,0.222,0.227272727273,1,6,0.166666666667,0,7,7,3,2,0,8,6,11
Robert Sacre,23.0,7,7,229,29,66,0.439393939394,0,0,0.0,29,66,0.439,0.439393939394,22,24,0.916666666667,15,44,59,4,3,10,11,17,80
Robert Swift,24.0,2,2,50,1,7,0.142857142857,0,0,0.0,1,7,0.143,0.142857142857,3,4,0.75,2,10,12,1,0,3,6,7,5
Robert Upshaw,22.0,28,2,438,83,174,0.477011494253,2,10,0.2,81,164,0.494,0.48275862069,36,59,0.610169491525,32,94,126,10,6,40,34,71,204
Robert Vaden,231.0,195,79,4664,616,1490,0.413422818792,335,818,0.409535452323,281,672,3.292,0.525838926174,131,173,0.757225433526,36,385,421,334,150,40,210,452,1698
Robert Whaley,25.0,21,9,271,43,93,0.462365591398,0,0,0.0,43,93,0.462,0.462365591398,3,7,0.428571428571,18,42,60,14,7,7,20,59,89
Roberto Bergersen,0.0,104,62,2659,404,920,0.439130434783,194,498,0.389558232932,210,422,1.359,0.544565217391,86,112,0.767857142857,41,187,228,207,109,22,159,221,1088
Roberto Nelson,25.0,3,0,20,0,4,0.0,0,3,0.0,0,1,0.0,0.0,0,0,0.0,0,3,3,3,0,0,3,4,0
Rod Benson,186.0,274,121,7108,1192,2252,0.529307282416,0,2,0.0,1192,2250,4.191,0.529307282416,655,1015,0.645320197044,837,1407,2244,311,232,377,439,754,3039
Rod Grizzard,45.0,93,40,2141,326,779,0.418485237484,51,180,0.283333333333,275,599,0.909,0.451219512195,180,224,0.803571428571,74,267,341,158,64,37,130,187,883
Rod Wilmont,0.0,145,75,4252,596,1612,0.369727047146,223,726,0.307162534435,373,886,1.257,0.438895781638,308,421,0.731591448931,78,391,469,167,174,13,183,274,1723
Roderick Riley,155.0,193,80,4332,548,1137,0.481970096746,4,14,0.285714285714,544,1123,2.933,0.483729111697,517,728,0.710164835165,429,703,1132,108,66,96,369,630,1617
Rodney Bartholomew,0.0,90,28,1914,288,569,0.506151142355,4,16,0.25,284,553,1.027,0.509666080844,201,284,0.707746478873,232,341,573,91,63,25,135,258,781
Rodney Bias,72.0,128,59,3078,339,587,0.577512776831,0,2,0.0,339,585,1.723,0.577512776831,110,229,0.480349344978,531,751,1282,86,65,131,148,378,788
Rodney Carney,31.0,36,5,780,135,306,0.441176470588,69,185,0.372972972973,66,121,0.545,0.553921568627,26,36,0.722222222222,15,75,90,32,27,15,33,61,365
Rodney Cooper,23.0,3,0,13,0,1,0.0,0,1,0.0,0,0,0.0,0.0,0,0,0.0,1,3,4,1,1,0,1,1,0
Rodney McGruder,93.0,106,58,3134,512,1037,0.493731918997,139,376,0.369680851064,373,661,2.247,0.56075216972,137,203,0.674876847291,180,303,483,194,96,19,136,207,1300
Rodney Webb,0.0,92,28,1954,274,580,0.472413793103,2,6,0.333333333333,272,574,1.908,0.474137931034,110,162,0.679012345679,152,288,440,80,62,74,100,220,660
Rodney Williams,70.0,62,28,1252,151,327,0.461773700306,34,119,0.285714285714,117,208,1.782,0.51376146789,85,118,0.720338983051,22,107,129,63,34,33,60,130,421
Roger Powell,24.0,28,23,981,222,424,0.52358490566,23,71,0.323943661972,199,353,0.564,0.55070754717,157,204,0.769607843137,86,96,182,55,12,24,69,78,624
Rolan Roberts,25.0,46,37,1157,177,337,0.525222551929,0,3,0.0,177,334,0.53,0.525222551929,68,158,0.430379746835,101,179,280,34,40,55,83,157,422
Roman Brown,25.0,9,0,54,3,5,0.6,0,0,0.0,3,5,0.6,0.6,1,4,0.25,0,5,5,1,1,1,1,16,7
Romel Beck,0.0,58,47,1768,372,696,0.534482758621,102,223,0.457399103139,270,473,1.105,0.60775862069,158,181,0.872928176796,31,132,163,146,56,12,135,100,1004
Romero Osby,47.0,30,27,842,189,402,0.470149253731,39,106,0.367924528302,150,296,0.992,0.518656716418,86,141,0.609929078014,52,152,204,54,15,11,67,81,503
Ron Anderson,147.0,135,39,2580,336,711,0.472573839662,8,22,0.363636363636,328,689,2.894,0.478199718706,154,294,0.52380952381,271,327,598,118,74,62,119,333,834
Ron Baker,23.0,4,4,144,17,40,0.425,8,18,0.444444444444,9,22,0.409,0.525,8,14,0.571428571429,3,18,21,28,11,2,14,11,50
Ron Howard,0.0,247,218,8259,1532,3182,0.481458202388,68,210,0.32380952381,1464,2972,3.511,0.492143306097,1193,1483,0.804450438301,183,809,992,758,331,25,576,749,4325
Ron Kelley,0.0,16,4,139,17,40,0.425,0,0,0.0,17,40,0.425,0.425,8,14,0.571428571429,18,11,29,0,1,2,6,23,42
Ron Riley,29.0,21,3,276,39,98,0.397959183673,2,14,0.142857142857,37,84,0.44,0.408163265306,15,23,0.652173913043,14,20,34,23,16,5,33,34,95
Ron Rollerson,22.0,33,6,329,55,113,0.486725663717,0,0,0.0,55,113,0.487,0.486725663717,12,17,0.705882352941,35,63,98,8,5,14,25,65,122
Ron Slay,23.0,48,22,1451,305,587,0.519591141397,9,25,0.36,296,562,0.527,0.527257240204,200,258,0.77519379845,85,215,300,118,40,16,146,173,819
Ronald Allen,0.0,104,42,1750,250,565,0.442477876106,7,37,0.189189189189,243,528,3.202,0.448672566372,130,160,0.8125,101,255,356,34,30,23,98,256,637
Ronald Blackshear,53.0,23,0,314,70,164,0.426829268293,10,29,0.344827586207,60,135,0.654,0.457317073171,10,13,0.769230769231,4,14,18,6,7,2,20,23,160
Ronald Dupree,260.0,227,176,7540,1371,2860,0.479370629371,80,274,0.29197080292,1291,2586,4.573,0.493356643357,739,1050,0.70380952381,362,1140,1502,739,269,96,524,729,3561
Ronald Murray,66.0,49,41,1854,349,794,0.439546599496,128,339,0.377581120944,221,455,1.229,0.520151133501,212,276,0.768115942029,25,188,213,189,68,24,147,107,1038
Ronald Roberts,93.0,56,50,1771,404,616,0.655844155844,0,4,0.0,404,612,2.772,0.655844155844,187,299,0.625418060201,223,448,671,82,42,72,113,169,995
Ronell Taylor,24.0,50,35,1603,283,573,0.493891797557,15,45,0.333333333333,268,528,0.508,0.506980802792,125,163,0.766871165644,80,217,297,178,70,35,104,142,706
Ronnie Aguilar,52.0,12,0,124,12,31,0.387096774194,0,0,0.0,12,31,0.795,0.387096774194,3,13,0.230769230769,16,26,42,2,3,4,11,29,27
Ronnie Brewer,30.0,41,31,1028,132,305,0.432786885246,19,74,0.256756756757,113,231,0.489,0.46393442623,16,30,0.533333333333,33,156,189,80,54,21,39,50,299
Roosevelt Jones,24.0,46,35,1267,139,282,0.492907801418,4,22,0.181818181818,135,260,0.519,0.5,23,52,0.442307692308,107,186,293,142,66,11,57,109,305
Roscoe Smith,98.0,133,72,3556,679,1290,0.526356589147,25,105,0.238095238095,654,1185,2.21,0.536046511628,372,537,0.692737430168,352,594,946,72,102,85,211,307,1755
Royce White,43.0,20,12,508,75,174,0.431034482759,4,19,0.210526315789,71,155,0.851,0.442528735632,64,98,0.65306122449,27,81,108,64,20,13,47,70,218
Ruben Boumtje-Boumtje,26.0,38,18,972,100,228,0.438596491228,0,0,0.0,100,228,0.439,0.438596491228,63,87,0.724137931034,79,205,284,34,13,61,76,129,263
Rudy Gobert,21.0,8,8,216,40,54,0.740740740741,0,0,0.0,40,54,0.741,0.740740740741,31,44,0.704545454545,36,55,91,3,5,24,11,18,111
Russ Conley,23.0,3,0,11,1,4,0.25,0,0,0.0,1,4,0.25,0.25,1,2,0.5,2,1,3,0,0,0,1,2,3
Russ Smith,166.0,119,74,3873,913,1955,0.467007672634,185,572,0.323426573427,728,1383,3.718,0.514322250639,548,728,0.752747252747,117,405,522,708,240,20,441,389,2559
Russell Carter,0.0,27,9,492,76,185,0.410810810811,9,44,0.204545454545,67,141,1.423,0.435135135135,29,43,0.674418604651,32,56,88,28,24,3,28,66,190
Russell Hicks,0.0,4,0,21,0,3,0.0,0,0,0.0,0,3,0.0,0.0,0,0,0.0,1,2,3,0,1,1,1,4,0
Russell Robinson,124.0,147,121,4944,740,1665,0.444444444444,218,588,0.37074829932,522,1077,2.108,0.50990990991,459,565,0.812389380531,102,343,445,661,294,23,412,349,2157
Rusty LaRue,58.0,53,18,1399,205,458,0.447598253275,95,208,0.456730769231,110,250,0.881,0.551310043668,88,101,0.871287128713,22,104,126,132,60,6,89,97,593
Ryan Anderson,0.0,12,0,175,27,59,0.457627118644,15,31,0.483870967742,12,28,0.429,0.584745762712,17,18,0.944444444444,4,21,25,7,10,1,7,24,86
Ryan Arcidiacono,22.0,47,34,1293,108,229,0.471615720524,40,95,0.421052631579,68,134,0.507,0.558951965066,48,59,0.813559322034,24,152,176,177,41,5,76,97,304
Ryan Ayers,0.0,71,34,1695,216,474,0.455696202532,113,260,0.434615384615,103,214,0.922,0.574894514768,27,34,0.794117647059,45,172,217,71,53,25,49,111,572
Ryan Boatright,23.0,20,5,422,80,191,0.418848167539,15,55,0.272727272727,65,136,0.478,0.458115183246,47,54,0.87037037037,2,58,60,57,15,1,32,28,222
Ryan Bright,0.0,27,3,328,46,85,0.541176470588,12,26,0.461538461538,34,59,1.025,0.611764705882,6,19,0.315789473684,21,50,71,29,16,17,16,33,110
Ryan Carroll,23.0,25,0,380,40,95,0.421052631579,20,48,0.416666666667,20,47,0.426,0.526315789474,32,41,0.780487804878,13,37,50,15,13,5,24,46,132
Ryan Diggs,0.0,41,0,429,56,128,0.4375,7,31,0.225806451613,49,97,0.505,0.46484375,43,49,0.877551020408,12,30,42,57,15,0,33,43,162
Ryan Evans,0.0,33,17,712,108,282,0.382978723404,25,91,0.274725274725,83,191,0.435,0.427304964539,40,78,0.512820512821,48,97,145,34,24,20,44,78,281
Ryan Forehan-Kelly,0.0,81,55,2502,431,830,0.519277108434,128,269,0.475836431227,303,561,1.073,0.596385542169,149,182,0.818681318681,77,301,378,254,118,36,86,214,1139
Ryan Gomes,33.0,31,28,993,205,425,0.482352941176,48,129,0.372093023256,157,296,0.53,0.538823529412,107,125,0.856,71,180,251,97,27,12,36,91,565
Ryan Hollins,22.0,5,5,164,23,48,0.479166666667,0,0,0.0,23,48,0.479,0.479166666667,15,22,0.681818181818,21,31,52,3,2,10,16,19,61
Ryan Humphrey,29.0,36,25,1006,216,427,0.505854800937,0,2,0.0,216,425,0.508,0.505854800937,132,205,0.643902439024,90,175,265,49,29,35,119,95,564
Ryan Kelly,94.0,21,17,775,173,354,0.488700564972,34,100,0.34,139,254,2.184,0.536723163842,147,181,0.812154696133,31,141,172,65,22,39,45,68,527
Ryan Randle,24.0,33,8,668,96,188,0.510638297872,0,2,0.0,96,186,0.516,0.510638297872,60,84,0.714285714286,81,69,150,22,20,11,27,86,252
Ryan Reid,49.0,73,58,1866,273,538,0.507434944238,0,1,0.0,273,537,1.017,0.507434944238,158,215,0.73488372093,175,316,491,80,59,44,127,219,704
Ryan Rossiter,0.0,43,16,680,102,204,0.5,3,11,0.272727272727,99,193,0.513,0.507352941176,51,67,0.761194029851,77,112,189,29,20,17,59,111,258
Ryan Thompson,0.0,42,8,1030,181,357,0.50700280112,20,60,0.333333333333,161,297,0.542,0.535014005602,78,105,0.742857142857,34,84,118,56,36,8,44,64,460
Ryan Wittman,0.0,21,2,385,56,119,0.470588235294,37,80,0.4625,19,39,0.487,0.626050420168,1,1,1.0,6,43,49,9,10,5,9,27,150
Rysheed Jordan,21.0,11,0,181,29,79,0.367088607595,15,44,0.340909090909,14,35,0.4,0.462025316456,16,24,0.666666666667,5,8,13,17,9,1,21,27,89
Sadiel Rojas,0.0,130,46,3176,428,944,0.453389830508,84,240,0.35,344,704,1.456,0.497881355932,245,331,0.740181268882,324,570,894,116,180,43,166,371,1185
Sah-u-Ra Brown,111.0,134,33,1700,126,335,0.376119402985,0,3,0.0,126,332,1.911,0.376119402985,133,212,0.627358490566,124,174,298,19,41,37,103,241,385
Salah Mejri,29.0,8,2,191,30,53,0.566037735849,1,8,0.125,29,45,0.644,0.575471698113,7,8,0.875,12,50,62,5,5,23,15,32,68
Salim Stoudamire,84.0,84,12,1888,306,690,0.44347826087,66,190,0.347368421053,240,500,1.439,0.491304347826,152,174,0.873563218391,20,98,118,180,38,6,72,146,830
Sam Clancy,23.0,1,0,15,2,5,0.4,0,0,0.0,2,5,0.4,0.4,3,6,0.5,0,1,1,0,1,0,1,0,7
Sam Coleman,52.0,19,4,273,39,87,0.448275862069,18,46,0.391304347826,21,41,0.736,0.551724137931,17,32,0.53125,19,45,64,9,8,15,10,48,113
Sam Dekker,21.0,7,0,163,33,79,0.417721518987,9,38,0.236842105263,24,41,0.585,0.474683544304,8,12,0.666666666667,16,21,37,11,4,1,12,5,83
Sam Thompson,69.0,86,50,2366,270,588,0.459183673469,38,146,0.260273972603,232,442,1.526,0.491496598639,92,128,0.71875,72,188,260,104,82,18,98,152,670
Samardo Samuels,94.0,70,66,2567,516,1058,0.487712665406,0,4,0.0,516,1054,2.041,0.487712665406,343,545,0.629357798165,215,491,706,142,42,77,207,230,1375
Sammy Mejia,0.0,12,12,481,98,206,0.47572815534,6,24,0.25,92,182,0.505,0.490291262136,51,76,0.671052631579,44,64,108,32,16,6,38,25,253
Sammy Yeager,0.0,27,0,300,58,110,0.527272727273,25,47,0.531914893617,33,63,0.524,0.640909090909,19,27,0.703703703704,14,31,45,16,17,3,22,34,160
Sasha Cuic,0.0,64,8,1130,152,462,0.329004329004,22,102,0.21568627451,130,360,1.071,0.352813852814,90,118,0.762711864407,82,158,240,20,32,16,72,198,416
Satnam Singh,41.0,27,2,193,16,39,0.410256410256,0,0,0.0,16,39,0.766,0.410256410256,10,17,0.588235294118,14,24,38,3,3,2,13,43,42
Saul Smith,45.0,104,12,1350,146,412,0.354368932039,54,155,0.348387096774,92,257,0.718,0.419902912621,84,102,0.823529411765,22,120,142,178,56,8,83,125,430
Scoonie Penn,51.0,29,22,816,84,240,0.35,24,71,0.338028169014,60,169,0.608,0.4,68,87,0.781609195402,15,65,80,141,46,10,51,58,260
Scoop Jardine,0.0,23,1,448,78,189,0.412698412698,7,24,0.291666666667,71,165,0.43,0.431216931217,17,31,0.548387096774,11,43,54,104,21,1,53,42,180
Scooter McFadgon,49.0,70,48,2294,453,979,0.462717058223,13,58,0.224137931034,440,921,0.956,0.46935648621,260,296,0.878378378378,73,169,242,152,46,5,127,116,1179
Scott Burrell,31.0,6,5,141,12,45,0.266666666667,3,16,0.1875,9,29,0.31,0.3,6,7,0.857142857143,10,12,22,6,2,2,8,12,33
Scott Machado,135.0,110,30,2668,330,876,0.376712328767,82,280,0.292857142857,248,596,2.453,0.423515981735,268,330,0.812121212121,52,232,284,538,110,16,266,202,1010
Scott Merritt,148.0,174,130,4374,661,1366,0.483894582723,3,14,0.214285714286,658,1352,2.374,0.484992679356,384,503,0.763419483101,345,613,958,114,83,117,256,471,1709
Scott Suggs,50.0,97,84,3527,632,1381,0.457639391745,252,613,0.411092985318,380,768,0.993,0.548877624909,251,290,0.865517241379,46,305,351,194,88,16,212,227,1767
Scott VanderMeer,0.0,82,27,1164,153,370,0.413513513514,7,35,0.2,146,335,1.319,0.422972972973,78,120,0.65,139,190,329,46,29,118,68,164,391
Scott Wood,26.0,50,49,1512,217,487,0.445585215606,166,386,0.430051813472,51,101,0.505,0.616016427105,99,105,0.942857142857,12,197,209,59,37,8,51,100,699
Scottie Reynolds,0.0,46,45,1577,193,434,0.444700460829,47,142,0.330985915493,146,292,0.5,0.498847926267,168,201,0.835820895522,27,149,176,270,88,4,118,100,601
Scotty Hopson,25.0,43,35,1381,315,598,0.526755852843,56,160,0.35,259,438,0.591,0.573578595318,139,176,0.789772727273,45,156,201,144,45,15,114,107,825
Seamus Boxley,23.0,38,15,475,48,108,0.444444444444,0,6,0.0,48,102,0.471,0.444444444444,19,30,0.633333333333,21,42,63,21,13,5,20,29,115
Sean Banks,136.0,158,112,4548,891,1990,0.447738693467,178,568,0.31338028169,713,1422,3.057,0.492462311558,758,968,0.78305785124,211,452,663,398,99,71,453,325,2718
Sean Barnette,0.0,58,4,974,138,320,0.43125,22,68,0.323529411765,116,252,1.353,0.465625,76,90,0.844444444444,58,90,148,46,30,20,54,110,374
Sean Colson,27.0,9,7,253,44,101,0.435643564356,7,16,0.4375,37,85,0.435,0.470297029703,31,35,0.885714285714,14,17,31,44,4,1,30,18,126
Sean Daugherty,53.0,61,34,1147,159,396,0.401515151515,30,97,0.309278350515,129,299,0.971,0.439393939394,39,75,0.52,93,159,252,43,17,15,64,156,387
Sean Dockery,24.0,15,0,131,17,37,0.459459459459,0,3,0.0,17,34,0.5,0.459459459459,11,17,0.647058823529,2,7,9,15,11,0,13,21,45
Sean Evans,0.0,46,25,1132,231,457,0.505470459519,0,1,0.0,231,456,0.507,0.505470459519,102,176,0.579545454545,138,249,387,33,46,26,93,127,564
Sean Finn,92.0,88,4,1404,130,222,0.585585585586,0,0,0.0,130,222,2.351,0.585585585586,26,94,0.276595744681,90,220,310,18,14,48,52,216,286
Sean Kilpatrick,101.0,116,80,3534,695,1563,0.444657709533,256,694,0.368876080692,439,869,2.025,0.526551503519,316,382,0.82722513089,53,337,390,225,118,16,202,140,1962
Sean Marshall,51.0,70,20,1803,290,735,0.394557823129,75,248,0.302419354839,215,487,0.889,0.445578231293,129,176,0.732954545455,83,192,275,92,55,12,116,128,784
Sean Peterson,0.0,52,5,696,96,210,0.457142857143,15,43,0.348837209302,81,167,0.94,0.492857142857,37,51,0.725490196078,13,40,53,108,28,1,53,52,244
Sean Singletary,134.0,91,85,2771,353,836,0.422248803828,72,198,0.363636363636,281,638,2.348,0.465311004785,257,311,0.826366559486,57,272,329,431,155,12,219,262,1035
Sean Sonderleiter,0.0,123,37,2072,297,648,0.458333333333,0,1,0.0,297,647,2.396,0.458333333333,181,253,0.715415019763,195,298,493,93,66,41,157,318,775
Sean Williams,97.0,114,90,3266,531,1016,0.522637795276,13,35,0.371428571429,518,981,2.043,0.529035433071,304,428,0.710280373832,312,609,921,113,85,301,290,399,1379
Sedric Webber,78.0,122,98,3590,663,1509,0.439363817097,91,263,0.346007604563,572,1246,1.381,0.469516235918,420,536,0.783582089552,249,381,630,240,166,45,276,351,1837
Semaj Christon,46.0,48,44,1688,324,755,0.429139072848,13,51,0.254901960784,311,704,0.816,0.437748344371,228,290,0.786206896552,39,137,176,272,77,8,153,114,889
Serge Angounou,0.0,119,27,1842,194,469,0.413646055437,7,40,0.175,187,429,1.736,0.421108742004,146,183,0.79781420765,165,269,434,69,54,26,97,295,541
Sergei Monia,22.0,8,0,180,25,60,0.416666666667,4,14,0.285714285714,21,46,0.457,0.45,13,16,0.8125,8,19,27,13,5,5,10,32,67
Sergey Karasev,20.0,18,18,539,80,177,0.45197740113,37,89,0.415730337079,43,88,0.489,0.556497175141,46,55,0.836363636364,12,78,90,44,18,5,31,46,243
Sergio McClain,23.0,20,0,231,22,53,0.415094339623,0,2,0.0,22,51,0.431,0.415094339623,15,25,0.6,14,20,34,14,9,5,24,40,59
Sergio Sanchez,0.0,16,1,181,19,47,0.404255319149,8,25,0.32,11,22,0.5,0.489361702128,4,6,0.666666666667,2,4,6,17,2,1,10,20,50
Seth Curry,47.0,81,79,2909,616,1333,0.462115528882,255,600,0.425,361,733,0.985,0.55776444111,284,317,0.895899053628,32,251,283,400,117,8,235,168,1771
Seth Doliboa,97.0,137,73,3605,471,1120,0.420535714286,49,150,0.326666666667,422,970,1.719,0.442410714286,317,389,0.814910025707,147,356,503,204,104,65,176,306,1308
Seth Tarver,0.0,186,88,4825,671,1515,0.442904290429,111,383,0.289817232376,560,1132,2.424,0.479537953795,319,463,0.68898488121,207,588,795,304,213,39,230,361,1772
Shabazz Muhammad,21.0,4,4,111,36,63,0.571428571429,3,6,0.5,33,57,0.579,0.595238095238,23,31,0.741935483871,21,18,39,7,6,1,5,8,98
Shabazz Napier,23.0,4,2,136,26,62,0.41935483871,9,20,0.45,17,42,0.405,0.491935483871,17,21,0.809523809524,4,16,20,15,3,1,11,8,78
Shagari Alleyne,0.0,15,7,251,23,44,0.522727272727,0,0,0.0,23,44,0.523,0.522727272727,2,8,0.25,15,43,58,3,2,33,18,25,48
Shan Foster,0.0,41,3,623,86,225,0.382222222222,46,141,0.326241134752,40,84,0.476,0.484444444444,18,22,0.818181818182,18,51,69,41,27,5,26,50,236
Shane Edwards,0.0,143,108,4092,773,1379,0.560551124003,9,38,0.236842105263,764,1341,2.679,0.563814358231,443,620,0.714516129032,291,530,821,166,119,96,296,424,1998
Shane Gibson,25.0,50,36,1327,221,494,0.447368421053,128,322,0.39751552795,93,172,0.541,0.576923076923,54,62,0.870967741935,20,115,135,70,43,13,53,102,624
Shane Larkin,21.0,4,3,143,22,47,0.468085106383,8,14,0.571428571429,14,33,0.424,0.553191489362,9,11,0.818181818182,2,19,21,33,8,0,14,9,61
Shannon Brown,87.0,23,15,839,188,445,0.422471910112,50,144,0.347222222222,138,301,1.821,0.478651685393,102,118,0.864406779661,27,99,126,72,30,16,87,77,528
Shannon Scott,23.0,48,37,1390,165,414,0.398550724638,45,141,0.31914893617,120,273,0.44,0.452898550725,65,88,0.738636363636,30,157,187,273,76,5,118,112,440
Shaquille Harrison,23.0,48,17,1327,181,400,0.4525,33,113,0.29203539823,148,287,0.516,0.49375,77,127,0.606299212598,46,152,198,83,62,37,56,113,472
Shaquille Thomas,24.0,5,0,14,1,1,1.0,0,0,0.0,1,1,1.0,1.0,1,1,1.0,0,2,2,1,0,0,0,2,3
Sharrod Ford,54.0,21,12,557,95,191,0.497382198953,0,5,0.0,95,186,0.977,0.497382198953,59,90,0.655555555556,49,110,159,23,10,32,57,84,249
Shaun Livingston,23.0,11,10,323,44,109,0.403669724771,0,5,0.0,44,104,0.423,0.403669724771,14,17,0.823529411765,6,33,39,66,7,6,32,26,102
Shawn Daniels,27.0,29,11,567,64,109,0.587155963303,0,0,0.0,64,109,0.587,0.587155963303,17,24,0.708333333333,46,66,112,36,18,11,17,54,145
Shawn Hawkins,0.0,52,10,1120,130,302,0.430463576159,54,118,0.457627118644,76,184,1.428,0.519867549669,56,78,0.717948717949,64,162,226,50,16,12,50,114,370
Shawn Igo,84.0,90,24,1570,174,352,0.494318181818,2,2,1.0,172,350,1.459,0.497159090909,98,156,0.628205128205,168,250,418,40,28,44,114,232,448
Shawn Jones,22.0,49,30,1226,272,472,0.576271186441,1,5,0.2,271,467,0.58,0.577330508475,99,146,0.678082191781,156,276,432,40,34,57,56,137,644
Shawn Long,24.0,39,36,1149,314,586,0.535836177474,10,46,0.217391304348,304,540,0.563,0.544368600683,150,217,0.691244239631,165,269,434,61,23,51,116,137,788
Shawn Taggart,0.0,13,5,262,37,95,0.389473684211,0,5,0.0,37,90,0.411,0.389473684211,31,38,0.815789473684,38,24,62,4,5,9,21,45,105
Shawn Vanzant,0.0,11,1,167,14,37,0.378378378378,4,15,0.266666666667,10,22,0.455,0.432432432432,4,4,1.0,4,12,16,20,8,1,15,16,36
Shawne Williams,0.0,23,21,724,160,351,0.45584045584,64,153,0.418300653595,96,198,0.485,0.547008547009,87,108,0.805555555556,37,124,161,39,18,48,37,88,471
Shawnson Johnson,75.0,94,22,1764,270,434,0.622119815668,0,0,0.0,270,434,1.868,0.622119815668,164,318,0.51572327044,160,246,406,88,30,54,200,284,704
Shayne Whittington,47.0,41,37,1249,176,410,0.429268292683,52,168,0.309523809524,124,242,1.013,0.492682926829,85,105,0.809523809524,79,240,319,56,58,22,80,121,489
Shea Seals,27.0,46,12,1002,165,452,0.365044247788,54,126,0.428571428571,111,326,0.34,0.424778761062,135,181,0.745856353591,44,85,129,57,39,7,76,87,519
Sheldon McClellan,24.0,6,1,153,22,40,0.55,3,10,0.3,19,30,0.633,0.5875,17,26,0.653846153846,5,16,21,9,9,1,8,6,64
Shelly Clark,29.0,28,26,825,112,270,0.414814814815,0,2,0.0,112,268,0.418,0.414814814815,84,116,0.724137931034,75,172,247,59,19,18,81,110,308
Shelvin Mack,23.0,23,22,928,164,361,0.454293628809,50,137,0.36496350365,114,224,0.509,0.523545706371,84,96,0.875,7,91,98,176,30,2,88,62,462
Sherman Gay,22.0,48,7,951,143,289,0.494809688581,0,0,0.0,143,289,0.495,0.494809688581,82,126,0.650793650794,78,75,153,17,22,41,55,95,368
Sherrod Wright,23.0,1,0,6,1,2,0.5,0,0,0.0,1,2,0.5,0.5,1,1,1.0,0,0,0,0,0,0,0,1,3
Sherron Collins,51.0,7,0,152,21,56,0.375,6,22,0.272727272727,15,34,0.767,0.428571428571,17,21,0.809523809524,2,6,8,16,7,0,14,9,65
Sherwood Brown,45.0,66,4,1056,128,300,0.426666666667,60,164,0.365853658537,68,136,0.94,0.526666666667,27,42,0.642857142857,56,187,243,60,32,14,31,94,343
Shevon Thompson,23.0,17,3,362,87,156,0.557692307692,0,0,0.0,87,156,0.558,0.557692307692,32,48,0.666666666667,60,67,127,6,11,6,38,44,206
Shonn Miller,23.0,45,9,703,89,180,0.494444444444,10,35,0.285714285714,79,145,0.545,0.522222222222,35,56,0.625,49,108,157,19,32,29,28,103,223
Shy Ely,0.0,112,15,1993,228,548,0.416058394161,102,255,0.4,126,293,1.344,0.509124087591,139,165,0.842424242424,25,194,219,137,71,16,107,148,697
Sim Bhullar,45.0,78,44,1856,325,469,0.692963752665,0,0,0.0,325,469,1.385,0.692963752665,129,221,0.58371040724,191,421,612,75,29,202,114,215,779
Sir'Dominic Pointer,23.0,50,9,1013,140,316,0.443037974684,10,58,0.172413793103,130,258,0.504,0.458860759494,57,90,0.633333333333,37,190,227,49,48,70,58,111,347
Skal Labissiere,20.0,17,17,527,101,221,0.457013574661,5,30,0.166666666667,96,191,0.503,0.468325791855,46,65,0.707692307692,48,81,129,19,15,22,42,74,253
Skip Youngblood,24.0,27,3,515,69,151,0.456953642384,0,1,0.0,69,150,0.46,0.456953642384,32,57,0.561403508772,30,81,111,4,5,24,43,78,170
Smush Parker,50.0,41,35,1484,270,587,0.45996592845,44,105,0.419047619048,226,482,0.927,0.497444633731,166,236,0.703389830508,35,155,190,344,111,15,191,127,750
Solomon Alabi,69.0,49,30,882,137,272,0.503676470588,0,0,0.0,137,272,1.503,0.503676470588,55,80,0.6875,95,190,285,19,26,73,61,141,329
Solomon Bozeman,0.0,58,9,1215,134,362,0.370165745856,30,91,0.32967032967,104,271,0.791,0.411602209945,183,225,0.813333333333,28,88,116,121,43,1,82,106,481
Solomon Hill,22.0,2,2,59,12,26,0.461538461538,5,13,0.384615384615,7,13,0.538,0.557692307692,5,6,0.833333333333,1,6,7,6,2,2,8,6,34
Solomon Jones,0.0,20,16,458,71,142,0.5,1,2,0.5,70,140,0.971,0.503521126761,24,32,0.75,38,73,111,27,14,28,29,69,167
Sonny Weems,22.0,22,8,622,190,389,0.488431876607,18,70,0.257142857143,172,319,0.539,0.511568123393,53,75,0.706666666667,27,72,99,65,22,14,61,76,451
Soumaila Samake,24.0,33,27,782,101,181,0.558011049724,0,0,0.0,101,181,0.558,0.558011049724,70,106,0.660377358491,93,138,231,16,14,53,53,106,272
Spencer Dinwiddie,66.0,28,26,950,144,328,0.439024390244,38,99,0.383838383838,106,229,1.349,0.496951219512,115,137,0.839416058394,12,85,97,182,51,15,63,79,441
Stais Boseman,78.0,64,14,1110,150,438,0.342465753425,52,172,0.302325581395,98,266,1.144,0.401826484018,150,196,0.765306122449,20,110,130,80,48,0,84,104,502
Stanley Asumnu,0.0,181,47,3714,731,1316,0.55547112462,1,19,0.0526315789474,730,1297,2.871,0.55585106383,172,376,0.457446808511,374,374,748,180,125,37,178,374,1635
Stanley Burrell,0.0,22,4,469,56,109,0.51376146789,4,11,0.363636363636,52,98,0.531,0.532110091743,21,28,0.75,11,24,35,45,11,2,30,38,137
Stanley Johnson,20.0,1,1,37,9,19,0.473684210526,3,8,0.375,6,11,0.545,0.552631578947,5,8,0.625,1,4,5,4,1,1,3,4,26
Stanley Robinson,0.0,58,4,885,201,376,0.534574468085,25,90,0.277777777778,176,286,2.387,0.567819148936,83,123,0.674796747967,90,151,241,33,28,24,54,78,510
Stanley Thomas,0.0,2,0,40,8,13,0.615384615385,1,2,0.5,7,11,0.636,0.653846153846,0,0,0.0,3,3,6,1,0,0,2,3,17
Stedmon Lemon,72.0,26,0,212,30,86,0.348837209302,4,36,0.111111111111,26,50,1.585,0.372093023256,2,8,0.25,8,32,40,6,14,6,12,12,66
Stefan Jankovic,69.0,62,32,1208,184,458,0.401746724891,42,164,0.256097560976,142,294,1.451,0.447598253275,94,122,0.770491803279,80,222,302,70,38,40,82,250,504
Stefan Welsh,0.0,21,4,345,47,112,0.419642857143,14,49,0.285714285714,33,63,1.025,0.482142857143,51,69,0.739130434783,5,42,47,45,12,1,32,51,159
Stefhon Hannah,223.0,172,90,4094,651,1756,0.370728929385,302,905,0.333701657459,349,851,2.924,0.456719817768,232,300,0.773333333333,111,349,460,596,274,10,412,406,1836
Stephan Hicks,47.0,81,52,2005,307,667,0.460269865067,80,239,0.334728033473,227,428,1.027,0.52023988006,216,268,0.805970149254,125,249,374,78,67,20,83,174,910
Stephane Lasme,87.0,66,29,1789,251,487,0.515400410678,19,50,0.38,232,437,1.56,0.534907597536,165,226,0.730088495575,182,287,469,75,65,165,107,195,686
Stephen Croone,0.0,3,0,22,1,6,0.166666666667,1,4,0.25,0,2,0.0,0.25,4,7,0.571428571429,1,2,3,1,1,0,1,3,7
Stephen Dennis,0.0,93,24,2072,345,777,0.444015444015,29,107,0.271028037383,316,670,0.943,0.462676962677,241,324,0.743827160494,70,216,286,361,139,34,207,194,960
Stephen Graham,53.0,42,40,1418,261,544,0.479779411765,20,65,0.307692307692,241,479,1.053,0.498161764706,176,202,0.871287128713,52,139,191,116,29,9,114,140,718
Stephen Holt,23.0,49,44,1449,176,411,0.428223844282,57,155,0.367741935484,119,256,0.465,0.497566909976,127,158,0.803797468354,52,102,154,152,66,2,83,96,536
Stephen McDowell,0.0,100,16,2064,283,755,0.374834437086,102,290,0.351724137931,181,465,2.547,0.44238410596,89,117,0.760683760684,35,87,122,221,70,4,138,124,757
Stephen Zimmerman,20.0,21,21,627,117,241,0.485477178423,0,1,0.0,117,240,0.488,0.485477178423,47,76,0.618421052632,46,140,186,30,24,27,49,78,281
Steve Hart,0.0,1,0,5,0,1,0.0,0,0,0.0,0,1,0.0,0.0,0,0,0.0,0,1,1,0,0,0,0,0,0
Steve Newman,0.0,70,20,1008,76,214,0.355140186916,14,58,0.241379310345,62,156,1.105,0.38785046729,10,20,0.5,56,114,170,50,24,36,42,132,176
Steve Novak,51.0,11,7,412,72,145,0.496551724138,36,74,0.486486486486,36,71,1.285,0.620689655172,22,27,0.814814814815,15,64,79,18,3,4,22,38,202
Steve Ross,24.0,8,0,134,16,60,0.266666666667,5,10,0.5,11,50,0.22,0.308333333333,6,8,0.75,5,13,18,4,7,0,13,23,43
Steve Weingarten,101.0,103,2,1496,212,486,0.43621399177,87,241,0.360995850622,125,245,1.984,0.525720164609,59,79,0.746835443038,78,166,244,33,36,14,99,242,570
Steven Allen,0.0,44,4,335,32,86,0.372093023256,0,0,0.0,32,86,0.372,0.372093023256,9,28,0.321428571429,29,52,81,8,10,11,21,63,73
Steven Barber,27.0,28,0,331,53,136,0.389705882353,14,38,0.368421052632,39,98,0.398,0.441176470588,36,41,0.878048780488,4,21,25,30,8,0,28,36,156
Steven Hill,47.0,18,6,234,24,44,0.545454545455,0,0,0.0,24,44,1.056,0.545454545455,16,33,0.484848484848,23,39,62,5,3,24,17,36,64
Steven Pledger,25.0,12,1,258,35,88,0.397727272727,16,55,0.290909090909,19,33,0.576,0.488636363636,3,8,0.375,8,25,33,11,3,4,15,37,89
Steven Smith,77.0,51,30,1727,331,680,0.486764705882,43,118,0.364406779661,288,562,1.358,0.518382352941,178,219,0.812785388128,98,225,323,79,58,23,139,163,883
Suleiman Braimoh,0.0,15,2,248,45,86,0.523255813953,8,26,0.307692307692,37,60,0.617,0.56976744186,24,31,0.774193548387,26,35,61,8,13,6,18,40,122
Sun Yue,23.0,6,6,200,23,58,0.396551724138,8,21,0.380952380952,15,37,0.405,0.465517241379,5,7,0.714285714286,2,18,20,22,8,14,12,18,59
Sundiata Gaines,109.0,82,57,2408,487,1058,0.460302457467,156,402,0.388059701493,331,656,2.028,0.534026465028,233,360,0.647222222222,89,308,397,384,142,16,176,152,1363
Sung-Yoon Bang,46.0,45,24,1222,211,502,0.4203187251,47,128,0.3671875,164,374,0.98,0.467131474104,94,115,0.817391304348,19,70,89,52,40,3,68,115,563
T.J. Campbell,0.0,50,36,1547,204,488,0.418032786885,73,176,0.414772727273,131,312,0.42,0.492827868852,151,180,0.838888888889,29,124,153,259,45,6,98,140,632
T.J. Cummings,210.0,175,97,4507,900,1840,0.489130434783,0,2,0.0,900,1838,3.853,0.489130434783,336,426,0.788732394366,335,710,1045,178,73,52,271,574,2136
T.J. Price,23.0,49,47,1559,247,579,0.426597582038,67,188,0.356382978723,180,391,0.46,0.484455958549,125,145,0.862068965517,19,135,154,133,90,12,107,168,686
T.J. Sorrentine,23.0,14,0,210,21,67,0.313432835821,6,22,0.272727272727,15,45,0.333,0.358208955224,3,4,0.75,4,11,15,29,8,0,7,25,51
T.J. Warren,21.0,9,9,319,98,180,0.544444444444,10,35,0.285714285714,88,145,0.607,0.572222222222,35,48,0.729166666667,28,35,63,14,14,5,20,17,241
Ta'Quan Zimmerman,47.0,47,16,891,74,231,0.320346320346,35,130,0.269230769231,39,101,0.688,0.396103896104,19,26,0.730769230769,19,72,91,93,23,1,60,105,202
Tack Minor,0.0,7,0,53,12,21,0.571428571429,2,6,0.333333333333,10,15,0.667,0.619047619048,3,4,0.75,1,2,3,7,2,0,11,5,29
Tai Crutchfield,46.0,39,17,780,105,276,0.380434782609,23,78,0.294871794872,82,198,0.831,0.422101449275,51,90,0.566666666667,37,50,87,38,16,8,65,96,284
Taj McCullough,0.0,99,75,2753,561,1247,0.449879711307,151,439,0.343963553531,410,808,2.1,0.510425020048,195,298,0.654362416107,85,327,412,129,112,36,132,273,1468
Tajuan Porter,173.0,200,23,4036,696,1736,0.400921658986,243,721,0.337031900139,453,1015,3.12,0.470910138249,381,437,0.871853546911,114,292,406,623,177,0,398,248,2016
Talib Zanna,49.0,95,78,2685,455,860,0.529069767442,12,41,0.292682926829,443,819,1.082,0.536046511628,376,526,0.714828897338,349,657,1006,91,91,31,189,296,1298
Tamar Slay,26.0,26,16,670,122,247,0.493927125506,7,21,0.333333333333,115,226,0.509,0.508097165992,47,59,0.796610169492,23,74,97,51,30,10,60,79,298
Tang Hamilton,100.0,106,94,3423,627,1214,0.51647446458,5,24,0.208333333333,622,1190,2.054,0.518533772652,317,440,0.720454545455,223,596,819,201,90,52,185,234,1576
Tarik Black,47.0,9,9,290,63,108,0.583333333333,0,2,0.0,63,106,1.273,0.583333333333,28,44,0.636363636364,35,71,106,11,6,18,21,40,154
Tarvis Williams,26.0,15,0,168,22,44,0.5,0,0,0.0,22,44,0.5,0.5,10,13,0.769230769231,13,18,31,2,5,17,13,23,54
Tasheed Carr,0.0,25,6,425,50,119,0.420168067227,5,25,0.2,45,94,0.479,0.441176470588,20,28,0.714285714286,8,42,50,38,17,0,31,38,125
Tasmin Mitchell,0.0,50,20,1654,338,631,0.535657686212,0,4,0.0,338,627,0.539,0.535657686212,140,181,0.773480662983,108,175,283,115,67,26,95,191,816
Taurean Green,63.0,16,10,532,84,198,0.424242424242,36,74,0.486486486486,48,124,1.187,0.515151515152,72,82,0.878048780488,6,68,74,110,28,6,52,24,276
Taurean Prince,22.0,5,3,142,40,80,0.5,8,21,0.380952380952,32,59,0.542,0.55,15,21,0.714285714286,6,32,38,11,8,4,14,15,103
Taylor Griffin,102.0,136,81,3213,464,1089,0.426078971534,85,246,0.345528455285,379,843,1.798,0.465105601469,246,351,0.700854700855,216,564,780,215,131,64,194,339,1259
Teddy Dupay,23.0,6,2,84,14,37,0.378378378378,6,16,0.375,8,21,0.381,0.459459459459,7,10,0.7,3,7,10,7,5,0,10,6,41
Tejay Anderson,0.0,21,0,131,11,20,0.55,1,3,0.333333333333,10,17,0.588,0.575,10,18,0.555555555556,15,13,28,4,4,0,3,14,33
Terence Morris,25.0,46,5,1220,220,482,0.45643153527,26,80,0.325,194,402,0.483,0.483402489627,60,83,0.722891566265,88,252,340,87,32,72,84,120,526
Terquin Mott,28.0,4,0,37,7,18,0.388888888889,0,2,0.0,7,16,0.438,0.388888888889,8,10,0.8,3,12,15,3,2,0,8,4,22
Terran Petteway,23.0,49,23,1305,207,504,0.410714285714,74,204,0.362745098039,133,300,0.443,0.484126984127,82,110,0.745454545455,12,157,169,123,43,13,93,106,570
Terrance Gamble,0.0,37,11,489,45,77,0.584415584416,0,0,0.0,45,77,2.399,0.584415584416,13,28,0.464285714286,31,94,125,18,11,35,24,90,103
Terrance Henry,0.0,4,0,79,11,29,0.379310344828,1,6,0.166666666667,10,23,0.435,0.396551724138,0,0,0.0,2,9,11,5,5,3,3,3,23
Terrance Martin,0.0,20,8,298,24,64,0.375,8,15,0.533333333333,16,49,0.327,0.4375,19,25,0.76,7,37,44,27,11,9,24,30,75
Terrance Roberson,75.0,52,28,1176,192,450,0.426666666667,26,90,0.288888888889,166,360,1.358,0.455555555556,110,154,0.714285714286,52,90,142,68,36,10,106,116,520
Terrance Thomas,212.0,203,76,5359,771,1597,0.482780212899,117,358,0.326815642458,654,1239,3.412,0.519411396368,257,322,0.798136645963,314,1020,1334,521,207,28,373,295,1916
Terrance Woodbury,0.0,61,28,1449,255,567,0.449735449735,53,147,0.360544217687,202,420,0.988,0.496472663139,97,130,0.746153846154,45,153,198,60,39,9,98,117,660
Terrel Harris,216.0,215,120,5611,777,1727,0.449913144181,300,799,0.375469336671,477,928,4.703,0.536768963521,403,536,0.751865671642,222,716,938,504,289,57,426,690,2257
Terrell Everett,0.0,54,10,998,142,360,0.394444444444,28,76,0.368421052632,114,284,1.018,0.433333333333,62,86,0.720930232558,26,90,116,124,58,8,60,76,374
Terrell McIntyre,49.0,89,87,2507,430,1000,0.43,120,290,0.413793103448,310,710,0.871,0.49,234,265,0.883018867925,52,195,247,445,136,3,229,163,1214
Terrence Crawford,99.0,121,65,2980,298,639,0.466353677621,7,46,0.152173913043,291,593,1.973,0.471830985915,378,523,0.72275334608,282,386,668,214,118,33,199,342,981
Terrence Drisdom,47.0,69,17,1231,158,346,0.456647398844,22,76,0.289473684211,136,270,1.007,0.488439306358,61,81,0.753086419753,54,184,238,92,55,39,50,102,399
Terrence Hill,22.0,8,0,75,4,15,0.266666666667,0,1,0.0,4,14,0.286,0.266666666667,5,10,0.5,2,9,11,4,5,0,2,8,13
Terrence Jennings,181.0,149,36,2445,394,759,0.519104084321,3,11,0.272727272727,391,748,4.016,0.521080368906,106,206,0.514563106796,188,372,560,81,92,151,141,375,897
Terrence Jones,21.0,24,15,741,167,349,0.478510028653,30,101,0.29702970297,137,248,0.552,0.521489971347,93,134,0.694029850746,57,160,217,59,36,32,42,50,457
Terrence Oblesby,27.0,19,3,211,23,70,0.328571428571,12,43,0.279069767442,11,27,0.407,0.414285714286,12,14,0.857142857143,3,19,22,10,5,1,15,14,70
Terrence Roberts,0.0,11,3,145,30,55,0.545454545455,0,2,0.0,30,53,0.566,0.545454545455,16,29,0.551724137931,17,26,43,8,2,10,17,26,76
Terrence Shannon,122.0,164,127,4865,853,1784,0.478139013453,10,51,0.196078431373,843,1733,2.428,0.480941704036,667,956,0.69769874477,279,553,832,236,136,106,366,541,2383
Terrence Williams,49.0,35,29,1266,259,614,0.421824104235,95,243,0.390946502058,164,371,0.845,0.499185667752,127,195,0.651282051282,23,171,194,236,50,9,97,50,740
Terrico White,46.0,61,51,2065,417,854,0.488290398126,123,294,0.418367346939,294,560,1.045,0.560304449649,134,184,0.728260869565,58,239,297,136,61,10,56,114,1091
Terry Dehere,30.0,31,0,544,82,186,0.440860215054,27,60,0.45,55,126,0.437,0.513440860215,50,57,0.877192982456,13,36,49,43,14,1,42,50,241
Terry Rozier,21.0,14,14,472,90,229,0.393013100437,25,74,0.337837837838,65,155,0.419,0.447598253275,66,85,0.776470588235,20,70,90,112,26,2,38,29,271
Terry Whisnant,47.0,95,46,2847,331,847,0.390791027155,219,607,0.3607907743,112,240,0.876,0.520070838253,95,116,0.818965517241,51,266,317,121,76,24,91,195,976
Tes Whitlock,0.0,56,50,1020,134,346,0.387283236994,22,74,0.297297297297,112,272,0.833,0.419075144509,68,80,0.85,22,86,108,162,36,2,94,60,358
Tezale Archie,24.0,7,4,102,13,28,0.464285714286,1,4,0.25,12,24,0.5,0.482142857143,3,4,0.75,2,5,7,12,3,0,12,8,30
Thad Delaney,29.0,30,13,544,43,99,0.434343434343,0,0,0.0,43,99,0.434,0.434343434343,12,29,0.413793103448,46,106,152,14,9,10,34,52,98
Thanasis Antetokounmpo,66.0,141,127,4217,632,1333,0.474118529632,103,390,0.264102564103,529,943,1.703,0.512753188297,366,572,0.63986013986,268,445,713,247,174,199,294,426,1733
Theron Smith,25.0,33,30,1108,170,380,0.447368421053,2,9,0.222222222222,168,371,0.453,0.45,146,177,0.824858757062,62,151,213,95,17,12,76,80,488
Thomas Baudinet,0.0,83,20,1414,210,469,0.44776119403,86,232,0.370689655172,124,237,2.021,0.539445628998,52,64,0.8125,22,133,155,96,37,5,71,109,558
Thomas Bropleh,24.0,9,0,139,17,51,0.333333333333,7,29,0.241379310345,10,22,0.455,0.401960784314,2,3,0.666666666667,4,13,17,6,2,0,4,9,43
Thomas Gardner,98.0,39,20,877,133,340,0.391176470588,47,154,0.305194805195,86,186,1.906,0.460294117647,51,79,0.645569620253,7,72,79,65,24,2,67,84,364
Thomas Hamilton,105.0,106,88,2803,442,750,0.589333333333,0,3,0.0,442,747,2.361,0.589333333333,137,281,0.487544483986,256,699,955,184,36,126,367,271,1021
Thomas McKenzie,23.0,29,12,310,25,56,0.446428571429,0,0,0.0,25,56,0.446,0.446428571429,22,34,0.647058823529,30,36,66,12,2,7,21,76,72
Thomas Sanders,0.0,2,0,23,4,8,0.5,0,0,0.0,4,8,0.5,0.5,1,2,0.5,2,5,7,1,1,0,0,4,9
Thomas Walkup,24.0,40,23,978,116,254,0.456692913386,22,78,0.282051282051,94,176,0.534,0.5,49,58,0.844827586207,31,126,157,136,42,6,41,90,303
Tiago Splitter,0.0,2,2,28,5,12,0.416666666667,0,0,0.0,5,12,0.417,0.416666666667,3,5,0.6,3,8,11,2,1,1,2,4,13
Tibor Pleiss,26.0,28,28,883,141,242,0.582644628099,6,19,0.315789473684,135,223,0.605,0.595041322314,57,65,0.876923076923,80,212,292,45,13,40,61,117,345
Tierre Brown,102.0,135,123,4352,859,1870,0.45935828877,55,203,0.270935960591,804,1667,1.969,0.474064171123,517,628,0.823248407643,85,424,509,782,200,20,460,246,2290
Tim Barnes,0.0,96,14,1696,124,328,0.378048780488,48,118,0.406779661017,76,210,1.148,0.451219512195,50,52,0.961538461538,26,128,154,218,78,4,94,136,346
Tim Frazier,49.0,49,47,1698,269,568,0.473591549296,51,138,0.369565217391,218,430,1.101,0.518485915493,191,238,0.802521008403,104,260,364,465,79,14,161,164,780
Tim Hardaway Jr.,69.0,10,4,268,52,126,0.412698412698,24,74,0.324324324324,28,52,1.641,0.507936507937,60,68,0.882352941176,4,22,26,20,6,0,18,26,188
Tim Ohlbrecht,99.0,122,71,2986,574,1011,0.567754698318,23,116,0.198275862069,551,895,2.503,0.579129574679,341,422,0.808056872038,333,529,862,107,84,104,277,438,1512
Tim Pickett,23.0,23,1,551,82,193,0.424870466321,14,27,0.518518518519,68,166,0.41,0.461139896373,36,48,0.75,20,62,82,57,32,13,42,50,214
Tim Quarterman,66.0,44,28,1356,190,522,0.36398467433,38,176,0.215909090909,152,346,1.313,0.400383141762,74,102,0.725490196078,64,212,276,312,74,16,158,100,492
Tim Washington,25.0,31,0,404,38,97,0.39175257732,0,2,0.0,38,95,0.4,0.39175257732,49,65,0.753846153846,30,47,77,18,7,5,23,56,125
Timmy Bowers,23.0,48,16,1370,198,411,0.481751824818,5,32,0.15625,193,379,0.509,0.487834549878,61,74,0.824324324324,36,131,167,192,60,8,89,65,462
Timothe Luwawu,21.0,3,3,81,10,24,0.416666666667,3,6,0.5,7,18,0.389,0.479166666667,8,9,0.888888888889,0,12,12,8,5,1,8,10,31
Timothy Bush,0.0,3,0,14,0,0,0.0,0,0,0.0,0,0,0.0,0.0,0,0,0.0,0,3,3,0,0,0,1,3,0
Tiny Gallon,107.0,136,92,3560,720,1405,0.512455516014,13,78,0.166666666667,707,1327,2.593,0.517081850534,370,531,0.696798493409,337,659,996,200,116,137,398,434,1823
Tirrell Baines,0.0,79,23,2000,383,766,0.5,0,6,0.0,383,760,1.008,0.5,148,222,0.666666666667,172,213,385,72,45,19,100,153,914
Titus Robinson,0.0,1,0,4,0,1,0.0,0,0,0.0,0,1,0.0,0.0,0,0,0.0,0,0,0,0,0,0,0,0,0
Titus Rubles,23.0,3,0,44,6,10,0.6,0,0,0.0,6,10,0.6,0.6,1,4,0.25,3,5,8,4,0,1,2,4,13
Tobe Carberry,49.0,46,7,706,113,261,0.432950191571,18,66,0.272727272727,95,195,0.896,0.467432950192,32,40,0.8,27,35,62,35,21,8,31,84,276
Todd Mayo,23.0,24,2,490,67,180,0.372222222222,16,63,0.253968253968,51,117,0.436,0.416666666667,48,56,0.857142857143,8,48,56,25,17,2,46,43,198
Tom Wideman,25.0,48,26,999,132,291,0.453608247423,0,2,0.0,132,289,0.457,0.453608247423,85,133,0.639097744361,99,206,305,46,14,27,79,115,349
Tomislav Zubcic,26.0,36,0,711,99,235,0.421276595745,44,125,0.352,55,110,0.5,0.514893617021,36,45,0.8,49,125,174,51,17,12,35,72,278
Tommy Mason-Griffin,0.0,5,0,58,4,21,0.190476190476,1,2,0.5,3,19,0.158,0.214285714286,4,4,1.0,5,6,11,9,2,0,2,4,13
Tommy Smith,0.0,67,37,1376,212,384,0.552083333333,0,3,0.0,212,381,1.113,0.552083333333,69,139,0.496402877698,143,207,350,74,65,91,112,202,493
Tony Bethel,0.0,20,14,510,70,159,0.440251572327,17,59,0.28813559322,53,100,0.53,0.493710691824,24,29,0.827586206897,9,47,56,28,17,3,29,50,181
Tony Bishop,49.0,92,49,2635,463,982,0.471486761711,160,442,0.361990950226,303,540,1.138,0.552953156823,165,223,0.739910313901,272,439,711,141,104,76,140,278,1251
Tony Bland,53.0,85,74,2755,332,805,0.412422360248,48,161,0.298136645963,284,644,0.867,0.442236024845,237,297,0.79797979798,61,238,299,369,49,14,161,191,949
Tony Bobbitt,324.0,241,116,6810,1202,2708,0.443870014771,521,1342,0.388226527571,681,1366,5.493,0.540066469719,332,406,0.817733990148,70,609,679,506,406,74,336,663,3257
Tony Christie,25.0,4,0,68,3,18,0.166666666667,1,12,0.0833333333333,2,6,0.333,0.194444444444,1,4,0.25,1,3,4,3,0,2,3,4,8
Tony Dobbins,23.0,47,6,918,96,233,0.412017167382,1,7,0.142857142857,95,226,0.42,0.414163090129,38,62,0.612903225806,43,109,152,62,56,18,34,84,231
Tony Gaffney,0.0,35,34,1002,149,275,0.541818181818,4,14,0.285714285714,145,261,0.556,0.549090909091,64,97,0.659793814433,85,165,250,81,50,81,44,60,366
Tony Gipson,0.0,21,15,681,102,220,0.463636363636,10,42,0.238095238095,92,178,0.517,0.486363636364,56,66,0.848484848485,23,35,58,88,27,3,74,50,270
Tony Harris,0.0,12,0,213,21,62,0.338709677419,14,32,0.4375,7,30,0.233,0.451612903226,17,24,0.708333333333,2,7,9,20,7,0,9,29,73
Tony Kitchings,51.0,64,50,1482,230,414,0.555555555556,0,1,0.0,230,413,1.106,0.555555555556,81,152,0.532894736842,130,262,392,56,38,76,117,219,541
Tony Mitchell,90.0,95,66,2959,674,1567,0.430121250798,162,508,0.318897637795,512,1059,2.044,0.481812380345,277,376,0.73670212766,203,381,584,231,109,85,248,259,1787
Tony Rutland,28.0,3,0,20,2,6,0.333333333333,1,4,0.25,1,2,0.5,0.416666666667,0,0,0.0,0,3,3,0,2,0,5,1,5
Tony Taylor,0.0,50,24,1129,115,272,0.422794117647,28,69,0.405797101449,87,203,0.429,0.474264705882,91,114,0.798245614035,15,68,83,159,31,2,73,125,349
Tony Wroten,42.0,27,5,670,136,326,0.41717791411,38,126,0.301587301587,98,200,0.991,0.475460122699,78,145,0.537931034483,17,49,66,77,28,5,75,68,388
Toree Morris,0.0,46,2,642,66,142,0.464788732394,0,0,0.0,66,142,1.346,0.464788732394,68,94,0.723404255319,56,108,164,8,8,28,62,128,200
Tornike Shengelia,43.0,14,14,475,104,196,0.530612244898,16,46,0.347826086957,88,150,1.196,0.571428571429,72,102,0.705882352941,39,63,102,46,25,15,64,55,296
Torraye Braggs,29.0,14,8,400,47,106,0.443396226415,0,1,0.0,47,105,0.448,0.443396226415,64,85,0.752941176471,29,64,93,35,14,3,55,58,158
Torrian Jones,23.0,15,0,217,27,63,0.428571428571,2,13,0.153846153846,25,50,0.5,0.444444444444,37,43,0.860465116279,6,13,19,16,10,1,15,24,93
Tory Jackson,0.0,45,20,987,118,319,0.369905956113,14,63,0.222222222222,104,256,0.406,0.391849529781,66,81,0.814814814815,20,111,131,137,63,4,61,92,316
Tory Walker,23.0,23,5,358,58,124,0.467741935484,13,29,0.448275862069,45,95,0.474,0.520161290323,9,12,0.75,31,34,65,16,9,3,17,48,138
Toure' Murry,200.0,183,133,5269,747,1772,0.421557562077,190,566,0.335689045936,557,1206,3.692,0.475169300226,333,491,0.678207739308,161,610,771,829,276,49,436,424,2017
Traevon Jackson,23.0,25,0,358,52,119,0.436974789916,6,26,0.230769230769,46,93,0.495,0.46218487395,24,31,0.774193548387,9,30,39,32,23,1,19,34,134
Trahson Burrell,24.0,49,36,1492,255,518,0.492277992278,44,124,0.354838709677,211,394,0.536,0.534749034749,86,115,0.747826086957,117,214,331,163,69,28,106,136,640
Travis Bader,23.0,22,12,653,93,228,0.407894736842,71,189,0.375661375661,22,39,0.564,0.563596491228,24,27,0.888888888889,8,25,33,27,16,1,20,57,281
Travis Betran,23.0,2,0,12,0,6,0.0,0,3,0.0,0,3,0.0,0.0,1,2,0.5,1,0,1,0,1,0,0,2,1
Travis Cohn,0.0,13,1,222,34,69,0.492753623188,7,17,0.411764705882,27,52,0.519,0.54347826087,10,13,0.769230769231,10,17,27,10,9,0,22,14,85
Travis Franklin,0.0,77,10,1324,212,401,0.528678304239,0,5,0.0,212,396,1.075,0.528678304239,155,216,0.717592592593,92,105,197,65,40,21,87,144,579
Travis George,0.0,2,0,30,1,2,0.5,0,0,0.0,1,2,0.5,0.5,6,10,0.6,1,2,3,0,2,5,4,7,8
Travis Holmes,0.0,4,0,23,1,4,0.25,0,1,0.0,1,3,0.333,0.25,0,0,0.0,0,2,2,1,3,0,1,1,2
Travis Hyman,210.0,208,57,3129,352,749,0.469959946595,0,2,0.0,352,747,3.574,0.469959946595,129,324,0.398148148148,347,538,885,106,130,291,237,541,833
Travis Leslie,69.0,94,50,2540,555,1118,0.496422182469,91,251,0.362549800797,464,867,1.596,0.537119856887,120,160,0.75,209,366,575,197,113,38,172,211,1321
Travis McKie,66.0,18,0,154,16,46,0.347826086957,6,26,0.230769230769,10,20,1.5,0.413043478261,0,4,0.0,8,24,32,8,4,2,10,16,38
Travis Releford,25.0,16,3,288,29,61,0.475409836066,6,22,0.272727272727,23,39,0.59,0.524590163934,10,15,0.666666666667,11,14,25,15,13,3,13,30,74
Travis Trice III,47.0,58,57,1988,344,784,0.438775510204,79,219,0.360730593607,265,565,0.908,0.489158163265,171,211,0.810426540284,25,176,201,336,74,5,131,93,938
Travis Walton,0.0,52,18,1016,80,212,0.377358490566,6,22,0.272727272727,74,190,1.33,0.391509433962,70,98,0.714285714286,20,66,86,102,24,4,34,84,236
Travis Wear,26.0,42,13,1067,206,476,0.432773109244,77,225,0.342222222222,129,251,0.514,0.513655462185,46,65,0.707692307692,58,246,304,43,34,20,51,98,535
Tre Bussey,23.0,38,11,777,106,292,0.36301369863,30,100,0.3,76,192,0.396,0.414383561644,38,50,0.76,10,54,64,89,30,6,70,56,280
Tre Kelley,172.0,178,136,6017,989,2179,0.453877925654,282,693,0.406926406926,707,1486,2.786,0.518586507572,496,610,0.813114754098,55,436,491,894,210,31,444,340,2756
Tre Whitted,0.0,92,30,2229,287,736,0.389945652174,83,270,0.307407407407,204,466,0.878,0.446331521739,109,138,0.789855072464,62,141,203,148,49,9,116,153,766
Tremaine Fowlkes,83.0,61,44,1724,257,640,0.4015625,9,49,0.183673469388,248,591,1.19,0.40859375,318,445,0.714606741573,138,170,308,76,61,12,107,177,841
Trent Lockett,0.0,46,43,1296,195,405,0.481481481481,47,111,0.423423423423,148,294,0.503,0.53950617284,69,95,0.726315789474,67,186,253,92,50,25,84,118,506
Trent Strickland,150.0,129,79,3252,588,1371,0.428884026258,76,272,0.279411764706,512,1099,2.399,0.456601021152,383,512,0.748046875,220,430,650,117,90,21,180,321,1635
Treveon Graham,22.0,46,20,1397,260,565,0.46017699115,68,206,0.330097087379,192,359,0.535,0.520353982301,135,217,0.622119815668,74,207,281,73,39,9,64,118,723
Trevin Parks,24.0,2,0,18,2,5,0.4,0,1,0.0,2,4,0.5,0.4,0,0,0.0,0,1,1,1,0,0,3,0,4
Trevor Cooney,24.0,22,4,293,29,77,0.376623376623,13,45,0.288888888889,16,32,0.5,0.461038961039,7,9,0.777777777778,3,19,22,16,5,5,11,21,78
Trey Davis,23.0,1,0,19,0,3,0.0,0,1,0.0,0,2,0.0,0.0,0,0,0.0,0,1,1,2,0,0,1,1,0
Trey Freeman,24.0,39,18,886,88,236,0.372881355932,27,83,0.325301204819,61,153,0.399,0.430084745763,18,24,0.75,10,106,116,87,27,4,28,63,221
Trey Gilder,216.0,214,100,6143,1107,2150,0.51488372093,60,187,0.320855614973,1047,1963,4.021,0.528837209302,703,904,0.777654867257,331,896,1227,418,225,196,441,483,2977
Trey Johnson,125.0,126,92,4412,911,1909,0.477213200629,88,251,0.350597609562,823,1658,2.457,0.500261917234,593,728,0.81456043956,85,388,473,600,95,8,365,317,2503
Trey McKinney-Jones,73.0,111,108,3761,617,1323,0.466364323507,118,377,0.31299734748,499,946,1.58,0.510959939531,353,423,0.83451536643,115,412,527,285,123,15,191,299,1705
Tristan Spurlock,23.0,4,1,82,5,21,0.238095238095,3,12,0.25,2,9,0.222,0.309523809524,3,6,0.5,0,11,11,0,4,1,4,6,16
Tristan Thompson,0.0,13,7,285,31,76,0.407894736842,7,24,0.291666666667,24,52,0.462,0.453947368421,45,51,0.882352941176,5,15,20,15,5,0,13,21,114
Troy Bell,78.0,86,34,2524,422,952,0.443277310924,92,242,0.380165289256,330,710,1.384,0.491596638655,326,372,0.876344086022,108,270,378,274,106,46,212,198,1262
Troy Daniels,22.0,48,37,1697,323,766,0.421671018277,240,599,0.400667779633,83,167,0.497,0.578328981723,146,179,0.815642458101,46,174,220,89,53,8,94,138,1032
Troy Devries,34.0,48,20,1139,172,398,0.43216080402,106,244,0.434426229508,66,154,0.429,0.565326633166,41,54,0.759259259259,13,85,98,84,36,4,54,92,491
Troy Hudson,36.0,14,12,369,60,148,0.405405405405,17,54,0.314814814815,43,94,0.457,0.462837837838,18,21,0.857142857143,8,29,37,51,3,0,27,10,155
Troy Huff,23.0,7,0,95,9,30,0.3,3,15,0.2,6,15,0.4,0.35,6,8,0.75,0,9,9,2,9,0,5,8,27
Troy Rolle,25.0,4,0,60,8,23,0.347826086957,1,5,0.2,7,18,0.389,0.369565217391,5,5,1.0,3,6,9,2,2,0,4,4,22
Troy Williams,66.0,66,30,1498,356,772,0.461139896373,104,314,0.331210191083,252,458,1.66,0.528497409326,170,234,0.726495726496,66,228,294,102,60,10,134,188,986
Tu Holloway,26.0,46,42,1636,320,698,0.458452722063,95,232,0.409482758621,225,466,0.483,0.526504297994,294,331,0.888217522659,26,119,145,291,62,5,130,87,1029
Turner Battle,22.0,3,0,43,1,4,0.25,0,1,0.0,1,3,0.333,0.25,0,0,0.0,1,3,4,3,1,0,2,9,2
Tweety Carter,0.0,31,13,823,115,283,0.406360424028,50,134,0.373134328358,65,149,0.436,0.494699646643,70,87,0.804597701149,9,52,61,120,23,0,58,60,350
Ty Greene,23.0,48,36,1229,156,358,0.435754189944,72,179,0.402234636872,84,179,0.469,0.536312849162,125,143,0.874125874126,12,95,107,45,54,12,33,111,509
Ty Shine,24.0,13,1,185,18,47,0.382978723404,7,21,0.333333333333,11,26,0.423,0.457446808511,8,8,1.0,1,8,9,22,8,0,5,9,51
Ty Walker,123.0,112,50,2308,276,443,0.6230248307,0,1,0.0,276,442,3.103,0.6230248307,55,104,0.528846153846,190,479,669,78,44,254,108,207,607
Tychicus Snow,0.0,16,7,270,30,68,0.441176470588,8,16,0.5,22,52,0.73,0.5,9,13,0.692307692308,5,21,26,45,10,0,18,16,77
Tyler Brown,0.0,26,4,559,67,171,0.391812865497,42,112,0.375,25,59,0.424,0.514619883041,27,35,0.771428571429,7,34,41,52,23,4,48,38,203
Tyler Ennis,20.0,9,9,302,67,140,0.478571428571,15,45,0.333333333333,52,95,0.547,0.532142857143,17,21,0.809523809524,18,21,39,48,16,2,23,29,166
Tyler Hansbrough,0.0,13,11,434,75,138,0.54347826087,3,9,0.333333333333,72,129,0.558,0.554347826087,76,98,0.775510204082,56,103,159,9,10,6,23,35,229
Tyler Harvey,22.0,37,13,984,153,419,0.365155131265,80,231,0.34632034632,73,188,0.388,0.46062052506,54,68,0.794117647059,12,78,90,56,36,4,53,66,440
Tyler Honeycutt,87.0,40,11,856,141,297,0.474747474747,32,80,0.4,109,217,1.996,0.52861952862,59,78,0.75641025641,74,175,249,53,71,41,78,86,373
Tyler Hughes,0.0,1,1,12,2,4,0.5,0,0,0.0,2,4,0.5,0.5,0,0,0.0,1,1,2,1,0,1,0,2,4
Tyler Johnson,22.0,15,15,517,99,202,0.490099009901,20,47,0.425531914894,79,155,0.51,0.539603960396,59,73,0.808219178082,20,45,65,64,14,6,26,37,277
Tyler Smith,27.0,49,30,1324,168,365,0.460273972603,11,35,0.314285714286,157,330,0.476,0.475342465753,113,141,0.801418439716,61,145,206,26,29,12,63,150,460
Tyler Ulis,21.0,1,1,36,6,17,0.352941176471,1,4,0.25,5,13,0.385,0.382352941176,0,0,0.0,1,4,5,9,3,0,4,4,13
Tyler Wilkerson,0.0,36,23,873,185,350,0.528571428571,0,7,0.0,185,343,0.539,0.528571428571,67,107,0.626168224299,96,185,281,20,12,41,68,120,437
Tyrell Biggs,0.0,100,35,2136,404,867,0.465974625144,11,53,0.207547169811,393,814,2.0,0.4723183391,120,180,0.666666666667,142,248,390,80,33,31,154,230,939
Tyrelle Blair,0.0,7,2,176,15,28,0.535714285714,0,0,0.0,15,28,0.536,0.535714285714,3,11,0.272727272727,14,34,48,5,1,14,4,21,33
Tyren Johnson,0.0,44,31,1187,196,432,0.453703703704,34,115,0.295652173913,162,317,0.511,0.493055555556,90,128,0.703125,69,177,246,106,44,32,115,118,516
Tyrone Brazelton,0.0,20,9,583,72,187,0.385026737968,13,44,0.295454545455,59,143,0.413,0.419786096257,26,37,0.702702702703,9,37,46,105,25,0,52,64,183
Tyrone Ellis,0.0,56,10,871,110,278,0.395683453237,18,67,0.268656716418,92,211,0.436,0.428057553957,52,78,0.666666666667,45,52,97,54,35,11,68,114,290
Tyrone Johnson,23.0,23,4,301,28,86,0.325581395349,8,37,0.216216216216,20,49,0.408,0.372093023256,17,22,0.772727272727,4,28,32,23,12,1,14,20,81
Tyrone Kent,0.0,7,2,163,12,36,0.333333333333,3,10,0.3,9,26,0.346,0.375,8,12,0.666666666667,3,13,16,12,10,1,11,21,35
Tyrone Sally,49.0,85,14,1378,206,400,0.515,6,17,0.352941176471,200,383,1.032,0.5225,104,135,0.77037037037,108,112,220,68,49,20,89,148,522
Tyrone Wallace,22.0,38,15,1020,208,460,0.452173913043,15,62,0.241935483871,193,398,0.485,0.46847826087,129,185,0.697297297297,22,125,147,138,51,10,94,96,560
Tyrone Washington,26.0,37,27,781,116,234,0.495726495726,0,0,0.0,116,234,0.496,0.495726495726,70,107,0.654205607477,65,98,163,31,21,20,60,128,302
Tyrone White,24.0,42,7,721,113,302,0.37417218543,52,163,0.319018404908,61,139,0.439,0.460264900662,42,59,0.71186440678,9,87,96,112,16,4,74,79,320
Tyrrel Tate,22.0,25,5,358,35,86,0.406976744186,9,32,0.28125,26,54,0.481,0.459302325581,25,37,0.675675675676,19,52,71,20,6,3,21,56,104
Tyrus Thomas,28.0,16,2,299,34,100,0.34,2,21,0.0952380952381,32,79,0.405,0.35,20,32,0.625,13,52,65,13,9,17,24,27,90
Tyshawn Taylor,91.0,58,32,1734,350,737,0.474898236092,22,111,0.198198198198,328,626,1.905,0.489823609227,165,222,0.743243243243,37,198,235,306,78,2,256,112,887
Tyson Patterson,0.0,6,3,110,10,42,0.238095238095,1,4,0.25,9,38,0.237,0.25,6,7,0.857142857143,9,7,16,11,9,0,9,4,27
Tyus Jones,19.0,6,6,211,58,119,0.487394957983,20,47,0.425531914894,38,72,0.528,0.571428571429,12,13,0.923076923077,4,19,23,30,9,1,14,13,148
Val Brown,22.0,8,0,65,9,32,0.28125,2,14,0.142857142857,7,18,0.389,0.3125,8,12,0.666666666667,3,6,9,6,7,0,3,10,28
Vance Cooksey,0.0,94,51,2064,228,599,0.380634390651,31,115,0.269565217391,197,484,1.642,0.406510851419,264,356,0.741573033708,51,162,213,415,99,2,227,185,751
Vander Blue,153.0,198,169,6889,1479,3384,0.437056737589,318,904,0.351769911504,1161,2480,3.115,0.484042553191,1202,1538,0.781534460338,189,795,984,722,326,20,472,423,4478
Vashil Fernandez,75.0,64,0,492,30,64,0.46875,0,0,0.0,30,64,1.219,0.46875,8,10,0.8,54,70,124,6,10,40,34,108,68
Verdell Jones,26.0,50,31,1550,295,642,0.459501557632,75,203,0.369458128079,220,439,0.501,0.517912772586,139,194,0.716494845361,33,127,160,190,65,13,100,108,804
Vernon Goodridge,0.0,96,74,2044,282,530,0.532075471698,0,0,0.0,282,530,1.485,0.532075471698,122,164,0.743902439024,178,286,464,56,38,170,122,338,686
Vernon Hamilton,0.0,84,18,1594,246,574,0.428571428571,42,111,0.378378378378,204,463,2.817,0.465156794425,114,170,0.670588235294,35,172,207,214,99,7,153,147,648
Vernon Jennings,0.0,18,8,301,32,92,0.347826086957,0,3,0.0,32,89,0.36,0.347826086957,17,20,0.85,11,37,48,41,18,0,31,38,81
Vernon Lewis,60.0,44,5,589,47,129,0.364341085271,1,9,0.111111111111,46,120,0.404,0.368217054264,15,25,0.6,54,100,154,27,34,6,22,84,110
Vernon Macklin,51.0,32,14,867,193,354,0.545197740113,0,1,0.0,193,353,1.083,0.545197740113,81,148,0.547297297297,112,154,266,48,21,28,68,74,467
Victor Avila,0.0,40,10,603,99,182,0.543956043956,0,0,0.0,99,182,0.544,0.543956043956,76,103,0.73786407767,61,83,144,8,11,9,42,103,274
Victor Claver,24.0,4,4,135,14,46,0.304347826087,3,20,0.15,11,26,0.423,0.336956521739,5,5,1.0,3,25,28,5,8,2,15,12,36
Victor Rudd,23.0,49,41,1529,277,642,0.431464174455,76,251,0.302788844622,201,391,0.514,0.490654205607,149,194,0.768041237113,61,270,331,123,44,18,96,148,779
Victor Williams,24.0,2,0,21,3,13,0.230769230769,0,3,0.0,3,10,0.3,0.230769230769,3,6,0.5,1,0,1,3,2,0,3,3,9
Vincent Grier,23.0,17,16,638,120,234,0.512820512821,4,10,0.4,116,224,0.518,0.521367521368,88,126,0.698412698413,31,69,100,64,22,3,42,50,332
Vincent Hunter,21.0,32,32,1020,261,443,0.589164785553,1,5,0.2,260,438,0.594,0.590293453725,174,264,0.659090909091,138,225,363,46,32,49,62,123,697
Vitor Faverani,25.0,4,4,129,27,50,0.54,7,13,0.538461538462,20,37,0.541,0.61,15,19,0.789473684211,9,35,44,12,2,5,15,16,76
Von Wafer,162.0,117,51,3160,722,1494,0.483266398929,229,519,0.441233140655,493,975,2.821,0.559906291834,250,336,0.744047619048,30,289,319,254,76,42,246,215,1923
Vonteego Cummings,29.0,24,23,803,102,235,0.434042553191,41,85,0.482352941176,61,150,0.407,0.521276595745,45,55,0.818181818182,15,71,86,111,37,4,40,83,290
Wade Baldwin,20.0,33,22,931,153,353,0.43342776204,23,74,0.310810810811,130,279,0.466,0.466005665722,98,131,0.748091603053,22,120,142,175,44,12,104,88,427
Walker Russell,285.0,241,176,7728,1062,2652,0.400452488688,180,577,0.311958405546,882,2075,4.129,0.434389140271,862,1047,0.823304680038,136,603,739,1697,329,18,753,465,3166
Wally Niang,20.0,5,0,18,1,7,0.142857142857,0,1,0.0,1,6,0.167,0.142857142857,2,2,1.0,1,3,4,0,0,1,3,6,4
Walter Craft,0.0,11,0,69,5,13,0.384615384615,0,1,0.0,5,12,0.417,0.384615384615,6,8,0.75,6,5,11,0,1,1,7,10,16
Walter Lemon Jr.,23.0,47,8,1163,251,541,0.463955637708,44,125,0.352,207,416,0.498,0.504621072089,90,121,0.743801652893,23,97,120,159,64,9,114,101,636
Walter Pitchford,23.0,5,1,72,4,17,0.235294117647,1,8,0.125,3,9,0.333,0.264705882353,2,4,0.5,4,18,22,0,1,1,4,7,11
Walter Sharpe,118.0,94,43,2153,374,905,0.413259668508,29,110,0.263636363636,345,795,2.183,0.429281767956,170,246,0.691056910569,156,352,508,118,66,82,179,291,947
Walter Tavares,116.0,106,75,2388,424,684,0.619883040936,0,2,0.0,424,682,2.955,0.619883040936,196,276,0.710144927536,321,536,857,93,65,325,194,336,1044
Wayne Chism,0.0,27,16,537,84,174,0.48275862069,0,2,0.0,84,172,0.488,0.48275862069,61,79,0.772151898734,64,85,149,27,21,22,36,78,229
Wayne Selden,22.0,35,21,1070,239,532,0.449248120301,76,218,0.348623853211,163,314,0.519,0.520676691729,93,143,0.65034965035,46,121,167,100,31,17,82,64,647
Wendell White,0.0,40,28,1122,209,403,0.518610421836,2,12,0.166666666667,207,391,0.529,0.521091811414,52,80,0.65,83,130,213,62,46,9,65,110,472
Wes Washpun,23.0,34,18,869,84,217,0.387096774194,25,83,0.301204819277,59,134,0.44,0.444700460829,35,59,0.593220338983,12,73,85,132,37,21,42,93,228
Wesley Saunders,89.0,122,18,2455,242,535,0.452336448598,4,25,0.16,238,510,1.703,0.456074766355,210,281,0.747330960854,154,353,507,300,87,20,131,202,698
Wesley Wilson,0.0,64,20,1320,242,450,0.537777777778,0,2,0.0,242,448,1.55,0.537777777778,72,104,0.692307692308,86,190,276,56,42,66,68,174,556
Wesley Witherspoon,0.0,52,8,758,64,184,0.347826086957,28,100,0.28,36,84,1.275,0.423913043478,90,138,0.652173913043,24,74,98,38,40,12,42,120,246
Will Barton,22.0,4,4,151,24,65,0.369230769231,6,23,0.260869565217,18,42,0.429,0.415384615385,13,15,0.866666666667,0,21,21,12,4,3,11,3,67
Will Blalock,182.0,239,160,6983,796,1840,0.432608695652,159,491,0.32382892057,637,1349,3.246,0.475815217391,415,561,0.739750445633,162,579,741,1297,278,27,503,433,2166
Will Bynum,57.0,51,48,1689,306,686,0.446064139942,51,170,0.3,255,516,0.972,0.483236151603,341,393,0.867684478372,27,115,142,335,85,5,217,164,1004
Will Cherry,0.0,18,12,546,80,179,0.446927374302,20,60,0.333333333333,60,119,0.504,0.502793296089,29,41,0.707317073171,5,61,66,81,25,4,34,47,209
Will Conroy,154.0,204,166,7690,1214,2589,0.468906913866,247,712,0.34691011236,967,1877,3.066,0.516608729239,871,1227,0.709861450693,207,779,986,1764,309,7,762,507,3546
Will Creekmore,0.0,13,0,100,8,28,0.285714285714,0,3,0.0,8,25,0.669,0.285714285714,3,6,0.5,6,16,22,4,3,5,6,18,19
Will Cummings,23.0,49,49,1780,321,682,0.470674486804,106,276,0.384057971014,215,406,0.53,0.548387096774,255,324,0.787037037037,42,134,176,235,94,3,151,160,1003
Will Daniels,0.0,31,13,802,163,296,0.550675675676,23,64,0.359375,140,232,0.603,0.589527027027,68,105,0.647619047619,50,95,145,45,28,45,56,90,417
Will Davis,24.0,42,6,763,176,288,0.611111111111,0,0,0.0,176,288,0.611,0.611111111111,57,76,0.75,84,98,182,16,11,48,32,63,409
Will Foster,0.0,114,12,1694,166,300,0.553333333333,0,6,0.0,166,294,2.931,0.553333333333,96,214,0.448598130841,238,312,550,42,22,244,114,174,428
Will Gibbs,0.0,2,0,8,0,2,0.0,0,0,0.0,0,2,0.0,0.0,1,2,0.5,0,2,2,0,0,0,0,0,1
Will Pippen,23.0,10,0,111,11,36,0.305555555556,4,14,0.285714285714,7,22,0.318,0.361111111111,2,4,0.5,2,5,7,7,5,1,6,7,28
Will Pratt,0.0,11,0,209,36,76,0.473684210526,0,6,0.0,36,70,0.514,0.473684210526,23,32,0.71875,11,13,24,8,8,1,17,30,95
Will Sheehey,94.0,72,27,1765,267,557,0.479353680431,67,182,0.368131868132,200,375,2.061,0.539497307002,110,132,0.833333333333,68,164,232,127,66,9,84,135,711
William Buford,147.0,156,24,3396,512,1182,0.433164128596,132,350,0.377142857143,380,832,2.743,0.489001692047,136,184,0.739130434783,86,428,514,196,102,18,172,304,1292
William Frisby,118.0,164,93,3471,630,1235,0.51012145749,7,13,0.538461538462,623,1222,2.002,0.512955465587,275,373,0.73726541555,318,543,861,210,88,89,273,540,1542
Willie Jenkins,0.0,74,24,1689,189,468,0.403846153846,52,178,0.292134831461,137,290,0.93,0.459401709402,127,156,0.814102564103,75,202,277,107,40,19,89,160,557
Willie Kemp,0.0,16,7,318,21,65,0.323076923077,3,13,0.230769230769,18,52,0.346,0.346153846154,7,11,0.636363636364,8,24,32,42,14,2,24,28,52
Willie Reed,163.0,240,172,7623,1581,2681,0.589705333831,0,3,0.0,1581,2678,4.212,0.589705333831,532,914,0.582056892779,971,1515,2486,237,142,427,332,667,3694
Willie Warren,43.0,26,5,649,128,289,0.442906574394,43,113,0.380530973451,85,176,0.965,0.517301038062,142,167,0.850299401198,18,66,84,121,22,2,74,53,441
Wink Adams,0.0,19,7,417,48,119,0.403361344538,10,37,0.27027027027,38,82,0.927,0.445378151261,6,8,0.75,6,43,49,48,25,0,26,31,112
Xavier Alexander,74.0,129,33,2908,327,797,0.410288582183,54,195,0.276923076923,273,602,1.364,0.444165621079,198,358,0.553072625698,186,362,548,218,127,45,160,288,906
Xavier Ford,23.0,38,1,435,43,96,0.447916666667,0,7,0.0,43,89,0.483,0.447916666667,16,21,0.761904761905,24,31,55,13,12,4,20,51,102
Xavier Henry,114.0,24,4,479,97,227,0.42731277533,24,69,0.347826086957,73,158,2.257,0.480176211454,117,151,0.774834437086,15,53,68,23,26,8,38,56,335
Xavier Munford,69.0,118,82,3528,679,1480,0.458783783784,162,461,0.351409978308,517,1019,1.523,0.513513513514,385,480,0.802083333333,57,416,473,555,119,39,324,256,1905
Xavier Silas,106.0,140,92,4105,617,1486,0.415208613728,255,692,0.368497109827,362,794,1.829,0.501009421265,418,490,0.85306122449,71,359,430,245,125,27,212,364,1907
Xavier Thames,49.0,66,27,1552,199,485,0.410309278351,60,182,0.32967032967,139,303,0.931,0.472164948454,82,111,0.738738738739,29,137,166,183,63,9,68,104,540
Yanick Moreira,25.0,48,7,908,151,319,0.473354231975,0,2,0.0,151,317,0.476,0.473354231975,89,128,0.6953125,102,198,300,71,29,23,51,105,391
Yaroslav Korolev,66.0,94,26,2122,326,756,0.431216931217,78,212,0.367924528302,248,544,1.366,0.482804232804,252,354,0.71186440678,148,368,516,110,96,56,136,220,982
Yemi Nicholson,0.0,7,1,62,6,16,0.375,0,0,0.0,6,16,0.375,0.375,4,6,0.666666666667,3,4,7,3,0,2,2,8,16
Yemi Ogunoye,0.0,181,61,4731,332,827,0.401451027811,59,161,0.366459627329,273,666,2.187,0.437122128174,162,246,0.658536585366,253,352,605,226,161,82,127,277,885
Yi Jianlian,24.0,2,2,73,18,38,0.473684210526,0,1,0.0,18,37,0.486,0.473684210526,10,17,0.588235294118,8,16,24,5,2,4,6,3,46
Yogi Ferrell,23.0,18,18,642,111,263,0.422053231939,49,123,0.39837398374,62,140,0.443,0.515209125475,65,72,0.902777777778,11,42,53,104,27,2,38,50,336
Youssou Ndoye,24.0,49,14,941,129,226,0.570796460177,0,1,0.0,129,225,0.573,0.570796460177,128,177,0.723163841808,112,231,343,40,22,56,84,96,386
Yuki Togashi,21.0,24,1,207,18,42,0.428571428571,10,22,0.454545454545,8,20,0.4,0.547619047619,4,6,0.666666666667,3,7,10,24,4,0,11,20,50
Yuta Tabuse,78.0,117,7,2097,262,656,0.399390243902,39,130,0.3,223,526,1.257,0.429115853659,100,127,0.787401574803,52,127,179,366,107,2,126,181,663
Zabian Dowdell,51.0,28,20,798,147,328,0.448170731707,17,60,0.283333333333,130,268,1.028,0.474085365854,79,104,0.759615384615,14,54,68,119,52,2,51,64,390
Zach Andrews,172.0,129,63,2691,393,656,0.599085365854,6,20,0.3,387,636,3.487,0.603658536585,137,263,0.520912547529,266,473,739,101,119,102,140,363,929
Zach Graham,0.0,43,23,1023,151,329,0.45896656535,43,113,0.380530973451,108,216,0.5,0.524316109422,124,143,0.867132867133,32,107,139,40,18,8,60,69,469
Zach Sowers,0.0,2,0,8,0,2,0.0,0,1,0.0,0,1,0.0,0.0,0,0,0.0,0,0,0,0,0,0,0,1,0
Zane Johnson,0.0,2,0,35,4,8,0.5,1,4,0.25,3,4,0.75,0.5625,1,1,1.0,0,3,3,1,1,0,2,5,10
Zeke Marshall,0.0,40,13,731,81,159,0.509433962264,0,0,0.0,81,159,0.509,0.509433962264,58,92,0.630434782609,77,122,199,17,21,71,38,117,220
Zeke Upshaw,25.0,34,13,739,71,199,0.356783919598,56,146,0.383561643836,15,53,0.283,0.497487437186,22,33,0.666666666667,18,85,103,30,16,7,20,60,220
Zendon Hamilton,36.0,12,1,207,26,63,0.412698412698,0,0,0.0,26,63,0.413,0.412698412698,30,43,0.697674418605,24,36,60,5,4,3,18,35,82
Zoran Dragic,25.0,4,1,117,21,55,0.381818181818,9,23,0.391304347826,12,32,0.375,0.463636363636,15,20,0.75,4,9,13,13,6,1,15,13,66
omm'A Givens,0.0,23,8,263,26,80,0.325,0,0,0.0,26,80,0.325,0.325,18,22,0.818181818182,15,34,49,4,7,4,14,53,70
