Player,Tm,Age,G,GS,MP,FG,FGA,FG%,3P,3PA,3P%,2P,2PA,2P%,eFG%,FT,FTA,FT%,ORB,DRB,TRB,AST,STL,BLK,TOV,PF,PTS,Yr
Q. Acy,TEX,26.0,12,12,383,68,136,0.5,16,41,0.39,52,95,0.547,0.559,55,72,0.764,18,80,98,14,19,24,33,41,207,2017
C. Alexander,TOT,21.0,40,13,1082,257,497,0.517,8,33,0.242,249,464,0.537,0.525,110,150,0.733,75,280,355,54,18,40,106,93,632,2017
C. Alexander,LIN,21.0,18,6,544,150,262,0.573,8,27,0.296,142,235,0.604,0.588,62,82,0.756,38,141,179,32,10,14,50,40,370,2017
C. Alexander,ERI,21.0,22,7,538,107,235,0.455,0,6,0.0,107,229,0.467,0.455,48,68,0.706,37,139,176,22,8,26,56,53,262,2017
D. Alexander,NAS,25.0,15,4,193,22,56,0.393,9,27,0.333,13,29,0.448,0.473,3,4,0.75,6,35,41,13,8,3,10,33,56,2017
C. Anderson,GRR,24.0,39,19,668,82,147,0.558,3,11,0.273,79,136,0.581,0.568,43,62,0.694,86,105,191,25,26,37,34,137,210,2017
M. Anderson,SWR,25.0,28,6,427,21,64,0.328,12,43,0.279,9,21,0.429,0.422,10,14,0.714,10,43,53,34,12,3,17,56,64,2017
R. Arcidiacono,AUS,22.0,47,34,1293,108,229,0.472,40,95,0.421,68,134,0.507,0.559,48,59,0.814,24,152,176,177,41,5,76,97,304,2017
J. Avila,TEX,25.0,20,2,275,52,107,0.486,7,30,0.233,45,77,0.584,0.519,14,19,0.737,24,64,88,34,15,6,12,35,125,2017
J. Avila,WCB,25.0,21,16,582,89,201,0.443,23,63,0.365,66,138,0.478,0.5,21,25,0.84,36,88,124,42,24,14,27,76,222,2017
J. Avila,TOT,25.0,41,18,857,141,308,0.458,30,93,0.323,111,215,0.516,0.506,35,44,0.795,60,152,212,76,39,20,39,111,347,2017
C. Ayers,REN,25.0,7,0,109,7,27,0.259,5,22,0.227,2,5,0.4,0.352,4,4,1.0,1,4,5,3,2,0,2,6,23,2017
C. Ayers,MAI,25.0,26,4,535,40,130,0.308,34,106,0.321,6,24,0.25,0.438,6,7,0.857,14,39,53,25,13,3,15,21,120,2017
C. Ayers,TOT,25.0,33,4,644,47,157,0.299,39,128,0.305,8,29,0.276,0.424,10,11,0.909,15,43,58,28,15,3,17,27,143,2017
J. Ayres,LOS,29.0,22,10,504,108,162,0.667,2,5,0.4,106,157,0.675,0.673,64,69,0.928,48,110,158,16,7,15,30,74,282,2017
R. Baker,WES,23.0,4,4,144,17,40,0.425,8,18,0.444,9,22,0.409,0.525,8,14,0.571,3,18,21,28,11,2,14,11,50,2017
G. Bakumanya,NAS,19.0,40,13,416,48,102,0.471,0,0,0.0,48,102,0.471,0.471,13,18,0.722,52,78,130,13,12,10,21,72,109,2017
W. Baldwin,IOW,20.0,33,22,931,153,353,0.433,23,74,0.311,130,279,0.466,0.466,98,131,0.748,22,120,142,175,44,12,104,88,427,2017
C. Barber,SWR,22.0,19,18,717,137,324,0.423,22,69,0.319,115,255,0.451,0.457,62,85,0.729,8,45,53,105,22,0,58,46,358,2017
C. Barber,DEL,22.0,21,21,654,111,254,0.437,17,45,0.378,94,209,0.45,0.47,59,87,0.678,8,67,75,81,22,3,66,56,298,2017
C. Barber,TOT,22.0,40,39,1371,248,578,0.429,39,114,0.342,209,464,0.45,0.463,121,172,0.703,16,112,128,186,44,3,124,102,656,2017
P. Bass,ERI,,15,0,178,23,68,0.338,6,15,0.4,17,53,0.321,0.382,6,14,0.429,16,25,41,12,3,10,16,25,58,2017
M. Beasley,SFL,20.0,16,12,497,108,236,0.458,30,81,0.37,78,155,0.503,0.521,56,63,0.889,23,98,121,41,17,2,34,31,302,2017
B. Beech,LIN,22.0,36,12,695,87,236,0.369,52,142,0.366,35,94,0.372,0.479,39,50,0.78,23,77,100,44,39,5,37,102,265,2017
C. Behanan,SLS,24.0,16,0,257,53,98,0.541,0,1,0.0,53,97,0.546,0.541,31,44,0.705,46,46,92,14,13,2,19,36,137,2017
C. Behanan,REN,24.0,19,4,321,65,130,0.5,1,5,0.2,64,125,0.512,0.504,36,56,0.643,36,48,84,11,15,2,30,47,167,2017
C. Behanan,TOT,24.0,35,4,578,118,228,0.518,1,6,0.167,117,222,0.527,0.52,67,100,0.67,82,94,176,25,28,4,49,83,304,2017
D. Bembry,SLS,22.0,6,5,189,40,74,0.541,6,16,0.375,34,58,0.586,0.581,11,20,0.55,9,29,38,21,9,6,15,10,97,2017
A. Bennett,LIN,23.0,2,2,70,14,28,0.5,6,13,0.462,8,15,0.533,0.607,2,4,0.5,6,10,16,7,4,2,6,4,36,2017
K. Benson,SFL,28.0,50,50,1597,418,694,0.602,3,7,0.429,415,687,0.604,0.604,185,240,0.771,166,360,526,35,32,111,80,196,1024,2017
B. Bentil,FOR,21.0,20,4,434,77,212,0.363,27,87,0.31,50,125,0.4,0.427,60,75,0.8,24,67,91,12,15,5,27,40,241,2017
D. Bertans,AUS,24.0,4,4,124,16,42,0.381,13,33,0.394,3,9,0.333,0.536,14,14,1.0,3,11,14,9,7,7,10,11,59,2017
G. Beverly,CAN,23.0,40,1,464,74,125,0.592,2,5,0.4,72,120,0.6,0.6,40,59,0.678,66,70,136,4,8,17,10,63,190,2017
D. Blair,TOT,27.0,19,3,364,91,185,0.492,0,1,0.0,91,184,0.495,0.492,28,48,0.583,50,62,112,14,11,5,28,70,210,2017
D. Blair,TEX,27.0,6,0,98,29,60,0.483,0,1,0.0,29,59,0.492,0.483,6,12,0.5,12,21,33,3,2,3,7,24,64,2017
D. Blair,LOS,27.0,13,3,266,62,125,0.496,0,0,0.0,62,125,0.496,0.496,22,36,0.611,38,41,79,11,9,2,21,46,146,2017
J. Bland,SLS,23.0,39,10,736,72,230,0.313,63,198,0.318,9,32,0.281,0.45,13,19,0.684,6,74,80,31,25,2,21,62,220,2017
V. Blue,LOS,24.0,47,46,1638,359,826,0.435,85,242,0.351,274,584,0.469,0.486,363,450,0.807,43,197,240,141,76,3,99,100,1166,2017
M. Bolden,AUS,27.0,26,0,227,32,79,0.405,5,21,0.238,27,58,0.466,0.437,16,20,0.8,17,40,57,14,8,7,11,26,85,2017
J. Bolomboy,SLS,23.0,24,22,826,137,252,0.544,22,47,0.468,115,205,0.561,0.587,103,146,0.705,112,207,319,43,16,30,53,59,399,2017
J. Bond,WES,23.0,45,4,837,149,314,0.475,14,36,0.389,135,278,0.486,0.497,26,56,0.464,114,171,285,59,31,9,37,122,338,2017
A. Booker,NAS,23.0,42,40,1333,230,586,0.392,76,221,0.344,154,365,0.422,0.457,112,158,0.709,38,133,171,224,50,4,104,109,648,2017
J. Branch,REN,24.0,25,0,342,45,115,0.391,4,17,0.235,41,98,0.418,0.409,18,21,0.857,5,35,40,53,15,3,42,39,112,2017
D. Brooks,WCB,24.0,3,0,36,2,13,0.154,0,4,0.0,2,9,0.222,0.154,1,2,0.5,0,6,6,8,1,2,3,3,5,2017
D. Brooks,TOT,24.0,15,1,278,31,94,0.33,4,22,0.182,27,72,0.375,0.351,20,25,0.8,9,26,35,50,14,3,20,34,86,2017
D. Brooks,LIN,24.0,12,1,242,29,81,0.358,4,18,0.222,25,63,0.397,0.383,19,23,0.826,9,20,29,42,13,1,17,31,81,2017
A. Brown,WCB,24.0,50,47,1168,215,452,0.476,56,154,0.364,159,298,0.534,0.538,47,58,0.81,104,157,261,44,37,95,53,162,533,2017
A. Brown,ERI,24.0,24,24,906,165,354,0.466,57,122,0.467,108,232,0.466,0.547,101,125,0.808,15,115,130,75,24,4,76,65,488,2017
J. Brown,SAN,24.0,9,0,243,61,117,0.521,28,51,0.549,33,66,0.5,0.641,51,58,0.879,4,30,34,27,3,2,22,16,201,2017
L. Brown,GRR,26.0,11,9,393,96,203,0.473,18,51,0.353,78,152,0.513,0.517,50,64,0.781,21,64,85,44,19,5,19,21,260,2017
N. Brussino,TEX,23.0,5,5,179,27,43,0.628,13,25,0.52,14,18,0.778,0.779,16,19,0.842,8,30,38,24,8,6,9,12,83,2017
M. Bryson,NAS,22.0,46,2,824,82,215,0.381,50,132,0.379,32,83,0.386,0.498,20,27,0.741,20,92,112,37,19,39,20,85,234,2017
A. Burks,SLS,25.0,1,1,21,5,17,0.294,1,8,0.125,4,9,0.444,0.324,2,3,0.667,2,3,5,3,1,0,3,2,13,2017
T. Burrell,LIN,24.0,49,36,1492,255,518,0.492,44,124,0.355,211,394,0.536,0.535,86,115,0.748,117,214,331,163,69,28,106,136,640,2017
D. Byars,DEL,32.0,13,0,226,20,61,0.328,4,33,0.121,16,28,0.571,0.361,4,6,0.667,6,26,32,13,2,3,6,12,48,2017
W. Bynum,WCB,34.0,22,20,595,100,246,0.407,26,87,0.299,74,159,0.465,0.459,81,88,0.92,8,51,59,142,37,3,52,63,307,2017
B. Caboclo,RAP,21.0,34,33,920,133,323,0.412,52,157,0.331,81,166,0.488,0.492,19,29,0.655,38,147,185,43,34,42,44,76,337,2017
J. Calliste,MAI,27.0,19,0,319,27,61,0.443,21,46,0.457,6,15,0.4,0.615,17,18,0.944,6,37,43,23,6,0,17,19,92,2017
K. Capers,WES,23.0,48,16,1100,135,361,0.374,28,95,0.295,107,266,0.402,0.413,132,167,0.79,15,84,99,112,70,9,78,143,430,2017
A. Caruso,OKL,22.0,50,46,1513,204,444,0.459,61,152,0.401,143,292,0.49,0.528,125,167,0.749,42,153,195,260,108,28,156,132,594,2017
Q. Chievous,IOW,24.0,48,17,1165,167,310,0.539,21,60,0.35,146,250,0.584,0.573,62,122,0.508,65,175,240,83,24,18,69,135,417,2017
D. Christmas,DEL,30.0,31,31,980,157,360,0.436,62,169,0.367,95,191,0.497,0.522,86,107,0.804,18,89,107,99,27,7,81,75,462,2017
R. Christmas,FOR,25.0,9,8,207,32,68,0.471,0,0,0.0,32,68,0.471,0.471,21,33,0.636,20,32,52,5,2,12,15,34,85,2017
S. Christon,OKL,24.0,4,4,133,24,64,0.375,2,4,0.5,22,60,0.367,0.391,22,28,0.786,2,13,15,21,7,1,15,10,72,2017
D. Clifford,SAN,24.0,38,34,990,171,289,0.592,0,0,0.0,171,289,0.592,0.592,111,172,0.645,79,230,309,77,23,39,101,120,453,2017
K. Collinsworth,TEX,25.0,36,16,983,97,225,0.431,12,41,0.293,85,184,0.462,0.458,28,51,0.549,97,156,253,139,63,32,46,92,234,2017
D. Cooke Jr.,NAS,25.0,50,10,1069,165,297,0.556,0,3,0.0,165,294,0.561,0.556,44,96,0.458,168,209,377,39,43,28,56,123,374,2017
E. Cook,SAN,24.0,20,1,465,116,207,0.56,8,24,0.333,108,183,0.59,0.58,84,108,0.778,40,65,105,19,20,9,31,63,324,2017
Q. Cook,CAN,23.0,39,38,1502,352,740,0.476,97,261,0.372,255,479,0.532,0.541,213,238,0.895,20,138,158,260,44,3,142,95,1014,2017
T. Cooney,LIN,24.0,22,4,293,29,77,0.377,13,45,0.289,16,32,0.5,0.461,7,9,0.778,3,19,22,16,5,5,11,21,78,2017
R. Cooper,MAI,23.0,3,0,13,0,1,0.0,0,1,0.0,0,0,0.0,0.0,0,0,0.0,1,3,4,1,1,0,1,1,0,2017
M. Costello,IOW,23.0,23,14,582,85,166,0.512,7,38,0.184,78,128,0.609,0.533,41,53,0.774,80,154,234,43,13,38,38,72,218,2017
I. Cousins,REN,22.0,50,50,1744,332,730,0.455,41,141,0.291,291,589,0.494,0.483,144,182,0.791,52,236,288,201,92,10,116,150,849,2017
J. Cousins,TOT,23.0,31,12,383,49,107,0.458,0,0,0.0,49,107,0.458,0.458,61,92,0.663,33,59,92,3,10,20,30,90,159,2017
J. Cousins,TEX,23.0,15,0,158,17,38,0.447,0,0,0.0,17,38,0.447,0.447,17,29,0.586,13,15,28,1,4,6,14,42,51,2017
J. Cousins,REN,23.0,16,12,225,32,69,0.464,0,0,0.0,32,69,0.464,0.464,44,63,0.698,20,44,64,2,6,14,16,48,108,2017
C. Crawford,IOW,24.0,3,0,50,9,23,0.391,3,11,0.273,6,12,0.5,0.457,1,2,0.5,1,2,3,11,2,2,7,4,22,2017
J. Crawford,GRR,28.0,37,17,1103,316,668,0.473,97,273,0.355,219,395,0.554,0.546,140,161,0.87,15,108,123,129,43,6,71,68,869,2017
J. Crawford,WES,26.0,31,9,728,124,282,0.44,27,64,0.422,97,218,0.445,0.488,66,87,0.759,8,55,63,89,32,1,45,60,341,2017
J. Crawford,TOT,26.0,46,12,987,154,373,0.413,36,97,0.371,118,276,0.428,0.461,83,107,0.776,12,74,86,125,48,1,72,84,427,2017
J. Crawford,CAN,26.0,15,3,259,30,91,0.33,9,33,0.273,21,58,0.362,0.379,17,20,0.85,4,19,23,36,16,0,27,24,86,2017
S. Croone,SFL,,3,0,22,1,6,0.167,1,4,0.25,0,2,0.0,0.25,4,7,0.571,1,2,3,1,1,0,1,3,7,2017
M. Cummings,SFL,28.0,7,0,62,7,14,0.5,1,5,0.2,6,9,0.667,0.536,2,2,1.0,2,5,7,0,2,1,3,10,17,2017
B. Dallo,LIN,22.0,46,19,1082,142,336,0.423,24,93,0.258,118,243,0.486,0.458,54,77,0.701,35,162,197,179,34,2,130,58,362,2017
A. Davis,TOT,25.0,51,39,1256,142,312,0.455,15,38,0.395,127,274,0.464,0.479,100,146,0.685,96,152,248,47,33,78,74,174,399,2017
A. Davis,NAS,25.0,23,21,560,61,136,0.449,4,13,0.308,57,123,0.463,0.463,46,64,0.719,49,64,113,23,18,44,33,81,172,2017
A. Davis,ERI,25.0,28,18,696,81,176,0.46,11,25,0.44,70,151,0.464,0.491,54,82,0.659,47,88,135,24,15,34,41,93,227,2017
D. Davis,IOW,,11,10,306,55,100,0.55,0,0,0.0,55,100,0.55,0.55,6,9,0.667,33,62,95,5,10,26,9,28,116,2017
M. Davis,WES,28.0,24,0,312,44,77,0.571,0,1,0.0,44,76,0.579,0.571,11,15,0.733,25,45,70,15,8,8,9,35,99,2017
T. Davis,CAN,23.0,1,0,19,0,3,0.0,0,1,0.0,0,2,0.0,0.0,0,0,0.0,0,1,1,2,0,0,1,1,0,2017
W. Davis,REN,24.0,42,6,763,176,288,0.611,0,0,0.0,176,288,0.611,0.611,57,76,0.75,84,98,182,16,11,48,32,63,409,2017
A. Dawkins,TOT,25.0,42,3,956,174,403,0.432,115,277,0.415,59,126,0.468,0.574,39,52,0.75,19,82,101,37,26,5,37,70,502,2017
A. Dawkins,TEX,25.0,28,3,653,124,278,0.446,86,193,0.446,38,85,0.447,0.601,29,34,0.853,15,64,79,22,20,5,28,46,363,2017
A. Dawkins,WCB,25.0,14,0,303,50,125,0.4,29,84,0.345,21,41,0.512,0.516,10,18,0.556,4,18,22,15,6,0,9,24,139,2017
B. Dawson,ERI,23.0,33,13,877,189,384,0.492,0,4,0.0,189,380,0.497,0.492,48,90,0.533,94,141,235,53,55,21,62,68,426,2017
E. Dawson,SLS,32.0,2,2,51,4,12,0.333,0,0,0.0,4,12,0.333,0.333,5,6,0.833,5,15,20,3,3,2,6,6,13,2017
C. DeBerry,WCB,22.0,12,0,113,13,28,0.464,0,0,0.0,13,28,0.464,0.464,7,12,0.583,9,18,27,5,4,4,8,20,33,2017
D. Deng,TEX,25.0,3,0,28,5,16,0.313,0,2,0.0,5,14,0.357,0.313,3,4,0.75,4,8,12,2,0,1,3,5,13,2017
T. Devries,LOS,34.0,48,20,1139,172,398,0.432,106,244,0.434,66,154,0.429,0.565,41,54,0.759,13,85,98,84,36,4,54,92,491,2017
C. Diallo,TOT,20.0,26,21,724,167,333,0.502,0,4,0.0,167,329,0.508,0.502,55,73,0.753,46,174,220,18,14,63,43,90,389,2017
C. Diallo,SWR,20.0,15,15,479,109,224,0.487,0,3,0.0,109,221,0.493,0.487,39,50,0.78,30,127,157,13,8,42,31,58,257,2017
C. Diallo,LIN,20.0,2,0,35,11,17,0.647,0,0,0.0,11,17,0.647,0.647,2,4,0.5,1,8,9,1,1,2,2,9,24,2017
C. Diallo,AUS,20.0,9,6,210,47,92,0.511,0,1,0.0,47,91,0.516,0.511,14,19,0.737,15,39,54,4,5,19,10,23,108,2017
S. Dinwiddie,WCB,23.0,9,9,337,57,119,0.479,12,29,0.414,45,90,0.5,0.529,49,61,0.803,3,30,33,73,20,5,25,28,175,2017
Q. Douby,WES,32.0,2,1,34,3,13,0.231,1,5,0.2,2,8,0.25,0.269,2,2,1.0,0,1,1,3,3,0,1,4,9,2017
L. Drew,SFL,26.0,10,1,237,31,65,0.477,14,35,0.4,17,30,0.567,0.585,5,7,0.714,4,23,27,59,7,1,22,23,81,2017
T. Drisdom,SAN,24.0,43,17,770,84,184,0.457,13,44,0.295,71,140,0.507,0.492,37,47,0.787,36,120,156,60,31,24,27,56,218,2017
D. Dukan,WCB,25.0,25,7,530,79,180,0.439,40,93,0.43,39,87,0.448,0.55,43,67,0.642,25,60,85,20,9,2,23,57,241,2017
K. Dunham,IOW,23.0,35,16,598,60,144,0.417,30,83,0.361,30,61,0.492,0.521,20,21,0.952,11,59,70,21,17,6,30,28,170,2017
M. Dunigan,CAN,25.0,39,11,653,101,237,0.426,0,2,0.0,101,235,0.43,0.426,91,124,0.734,57,96,153,18,34,43,42,114,293,2017
C. Early,SAN,25.0,14,0,248,52,105,0.495,13,30,0.433,39,75,0.52,0.557,23,36,0.639,15,45,60,10,8,14,15,31,140,2017
J. Eddie,WCB,25.0,20,13,601,127,254,0.5,68,138,0.493,59,116,0.509,0.634,33,39,0.846,13,76,89,40,10,11,27,40,355,2017
J. Eddie,TOT,25.0,45,27,1273,222,483,0.46,114,275,0.415,108,208,0.519,0.578,75,87,0.862,26,151,177,69,26,18,78,83,633,2017
J. Eddie,AUS,25.0,25,14,672,95,229,0.415,46,137,0.336,49,92,0.533,0.515,42,48,0.875,13,75,88,29,16,7,51,43,278,2017
A. Edwards,MAI,24.0,47,3,967,119,288,0.413,60,181,0.331,59,107,0.551,0.517,56,73,0.767,27,150,177,57,40,33,78,86,354,2017
S. Edwards,DEL,,8,1,204,35,76,0.461,2,15,0.133,33,61,0.541,0.474,21,31,0.677,8,48,56,3,1,9,10,13,93,2017
H. Ellenson,GRR,20.0,21,21,740,127,305,0.416,38,116,0.328,89,189,0.471,0.479,83,103,0.806,33,154,187,28,12,18,40,55,375,2017
P. Ellis,SWR,23.0,50,12,1122,179,395,0.453,41,109,0.376,138,286,0.483,0.505,90,117,0.769,80,157,237,46,29,8,38,74,489,2017
C. Evans,CAN,26.0,33,28,1137,203,451,0.45,56,156,0.359,147,295,0.498,0.512,121,171,0.708,63,108,171,78,64,20,78,103,583,2017
K. Felder,CAN,21.0,11,11,396,119,255,0.467,20,55,0.364,99,200,0.495,0.506,71,86,0.826,8,29,37,66,17,4,46,33,329,2017
C. Felicio,WCB,24.0,1,1,38,8,16,0.5,0,0,0.0,8,16,0.5,0.5,4,5,0.8,5,7,12,1,1,2,6,4,20,2017
C. Felix,LIN,26.0,34,21,780,117,268,0.437,20,81,0.247,97,187,0.519,0.474,54,91,0.593,44,88,132,47,40,16,53,99,308,2017
C. Fells,TEX,30.0,10,8,279,32,82,0.39,11,41,0.268,21,41,0.512,0.457,2,2,1.0,6,23,29,17,23,6,11,20,77,2017
C. Fells,WES,30.0,30,26,924,140,319,0.439,55,155,0.355,85,164,0.518,0.525,39,49,0.796,17,111,128,91,53,22,63,67,374,2017
C. Fells,TOT,30.0,40,34,1203,172,401,0.429,66,196,0.337,106,205,0.517,0.511,41,51,0.804,23,134,157,108,76,28,74,87,451,2017
V. Fernandez,SWR,25.0,5,0,33,1,4,0.25,0,0,0.0,1,4,0.25,0.25,2,2,1.0,4,4,8,0,0,0,3,6,4,2017
V. Fernandez,SFL,25.0,27,0,213,14,28,0.5,0,0,0.0,14,28,0.5,0.5,2,3,0.667,23,31,54,3,5,20,14,48,30,2017
V. Fernandez,TOT,25.0,32,0,246,15,32,0.469,0,0,0.0,15,32,0.469,0.469,4,5,0.8,27,35,62,3,5,20,17,54,34,2017
Y. Ferrell,LIN,23.0,18,18,642,111,263,0.422,49,123,0.398,62,140,0.443,0.515,65,72,0.903,11,42,53,104,27,2,38,50,336,2017
B. Fonville,TEX,22.0,49,7,797,98,229,0.428,29,81,0.358,69,148,0.466,0.491,9,15,0.6,16,39,55,121,32,5,56,82,234,2017
B. Forbes,AUS,23.0,19,19,674,158,315,0.502,56,122,0.459,102,193,0.528,0.59,73,84,0.869,7,59,66,51,25,2,47,43,445,2017
G. Forbes,LIN,31.0,20,3,394,48,140,0.343,24,73,0.329,24,67,0.358,0.429,20,25,0.8,16,36,52,25,8,1,23,48,140,2017
Q. Ford,SLS,24.0,26,15,505,41,120,0.342,18,64,0.281,23,56,0.411,0.417,20,24,0.833,21,96,117,38,24,10,24,46,120,2017
D. Foster,LOS,28.0,30,8,335,38,77,0.494,1,1,1.0,37,76,0.487,0.5,5,7,0.714,31,63,94,5,5,50,13,59,82,2017
C. Fowler,FOR,,5,0,48,7,13,0.538,1,2,0.5,6,11,0.545,0.577,7,10,0.7,0,2,2,7,2,2,4,8,22,2017
T. Freeman,GRR,24.0,39,18,886,88,236,0.373,27,83,0.325,61,153,0.399,0.43,18,24,0.75,10,106,116,87,27,4,28,63,221,2017
S. Gaines,SLS,30.0,46,30,1269,244,561,0.435,92,238,0.387,152,323,0.471,0.517,90,153,0.588,47,180,227,177,75,11,96,87,670,2017
R. Galloway,ERI,25.0,21,9,555,75,193,0.389,16,67,0.239,59,126,0.468,0.43,38,49,0.776,11,48,59,68,23,2,47,39,204,2017
C. Garcia,AUS,28.0,49,1,1075,242,436,0.555,1,2,0.5,241,434,0.555,0.556,187,278,0.673,65,191,256,56,15,28,112,147,672,2017
P. Garino,AUS,23.0,49,46,1429,202,432,0.468,58,135,0.43,144,297,0.485,0.535,86,112,0.768,19,149,168,101,73,34,115,131,548,2017
E. Gary,TOT,25.0,7,0,108,16,38,0.421,7,16,0.438,9,22,0.409,0.513,1,2,0.5,1,15,16,10,1,0,7,9,40,2017
E. Gary,SLS,25.0,4,0,73,9,27,0.333,6,12,0.5,3,15,0.2,0.444,1,2,0.5,0,13,13,8,0,0,6,6,25,2017
E. Gary,IOW,25.0,3,0,35,7,11,0.636,1,4,0.25,6,7,0.857,0.682,0,0,0.0,1,2,3,2,1,0,1,3,15,2017
M. Gatens,IOW,27.0,2,2,31,2,7,0.286,2,6,0.333,0,1,0.0,0.429,0,0,0.0,2,3,5,0,3,0,2,1,6,2017
M. Gbinije,GRR,24.0,16,16,560,69,164,0.421,31,93,0.333,38,71,0.535,0.515,23,32,0.719,13,56,69,28,30,4,19,24,192,2017
M. Georges-Hunt,MAI,22.0,45,40,1639,240,520,0.462,74,189,0.392,166,331,0.502,0.533,159,179,0.888,48,233,281,200,46,15,90,118,713,2017
A. Goodwin,SWR,22.0,34,33,1112,189,432,0.438,23,98,0.235,166,334,0.497,0.464,178,246,0.724,52,126,178,78,41,10,81,71,579,2017
B. Gordon,TEX,33.0,25,17,737,130,280,0.464,72,158,0.456,58,122,0.475,0.593,47,53,0.887,5,62,67,85,23,6,42,62,379,2017
P. Graham,GRR,31.0,1,0,6,0,2,0.0,0,1,0.0,0,1,0.0,0.0,1,2,0.5,0,1,1,3,0,0,0,0,1,2017
J. Grant,WCB,24.0,2,2,83,19,42,0.452,3,11,0.273,16,31,0.516,0.488,13,16,0.813,2,6,8,16,5,1,7,4,54,2017
J. Gray,NAS,23.0,50,9,1254,268,603,0.444,39,109,0.358,229,494,0.464,0.477,96,144,0.667,56,122,178,227,72,4,109,101,671,2017
B. Greene,TOT,22.0,24,0,243,33,72,0.458,15,37,0.405,18,35,0.514,0.563,13,16,0.813,3,43,46,9,3,1,19,21,94,2017
B. Greene,SLS,22.0,9,0,92,9,28,0.321,2,16,0.125,7,12,0.583,0.357,0,0,0.0,2,16,18,3,1,1,6,11,20,2017
B. Greene,DEL,22.0,15,0,151,24,44,0.545,13,21,0.619,11,23,0.478,0.693,13,16,0.813,1,27,28,6,2,0,13,10,74,2017
C. Griffin,REN,23.0,15,0,146,17,34,0.5,1,1,1.0,16,33,0.485,0.515,10,17,0.588,13,15,28,2,5,1,7,14,45,2017
J. Hagins,MAI,,20,3,324,36,84,0.429,16,43,0.372,20,41,0.488,0.524,12,12,1.0,7,46,53,51,11,4,20,22,100,2017
P. Hairston,RIO,24.0,10,4,232,36,112,0.321,17,73,0.233,19,39,0.487,0.397,29,34,0.853,2,21,23,16,14,2,17,29,118,2017
F. Hall,WCB,26.0,36,1,697,98,232,0.422,17,60,0.283,81,172,0.471,0.459,23,36,0.639,31,80,111,29,14,12,36,104,236,2017
F. Hall,TOT,26.0,46,9,851,112,276,0.406,22,76,0.289,90,200,0.45,0.446,31,47,0.66,37,104,141,38,17,14,48,124,277,2017
F. Hall,SAN,26.0,10,8,154,14,44,0.318,5,16,0.313,9,28,0.321,0.375,8,11,0.727,6,24,30,9,3,2,12,20,41,2017
A. Hamilton,SAN,23.0,43,5,1004,165,362,0.456,12,53,0.226,153,309,0.495,0.472,148,212,0.698,32,114,146,193,49,7,97,67,490,2017
D. Hamilton,OKL,21.0,49,47,1528,262,615,0.426,96,257,0.374,166,358,0.464,0.504,112,146,0.767,58,336,394,226,63,16,142,96,732,2017
A. Hammons,TEX,24.0,15,14,385,80,156,0.513,5,20,0.25,75,136,0.551,0.529,16,20,0.8,29,83,112,17,5,30,21,69,181,2017
T. Hansbrough,FOR,,13,11,434,75,138,0.543,3,9,0.333,72,129,0.558,0.554,76,98,0.776,56,103,159,9,10,6,23,35,229,2017
J. Harper,LOS,27.0,45,45,1304,261,542,0.482,104,254,0.409,157,288,0.545,0.577,113,146,0.774,67,236,303,63,13,27,56,120,739,2017
A. Harrison,TOT,22.0,39,29,1260,216,494,0.437,73,181,0.403,143,313,0.457,0.511,176,213,0.826,24,156,180,103,52,13,77,108,681,2017
A. Harrison,SWR,22.0,20,14,663,103,263,0.392,33,98,0.337,70,165,0.424,0.454,119,145,0.821,15,84,99,59,26,7,47,58,358,2017
A. Harrison,DEL,22.0,19,15,597,113,231,0.489,40,83,0.482,73,148,0.493,0.576,57,68,0.838,9,72,81,44,26,6,30,50,323,2017
M. Harris,TEX,27.0,42,40,1622,380,845,0.45,76,215,0.353,304,630,0.483,0.495,241,304,0.793,78,233,311,164,80,11,149,86,1077,2017
R. Harris,TOT,28.0,49,20,1120,122,321,0.38,85,230,0.37,37,91,0.407,0.512,31,67,0.463,15,191,206,44,34,22,43,116,360,2017
R. Harris,IOW,28.0,12,4,219,27,76,0.355,16,52,0.308,11,24,0.458,0.461,6,17,0.353,7,36,43,12,7,3,16,28,76,2017
R. Harris,GRR,28.0,37,16,901,95,245,0.388,69,178,0.388,26,67,0.388,0.529,25,50,0.5,8,155,163,32,27,19,27,88,284,2017
S. Harrison,NAS,23.0,48,17,1327,181,400,0.453,33,113,0.292,148,287,0.516,0.494,77,127,0.606,46,152,198,83,62,37,56,113,472,2017
L. Hayward,LIN,30.0,20,9,487,92,200,0.46,10,50,0.2,82,150,0.547,0.485,53,70,0.757,41,76,117,20,28,14,26,43,247,2017
R. Hearn,REN,25.0,42,38,1321,196,433,0.453,134,303,0.442,62,130,0.477,0.607,40,56,0.714,19,201,220,45,29,8,48,143,566,2017
M. Henry,OKL,24.0,38,0,461,46,121,0.38,12,52,0.231,34,69,0.493,0.43,30,37,0.811,15,52,67,22,26,8,27,59,134,2017
X. Henry,OKL,25.0,10,0,168,25,61,0.41,10,29,0.345,15,32,0.469,0.492,36,51,0.706,6,25,31,7,8,4,10,22,96,2017
L. Henton,SAN,,37,18,1069,181,450,0.402,90,235,0.383,91,215,0.423,0.502,50,68,0.735,40,156,196,62,29,20,48,72,502,2017
J. Hernangomez,SFL,21.0,1,0,26,6,14,0.429,1,5,0.2,5,9,0.556,0.464,4,7,0.571,3,8,11,1,0,2,4,5,17,2017
B. Heslip,RAP,26.0,48,30,1380,261,587,0.445,182,435,0.418,79,152,0.52,0.6,66,76,0.868,7,85,92,139,33,1,63,86,770,2017
S. Hicks,FOR,24.0,49,48,1496,233,497,0.469,63,189,0.333,170,308,0.552,0.532,138,171,0.807,88,197,285,59,47,12,65,127,667,2017
D. Hilliard,GRR,23.0,4,4,137,34,74,0.459,13,32,0.406,21,42,0.5,0.547,13,17,0.765,5,18,23,10,3,0,5,8,94,2017
J. Holland,CAN,28.0,37,37,1437,293,609,0.481,90,260,0.346,203,349,0.582,0.555,171,194,0.881,44,131,175,113,57,7,91,117,847,2017
J. Holmes,CAN,24.0,30,20,852,139,316,0.44,54,145,0.372,85,171,0.497,0.525,51,60,0.85,53,141,194,28,31,19,48,88,383,2017
R. Holmes,DEL,23.0,6,6,147,29,49,0.592,1,6,0.167,28,43,0.651,0.602,14,19,0.737,16,24,40,6,2,9,9,23,73,2017
M. Hooper,WES,21.0,2,0,18,1,6,0.167,1,6,0.167,0,0,0.25,0.0,0,0,0.0,0,0,0,1,2,0,1,1,3,2017
J. Horford,CAN,25.0,6,0,68,6,9,0.667,1,1,1.0,5,8,0.625,0.722,2,2,1.0,9,11,20,4,1,1,4,11,15,2017
K. Hornsby,TEX,25.0,37,1,452,66,137,0.482,11,32,0.344,55,105,0.524,0.522,25,33,0.758,19,56,75,38,16,4,13,25,168,2017
C. Horton,GRR,22.0,49,11,913,123,204,0.603,0,1,0.0,123,203,0.606,0.603,59,98,0.602,135,136,271,15,38,46,61,132,305,2017
D. House,DEL,23.0,7,1,187,31,69,0.449,13,32,0.406,18,37,0.486,0.543,18,27,0.667,8,32,40,14,8,6,8,12,93,2017
P. Howard,REN,26.0,40,6,736,115,276,0.417,49,130,0.377,66,146,0.452,0.505,67,79,0.848,9,72,81,51,35,4,40,47,346,2017
J. Huestis,OKL,25.0,32,32,1026,181,407,0.445,70,182,0.385,111,225,0.493,0.531,35,56,0.625,44,154,198,41,21,55,34,56,467,2017
R. Hunter,TOT,23.0,29,18,895,163,422,0.386,77,242,0.318,86,180,0.478,0.477,122,158,0.772,15,59,74,95,35,16,58,95,525,2017
R. Hunter,LIN,23.0,24,13,722,137,339,0.404,68,195,0.349,69,144,0.479,0.504,90,116,0.776,11,39,50,72,25,15,47,78,432,2017
R. Hunter,WCB,23.0,5,5,173,26,83,0.313,9,47,0.191,17,36,0.472,0.367,32,42,0.762,4,20,24,23,10,1,11,17,93,2017
P. Ibeh,LIN,,10,0,101,4,19,0.211,0,0,0.0,4,19,0.211,0.211,3,5,0.6,11,9,20,1,1,9,8,23,11,2017
D. Inglis,WES,21.0,39,39,1158,189,416,0.454,16,63,0.254,173,353,0.49,0.474,108,149,0.725,37,230,267,134,39,22,97,144,502,2017
A. Ingram,LOS,31.0,10,4,293,37,70,0.529,27,49,0.551,10,21,0.476,0.721,15,19,0.789,6,30,36,15,11,4,4,18,116,2017
K. Jack,SFL,24.0,2,0,21,7,8,0.875,0,0,0.0,7,8,0.875,0.875,0,0,0.0,1,1,2,0,2,2,0,2,14,2017
K. Jack,REN,24.0,30,2,420,88,190,0.463,3,23,0.13,85,167,0.509,0.471,63,97,0.649,30,67,97,11,13,14,28,58,242,2017
K. Jack,TOT,24.0,32,2,441,95,198,0.48,3,23,0.13,92,175,0.526,0.487,63,97,0.649,31,68,99,11,15,16,28,60,256,2017
D. Jackson,MAI,22.0,32,23,1071,176,419,0.42,38,138,0.275,138,281,0.491,0.465,85,107,0.794,42,121,163,191,41,14,82,94,475,2017
J. Jackson,NAS,24.0,4,1,65,13,24,0.542,1,2,0.5,12,22,0.545,0.563,9,10,0.9,1,8,9,12,2,0,9,13,36,2017
L. Jackson,ERI,27.0,6,3,119,14,24,0.583,0,3,0.0,14,21,0.667,0.583,5,7,0.714,3,11,14,15,6,0,12,15,33,2017
P. Jackson,TEX,25.0,28,28,1004,207,419,0.494,70,188,0.372,137,231,0.593,0.578,147,176,0.835,23,98,121,216,52,4,92,75,631,2017
J. Jacobs,LOS,22.0,34,0,591,76,165,0.461,18,52,0.346,58,113,0.513,0.515,35,48,0.729,18,72,90,89,24,5,68,45,205,2017
S. Jankovic,SFL,23.0,22,10,378,46,133,0.346,13,58,0.224,33,75,0.44,0.395,25,34,0.735,25,68,93,21,12,19,22,83,130,2017
S. Jankovic,ERI,23.0,9,6,226,46,96,0.479,8,24,0.333,38,72,0.528,0.521,22,27,0.815,15,43,58,14,7,1,19,42,122,2017
S. Jankovic,TOT,23.0,31,16,604,92,229,0.402,21,82,0.256,71,147,0.483,0.448,47,61,0.77,40,111,151,35,19,20,41,125,252,2017
L. Jean-Charles,AUS,23.0,45,28,1138,200,365,0.548,1,3,0.333,199,362,0.55,0.549,50,66,0.758,85,165,250,69,31,63,78,95,451,2017
C. Jefferson,AUS,26.0,42,36,1189,236,497,0.475,33,86,0.384,203,411,0.494,0.508,158,194,0.814,100,252,352,41,29,32,47,122,663,2017
J. Jenkins,WES,25.0,16,15,552,121,265,0.457,32,83,0.386,89,182,0.489,0.517,61,68,0.897,14,54,68,31,10,6,36,20,335,2017
T. Jennings,GRR,28.0,8,2,72,11,15,0.733,0,0,0.0,11,15,0.733,0.733,2,6,0.333,3,6,9,2,1,2,3,14,24,2017
T. Jennings,DEL,28.0,10,8,172,19,42,0.452,0,0,0.0,19,42,0.452,0.452,6,11,0.545,8,29,37,9,8,7,7,25,44,2017
T. Jennings,TOT,28.0,18,10,244,30,57,0.526,0,0,0.0,30,57,0.526,0.526,8,17,0.471,11,35,46,11,9,9,10,39,68,2017
G. Jerrett,CAN,23.0,10,9,370,44,115,0.383,17,42,0.405,27,73,0.37,0.457,23,30,0.767,12,60,72,20,9,10,20,32,128,2017
P. Jesperson,RIO,24.0,1,0,2,0,1,0.0,0,1,0.0,0,0,0.0,0.0,0,0,0.0,0,0,0,0,0,0,0,0,0,2017
A. Johnson,GRR,29.0,10,0,79,6,17,0.353,3,6,0.5,3,11,0.273,0.441,6,10,0.6,2,11,13,10,2,0,5,5,21,2017
B. Johnson,SLS,,6,0,116,31,63,0.492,1,6,0.167,30,57,0.526,0.5,10,14,0.714,12,27,39,2,2,9,5,19,73,2017
C. Johnson,RIO,26.0,32,17,1017,157,295,0.532,42,123,0.341,115,172,0.669,0.603,75,97,0.773,83,115,198,59,32,18,45,93,431,2017
D. Johnson,OKL,21.0,49,49,1421,344,619,0.556,2,13,0.154,342,606,0.564,0.557,216,316,0.684,150,238,388,111,40,63,122,157,906,2017
J. Johnson,RIO,24.0,13,0,309,57,125,0.456,39,87,0.448,18,38,0.474,0.612,10,16,0.625,5,31,36,16,11,3,18,27,163,2017
J. Johnson,CAN,28.0,20,7,496,65,148,0.439,22,46,0.478,43,102,0.422,0.514,26,31,0.839,6,51,57,42,18,1,25,46,178,2017
O. Johnson,AUS,27.0,13,11,396,74,168,0.44,11,40,0.275,63,128,0.492,0.473,65,84,0.774,17,52,69,26,13,3,29,21,224,2017
S. Johnson,GRR,20.0,1,1,37,9,19,0.474,3,8,0.375,6,11,0.545,0.553,5,8,0.625,1,4,5,4,1,1,3,4,26,2017
C. Jones,TOT,27.0,47,17,1249,212,475,0.446,32,98,0.327,180,377,0.477,0.48,98,122,0.803,43,120,163,127,45,5,86,100,554,2017
C. Jones,SAN,27.0,34,15,904,156,351,0.444,18,66,0.273,138,285,0.484,0.47,81,100,0.81,30,94,124,103,37,5,71,77,411,2017
C. Jones,CAN,27.0,13,2,345,56,124,0.452,14,32,0.438,42,92,0.457,0.508,17,22,0.773,13,26,39,24,8,0,15,23,143,2017
D. Jones,SAN,21.0,31,21,819,148,255,0.58,0,1,0.0,148,254,0.583,0.58,55,111,0.495,81,143,224,33,13,65,42,95,351,2017
D. Jones Jr.,NAS,19.0,19,17,602,103,206,0.5,12,47,0.255,91,159,0.572,0.529,58,95,0.611,38,69,107,19,23,28,28,69,276,2017
J. Jones,MAI,23.0,46,46,1654,316,709,0.446,90,261,0.345,226,448,0.504,0.509,244,327,0.746,90,323,413,102,45,26,143,138,966,2017
P. Jones,IOW,25.0,24,13,523,61,194,0.314,18,89,0.202,43,105,0.41,0.361,26,36,0.722,9,61,70,42,7,11,39,34,166,2017
R. Jones,CAN,24.0,46,35,1267,139,282,0.493,4,22,0.182,135,260,0.519,0.5,23,52,0.442,107,186,293,142,66,11,57,109,305,2017
S. Jones,OKL,,3,0,45,7,15,0.467,0,0,0.0,7,15,0.467,0.467,1,2,0.5,3,4,7,4,4,3,2,5,15,2017
J. Jordan,RAP,24.0,40,2,705,83,196,0.423,20,49,0.408,63,147,0.429,0.474,48,67,0.716,23,75,98,129,43,3,45,73,234,2017
N. Jovanovic,WES,23.0,12,0,205,38,82,0.463,0,2,0.0,38,80,0.475,0.463,28,39,0.718,27,40,67,9,2,5,12,27,104,2017
N. Jovanovic,TOT,23.0,36,14,621,123,257,0.479,5,11,0.455,118,246,0.48,0.488,80,120,0.667,87,150,237,21,10,10,38,75,331,2017
N. Jovanovic,GRR,23.0,24,14,416,85,175,0.486,5,9,0.556,80,166,0.482,0.5,52,81,0.642,60,110,170,12,8,5,26,48,227,2017
R. Kelly,MAI,25.0,8,4,281,62,122,0.508,14,39,0.359,48,83,0.578,0.566,44,59,0.746,4,75,79,23,5,17,15,23,182,2017
M. Kennedy,RIO,25.0,14,1,56,6,22,0.273,0,9,0.0,6,13,0.462,0.273,6,9,0.667,3,8,11,4,1,1,5,10,18,2017
A. Kent,WES,33.0,4,0,48,5,7,0.714,0,0,0.0,5,7,0.714,0.714,5,9,0.556,4,3,7,1,0,0,2,10,15,2017
L. Kromah,WES,25.0,2,0,28,4,8,0.5,1,2,0.5,3,6,0.5,0.563,7,9,0.778,0,5,5,2,2,0,1,1,16,2017
M. Kyser,SLS,25.0,26,3,389,38,87,0.437,0,3,0.0,38,84,0.452,0.437,9,19,0.474,39,63,102,12,8,10,16,32,85,2017
S. Labissiere,REN,20.0,17,17,527,101,221,0.457,5,30,0.167,96,191,0.503,0.468,46,65,0.708,48,81,129,19,15,22,42,74,253,2017
D. Lamb,WES,25.0,42,29,1178,188,411,0.457,51,135,0.378,137,276,0.496,0.519,83,98,0.847,36,102,138,67,36,2,54,100,510,2017
S. Lasme,TEX,34.0,19,15,517,89,163,0.546,18,43,0.419,71,120,0.592,0.601,29,40,0.725,44,89,133,20,19,62,27,64,225,2017
D. Lauderdale,MAI,28.0,37,25,637,65,102,0.637,0,1,0.0,65,101,0.644,0.637,21,29,0.724,60,113,173,20,13,56,34,76,151,2017
D. Laury,WCB,26.0,10,0,232,48,111,0.432,5,14,0.357,43,97,0.443,0.455,23,37,0.622,26,51,77,16,4,8,19,20,124,2017
D. Laury,TOT,26.0,38,6,799,158,344,0.459,10,41,0.244,148,303,0.488,0.474,90,145,0.621,79,164,243,58,15,20,56,74,416,2017
D. Laury,DEL,26.0,28,6,567,110,233,0.472,5,27,0.185,105,206,0.51,0.483,67,108,0.62,53,113,166,42,11,12,37,54,292,2017
J. Layman,WCB,22.0,8,8,267,53,125,0.424,12,53,0.226,41,72,0.569,0.472,25,30,0.833,10,38,48,16,13,6,17,16,143,2017
J. Ledbetter,AUS,28.0,38,0,732,129,250,0.516,74,153,0.484,55,97,0.567,0.664,31,36,0.861,9,63,72,83,41,7,56,89,363,2017
D. Lee,MAI,24.0,16,16,544,93,197,0.472,41,88,0.466,52,109,0.477,0.576,58,71,0.817,14,86,100,54,17,6,31,38,285,2017
S. Lemon,TOT,24.0,13,0,106,15,43,0.349,2,18,0.111,13,25,0.52,0.372,1,4,0.25,4,16,20,3,7,3,6,6,33,2017
S. Lemon,DEL,24.0,8,0,63,6,23,0.261,0,9,0.0,6,14,0.429,0.261,1,3,0.333,4,7,11,3,4,2,5,1,13,2017
S. Lemon,CAN,24.0,5,0,43,9,20,0.45,2,9,0.222,7,11,0.636,0.5,0,1,0.0,0,9,9,0,3,1,1,5,20,2017
C. Leslie,RAP,25.0,45,19,938,202,372,0.543,17,54,0.315,185,318,0.582,0.566,90,150,0.6,85,186,271,69,30,21,80,103,511,2017
T. Leslie,FOR,26.0,48,15,1355,274,553,0.495,61,168,0.363,213,385,0.553,0.551,56,71,0.789,95,201,296,107,48,16,71,110,665,2017
J. Lewis,RIO,24.0,14,0,192,22,60,0.367,14,40,0.35,8,20,0.4,0.483,6,6,1.0,4,21,25,11,9,3,4,20,64,2017
S. Long,DEL,24.0,39,36,1149,314,586,0.536,10,46,0.217,304,540,0.563,0.544,150,217,0.691,165,269,434,61,23,51,116,137,788,2017
K. Looney,SAN,20.0,4,1,79,23,41,0.561,0,3,0.0,23,38,0.605,0.561,5,12,0.417,20,25,45,2,4,4,1,11,51,2017
C. Lopez-Sosa,DEL,26.0,38,2,567,90,143,0.629,0,1,0.0,90,142,0.634,0.629,41,64,0.641,47,93,140,42,13,20,47,72,221,2017
J. Loyd,FOR,23.0,49,19,1391,253,580,0.436,66,193,0.342,187,387,0.483,0.493,169,194,0.871,51,154,205,195,46,14,84,158,741,2017
K. Lucas,IOW,27.0,14,13,426,78,195,0.4,30,74,0.405,48,121,0.397,0.477,50,56,0.893,9,46,55,71,15,0,29,20,236,2017
K. Lucas,ERI,27.0,34,11,1071,223,486,0.459,42,104,0.404,181,382,0.474,0.502,143,165,0.867,17,114,131,171,32,2,79,65,631,2017
K. Lucas,TOT,27.0,48,24,1497,301,681,0.442,72,178,0.404,229,503,0.455,0.495,193,221,0.873,26,160,186,242,47,2,108,85,867,2017
T. Luwawu,DEL,21.0,3,3,81,10,24,0.417,3,6,0.5,7,18,0.389,0.479,8,9,0.889,0,12,12,8,5,1,8,10,31,2017
M. Lyons,ERI,26.0,41,20,831,76,199,0.382,39,114,0.342,37,85,0.435,0.48,22,31,0.71,35,61,96,37,34,4,18,78,213,2017
J. Magette,LOS,27.0,50,50,1767,273,668,0.409,111,315,0.352,162,353,0.459,0.492,135,163,0.828,30,193,223,470,74,2,132,152,792,2017
R. Major,REN,34.0,29,1,526,41,105,0.39,22,58,0.379,19,47,0.404,0.495,45,58,0.776,11,40,51,16,20,11,12,56,149,2017
K. Marshall,REN,25.0,21,18,760,114,249,0.458,19,59,0.322,95,190,0.5,0.496,70,83,0.843,10,70,80,190,26,1,68,40,317,2017
C. Martin,IOW,32.0,25,22,654,100,269,0.372,43,128,0.336,57,141,0.404,0.452,45,55,0.818,14,82,96,34,25,5,45,53,288,2017
C. Martin,WCB,32.0,6,0,149,27,58,0.466,8,24,0.333,19,34,0.559,0.534,19,23,0.826,2,15,17,15,4,1,9,10,81,2017
C. Martin,TOT,32.0,31,22,803,127,327,0.388,51,152,0.336,76,175,0.434,0.466,64,78,0.821,16,97,113,49,29,6,54,63,369,2017
J. Martin,IOW,22.0,22,19,619,125,303,0.413,12,40,0.3,113,263,0.43,0.432,87,103,0.845,51,115,166,25,15,24,49,78,349,2017
B. Massey,GRR,26.0,17,2,181,31,58,0.534,5,12,0.417,26,46,0.565,0.578,10,18,0.556,11,22,33,16,6,1,6,21,77,2017
B. Massey,ERI,26.0,2,0,29,4,9,0.444,0,0,0.0,4,9,0.444,0.444,2,2,1.0,3,1,4,3,1,0,6,3,10,2017
B. Massey,TOT,26.0,19,2,210,35,67,0.522,5,12,0.417,30,55,0.545,0.56,12,20,0.6,14,23,37,19,7,1,12,24,87,2017
D. Mathieu,IOW,24.0,7,0,77,11,18,0.611,2,5,0.4,9,13,0.692,0.667,5,7,0.714,1,8,9,10,8,0,7,12,29,2017
G. Mays,NAS,24.0,5,0,21,5,9,0.556,0,0,0.0,5,9,0.556,0.556,4,4,1.0,4,2,6,0,1,0,1,1,14,2017
R. McCallum,GRR,25.0,43,42,1587,286,644,0.444,37,118,0.314,249,526,0.473,0.473,147,189,0.778,53,197,250,303,96,13,116,99,756,2017
D. McCamey,AUS,27.0,41,2,698,79,235,0.336,30,111,0.27,49,124,0.395,0.4,43,51,0.843,6,68,74,85,19,1,44,59,231,2017
P. McCaw,SAN,21.0,2,2,71,9,26,0.346,2,10,0.2,7,16,0.438,0.385,5,6,0.833,0,8,8,9,2,2,5,4,25,2017
S. McClellan,DEL,24.0,6,1,153,22,40,0.55,3,10,0.3,19,30,0.633,0.588,17,26,0.654,5,16,21,9,9,1,8,6,64,2017
C. McCullough,TOT,21.0,43,35,1267,257,576,0.446,48,137,0.35,209,439,0.476,0.488,131,195,0.672,88,215,303,69,49,35,93,136,693,2017
C. McCullough,NAS,21.0,12,6,285,48,107,0.449,15,42,0.357,33,65,0.508,0.519,20,28,0.714,18,46,64,11,8,11,15,31,131,2017
C. McCullough,LIN,21.0,31,29,982,209,469,0.446,33,95,0.347,176,374,0.471,0.481,111,167,0.665,70,169,239,58,41,24,78,105,562,2017
D. McGrath,LIN,32.0,12,12,435,39,99,0.394,16,51,0.314,23,48,0.479,0.475,10,13,0.769,1,28,29,107,11,3,38,30,104,2017
A. McKinnie,WCB,24.0,50,34,1525,291,573,0.508,41,133,0.308,250,440,0.568,0.544,120,170,0.706,132,328,460,37,28,25,70,131,743,2017
M. McKinney,DEL,25.0,31,8,601,64,163,0.393,15,56,0.268,49,107,0.458,0.439,25,34,0.735,10,47,57,78,15,3,39,53,168,2017
T. McKinney-Jones,FOR,26.0,48,48,1715,280,593,0.472,50,173,0.289,230,420,0.548,0.514,186,220,0.845,62,176,238,151,54,5,104,145,796,2017
J. Mickey,MAI,22.0,12,12,391,102,198,0.515,14,32,0.438,88,166,0.53,0.551,31,41,0.756,36,69,105,19,10,33,30,37,249,2017
J. Miller,WES,24.0,25,1,389,18,68,0.265,9,34,0.265,9,34,0.265,0.331,18,21,0.857,6,23,29,35,13,2,29,39,63,2017
M. Miller,MAI,25.0,22,0,278,23,66,0.348,9,38,0.237,14,28,0.5,0.417,9,11,0.818,16,42,58,12,8,1,10,17,64,2017
P. Miller,TEX,24.0,5,4,159,26,55,0.473,2,8,0.25,24,47,0.511,0.491,24,29,0.828,4,10,14,21,7,0,17,11,78,2017
P. Miller,SFL,24.0,42,25,1309,245,513,0.478,27,83,0.325,218,430,0.507,0.504,166,216,0.769,39,97,136,209,54,17,84,91,683,2017
P. Miller,TOT,24.0,47,29,1468,271,568,0.477,29,91,0.319,242,477,0.507,0.503,190,245,0.776,43,107,150,230,61,17,101,102,761,2017
S. Miller,SWR,23.0,45,9,703,89,180,0.494,10,35,0.286,79,145,0.545,0.522,35,56,0.625,49,108,157,19,32,29,28,103,223,2017
E. Millsap,NAS,29.0,50,50,1838,331,771,0.429,72,237,0.304,259,534,0.485,0.476,254,347,0.732,68,325,393,201,103,24,160,192,988,2017
A. Mitchell,LIN,24.0,4,4,115,16,42,0.381,1,10,0.1,15,32,0.469,0.393,0,2,0.0,10,17,27,11,3,4,7,7,33,2017
E. Mockevicius,LIN,24.0,35,24,741,117,233,0.502,2,18,0.111,115,215,0.535,0.506,37,69,0.536,100,178,278,54,31,29,64,103,273,2017
L. Montero,REN,23.0,13,0,300,42,94,0.447,16,36,0.444,26,58,0.448,0.532,15,23,0.652,12,79,91,34,13,10,26,38,115,2017
L. Montero,TOT,23.0,49,15,1180,153,377,0.406,61,186,0.328,92,191,0.482,0.487,63,82,0.768,43,262,305,103,51,33,86,135,430,2017
L. Montero,SFL,23.0,36,15,880,111,283,0.392,45,150,0.3,66,133,0.496,0.472,48,59,0.814,31,183,214,69,38,23,60,97,315,2017
J. Moore,LIN,25.0,46,23,1219,257,517,0.497,49,152,0.322,208,365,0.57,0.544,105,142,0.739,72,89,161,55,41,16,49,93,668,2017
Y. Moreira,RAP,25.0,48,7,908,151,319,0.473,0,2,0.0,151,317,0.476,0.473,89,128,0.695,102,198,300,71,29,23,51,105,391,2017
E. Moreland,CAN,25.0,44,41,1469,247,440,0.561,1,3,0.333,246,437,0.563,0.563,69,183,0.377,141,397,538,123,75,117,106,161,564,2017
D. Morris,RIO,26.0,47,39,1585,311,695,0.447,94,285,0.33,217,410,0.529,0.515,225,273,0.824,40,162,202,302,58,2,149,97,941,2017
B. Moungoro,OKL,22.0,43,0,410,43,127,0.339,32,103,0.311,11,24,0.458,0.465,7,10,0.7,5,38,43,15,13,3,13,39,125,2017
X. Munford,SWR,24.0,30,30,1116,193,458,0.421,43,136,0.316,150,322,0.466,0.468,125,155,0.806,16,127,143,159,32,10,108,93,554,2017
K. Murphy,GRR,26.0,45,36,1522,337,757,0.445,142,343,0.414,195,414,0.471,0.539,223,276,0.808,37,225,262,67,44,3,116,134,1039,2017
D. Murray,AUS,20.0,15,15,527,103,233,0.442,7,45,0.156,96,188,0.511,0.457,45,64,0.703,19,99,118,93,30,2,76,43,258,2017
A. Nader,MAI,23.0,40,40,1340,295,660,0.447,99,284,0.349,196,376,0.521,0.522,162,204,0.794,29,219,248,155,40,33,146,101,851,2017
L. Nash,RIO,24.0,27,4,517,72,193,0.373,20,62,0.323,52,131,0.397,0.425,65,90,0.722,17,68,85,32,15,7,44,57,229,2017
M. Ndour,WES,24.0,18,18,507,98,209,0.469,8,29,0.276,90,180,0.5,0.488,60,77,0.779,34,89,123,21,20,26,35,51,264,2017
G. Neal,TEX,32.0,2,1,66,15,35,0.429,3,12,0.25,12,23,0.522,0.471,9,9,1.0,2,4,6,8,2,0,6,4,42,2017
G. Neal,REN,32.0,6,4,175,44,93,0.473,10,26,0.385,34,67,0.507,0.527,30,35,0.857,1,21,22,9,7,0,5,9,128,2017
G. Neal,WES,32.0,1,0,14,1,3,0.333,0,0,0.0,1,3,0.333,0.333,2,2,1.0,0,1,1,0,1,0,2,2,4,2017
G. Neal,TOT,32.0,9,5,255,60,131,0.458,13,38,0.342,47,93,0.505,0.508,41,46,0.891,3,26,29,17,10,0,13,15,174,2017
R. Nelson,DEL,25.0,3,0,20,0,4,0.0,0,3,0.0,0,1,0.0,0.0,0,0,0.0,0,3,3,3,0,0,3,4,0,2017
R. Neto,SLS,24.0,1,1,34,6,11,0.545,1,4,0.25,5,7,0.714,0.591,1,1,1.0,1,8,9,12,1,0,0,5,14,2017
J. Newberry,GRR,24.0,25,0,285,30,83,0.361,4,13,0.308,26,70,0.371,0.386,11,17,0.647,9,34,43,22,17,2,18,16,75,2017
G. Niang,FOR,23.0,6,6,198,47,105,0.448,10,33,0.303,37,72,0.514,0.495,10,13,0.769,11,32,43,20,7,2,14,19,114,2017
W. Niang,LIN,20.0,5,0,18,1,7,0.143,0,1,0.0,1,6,0.167,0.143,2,2,1.0,1,3,4,0,0,1,3,6,4,2017
E. Nickerson,FOR,24.0,14,0,131,4,20,0.2,0,5,0.0,4,15,0.267,0.2,7,12,0.583,5,15,20,5,7,1,10,26,15,2017
D. Nwaba,LOS,24.0,40,31,1150,229,354,0.647,4,17,0.235,225,337,0.668,0.653,101,165,0.612,107,168,275,42,54,46,30,108,563,2017
D. Nwaelele,AUS,32.0,32,7,724,95,202,0.47,62,124,0.5,33,78,0.423,0.624,40,48,0.833,17,102,119,40,18,6,32,44,292,2017
I. Nwamu,SFL,23.0,47,13,1152,144,363,0.397,83,243,0.342,61,120,0.508,0.511,58,72,0.806,30,119,149,48,45,7,46,108,429,2017
C. Obekpa,SAN,23.0,31,0,468,68,127,0.535,0,1,0.0,68,126,0.54,0.535,23,43,0.535,64,103,167,23,18,71,27,89,159,2017
J. O'Brien,SLS,24.0,47,44,1547,178,454,0.392,44,131,0.336,134,323,0.415,0.441,79,109,0.725,25,149,174,126,40,14,76,90,479,2017
J. O'Bryant III,NAS,23.0,25,25,807,175,384,0.456,28,75,0.373,147,309,0.476,0.492,82,105,0.781,60,157,217,40,25,16,53,96,460,2017
J. Octeus,WCB,,41,10,657,80,200,0.4,19,51,0.373,61,149,0.409,0.448,52,73,0.712,28,83,111,87,21,4,33,77,231,2017
G. Okonoboh,RAP,22.0,7,0,51,7,9,0.778,0,0,0.0,7,9,0.778,0.778,0,2,0.0,8,6,14,2,2,2,6,10,14,2017
K. Olekaibe,CAN,24.0,24,5,413,59,158,0.373,35,100,0.35,24,58,0.414,0.484,7,9,0.778,8,28,36,23,18,1,23,29,160,2017
C. Ona-Embo,SAN,27.0,6,0,53,4,12,0.333,3,7,0.429,1,5,0.2,0.458,2,3,0.667,0,6,6,7,0,0,3,6,13,2017
C. Onuaku,RIO,20.0,43,40,1202,236,376,0.628,2,7,0.286,234,369,0.634,0.63,112,153,0.732,153,304,457,92,51,68,115,172,586,2017
R. Onwukamuche,ERI,24.0,36,16,571,29,64,0.453,0,1,0.0,29,63,0.46,0.453,20,43,0.465,52,81,133,14,6,28,36,115,78,2017
M. Paige,SLS,23.0,46,40,1505,192,481,0.399,97,273,0.355,95,208,0.457,0.5,77,92,0.837,21,81,102,102,41,14,78,89,558,2017
B. Palo,SFL,25.0,25,24,850,118,268,0.44,20,58,0.345,98,210,0.467,0.478,151,193,0.782,18,85,103,128,23,1,59,77,407,2017
J. Panoske,MAI,24.0,11,0,123,15,30,0.5,12,26,0.462,3,4,0.75,0.7,1,2,0.5,7,11,18,4,3,7,12,15,43,2017
G. Papagiannis,REN,19.0,23,20,739,142,279,0.509,3,6,0.5,139,273,0.509,0.514,29,38,0.763,55,131,186,11,13,59,44,69,316,2017
J. Pargo,OKL,37.0,25,0,572,103,272,0.379,69,175,0.394,34,97,0.351,0.506,26,29,0.897,2,46,48,81,21,0,58,38,301,2017
L. Patterson,REN,25.0,28,27,1003,214,496,0.431,63,186,0.339,151,310,0.487,0.495,183,234,0.782,33,142,175,131,56,6,98,74,674,2017
C. Payne,WCB,22.0,3,3,91,21,50,0.42,5,21,0.238,16,29,0.552,0.47,9,12,0.75,0,18,18,23,8,0,4,4,56,2017
C. Payne,TOT,22.0,5,3,131,34,83,0.41,12,38,0.316,22,45,0.489,0.482,12,16,0.75,1,19,20,29,9,0,6,9,92,2017
C. Payne,OKL,22.0,2,0,40,13,33,0.394,7,17,0.412,6,16,0.375,0.5,3,4,0.75,1,1,2,6,1,0,2,5,36,2017
G. Payton II,RIO,24.0,49,49,1603,274,550,0.498,73,238,0.307,201,312,0.644,0.565,72,103,0.699,88,232,320,162,98,33,77,129,693,2017
J. Petro,SFL,,2,0,10,1,4,0.25,0,0,0.0,1,4,0.25,0.25,0,0,0.0,0,1,1,1,1,0,0,2,2,2017
J. Petrucelli,ERI,24.0,32,12,673,64,144,0.444,9,28,0.321,55,116,0.474,0.476,41,56,0.732,24,75,99,42,27,9,31,81,178,2017
M. Plumlee,WES,24.0,15,15,461,68,121,0.562,0,0,0.0,68,121,0.562,0.562,49,79,0.62,43,94,137,11,9,19,36,40,185,2017
J. Poeltl,RAP,21.0,2,2,67,14,25,0.56,0,1,0.0,14,24,0.583,0.56,4,10,0.4,9,17,26,2,2,6,3,8,32,2017
D. Polee Jr.,LIN,25.0,22,0,287,42,99,0.424,7,20,0.35,35,79,0.443,0.46,34,43,0.791,15,40,55,5,20,8,23,30,125,2017
B. Portis,WCB,21.0,1,1,39,12,24,0.5,1,4,0.25,11,20,0.55,0.521,7,8,0.875,6,3,9,3,1,3,3,4,32,2017
M. Posley,SFL,22.0,47,17,1169,156,445,0.351,98,275,0.356,58,170,0.341,0.461,48,66,0.727,10,84,94,97,44,4,68,70,458,2017
A. Poythress,FOR,23.0,46,45,1430,330,625,0.528,31,77,0.403,299,548,0.546,0.553,159,203,0.783,117,208,325,69,34,63,123,177,850,2017
P. Pressey,SAN,25.0,46,45,1534,285,722,0.395,106,321,0.33,179,401,0.446,0.468,154,200,0.77,32,210,242,372,97,8,157,94,830,2017
T. Price,ERI,23.0,49,47,1559,247,579,0.427,67,188,0.356,180,391,0.46,0.484,125,145,0.862,19,135,154,133,90,12,107,168,686,2017
T. Prince,LIN,22.0,5,3,142,40,80,0.5,8,21,0.381,32,59,0.542,0.55,15,21,0.714,6,32,38,11,8,4,14,15,103,2017
T. Quarterman,TOT,22.0,22,14,678,95,261,0.364,19,88,0.216,76,173,0.439,0.4,37,51,0.725,32,106,138,156,37,8,79,50,246,2017
T. Quarterman,LIN,22.0,13,7,412,59,150,0.393,14,51,0.275,45,99,0.455,0.44,26,36,0.722,19,62,81,91,21,6,49,27,158,2017
T. Quarterman,WCB,22.0,9,7,266,36,111,0.324,5,37,0.135,31,74,0.419,0.347,11,15,0.733,13,44,57,65,16,2,30,23,88,2017
J. Railey,DEL,24.0,2,0,31,6,8,0.75,0,0,0.0,6,8,0.75,0.75,0,2,0.0,2,4,6,1,2,3,1,7,12,2017
B. Raley-Ross,ERI,29.0,8,3,154,13,28,0.464,4,12,0.333,9,16,0.563,0.536,3,3,1.0,3,13,16,9,3,0,4,19,33,2017
C. Randle,WES,23.0,20,20,646,137,321,0.427,54,128,0.422,83,193,0.43,0.511,89,109,0.817,14,59,73,74,20,3,68,67,417,2017
C. Randle,TOT,23.0,21,21,681,142,333,0.426,55,132,0.417,87,201,0.433,0.509,92,113,0.814,14,60,74,79,22,3,74,71,431,2017
C. Randle,DEL,23.0,1,1,35,5,12,0.417,1,4,0.25,4,8,0.5,0.458,3,4,0.75,0,1,1,5,2,0,6,4,14,2017
J. Reischel,WES,,2,0,37,3,8,0.375,0,3,0.0,3,5,0.6,0.375,1,2,0.5,0,6,6,2,3,0,1,5,7,2017
M. Richardson,REN,21.0,11,10,385,69,162,0.426,22,50,0.44,47,112,0.42,0.494,71,93,0.763,4,43,47,16,10,0,39,36,231,2017
D. Riley,SLS,26.0,29,14,512,41,97,0.423,0,3,0.0,41,94,0.436,0.423,10,14,0.714,31,84,115,29,11,45,32,91,92,2017
D. Riley,IOW,28.0,24,3,296,35,69,0.507,0,2,0.0,35,67,0.522,0.507,23,34,0.676,25,45,70,20,10,29,28,50,93,2017
J. Roberts,TOT,24.0,21,0,203,22,43,0.512,0,0,0.0,22,43,0.512,0.512,8,9,0.889,20,35,55,7,4,13,20,39,52,2017
J. Roberts,SLS,24.0,15,0,159,16,31,0.516,0,0,0.0,16,31,0.516,0.516,3,3,1.0,19,29,48,4,4,9,17,29,35,2017
J. Roberts,SAN,24.0,6,0,44,6,12,0.5,0,0,0.0,6,12,0.5,0.5,5,6,0.833,1,6,7,3,0,4,3,10,17,2017
N. Robinson,DEL,,17,2,440,72,168,0.429,26,62,0.419,46,106,0.434,0.506,37,48,0.771,10,29,39,72,30,3,32,44,207,2017
F. Rogers,SWR,23.0,3,0,20,4,6,0.667,0,1,0.0,4,5,0.8,0.667,2,3,0.667,1,2,3,0,1,1,1,8,10,2017
I. Romero,GRR,25.0,18,3,217,40,71,0.563,0,0,0.0,40,71,0.563,0.563,15,42,0.357,16,36,52,8,6,8,17,46,95,2017
J. Sampson,IOW,33.0,32,16,844,179,368,0.486,19,66,0.288,160,302,0.53,0.512,98,146,0.671,48,149,197,43,31,27,75,103,475,2017
J. Sampson,IOW,23.0,15,6,362,99,202,0.49,8,29,0.276,91,173,0.526,0.51,30,40,0.75,18,61,79,18,10,9,21,31,236,2017
L. Sanders,CAN,28.0,4,0,77,10,27,0.37,0,0,0.0,10,27,0.37,0.37,4,11,0.364,11,21,32,3,0,10,4,11,24,2017
W. Saunders,WCB,23.0,46,10,1149,134,277,0.484,0,7,0.0,134,270,0.496,0.484,122,151,0.808,84,167,251,180,33,8,71,70,390,2017
M. Scott,TOT,28.0,6,4,141,36,87,0.414,10,30,0.333,26,57,0.456,0.471,1,3,0.333,11,15,26,10,3,7,8,17,83,2017
M. Scott,LIN,28.0,4,4,100,29,68,0.426,7,20,0.35,22,48,0.458,0.478,1,3,0.333,10,10,20,8,3,6,5,10,66,2017
M. Scott,DEL,28.0,2,0,41,7,19,0.368,3,10,0.3,4,9,0.444,0.447,0,0,0.0,1,5,6,2,0,1,3,7,17,2017
W. Selden,IOW,22.0,35,21,1070,239,532,0.449,76,218,0.349,163,314,0.519,0.521,93,143,0.65,46,121,167,100,31,17,82,64,647,2017
W. Sheehey,RAP,25.0,38,21,895,149,307,0.485,37,104,0.356,112,203,0.552,0.546,58,76,0.763,34,90,124,77,48,5,62,81,393,2017
D. Shumpert,LOS,26.0,1,0,3,0,0,0.0,0,0,0.0,0,0,0.0,0.0,0,0,0.0,0,1,1,0,0,0,0,1,0,2017
P. Siakam,RAP,,5,5,145,36,66,0.545,6,12,0.5,30,54,0.556,0.591,13,20,0.65,14,29,43,13,11,8,10,12,91,2017
X. Silas,NAS,29.0,40,32,1249,199,466,0.427,121,299,0.405,78,167,0.467,0.557,97,110,0.882,23,93,116,32,33,4,51,110,616,2017
M. Simmons,GRR,29.0,25,6,589,53,124,0.427,11,36,0.306,42,88,0.477,0.472,17,27,0.63,31,55,86,28,16,9,26,64,134,2017
M. Simmons,LOS,,1,0,1,0,0,0.0,0,0,0.0,0,0,0.0,0.0,0,0,0.0,0,0,0,0,0,0,0,0,0,2017
P. Simon,SLS,24.0,2,0,9,1,8,0.125,1,7,0.143,0,1,0.0,0.188,0,0,0.0,0,0,0,0,0,0,0,2,3,2017
H. Sims,SLS,26.0,25,23,764,145,316,0.459,12,35,0.343,133,281,0.473,0.478,123,160,0.769,69,162,231,46,23,21,72,106,425,2017
S. Singh,TEX,21.0,8,0,43,3,9,0.333,0,0,0.0,3,9,0.333,0.333,7,11,0.636,4,6,10,1,1,0,4,10,13,2017
E. Singler,RAP,26.0,48,35,1355,145,359,0.404,75,211,0.355,70,148,0.473,0.508,61,73,0.836,28,170,198,120,32,15,78,104,426,2017
D. Smith-Rivera,WCB,24.0,6,0,67,7,26,0.269,1,11,0.091,6,15,0.4,0.288,3,5,0.6,2,8,10,5,2,0,7,3,18,2017
D. Smith-Rivera,TOT,24.0,7,0,69,7,26,0.269,1,11,0.091,6,15,0.4,0.288,3,5,0.6,2,8,10,5,2,0,7,3,18,2017
D. Smith-Rivera,FOR,24.0,1,0,2,0,0,0.0,0,0,0.0,0,0,0.0,0.0,0,0,0.0,0,0,0,0,0,0,0,0,0,2017
J. Smith,RIO,24.0,44,8,620,144,226,0.637,0,1,0.0,144,225,0.64,0.637,82,118,0.695,102,110,212,39,28,20,61,124,370,2017
K. Smith,LOS,24.0,47,5,1049,105,315,0.333,32,121,0.264,73,194,0.376,0.384,64,89,0.719,31,118,149,184,67,3,85,83,306,2017
R. Smith,TOT,25.0,42,13,891,163,311,0.524,6,28,0.214,157,283,0.555,0.534,101,152,0.664,85,118,203,12,27,26,50,75,433,2017
R. Smith,LOS,25.0,18,0,345,61,124,0.492,3,18,0.167,58,106,0.547,0.504,59,78,0.756,36,33,69,2,8,8,27,31,184,2017
R. Smith,DEL,25.0,24,13,546,102,187,0.545,3,10,0.3,99,177,0.559,0.553,42,74,0.568,49,85,134,10,19,18,23,44,249,2017
R. Smith,DEL,25.0,25,22,705,153,351,0.436,29,100,0.29,124,251,0.494,0.477,92,110,0.836,25,63,88,154,50,4,75,73,427,2017
J. Southerland,SAN,26.0,35,28,945,175,376,0.465,93,237,0.392,82,139,0.59,0.589,38,53,0.717,37,181,218,32,38,43,26,89,481,2017
T. Splitter,DEL,,2,2,28,5,12,0.417,0,0,0.0,5,12,0.417,0.417,3,5,0.6,3,8,11,2,1,1,2,4,13,2017
K. Steffeck,SAN,27.0,1,0,15,2,5,0.4,2,4,0.5,0,1,0.0,0.6,0,0,0.0,1,0,1,2,2,0,2,4,6,2017
D. Stephens,LOS,,10,1,189,35,58,0.603,0,3,0.0,35,55,0.636,0.603,10,17,0.588,29,26,55,5,3,7,6,20,80,2017
D. Stewart,AUS,25.0,35,20,509,44,81,0.543,0,0,0.0,44,81,0.543,0.543,33,48,0.688,41,81,122,20,15,6,37,86,121,2017
D. Stockton,REN,25.0,15,13,527,89,211,0.422,31,80,0.388,58,131,0.443,0.495,37,47,0.787,16,56,72,79,22,3,38,49,246,2017
D. Stone,TOT,19.0,13,2,282,81,165,0.491,10,27,0.37,71,138,0.514,0.521,38,46,0.826,28,63,91,11,6,12,35,45,210,2017
D. Stone,SLS,19.0,9,0,214,59,116,0.509,7,17,0.412,52,99,0.525,0.539,27,33,0.818,22,51,73,9,5,8,22,36,152,2017
D. Stone,SAN,19.0,4,2,68,22,49,0.449,3,10,0.3,19,39,0.487,0.48,11,13,0.846,6,12,18,2,1,4,13,9,58,2017
J. Stone,FOR,28.0,33,31,1144,91,228,0.399,36,104,0.346,55,124,0.444,0.478,44,65,0.677,22,176,198,284,45,31,90,96,262,2017
R. Sulaimon,SWR,22.0,49,34,1649,234,534,0.438,77,219,0.352,157,315,0.498,0.51,109,142,0.768,31,158,189,158,63,5,93,138,654,2017
J. Sullinger,RAP,24.0,2,2,55,12,30,0.4,4,9,0.444,8,21,0.381,0.467,6,8,0.75,6,19,25,5,0,0,3,7,34,2017
K. Tarczewski,OKL,23.0,43,1,1097,152,242,0.628,0,0,0.0,152,242,0.628,0.628,125,172,0.727,105,208,313,23,12,30,54,110,429,2017
A. Dixon-Tatum,MAI,25.0,42,9,699,94,172,0.547,0,0,0.0,94,172,0.547,0.547,41,67,0.612,72,76,148,10,4,29,40,83,229,2017
W. Tavares,RAP,24.0,48,41,1134,214,362,0.591,0,2,0.0,214,360,0.594,0.591,80,112,0.714,139,232,371,69,39,131,84,150,508,2017
I. Taylor,RIO,22.0,25,19,872,176,342,0.515,43,94,0.457,133,248,0.536,0.577,129,158,0.816,15,59,74,150,18,3,61,70,524,2017
J. Taylor,SLS,30.0,45,18,1140,249,535,0.465,66,198,0.333,183,337,0.543,0.527,75,114,0.658,34,106,140,60,44,14,85,93,639,2017
M. Teague,FOR,23.0,12,1,311,51,126,0.405,9,26,0.346,42,100,0.42,0.44,33,41,0.805,3,20,23,58,6,1,19,27,144,2017
J. Terrell,RAP,25.0,1,0,9,0,2,0.0,0,1,0.0,0,1,0.0,0.0,2,2,1.0,0,0,0,1,0,0,2,2,2,2017
N. Tharpe,DEL,25.0,1,0,27,4,11,0.364,3,6,0.5,1,5,0.2,0.5,0,0,0.0,0,3,3,5,0,0,2,4,11,2017
A. Thomas,WCB,25.0,43,27,1130,246,548,0.449,43,138,0.312,203,410,0.495,0.488,85,111,0.766,15,137,152,69,35,7,62,61,620,2017
J. Thomasson,ERI,,3,0,65,8,14,0.571,3,5,0.6,5,9,0.556,0.679,0,0,0.0,3,7,10,8,2,2,4,4,19,2017
S. Thomas,AUS,24.0,5,0,14,1,1,1.0,0,0,0.0,1,1,1.0,1.0,1,1,1.0,0,2,2,1,0,0,0,2,3,2017
H. Thompson,AUS,25.0,16,7,426,86,177,0.486,25,57,0.439,61,120,0.508,0.556,33,42,0.786,16,61,77,21,11,7,20,49,230,2017
M. Thompson,SAN,28.0,27,4,560,42,145,0.29,28,85,0.329,14,60,0.233,0.386,16,23,0.696,10,59,69,39,20,10,15,57,128,2017
S. Thompson,ERI,23.0,17,3,362,87,156,0.558,0,0,0.0,87,156,0.558,0.558,32,48,0.667,60,67,127,6,11,6,38,44,206,2017
J. Threatt,RIO,23.0,41,2,673,125,307,0.407,13,67,0.194,112,240,0.467,0.428,98,153,0.641,24,65,89,75,24,4,57,42,361,2017
M. Tobey,SWR,22.0,35,25,936,173,335,0.516,11,56,0.196,162,279,0.581,0.533,62,85,0.729,113,203,316,35,28,46,60,104,419,2017
J. Tokoto,RIO,23.0,43,33,1436,218,445,0.49,58,172,0.337,160,273,0.586,0.555,90,132,0.682,52,193,245,119,102,22,66,128,584,2017
A. Toupane,RAP,24.0,36,13,993,169,365,0.463,36,104,0.346,133,261,0.51,0.512,204,253,0.806,11,135,146,130,40,6,99,106,578,2017
J. Trawick,SFL,24.0,37,18,931,157,324,0.485,35,95,0.368,122,229,0.533,0.539,128,171,0.749,28,95,123,100,32,13,74,119,477,2017
T. Trice III,WES,24.0,9,9,320,64,143,0.448,16,31,0.516,48,112,0.429,0.503,46,51,0.902,6,26,32,58,8,0,16,15,190,2017
B. Triche,SLS,25.0,13,2,245,35,72,0.486,14,31,0.452,21,41,0.512,0.583,16,21,0.762,4,17,21,16,3,1,11,24,100,2017
B. Triche,DEL,25.0,35,10,681,84,206,0.408,21,65,0.323,63,141,0.447,0.459,41,55,0.745,20,62,82,69,23,7,38,61,230,2017
B. Triche,TOT,25.0,48,12,926,119,278,0.428,35,96,0.365,84,182,0.462,0.491,57,76,0.75,24,79,103,85,26,8,49,85,330,2017
D. Tucker,SLS,22.0,1,0,35,2,9,0.222,0,4,0.0,2,5,0.4,0.222,2,4,0.5,1,0,1,0,2,0,1,1,6,2017
R. Turner,SWR,25.0,37,3,448,54,127,0.425,38,93,0.409,16,34,0.471,0.575,17,24,0.708,12,48,60,14,9,3,22,69,163,2017
M. Tyndale,REN,31.0,39,22,977,50,98,0.51,1,3,0.333,49,95,0.516,0.515,34,58,0.586,64,163,227,134,51,5,57,64,135,2017
T. Ulis,NAS,21.0,1,1,36,6,17,0.353,1,4,0.25,5,13,0.385,0.382,0,0,0.0,1,4,5,9,3,0,4,4,13,2017
Z. Upshaw,GRR,25.0,34,13,739,71,199,0.357,56,146,0.384,15,53,0.283,0.497,22,33,0.667,18,85,103,30,16,7,20,60,220,2017
J. Uthoff,RAP,23.0,24,2,488,68,158,0.43,19,40,0.475,49,118,0.415,0.491,33,39,0.846,27,91,118,29,17,16,28,31,188,2017
J. Uthoff,FOR,23.0,11,5,349,74,135,0.548,10,20,0.5,64,115,0.557,0.585,30,33,0.909,36,64,100,27,14,17,25,23,188,2017
J. Uthoff,TOT,23.0,37,9,902,154,318,0.484,30,65,0.462,124,253,0.49,0.531,71,83,0.855,70,165,235,60,31,34,59,56,409,2017
J. Uthoff,TEX,23.0,2,2,65,12,25,0.48,1,5,0.2,11,20,0.55,0.5,8,11,0.727,7,10,17,4,0,1,6,2,33,2017
R. Vaden,ERI,31.0,21,1,470,60,157,0.382,37,102,0.363,23,55,0.418,0.5,9,10,0.9,3,51,54,32,12,6,12,54,166,2017
R. Vaden,WES,31.0,12,4,218,26,59,0.441,18,37,0.486,8,22,0.364,0.593,2,3,0.667,0,20,20,4,9,0,9,27,72,2017
R. Vaden,TOT,31.0,33,5,688,86,216,0.398,55,139,0.396,31,77,0.403,0.525,11,13,0.846,3,71,74,36,21,6,21,81,238,2017
D. Valentine,WCB,23.0,3,3,118,28,56,0.5,21,39,0.538,7,17,0.412,0.688,8,9,0.889,6,25,31,22,5,1,19,11,85,2017
F. VanVleet,RAP,22.0,16,16,518,89,219,0.406,22,54,0.407,67,165,0.406,0.457,70,83,0.843,11,45,56,122,24,2,45,31,270,2017
R. Vaughn,WES,20.0,3,0,50,14,30,0.467,7,17,0.412,7,13,0.538,0.583,2,3,0.667,1,9,10,1,1,0,4,0,37,2017
L. Wade,DEL,31.0,15,10,422,72,148,0.486,7,22,0.318,65,126,0.516,0.51,24,38,0.632,23,38,61,19,18,5,21,42,175,2017
M. Wade,SWR,25.0,6,2,152,9,24,0.375,4,11,0.364,5,13,0.385,0.458,10,16,0.625,0,8,8,6,6,2,6,20,32,2017
M. Wade,IOW,25.0,8,0,161,11,26,0.423,3,9,0.333,8,17,0.471,0.481,14,14,1.0,2,7,9,14,6,1,6,18,39,2017
M. Wade,TOT,25.0,14,2,313,20,50,0.4,7,20,0.35,13,30,0.433,0.47,24,30,0.8,2,15,17,20,12,3,12,38,71,2017
V. Wafer,WES,31.0,26,3,647,166,327,0.508,44,95,0.463,122,232,0.526,0.575,38,56,0.679,2,70,72,39,16,11,56,47,414,2017
V. Wafer,TOT,31.0,31,3,758,181,364,0.497,46,102,0.451,135,262,0.515,0.56,43,62,0.694,2,82,84,48,19,13,63,53,451,2017
V. Wafer,DEL,31.0,5,0,111,15,37,0.405,2,7,0.286,13,30,0.433,0.432,5,6,0.833,0,12,12,9,3,2,7,6,37,2017
A. Walker,FOR,23.0,3,0,17,1,5,0.2,0,0,0.0,1,5,0.2,0.2,2,2,1.0,1,2,3,0,0,1,0,2,4,2017
H. Walker,SFL,29.0,25,5,537,103,268,0.384,81,209,0.388,22,59,0.373,0.535,34,41,0.829,8,97,105,38,24,20,25,71,321,2017
C. Walker,RIO,22.0,47,4,622,100,171,0.585,2,6,0.333,98,165,0.594,0.591,74,101,0.733,77,104,181,26,24,42,38,90,276,2017
D. Walker,WES,24.0,10,5,206,34,76,0.447,18,48,0.375,16,28,0.571,0.566,15,16,0.938,1,20,21,7,8,1,17,18,101,2017
D. Walker,TOT,24.0,48,17,1277,199,427,0.466,99,244,0.406,100,183,0.546,0.582,78,84,0.929,20,112,132,63,37,10,61,107,575,2017
D. Walker,DEL,24.0,38,12,1071,165,351,0.47,81,196,0.413,84,155,0.542,0.585,63,68,0.926,19,92,111,56,29,9,44,89,474,2017
T. Walkup,WCB,24.0,40,23,978,116,254,0.457,22,78,0.282,94,176,0.534,0.5,49,58,0.845,31,126,157,136,42,6,41,90,303,2017
T. Wallace,SLS,22.0,38,15,1020,208,460,0.452,15,62,0.242,193,398,0.485,0.468,129,185,0.697,22,125,147,138,51,10,94,96,560,2017
A. Wangmene,AUS,27.0,2,0,4,0,0,0.0,0,0,0.0,0,0,0.0,0.0,0,0,0.0,0,0,0,0,1,0,2,2,0,2017
K. Ward,OKL,23.0,22,1,111,10,31,0.323,7,22,0.318,3,9,0.333,0.435,2,4,0.5,0,13,13,2,1,2,2,17,29,2017
J. Warney,TEX,23.0,44,34,1286,322,560,0.575,0,1,0.0,322,559,0.576,0.575,118,168,0.702,146,207,353,61,44,51,55,138,762,2017
W. Washpun,IOW,23.0,34,18,869,84,217,0.387,25,83,0.301,59,134,0.44,0.445,35,59,0.593,12,73,85,132,37,21,42,93,228,2017
C. Watford,TOT,25.0,39,3,602,60,173,0.347,46,117,0.393,14,56,0.25,0.48,37,43,0.86,23,84,107,29,19,11,25,59,203,2017
C. Watford,RAP,25.0,19,1,277,26,75,0.347,22,50,0.44,4,25,0.16,0.493,12,14,0.857,15,45,60,10,6,4,8,30,86,2017
C. Watford,FOR,25.0,20,2,325,34,98,0.347,24,67,0.358,10,31,0.323,0.469,25,29,0.862,8,39,47,19,13,7,17,29,117,2017
T. Wear,LOS,26.0,42,13,1067,206,476,0.433,77,225,0.342,129,251,0.514,0.514,46,65,0.708,58,246,304,43,34,20,51,98,535,2017
E. Weary Jr.,SFL,23.0,4,0,17,5,7,0.714,3,5,0.6,2,2,1.0,0.929,2,3,0.667,0,5,5,0,0,0,2,1,15,2017
J. Webb III,DEL,23.0,39,39,1357,186,416,0.447,71,198,0.359,115,218,0.528,0.532,68,90,0.756,80,281,361,46,50,30,61,122,511,2017
B. Weber,SFL,24.0,31,31,1141,195,429,0.455,37,104,0.356,158,325,0.486,0.498,84,108,0.778,51,182,233,227,101,5,95,85,511,2017
N. Webster-Chan,RAP,24.0,23,6,281,25,75,0.333,14,50,0.28,11,25,0.44,0.427,6,8,0.75,4,45,49,26,11,5,14,24,70,2017
D. Wells,OKL,24.0,23,1,587,103,223,0.462,38,90,0.422,65,133,0.489,0.547,50,76,0.658,13,69,82,47,31,7,42,56,294,2017
T. Whisnant,IOW,24.0,45,13,1208,134,383,0.35,109,316,0.345,25,67,0.373,0.492,49,58,0.845,24,129,153,47,19,9,42,68,426,2017
O. White,SFL,24.0,23,23,759,144,328,0.439,38,126,0.302,106,202,0.525,0.497,98,114,0.86,58,143,201,40,25,13,72,93,424,2017
G. Whittington,SFL,23.0,9,6,270,48,100,0.48,24,53,0.453,24,47,0.511,0.6,2,2,1.0,8,43,51,18,9,6,18,30,122,2017
A. Wiggins,RAP,28.0,39,10,731,141,250,0.564,17,48,0.354,124,202,0.614,0.598,41,71,0.577,53,73,126,26,24,16,33,44,340,2017
C. Wilcox,ERI,26.0,4,1,103,20,39,0.513,9,21,0.429,11,18,0.611,0.628,1,2,0.5,0,17,17,8,5,3,7,8,50,2017
D. Wilkins,SWR,37.0,48,30,1510,215,442,0.486,49,137,0.358,166,305,0.544,0.542,233,276,0.844,51,202,253,180,46,30,102,133,712,2017
A. Williams,NAS,24.0,1,1,28,7,14,0.5,0,0,0.0,7,14,0.5,0.5,6,8,0.75,3,6,9,1,1,0,2,4,20,2017
A. Williams,IOW,24.0,29,14,514,55,99,0.556,0,0,0.0,55,99,0.556,0.556,41,60,0.683,71,114,185,16,15,38,24,64,151,2017
C. Williams,TEX,26.0,50,39,1462,231,524,0.441,107,277,0.386,124,247,0.502,0.543,71,90,0.789,29,178,207,92,52,46,59,149,640,2017
C. Williams,MAI,27.0,50,24,1098,127,323,0.393,87,247,0.352,40,76,0.526,0.528,15,17,0.882,20,74,94,71,17,7,34,72,356,2017
D. Williams,SWR,,8,0,67,10,14,0.714,0,0,0.0,10,14,0.714,0.714,3,6,0.5,8,18,26,1,2,0,5,12,23,2017
J. Williams,SLS,29.0,22,5,347,38,111,0.342,13,48,0.271,25,63,0.397,0.401,31,40,0.775,21,52,73,15,11,12,16,48,120,2017
M. Williams,CAN,25.0,43,2,778,86,217,0.396,47,114,0.412,39,103,0.379,0.505,23,36,0.639,3,71,74,91,24,3,36,61,242,2017
P. Williams,MAI,25.0,10,0,63,3,9,0.333,0,5,0.0,3,4,0.75,0.333,0,0,0.0,3,8,11,6,3,1,2,7,6,2017
P. Williams,SWR,24.0,24,1,200,28,63,0.444,11,29,0.379,17,34,0.5,0.532,5,9,0.556,4,10,14,12,6,0,17,11,72,2017
R. Williams,OKL,30.0,36,36,1188,246,510,0.482,88,213,0.413,158,297,0.532,0.569,79,100,0.79,32,139,171,122,32,1,70,55,659,2017
R. Williams,SWR,25.0,12,2,137,12,19,0.632,4,7,0.571,8,12,0.667,0.737,4,9,0.444,0,14,14,6,2,4,5,23,32,2017
T. Williams,RIO,22.0,10,8,289,70,147,0.476,23,65,0.354,47,82,0.573,0.554,35,44,0.795,8,45,53,26,8,2,21,30,198,2017
T. Williams,IOW,22.0,23,7,460,108,239,0.452,29,92,0.315,79,147,0.537,0.513,50,73,0.685,25,69,94,25,22,3,46,64,295,2017
T. Williams,TOT,22.0,33,15,749,178,386,0.461,52,157,0.331,126,229,0.55,0.528,85,117,0.726,33,114,147,51,30,5,67,94,493,2017
K. Wiltjer,RIO,24.0,22,22,789,156,375,0.416,81,215,0.377,75,160,0.469,0.524,57,66,0.864,30,111,141,38,12,18,44,50,450,2017
A. Woodbury,FOR,23.0,24,5,301,28,61,0.459,0,2,0.0,28,59,0.475,0.459,15,22,0.682,26,59,85,12,7,6,13,38,71,2017
C. Wood,SWR,21.0,18,16,540,133,263,0.506,12,51,0.235,121,212,0.571,0.529,74,102,0.725,45,136,181,19,8,47,41,40,352,2017
A. Woods,NAS,24.0,23,1,175,12,30,0.4,5,17,0.294,7,13,0.538,0.483,9,12,0.75,4,17,21,3,3,1,7,35,38,2017
S. Wood,SAN,26.0,50,49,1512,217,487,0.446,166,386,0.43,51,101,0.505,0.616,99,105,0.943,12,197,209,59,37,8,51,100,699,2017
K. Woods,OKL,23.0,50,29,1276,89,222,0.401,19,81,0.235,70,141,0.496,0.444,32,50,0.64,35,191,226,76,37,29,62,65,229,2017
C. Wright,OKL,28.0,20,4,438,86,166,0.518,4,20,0.2,82,146,0.562,0.53,22,39,0.564,33,50,83,27,27,20,29,50,198,2017
D. Wright,RAP,24.0,5,5,150,22,51,0.431,0,8,0.0,22,43,0.512,0.431,19,24,0.792,2,12,14,26,9,8,9,5,63,2017
K. Wright,WES,27.0,47,32,1257,186,345,0.539,3,15,0.2,183,330,0.555,0.543,40,67,0.597,140,186,326,52,38,33,52,122,415,2017
T. Wroten,TEX,23.0,16,2,379,70,167,0.419,23,80,0.288,47,87,0.54,0.488,38,72,0.528,6,31,37,37,13,3,49,42,201,2017
G. Yabusele,MAI,,2,1,54,11,17,0.647,4,6,0.667,7,11,0.636,0.765,11,12,0.917,9,11,20,2,1,0,9,4,37,2017
G. York,ERI,23.0,44,35,1436,250,574,0.436,107,296,0.361,143,278,0.514,0.529,87,104,0.837,23,162,185,164,59,7,78,89,694,2017
J. Young,FOR,24.0,2,1,49,8,22,0.364,3,9,0.333,5,13,0.385,0.432,2,2,1.0,0,4,4,9,3,2,5,2,21,2017
N. Zeisloft,FOR,24.0,47,1,694,112,282,0.397,90,228,0.395,22,54,0.407,0.557,32,39,0.821,14,44,58,18,15,7,17,43,346,2017
S. Zimmerman,ERI,20.0,21,21,627,117,241,0.485,0,1,0.0,117,240,0.488,0.485,47,76,0.618,46,140,186,30,24,27,49,78,281,2017
P. Zipser,WCB,22.0,3,3,106,14,40,0.35,4,11,0.364,10,29,0.345,0.4,14,17,0.824,11,18,29,7,1,4,11,10,46,2017
I. Zubac,LOS,19.0,14,14,421,94,161,0.584,4,11,0.364,90,150,0.6,0.596,29,35,0.829,29,107,136,18,3,14,45,48,221,2017
J. Abdul-Bassit,IDA,23.0,2,0,26,4,11,0.364,1,4,0.25,3,7,0.429,0.409,2,2,1.0,0,2,2,1,0,0,0,5,11,2016
A. Agudio,CAN,31.0,36,5,590,59,135,0.437,36,84,0.429,23,51,0.451,0.57,19,28,0.679,5,34,39,37,14,0,20,48,173,2016
R. Aguilar,TEX,28.0,6,0,55,6,13,0.462,0,0,0.0,6,13,0.462,0.462,2,4,0.5,5,12,17,1,2,2,7,15,14,2016
C. Alexander,SAN,20.0,4,4,108,25,48,0.521,0,0,0.0,25,48,0.521,0.521,10,14,0.714,7,22,29,2,2,8,9,15,60,2016
M. Ammons,IDA,24.0,14,0,187,13,41,0.317,0,3,0.0,13,38,0.342,0.317,5,6,0.833,21,30,51,12,7,1,15,35,31,2016
J. Anderson,TEX,22.0,7,7,268,63,137,0.46,16,48,0.333,47,89,0.528,0.518,19,24,0.792,4,28,32,24,3,4,13,15,161,2016
M. Anderson,RAP,24.0,1,0,5,0,0,0.0,0,0,0.0,0,0,0.0,0.0,0,0,0.0,0,2,2,1,1,0,1,0,0,2016
Z. Andrews,TOT,30.0,21,4,291,45,81,0.556,1,4,0.25,44,77,0.571,0.562,16,25,0.64,23,53,76,13,13,16,23,52,107,2016
Z. Andrews,LOS,30.0,19,4,250,39,67,0.582,1,4,0.25,38,63,0.603,0.59,16,25,0.64,22,39,61,11,12,14,20,48,95,2016
Z. Andrews,IOW,30.0,2,0,41,6,14,0.429,0,0,0.0,6,14,0.429,0.429,0,0,0.0,1,14,15,2,1,2,3,4,12,2016
T. Antetokounmpo,WES,23.0,44,38,1205,183,365,0.501,22,100,0.22,161,265,0.608,0.532,93,143,0.65,60,150,210,63,36,55,76,129,481,2016
K. Appling,ERI,23.0,35,34,1129,230,483,0.476,27,72,0.375,203,411,0.494,0.504,179,214,0.836,20,129,149,178,58,7,81,115,666,2016
B. Ashley,TEX,21.0,33,33,1045,184,404,0.455,46,117,0.393,138,287,0.481,0.512,73,96,0.76,37,186,223,68,32,45,81,134,487,2016
D. Atkins,WES,23.0,50,37,1472,208,450,0.462,1,6,0.167,207,444,0.466,0.463,18,32,0.563,84,282,366,89,49,67,93,138,435,2016
E. Atkins,ERI,24.0,24,8,582,57,139,0.41,18,50,0.36,39,89,0.438,0.475,23,28,0.821,12,31,43,72,23,3,33,55,155,2016
J. Ayres,LOS,28.0,2,1,65,10,20,0.5,1,3,0.333,9,17,0.529,0.525,12,14,0.857,10,16,26,3,0,0,0,6,33,2016
J. Ayres,IDA,28.0,25,23,810,140,251,0.558,2,7,0.286,138,244,0.566,0.562,123,139,0.885,48,183,231,57,19,30,62,102,405,2016
J. Ayres,TOT,28.0,27,24,875,150,271,0.554,3,10,0.3,147,261,0.563,0.559,135,153,0.882,58,199,257,60,19,30,62,108,438,2016
D. Bachynski,GRR,24.0,13,0,102,9,24,0.375,2,2,1.0,7,22,0.318,0.417,4,6,0.667,11,17,28,2,2,1,3,19,24,2016
J. Bachynski,WES,26.0,49,49,1339,256,442,0.579,0,1,0.0,256,441,0.58,0.579,131,192,0.682,102,242,344,44,19,115,80,172,643,2016
C. Bairstow,AUS,25.0,5,4,133,28,59,0.475,0,2,0.0,28,57,0.491,0.475,14,17,0.824,10,30,40,6,4,3,13,13,70,2016
M. Baker,SAN,36.0,19,2,332,30,74,0.405,0,12,0.0,30,62,0.484,0.405,5,7,0.714,13,37,50,29,14,1,10,33,65,2016
K. Barlow,GRR,24.0,47,37,1502,219,529,0.414,81,226,0.358,138,303,0.455,0.491,67,82,0.817,22,198,220,100,48,15,69,134,586,2016
B. Barnes,TEX,25.0,3,0,25,3,8,0.375,1,4,0.25,2,4,0.5,0.438,0,0,0.0,0,2,2,1,1,0,1,1,7,2016
A. Barton,CAN,24.0,3,0,32,1,9,0.111,0,4,0.0,1,5,0.2,0.111,1,2,0.5,0,1,1,1,0,0,4,1,3,2016
A. Bennett,RAP,22.0,6,4,107,19,56,0.339,6,24,0.25,13,32,0.406,0.393,11,14,0.786,2,17,19,4,6,4,5,6,55,2016
K. Benson,SFL,27.0,49,23,1168,276,482,0.573,1,7,0.143,275,475,0.579,0.574,122,158,0.772,119,250,369,38,21,77,79,147,675,2016
D. Berry,TOT,24.0,41,23,1038,145,307,0.472,50,117,0.427,95,190,0.5,0.554,78,100,0.78,7,79,86,125,26,4,68,84,418,2016
D. Berry,RAP,24.0,10,6,336,64,115,0.557,19,37,0.514,45,78,0.577,0.639,32,41,0.78,1,25,26,37,11,1,20,25,179,2016
D. Berry,MAI,24.0,31,17,702,81,192,0.422,31,80,0.388,50,112,0.446,0.503,46,59,0.78,6,54,60,88,15,3,48,59,239,2016
S. Bhullar,RAP,23.0,39,27,850,152,231,0.658,0,0,0.0,152,231,0.658,0.658,72,126,0.571,76,194,270,42,19,51,57,91,376,2016
T. Black,LOS,24.0,8,8,257,54,94,0.574,0,1,0.0,54,93,0.581,0.574,23,38,0.605,31,63,94,8,6,18,21,35,131,2016
V. Blue,LOS,23.0,48,48,1836,412,937,0.44,89,270,0.33,323,667,0.484,0.487,349,431,0.81,49,191,240,163,85,2,110,103,1262,2016
R. Boatright,GRR,23.0,20,5,422,80,191,0.419,15,55,0.273,65,136,0.478,0.458,47,54,0.87,2,58,60,57,15,1,32,28,222,2016
K. Bogans,WES,35.0,7,0,106,3,12,0.25,2,7,0.286,1,5,0.2,0.333,1,2,0.5,5,12,17,2,3,0,6,11,9,2016
J. Bohannon,TOT,24.0,44,23,1018,119,242,0.492,4,21,0.19,115,221,0.52,0.5,60,93,0.645,96,195,291,66,38,38,64,121,302,2016
J. Bohannon,ERI,24.0,20,0,385,43,107,0.402,0,4,0.0,43,103,0.417,0.402,19,32,0.594,41,75,116,24,16,16,35,45,105,2016
J. Bohannon,DEL,24.0,24,23,633,76,135,0.563,4,17,0.235,72,118,0.61,0.578,41,61,0.672,55,120,175,42,22,22,29,76,197,2016
A. Booker,BAK,22.0,47,0,974,222,481,0.462,32,96,0.333,190,385,0.494,0.495,127,168,0.756,20,127,147,163,35,1,96,114,603,2016
A. Bowen,ERI,24.0,36,11,579,85,164,0.518,3,10,0.3,82,154,0.532,0.527,18,30,0.6,40,58,98,23,21,6,36,93,191,2016
J. Branch,LOS,23.0,10,1,64,3,10,0.3,1,3,0.333,2,7,0.286,0.35,4,4,1.0,1,2,3,8,3,0,3,8,11,2016
R. Brewer,SAN,30.0,41,31,1028,132,305,0.433,19,74,0.257,113,231,0.489,0.464,16,30,0.533,33,156,189,80,54,21,39,50,299,2016
T. Bropleh,TEX,24.0,9,0,139,17,51,0.333,7,29,0.241,10,22,0.455,0.402,2,3,0.667,4,13,17,6,2,0,4,9,43,2016
A. Brown,LOS,23.0,7,2,235,38,97,0.392,15,47,0.319,23,50,0.46,0.469,11,16,0.688,5,23,28,12,4,3,14,20,102,2016
J. Brown,LOS,23.0,8,4,219,43,118,0.364,12,43,0.279,31,75,0.413,0.415,36,41,0.878,5,15,20,6,5,2,15,21,134,2016
L. Brown,GRR,25.0,25,20,833,179,356,0.503,25,71,0.352,154,285,0.54,0.538,74,86,0.86,38,99,137,145,52,7,73,62,457,2016
R. Bullock,GRR,24.0,1,1,36,10,12,0.833,6,8,0.75,4,4,1.0,1.083,3,4,0.75,0,5,5,5,4,1,2,4,29,2016
D. Burton,BAK,24.0,43,29,1126,142,314,0.452,29,81,0.358,113,233,0.485,0.498,88,122,0.721,29,79,108,96,41,12,53,127,401,2016
D. Buycks,OKL,26.0,15,13,496,111,253,0.439,29,85,0.341,82,168,0.488,0.496,39,48,0.813,16,49,65,72,25,3,48,24,290,2016
B. Caboclo,RAP,20.0,37,35,1270,193,479,0.403,85,254,0.335,108,225,0.48,0.492,72,99,0.727,45,194,239,64,40,65,76,139,543,2016
K. Capers,WES,22.0,35,0,326,53,109,0.486,7,26,0.269,46,83,0.554,0.518,55,80,0.688,11,19,30,27,16,0,25,72,168,2016
D. Caracter,ERI,27.0,24,0,272,45,102,0.441,0,2,0.0,45,100,0.45,0.441,24,28,0.857,36,50,86,8,8,12,33,56,114,2016
M. Carlino,RIO,23.0,27,2,382,33,111,0.297,26,84,0.31,7,27,0.259,0.414,11,15,0.733,7,37,44,43,23,1,15,49,103,2016
J. Carlton,OKL,23.0,7,0,22,4,13,0.308,3,11,0.273,1,2,0.5,0.423,0,0,0.0,3,4,7,0,0,3,0,1,11,2016
R. Carney,DEL,31.0,36,5,780,135,306,0.441,69,185,0.373,66,121,0.545,0.554,26,36,0.722,15,75,90,32,27,15,33,61,365,2016
J. Carter,BAK,24.0,41,0,484,57,128,0.445,6,17,0.353,51,111,0.459,0.469,32,41,0.78,53,66,119,19,12,27,28,72,152,2016
K. Casey,BAK,26.0,50,27,1215,143,332,0.431,25,83,0.301,118,249,0.474,0.468,91,119,0.765,67,180,247,85,24,30,90,161,402,2016
J. Childress,TEX,32.0,8,1,242,39,79,0.494,4,11,0.364,35,68,0.515,0.519,14,20,0.7,12,40,52,13,8,5,3,17,96,2016
I. Chiles,TOT,25.0,10,0,79,18,34,0.529,0,0,0.0,18,34,0.529,0.529,5,5,1.0,12,16,28,2,0,5,7,15,41,2016
I. Chiles,OKL,25.0,1,0,0,0,0,0.0,0,0,0.0,0,0,0.0,0.0,0,0,0.0,0,0,0,0,0,0,0,0,0,2016
I. Chiles,IDA,25.0,9,0,79,18,34,0.529,0,0,0.0,18,34,0.529,0.529,5,5,1.0,12,16,28,2,0,5,7,15,41,2016
P. Christopher,IOW,27.0,20,19,643,118,262,0.45,36,97,0.371,82,165,0.497,0.519,33,42,0.786,8,45,53,50,15,5,21,57,305,2016
R. Christmas,FOR,24.0,48,46,1443,245,518,0.473,1,4,0.25,244,514,0.475,0.474,175,239,0.732,108,235,343,37,29,81,107,192,666,2016
C. Clarke,MAI,23.0,44,16,1152,254,495,0.513,76,187,0.406,178,308,0.578,0.59,133,168,0.792,86,243,329,115,50,29,85,105,717,2016
E. Clark,DEL,28.0,11,5,310,62,131,0.473,18,37,0.486,44,94,0.468,0.542,25,33,0.758,9,72,81,18,7,6,25,23,167,2016
E. Clark,BAK,28.0,22,22,772,168,424,0.396,38,104,0.365,130,320,0.406,0.441,70,98,0.714,32,145,177,49,15,31,56,42,444,2016
E. Clark,TOT,28.0,33,27,1082,230,555,0.414,56,141,0.397,174,414,0.42,0.465,95,131,0.725,41,217,258,67,22,37,81,65,611,2016
M. Cobbins,OKL,23.0,29,0,209,19,38,0.5,0,1,0.0,19,37,0.514,0.5,9,20,0.45,10,28,38,4,6,4,14,38,47,2016
J. Cobb,CAN,24.0,8,0,117,13,35,0.371,7,24,0.292,6,11,0.545,0.471,4,4,1.0,2,9,11,12,5,2,4,16,37,2016
K. Cochran,RIO,23.0,17,0,198,27,59,0.458,10,33,0.303,17,26,0.654,0.542,5,6,0.833,4,16,20,10,13,7,9,20,69,2016
S. Coleman,BAK,28.0,6,0,54,1,10,0.1,0,1,0.0,1,9,0.111,0.1,4,8,0.5,5,9,14,3,2,1,2,14,6,2016
S. Collins,TEX,28.0,2,0,22,2,8,0.25,0,1,0.0,2,7,0.286,0.25,1,2,0.5,0,0,0,0,1,0,3,2,5,2016
D. Cooke Jr.,BAK,24.0,47,21,1099,94,167,0.563,0,0,0.0,94,167,0.563,0.563,39,79,0.494,145,186,331,51,35,36,53,118,227,2016
Q. Cook,CAN,22.0,43,37,1451,309,663,0.466,86,225,0.382,223,438,0.509,0.531,138,160,0.863,31,138,169,233,51,1,99,88,842,2016
J. Cooley,IDA,24.0,6,5,168,35,64,0.547,0,3,0.0,35,61,0.574,0.547,17,27,0.63,32,39,71,8,11,1,14,20,87,2016
B. Cotton,AUS,23.0,6,6,197,37,71,0.521,15,31,0.484,22,40,0.55,0.627,27,29,0.931,3,17,20,24,7,1,11,14,116,2016
D. Coursey,ERI,23.0,20,3,220,21,52,0.404,0,2,0.0,21,50,0.42,0.404,4,8,0.5,12,27,39,8,7,4,8,38,46,2016
D. Coursey,TOT,23.0,44,11,612,90,166,0.542,0,2,0.0,90,164,0.549,0.542,17,23,0.739,36,91,127,20,16,25,24,99,197,2016
D. Coursey,SAN,23.0,24,8,392,69,114,0.605,0,0,0.0,69,114,0.605,0.605,13,15,0.867,24,64,88,12,9,21,16,61,151,2016
A. Craft,SAN,24.0,30,30,1055,157,337,0.466,25,90,0.278,132,247,0.534,0.503,65,79,0.823,16,123,139,219,59,26,70,92,404,2016
C. Crawford,CAN,23.0,15,3,325,33,105,0.314,20,69,0.29,13,36,0.361,0.41,1,2,0.5,2,41,43,59,8,10,20,31,87,2016
J. Crawford,WES,25.0,47,6,929,152,349,0.436,29,98,0.296,123,251,0.49,0.477,67,76,0.882,13,56,69,111,56,3,69,91,400,2016
W. Cummings,RIO,23.0,49,49,1780,321,682,0.471,106,276,0.384,215,406,0.53,0.548,255,324,0.787,42,134,176,235,94,3,151,160,1003,2016
J. Cunningham,IDA,24.0,3,3,96,12,43,0.279,7,19,0.368,5,24,0.208,0.36,21,25,0.84,0,10,10,14,2,0,8,9,52,2016
D. Daniels,RAP,23.0,8,5,110,8,35,0.229,4,15,0.267,4,20,0.2,0.286,3,6,0.5,7,19,26,4,2,2,6,9,23,2016
A. Davis,ERI,24.0,50,42,1340,153,329,0.465,0,3,0.0,153,326,0.469,0.465,126,162,0.778,97,166,263,43,31,63,83,186,432,2016
B. Davis,DEL,36.0,6,0,135,27,76,0.355,14,44,0.318,13,32,0.406,0.447,9,10,0.9,2,13,15,21,7,2,12,18,77,2016
A. Dawkins,TEX,24.0,12,8,360,64,137,0.467,38,87,0.437,26,50,0.52,0.606,14,16,0.875,3,23,26,19,11,1,18,30,180,2016
B. Dawson,ERI,22.0,8,0,245,68,113,0.602,1,1,1.0,67,112,0.598,0.606,22,31,0.71,28,38,66,18,16,11,15,15,159,2016
B. Dawson,BAK,22.0,6,0,105,17,41,0.415,0,0,0.0,17,41,0.415,0.415,4,15,0.267,12,11,23,3,2,3,8,10,38,2016
B. Dawson,TOT,22.0,29,0,613,130,251,0.518,4,9,0.444,126,242,0.521,0.526,34,59,0.576,62,81,143,30,32,20,36,46,298,2016
B. Dawson,GRR,22.0,15,0,263,45,97,0.464,3,8,0.375,42,89,0.472,0.479,8,13,0.615,22,32,54,9,14,6,13,21,101,2016
D. Dedmon,ERI,26.0,1,1,34,7,13,0.538,0,0,0.0,7,13,0.538,0.538,3,3,1.0,9,13,22,0,0,3,2,4,17,2016
B. Dejean-Jones,IDA,23.0,9,7,282,56,131,0.427,20,59,0.339,36,72,0.5,0.504,41,51,0.804,15,31,46,20,18,2,20,29,173,2016
S. Dekker,RIO,21.0,7,0,163,33,79,0.418,9,38,0.237,24,41,0.585,0.475,8,12,0.667,16,21,37,11,4,1,12,5,83,2016
D. Deng,TEX,24.0,16,0,209,17,44,0.386,0,3,0.0,17,41,0.415,0.386,9,16,0.563,23,41,64,7,10,12,15,31,43,2016
S. Dinwiddie,GRR,22.0,13,11,438,61,145,0.421,16,47,0.34,45,98,0.459,0.476,53,61,0.869,8,37,45,78,28,9,28,35,191,2016
H. Domercant,IDA,35.0,12,0,201,21,60,0.35,9,32,0.281,12,28,0.429,0.425,22,26,0.846,5,16,21,8,4,2,7,18,73,2016
C. Douglas-Roberts,TEX,29.0,15,15,546,110,215,0.512,14,43,0.326,96,172,0.558,0.544,51,55,0.927,10,55,65,30,19,7,32,38,285,2016
J. Downing,BAK,24.0,10,0,82,12,39,0.308,5,17,0.294,7,22,0.318,0.372,0,0,0.0,0,4,4,3,0,0,2,5,29,2016
L. Drew,SFL,25.0,3,0,45,6,10,0.6,4,8,0.5,2,2,1.0,0.8,1,2,0.5,0,2,2,4,2,0,0,3,17,2016
T. Drisdom,SAN,23.0,26,0,461,74,162,0.457,9,32,0.281,65,130,0.5,0.485,24,34,0.706,18,64,82,32,24,15,23,46,181,2016
D. Dukan,REN,24.0,27,27,780,140,347,0.403,73,197,0.371,67,150,0.447,0.509,39,54,0.722,18,98,116,32,18,12,46,84,392,2016
M. Dunigan,CAN,24.0,33,19,686,98,196,0.5,0,1,0.0,98,195,0.503,0.5,63,103,0.612,61,115,176,28,22,32,31,102,259,2016
A. Durham,TEX,27.0,24,7,565,90,163,0.552,4,9,0.444,86,154,0.558,0.564,28,41,0.683,78,100,178,24,13,19,26,48,212,2016
C. Early,WES,24.0,7,7,234,41,92,0.446,10,30,0.333,31,62,0.5,0.5,17,28,0.607,10,41,51,8,9,5,16,21,109,2016
D. Ebanks,GRR,26.0,48,48,1746,359,818,0.439,84,267,0.315,275,551,0.499,0.49,248,308,0.805,67,266,333,77,77,13,116,114,1050,2016
J. Eddie,AUS,24.0,11,9,315,53,100,0.53,32,61,0.525,21,39,0.538,0.69,17,18,0.944,0,44,44,11,4,2,14,22,155,2016
N. Egwu,ERI,23.0,50,50,1588,212,438,0.484,0,0,0.0,212,438,0.484,0.484,34,45,0.756,121,238,359,71,38,66,81,154,458,2016
M. Ejim,ERI,24.0,39,39,1275,208,440,0.473,35,106,0.33,173,334,0.518,0.513,117,148,0.791,77,223,300,121,61,15,115,153,568,2016
E. Ellis,MAI,25.0,3,0,5,0,2,0.0,0,2,0.0,0,0,0.0,0.0,2,2,1.0,0,0,0,0,0,1,0,0,2,2016
J. Ennis,IOW,25.0,24,21,799,158,348,0.454,42,131,0.321,116,217,0.535,0.514,92,132,0.697,45,100,145,62,24,11,64,66,450,2016
M. Eric,TEX,27.0,39,37,1055,199,333,0.598,0,0,0.0,199,333,0.598,0.598,61,83,0.735,131,235,366,24,20,79,74,131,459,2016
M. Esho,IOW,24.0,35,0,554,82,186,0.441,9,34,0.265,73,152,0.48,0.465,33,45,0.733,30,91,121,15,21,14,40,72,206,2016
J. Evans,TEX,28.0,4,4,143,26,52,0.5,7,18,0.389,19,34,0.559,0.567,8,11,0.727,11,25,36,4,6,2,7,16,67,2016
C. Fair,FOR,24.0,50,43,1663,300,619,0.485,54,152,0.355,246,467,0.527,0.528,145,181,0.801,67,280,347,94,49,28,104,106,799,2016
M. Farrakhan,OKL,27.0,19,0,326,56,140,0.4,25,60,0.417,31,80,0.388,0.489,24,32,0.75,8,25,33,21,14,4,24,26,161,2016
C. Felicio,CAN,23.0,4,4,95,25,39,0.641,4,10,0.4,21,29,0.724,0.692,3,4,0.75,8,14,22,4,2,6,8,13,57,2016
B. Fields,TOT,27.0,50,23,1441,267,613,0.436,53,175,0.303,214,438,0.489,0.479,147,190,0.774,31,144,175,202,40,0,137,103,734,2016
B. Fields,IDA,27.0,36,19,1091,205,484,0.424,42,143,0.294,163,341,0.478,0.467,118,155,0.761,25,106,131,159,32,0,110,69,570,2016
B. Fields,AUS,27.0,14,4,350,62,129,0.481,11,32,0.344,51,97,0.526,0.523,29,35,0.829,6,38,44,43,8,0,27,34,164,2016
G. Forbes,GRR,30.0,3,0,38,4,18,0.222,1,11,0.091,3,7,0.429,0.25,0,0,0.0,3,4,7,1,0,0,3,4,9,2016
X. Ford,GRR,23.0,38,1,435,43,96,0.448,0,7,0.0,43,89,0.483,0.448,16,21,0.762,24,31,55,13,12,4,20,51,102,2016
J. Franklin,LOS,24.0,4,2,103,16,34,0.471,4,11,0.364,12,23,0.522,0.529,9,16,0.563,7,13,20,15,3,3,10,13,45,2016
M. Frazier,LOS,21.0,14,0,233,29,80,0.363,7,30,0.233,22,50,0.44,0.406,18,23,0.783,2,26,28,25,11,0,12,14,83,2016
M. Frazier,IOW,21.0,12,0,150,13,43,0.302,9,25,0.36,4,18,0.222,0.407,13,14,0.929,2,22,24,9,5,2,9,14,48,2016
M. Frazier,FOR,21.0,10,2,222,44,76,0.579,10,18,0.556,34,58,0.586,0.645,11,22,0.5,6,26,32,12,7,2,9,16,109,2016
M. Frazier,TOT,21.0,36,2,605,86,199,0.432,26,73,0.356,60,126,0.476,0.497,42,59,0.712,10,74,84,46,23,4,30,44,240,2016
T. Frazier,MAI,25.0,8,7,240,44,79,0.557,8,20,0.4,36,59,0.61,0.608,24,32,0.75,19,54,73,77,11,3,25,23,120,2016
J. Fredette,WES,26.0,40,39,1431,290,633,0.458,83,202,0.411,207,431,0.48,0.524,179,198,0.904,24,153,177,200,70,6,100,76,842,2016
S. Gaines,REN,29.0,4,4,108,28,60,0.467,11,24,0.458,17,36,0.472,0.558,13,16,0.813,2,14,16,16,7,0,9,5,80,2016
G. Gamble,FOR,25.0,5,0,34,4,17,0.235,2,10,0.2,2,7,0.286,0.294,0,0,0.0,0,3,3,3,1,1,0,6,10,2016
C. Giles,WES,30.0,4,0,23,0,2,0.0,0,0,0.0,0,2,0.0,0.0,1,2,0.5,3,5,8,0,0,3,3,8,1,2016
R. Gomes,LOS,33.0,31,28,993,205,425,0.482,48,129,0.372,157,296,0.53,0.539,107,125,0.856,71,180,251,97,27,12,36,91,565,2016
T. Graham,IDA,22.0,46,20,1397,260,565,0.46,68,206,0.33,192,359,0.535,0.52,135,217,0.622,74,207,281,73,39,9,64,118,723,2016
K. Gransberry,LOS,30.0,1,0,7,0,0,0.0,0,0,0.0,0,0,0.0,0.0,1,2,0.5,1,2,3,0,0,0,0,4,1,2016
E. Green,REN,24.0,40,39,1488,350,684,0.512,117,264,0.443,233,420,0.555,0.597,211,249,0.847,25,151,176,162,52,11,70,70,1028,2016
T. Greene,DEL,23.0,48,36,1229,156,358,0.436,72,179,0.402,84,179,0.469,0.536,125,143,0.874,12,95,107,45,54,12,33,111,509,2016
C. Griffin,TEX,22.0,6,0,36,5,10,0.5,0,0,0.0,5,10,0.5,0.5,1,2,0.5,3,4,7,1,1,0,1,4,11,2016
J. Gutierrez,CAN,27.0,22,20,611,93,216,0.431,9,44,0.205,84,172,0.488,0.451,54,64,0.844,13,79,92,125,48,3,67,70,249,2016
J. Hamilton,RIO,25.0,14,0,409,82,165,0.497,17,47,0.362,65,118,0.551,0.548,28,38,0.737,34,97,131,55,12,12,28,41,209,2016
C. Hammonds,REN,30.0,46,9,1386,147,332,0.443,54,171,0.316,93,161,0.578,0.524,34,57,0.596,37,146,183,241,60,10,71,113,382,2016
S. Hannah,GRR,30.0,9,0,143,16,40,0.4,8,16,0.5,8,24,0.333,0.5,6,8,0.75,2,12,14,20,8,2,13,13,46,2016
T. Hardaway Jr.,CAN,23.0,2,2,65,8,29,0.276,1,14,0.071,7,15,0.467,0.293,17,19,0.895,0,4,4,4,0,0,3,5,34,2016
T. Hardaway Jr.,AUS,23.0,3,0,69,18,34,0.529,11,23,0.478,7,11,0.636,0.691,13,15,0.867,2,7,9,6,3,0,6,8,60,2016
T. Hardaway Jr.,TOT,23.0,5,2,134,26,63,0.413,12,37,0.324,14,26,0.538,0.508,30,34,0.882,2,11,13,10,3,0,9,13,94,2016
J. Harper,LOS,26.0,42,26,1214,237,502,0.472,88,225,0.391,149,277,0.538,0.56,82,92,0.891,84,157,241,67,30,28,44,122,644,2016
M. Harrell,RIO,22.0,12,12,467,114,214,0.533,12,50,0.24,102,164,0.622,0.561,51,78,0.654,38,73,111,40,12,29,34,43,291,2016
A. Harrison,TOT,21.0,13,7,389,69,190,0.363,18,68,0.265,51,122,0.418,0.411,73,89,0.82,9,39,48,25,14,5,28,33,229,2016
A. Harrison,OKL,21.0,4,0,73,12,39,0.308,3,18,0.167,9,21,0.429,0.346,10,14,0.714,0,9,9,7,2,1,8,9,37,2016
A. Harrison,ERI,21.0,9,7,316,57,151,0.377,15,50,0.3,42,101,0.416,0.427,63,75,0.84,9,30,39,18,12,4,20,24,192,2016
A. Harris,FOR,30.0,29,11,431,71,157,0.452,11,26,0.423,60,131,0.458,0.487,18,26,0.692,10,37,47,55,19,3,39,55,171,2016
A. Harrison,IOW,21.0,46,45,1622,262,599,0.437,76,208,0.365,186,391,0.476,0.501,249,318,0.783,22,177,199,226,67,24,148,146,849,2016
J. Harris,TOT,23.0,29,2,478,58,163,0.356,21,61,0.344,37,102,0.363,0.42,28,34,0.824,12,40,52,66,13,1,49,28,165,2016
J. Harris,RAP,23.0,20,0,333,47,124,0.379,15,40,0.375,32,84,0.381,0.44,24,30,0.8,6,31,37,46,9,1,34,19,133,2016
J. Harris,DEL,23.0,9,2,145,11,39,0.282,6,21,0.286,5,18,0.278,0.359,4,4,1.0,6,9,15,20,4,0,15,9,32,2016
J. Harris,CAN,24.0,10,10,331,58,146,0.397,21,65,0.323,37,81,0.457,0.469,27,34,0.794,11,41,52,26,8,2,21,28,164,2016
M. Harris,LOS,26.0,8,8,320,63,153,0.412,11,34,0.324,52,119,0.437,0.448,50,59,0.847,11,43,54,33,15,3,27,18,187,2016
M. Harris,TOT,26.0,18,14,614,127,292,0.435,30,69,0.435,97,223,0.435,0.486,75,92,0.815,22,88,110,63,26,10,46,37,359,2016
M. Harris,TEX,26.0,10,6,294,64,139,0.46,19,35,0.543,45,104,0.433,0.529,25,33,0.758,11,45,56,30,11,7,19,19,172,2016
R. Harris,TOT,27.0,47,22,1160,130,350,0.371,83,223,0.372,47,127,0.37,0.49,58,91,0.637,26,239,265,74,50,25,45,122,401,2016
R. Harris,IOW,27.0,25,22,846,96,262,0.366,54,151,0.358,42,111,0.378,0.469,48,71,0.676,20,191,211,54,40,18,38,83,294,2016
R. Harris,FOR,27.0,22,0,314,34,88,0.386,29,72,0.403,5,16,0.313,0.551,10,20,0.5,6,48,54,20,10,7,7,39,107,2016
T. Harvey,ERI,22.0,37,13,984,153,419,0.365,80,231,0.346,73,188,0.388,0.461,54,68,0.794,12,78,90,56,36,4,53,66,440,2016
C. Hawkins,SFL,24.0,9,1,89,7,26,0.269,3,14,0.214,4,12,0.333,0.327,2,2,1.0,1,11,12,5,2,1,3,10,19,2016
C. Hawkins,IDA,24.0,30,25,904,146,314,0.465,63,155,0.406,83,159,0.522,0.565,55,69,0.797,15,89,104,74,33,7,39,58,410,2016
C. Hawkins,TOT,24.0,39,26,993,153,340,0.45,66,169,0.391,87,171,0.509,0.547,57,71,0.803,16,100,116,79,35,8,42,68,429,2016
J. Hawkins,LOS,30.0,41,35,1121,162,388,0.418,51,167,0.305,111,221,0.502,0.483,58,73,0.795,45,141,186,66,30,15,48,111,433,2016
L. Hayward,LOS,29.0,12,0,164,21,55,0.382,0,9,0.0,21,46,0.457,0.382,18,21,0.857,14,16,30,5,4,0,12,27,60,2016
R. Hearn,REN,24.0,48,22,1240,185,401,0.461,123,278,0.442,62,123,0.504,0.615,61,78,0.782,23,181,204,64,31,23,60,167,554,2016
M. Henderson,REN,25.0,4,0,44,9,25,0.36,9,22,0.409,0,3,0.0,0.54,0,0,0.0,2,3,5,2,3,0,1,4,27,2016
P. Henderson-Niles,IOW,28.0,11,2,128,6,12,0.5,0,0,0.0,6,12,0.5,0.5,3,6,0.5,4,17,21,4,6,3,12,24,15,2016
X. Henry,SAN,24.0,9,0,169,39,87,0.448,7,20,0.35,32,67,0.478,0.489,55,67,0.821,5,21,26,6,7,3,18,19,140,2016
S. Hicks,FOR,23.0,32,4,509,74,170,0.435,17,50,0.34,57,120,0.475,0.485,78,97,0.804,37,52,89,19,20,8,18,47,243,2016
D. Hilliard,GRR,22.0,3,3,99,25,51,0.49,11,25,0.44,14,26,0.538,0.598,16,20,0.8,1,10,11,8,7,2,7,5,77,2016
D. Hobson,SAN,28.0,44,35,1532,289,678,0.426,95,251,0.378,194,427,0.454,0.496,102,142,0.718,58,295,353,217,64,29,120,131,775,2016
J. Holland,CAN,27.0,37,30,1119,212,408,0.52,59,160,0.369,153,248,0.617,0.592,109,128,0.852,28,88,116,73,46,6,51,76,592,2016
T. Holloway,TEX,26.0,46,42,1636,320,698,0.458,95,232,0.409,225,466,0.483,0.527,294,331,0.888,26,119,145,291,62,5,130,87,1029,2016
K. Holsey,GRR,25.0,46,17,979,150,273,0.549,0,3,0.0,150,270,0.556,0.549,77,111,0.694,89,126,215,31,17,15,58,157,377,2016
M. Holyfield,TOT,23.0,40,3,526,60,109,0.55,0,0,0.0,60,109,0.55,0.55,37,61,0.607,75,101,176,7,7,32,43,101,157,2016
M. Holyfield,LOS,23.0,18,3,249,32,52,0.615,0,0,0.0,32,52,0.615,0.615,18,35,0.514,38,39,77,4,4,21,18,42,82,2016
M. Holyfield,IOW,23.0,22,0,277,28,57,0.491,0,0,0.0,28,57,0.491,0.491,19,26,0.731,37,62,99,3,3,11,25,59,75,2016
J. Horford,CAN,24.0,32,18,596,57,144,0.396,10,42,0.238,47,102,0.461,0.431,14,20,0.7,65,159,224,30,6,12,21,74,138,2016
J. Huestis,OKL,24.0,25,25,801,118,297,0.397,45,144,0.313,73,153,0.477,0.473,36,76,0.474,42,90,132,22,16,36,31,53,317,2016
T. Huff,ERI,23.0,7,0,95,9,30,0.3,3,15,0.2,6,15,0.4,0.35,6,8,0.75,0,9,9,2,9,0,5,8,27,2016
R. Hunter,MAI,22.0,8,5,246,37,103,0.359,16,54,0.296,21,49,0.429,0.437,20,27,0.741,5,30,35,26,15,5,21,21,110,2016
V. Hunter,REN,21.0,32,32,1020,261,443,0.589,1,5,0.2,260,438,0.594,0.59,174,264,0.659,138,225,363,46,32,49,62,123,697,2016
T. Hyman,FOR,28.0,8,1,101,8,18,0.444,0,0,0.0,8,18,0.444,0.444,7,14,0.5,12,22,34,3,6,8,7,19,23,2016
D. Inglis,WES,20.0,13,0,278,48,108,0.444,12,33,0.364,36,75,0.48,0.5,21,33,0.636,8,56,64,22,18,2,17,25,129,2016
D. Inglis,TOT,20.0,16,0,343,60,138,0.435,14,42,0.333,46,96,0.479,0.486,27,42,0.643,15,64,79,27,21,3,23,33,161,2016
D. Inglis,CAN,20.0,3,0,65,12,30,0.4,2,9,0.222,10,21,0.476,0.433,6,9,0.667,7,8,15,5,3,1,6,8,32,2016
A. Ingram,LOS,30.0,50,17,1319,166,339,0.49,113,228,0.496,53,111,0.477,0.656,74,86,0.86,17,123,140,72,53,9,28,99,519,2016
J. Inman,WES,28.0,2,0,13,2,3,0.667,0,0,0.0,2,3,0.667,0.667,1,2,0.5,2,1,3,0,0,0,0,3,5,2016
K. Jack,TOT,23.0,43,8,599,143,255,0.561,16,37,0.432,127,218,0.583,0.592,71,97,0.732,65,118,183,9,13,24,34,95,373,2016
K. Jack,REN,23.0,28,8,411,110,179,0.615,14,32,0.438,96,147,0.653,0.654,59,79,0.747,42,92,134,3,7,19,26,73,293,2016
K. Jack,FOR,23.0,15,0,188,33,76,0.434,2,5,0.4,31,71,0.437,0.447,12,18,0.667,23,26,49,6,6,5,8,22,80,2016
C. Jackson,DEL,22.0,6,1,131,19,33,0.576,0,0,0.0,19,33,0.576,0.576,5,11,0.455,22,25,47,5,6,7,5,20,43,2016
P. Jackson,IDA,24.0,8,0,164,27,74,0.365,8,30,0.267,19,44,0.432,0.419,11,12,0.917,4,16,20,20,4,2,18,12,73,2016
R. Jackson,TOT,26.0,30,11,655,99,177,0.559,0,0,0.0,99,177,0.559,0.559,26,36,0.722,50,129,179,27,17,32,30,61,224,2016
R. Jackson,IOW,26.0,3,0,54,9,11,0.818,0,0,0.0,9,11,0.818,0.818,2,3,0.667,2,4,6,2,1,3,1,1,20,2016
R. Jackson,DEL,26.0,27,11,601,90,166,0.542,0,0,0.0,90,166,0.542,0.542,24,33,0.727,48,125,173,25,16,29,29,60,204,2016
T. Jackson,IOW,23.0,25,0,358,52,119,0.437,6,26,0.231,46,93,0.495,0.462,24,31,0.774,9,30,39,32,23,1,19,34,134,2016
R. James,WES,26.0,15,2,416,100,199,0.503,21,57,0.368,79,142,0.556,0.555,26,37,0.703,15,50,65,16,12,0,23,30,247,2016
C. Jefferson,BAK,25.0,19,19,633,121,240,0.504,18,45,0.4,103,195,0.528,0.542,69,90,0.767,50,137,187,27,12,19,36,71,329,2016
B. Jennings,GRR,26.0,1,1,27,4,9,0.444,2,5,0.4,2,4,0.5,0.556,1,2,0.5,0,3,3,12,0,0,5,2,11,2016
D. Johnson,OKL,20.0,50,47,1381,251,474,0.53,0,1,0.0,251,473,0.531,0.53,115,198,0.581,136,268,404,100,33,58,80,151,617,2016
J. Johnson,RIO,23.0,50,50,1821,303,695,0.436,101,289,0.349,202,406,0.498,0.509,204,271,0.753,82,188,270,153,54,22,132,116,911,2016
M. Johnson,TEX,25.0,3,0,36,6,13,0.462,3,6,0.5,3,7,0.429,0.577,7,8,0.875,0,6,6,4,0,0,2,6,22,2016
M. Johnson,RAP,25.0,30,0,525,96,233,0.412,46,112,0.411,50,121,0.413,0.511,45,63,0.714,11,87,98,23,21,2,39,41,283,2016
M. Johnson,MAI,25.0,1,0,7,0,3,0.0,0,2,0.0,0,1,0.0,0.0,1,2,0.5,0,1,1,1,0,0,0,2,1,2016
M. Johnson,GRR,25.0,1,0,25,4,8,0.5,3,6,0.5,1,2,0.5,0.688,0,0,0.0,1,2,3,0,1,0,3,2,11,2016
M. Johnson,TOT,25.0,35,0,593,106,257,0.412,52,126,0.413,54,131,0.412,0.514,53,73,0.726,12,96,108,28,22,2,44,51,317,2016
N. Johnson,AUS,23.0,34,25,982,133,334,0.398,30,93,0.323,103,241,0.427,0.443,59,80,0.738,23,104,127,101,35,10,80,94,355,2016
O. Johnson,MAI,26.0,50,50,1522,290,644,0.45,158,384,0.411,132,260,0.508,0.573,43,70,0.614,65,260,325,72,37,33,71,139,781,2016
O. Johnson,AUS,26.0,30,26,961,150,346,0.434,53,115,0.461,97,231,0.42,0.51,111,136,0.816,33,125,158,84,17,12,50,51,464,2016
T. Johnson,RIO,23.0,23,4,301,28,86,0.326,8,37,0.216,20,49,0.408,0.372,17,22,0.773,4,28,32,23,12,1,14,20,81,2016
D. Jones,GRR,35.0,43,39,1534,219,401,0.546,33,80,0.413,186,321,0.579,0.587,206,242,0.851,27,153,180,106,36,7,82,140,677,2016
J. Jones,DEL,22.0,13,1,201,26,70,0.371,12,34,0.353,14,36,0.389,0.457,6,8,0.75,6,15,21,10,7,2,12,29,70,2016
L. Jones,IOW,25.0,21,20,767,125,278,0.45,28,74,0.378,97,204,0.475,0.5,61,76,0.803,14,74,88,101,36,9,61,64,339,2016
P. Jones,IOW,24.0,5,5,165,27,69,0.391,7,18,0.389,20,51,0.392,0.442,5,7,0.714,2,35,37,8,4,1,10,3,66,2016
T. Jones,IDA,19.0,6,6,211,58,119,0.487,20,47,0.426,38,72,0.528,0.571,12,13,0.923,4,19,23,30,9,1,14,13,148,2016
V. Jones,SAN,26.0,50,31,1550,295,642,0.46,75,203,0.369,220,439,0.501,0.518,139,194,0.716,33,127,160,190,65,13,100,108,804,2016
J. Jordan,ERI,23.0,10,2,197,35,59,0.593,3,4,0.75,32,55,0.582,0.619,10,17,0.588,5,15,20,33,11,1,16,28,83,2016
J. Jordan,DEL,23.0,8,0,119,16,37,0.432,0,3,0.0,16,34,0.471,0.432,8,13,0.615,3,9,12,16,11,2,10,16,40,2016
J. Jordan,TOT,23.0,33,2,505,71,145,0.49,4,18,0.222,67,127,0.528,0.503,36,58,0.621,14,43,57,75,29,4,48,71,182,2016
J. Jordan,RAP,23.0,15,0,189,20,49,0.408,1,11,0.091,19,38,0.5,0.418,18,28,0.643,6,19,25,26,7,1,22,27,59,2016
R. Jordan,DEL,21.0,11,0,181,29,79,0.367,15,44,0.341,14,35,0.4,0.462,16,24,0.667,5,8,13,17,9,1,21,27,89,2016
M. Kabongo,ERI,24.0,43,16,948,107,265,0.404,15,59,0.254,92,206,0.447,0.432,77,112,0.688,14,104,118,144,39,4,82,106,306,2016
T. Kelley,SFL,31.0,31,31,1114,178,421,0.423,34,116,0.293,144,305,0.472,0.463,93,118,0.788,9,65,74,174,45,7,89,57,483,2016
R. Kelly,LOS,24.0,7,7,250,64,121,0.529,12,32,0.375,52,89,0.584,0.579,49,63,0.778,13,38,51,21,9,14,12,23,189,2016
S. Kilpatrick,DEL,26.0,28,26,1074,249,527,0.472,86,202,0.426,163,325,0.502,0.554,154,198,0.778,25,83,108,59,32,4,70,34,738,2016
M. Koshwal,BAK,28.0,15,14,335,31,59,0.525,0,0,0.0,31,59,0.525,0.525,7,17,0.412,40,66,106,20,11,1,14,43,69,2016
M. Koshwal,TOT,28.0,32,28,807,86,175,0.491,0,0,0.0,86,175,0.491,0.491,21,57,0.368,100,151,251,43,39,10,41,91,193,2016
M. Koshwal,SAN,28.0,17,14,472,55,116,0.474,0,0,0.0,55,116,0.474,0.474,14,40,0.35,60,85,145,23,28,9,27,48,124,2016
M. Kyser,RAP,24.0,43,3,623,72,154,0.468,0,7,0.0,72,147,0.49,0.468,23,34,0.676,63,89,152,14,14,34,21,64,167,2016
C. Lallane,AUS,23.0,50,28,1305,246,524,0.469,61,181,0.337,185,343,0.539,0.528,110,161,0.683,129,250,379,46,24,64,98,151,663,2016
D. Laury,DEL,25.0,44,15,1105,173,366,0.473,30,97,0.309,143,269,0.532,0.514,92,149,0.617,83,260,343,80,35,28,74,102,468,2016
G. Lawal,REN,27.0,9,0,104,24,38,0.632,0,0,0.0,24,38,0.632,0.632,8,16,0.5,20,33,53,3,1,7,17,22,56,2016
G. Lawal,DEL,27.0,10,2,149,18,39,0.462,0,0,0.0,18,39,0.462,0.462,11,22,0.5,11,29,40,4,2,13,20,30,47,2016
G. Lawal,WES,27.0,17,0,308,61,106,0.575,0,0,0.0,61,106,0.575,0.575,30,53,0.566,39,88,127,5,4,10,34,44,152,2016
G. Lawal,TOT,27.0,36,2,561,103,183,0.563,0,0,0.0,103,183,0.563,0.563,49,91,0.538,70,150,220,12,7,30,71,96,255,2016
R. Ledo,REN,23.0,50,49,1527,369,835,0.442,126,319,0.395,243,516,0.471,0.517,200,246,0.813,59,247,306,138,55,14,112,117,1064,2016
W. Lemon Jr.,FOR,23.0,47,8,1163,251,541,0.464,44,125,0.352,207,416,0.498,0.505,90,121,0.744,23,97,120,159,64,9,114,101,636,2016
D. Liggins,SFL,27.0,34,33,1304,137,320,0.428,62,143,0.434,75,177,0.424,0.525,106,149,0.711,27,187,214,238,70,17,151,95,442,2016
D. Livington,RIO,22.0,48,26,1195,140,341,0.411,61,184,0.332,79,157,0.503,0.5,105,129,0.814,21,177,198,74,58,27,30,111,446,2016
K. Looney,SAN,19.0,12,0,230,44,111,0.396,9,29,0.31,35,82,0.427,0.437,20,28,0.714,36,53,89,9,8,11,11,33,117,2016
J. Lucas,FOR,33.0,18,18,629,123,265,0.464,41,115,0.357,82,150,0.547,0.542,32,37,0.865,10,45,55,89,12,0,26,32,319,2016
J. Magette,LOS,26.0,45,45,1710,181,464,0.39,84,257,0.327,97,207,0.469,0.481,70,87,0.805,47,157,204,410,110,6,130,163,516,2016
R. Major,BAK,33.0,42,8,809,78,170,0.459,31,86,0.36,47,84,0.56,0.55,69,81,0.852,16,64,80,43,27,22,17,94,256,2016
J. Manns,TOT,26.0,35,3,351,35,69,0.507,0,0,0.0,35,69,0.507,0.507,14,30,0.467,44,39,83,8,9,15,26,62,84,2016
J. Manns,IDA,26.0,17,3,172,16,28,0.571,0,0,0.0,16,28,0.571,0.571,10,18,0.556,16,12,28,5,5,4,17,29,42,2016
J. Manns,ERI,26.0,18,0,179,19,41,0.463,0,0,0.0,19,41,0.463,0.463,4,12,0.333,28,27,55,3,4,11,9,33,42,2016
D. Marble,ERI,23.0,14,1,433,74,186,0.398,24,68,0.353,50,118,0.424,0.462,35,44,0.795,14,59,73,31,22,2,32,35,207,2016
B. Marjanovic,AUS,27.0,3,3,79,33,41,0.805,0,0,0.0,33,41,0.805,0.805,5,8,0.625,14,23,37,7,1,4,9,8,71,2016
S. Marshall,WES,28.0,22,10,677,93,240,0.388,21,81,0.259,72,159,0.453,0.431,45,61,0.738,32,88,120,42,25,6,44,40,252,2016
C. Martin,IOW,31.0,5,5,197,35,81,0.432,12,30,0.4,23,51,0.451,0.506,20,22,0.909,2,34,36,9,9,3,9,13,102,2016
J. Martin,IOW,21.0,10,6,289,61,124,0.492,2,7,0.286,59,117,0.504,0.5,26,46,0.565,18,42,60,7,8,5,21,32,150,2016
J. Martin,TEX,25.0,12,1,170,19,50,0.38,10,24,0.417,9,26,0.346,0.48,9,16,0.563,10,27,37,5,5,4,8,28,57,2016
L. Martinez,REN,25.0,11,1,156,22,54,0.407,17,43,0.395,5,11,0.455,0.565,6,6,1.0,5,25,30,9,5,3,6,19,67,2016
B. Massey,GRR,25.0,7,2,211,30,69,0.435,4,13,0.308,26,56,0.464,0.464,12,16,0.75,10,17,27,32,10,1,18,19,76,2016
A. Mbodji,REN,29.0,6,0,28,2,3,0.667,0,0,0.0,2,3,0.667,0.667,0,1,0.0,2,4,6,0,0,1,3,8,4,2016
R. McCallum,AUS,24.0,9,9,347,59,137,0.431,15,40,0.375,44,97,0.454,0.485,21,28,0.75,6,29,35,43,12,2,23,26,154,2016
D. McCamey,AUS,26.0,49,8,1228,158,382,0.414,67,187,0.358,91,195,0.467,0.501,63,73,0.863,5,118,123,115,29,3,58,89,446,2016
K. McDaniels,RIO,22.0,16,15,577,92,196,0.469,30,85,0.353,62,111,0.559,0.546,32,41,0.78,38,95,133,48,15,32,47,54,246,2016
M. McGary,OKL,23.0,26,9,647,156,341,0.457,11,46,0.239,145,295,0.492,0.474,58,76,0.763,78,150,228,38,28,21,72,84,381,2016
R. McGruder,SFL,24.0,48,44,1798,290,565,0.513,93,242,0.384,197,323,0.61,0.596,85,115,0.739,104,151,255,112,66,13,64,103,758,2016
J. McRae,DEL,24.0,29,29,1028,233,508,0.459,50,157,0.318,183,351,0.521,0.508,159,199,0.799,24,108,132,152,50,15,114,65,675,2016
S. Mejri,TEX,29.0,8,2,191,30,53,0.566,1,8,0.125,29,45,0.644,0.575,7,8,0.875,12,50,62,5,5,23,15,32,68,2016
J. Mickey,MAI,21.0,23,22,767,162,305,0.531,7,20,0.35,155,285,0.544,0.543,70,94,0.745,52,184,236,29,18,101,49,54,401,2016
L. Miles,BAK,24.0,3,0,13,0,3,0.0,0,1,0.0,0,2,0.0,0.0,0,0,0.0,1,0,1,0,0,0,1,1,0,2016
D. Miller,OKL,25.0,26,0,450,72,151,0.477,5,22,0.227,67,129,0.519,0.493,36,71,0.507,33,58,91,48,16,14,51,45,185,2016
M. Miller,MAI,22.0,47,43,1496,198,399,0.496,84,211,0.398,114,188,0.606,0.602,104,131,0.794,52,144,196,56,32,61,59,117,584,2016
P. Miller,TEX,23.0,47,9,1248,193,404,0.478,28,66,0.424,165,338,0.488,0.512,125,182,0.687,46,112,158,193,62,14,77,93,539,2016
N. Minnerath,CAN,27.0,49,10,1459,320,630,0.508,84,209,0.402,236,421,0.561,0.575,182,205,0.888,73,264,337,37,29,8,87,153,906,2016
L. Montero,SAN,22.0,4,4,113,21,51,0.412,5,13,0.385,16,38,0.421,0.461,18,23,0.783,6,18,24,15,6,7,12,12,65,2016
E. Moreland,REN,24.0,5,4,135,21,38,0.553,0,0,0.0,21,38,0.553,0.553,6,21,0.286,21,49,70,6,6,14,6,16,48,2016
J. Morgan,CAN,24.0,3,0,45,3,7,0.429,0,0,0.0,3,7,0.429,0.429,1,2,0.5,4,10,14,5,1,0,5,8,7,2016
D. Morris,RIO,25.0,3,0,85,15,35,0.429,7,13,0.538,8,22,0.364,0.529,4,7,0.571,5,8,13,13,5,0,2,5,41,2016
D. Motiejunas,RIO,25.0,4,0,100,21,40,0.525,7,15,0.467,14,25,0.56,0.613,3,6,0.5,4,19,23,12,4,4,14,9,52,2016
B. Moungoro,OKL,21.0,47,8,897,91,265,0.343,66,200,0.33,25,65,0.385,0.468,22,30,0.733,10,85,95,48,34,9,39,109,270,2016
B. Mullens,SFL,26.0,27,18,694,92,242,0.38,35,114,0.307,57,128,0.445,0.452,28,43,0.651,44,159,203,39,16,10,50,47,247,2016
X. Munford,BAK,23.0,41,37,1383,300,612,0.49,70,170,0.412,230,442,0.52,0.547,167,206,0.811,19,155,174,264,41,17,134,91,837,2016
T. Murry,TOT,26.0,45,36,1410,189,458,0.413,65,179,0.363,124,279,0.444,0.484,73,115,0.635,40,144,184,212,65,11,103,115,516,2016
T. Murry,TEX,26.0,36,35,1209,158,399,0.396,52,153,0.34,106,246,0.431,0.461,66,100,0.66,38,124,162,193,59,9,94,103,434,2016
T. Murry,SFL,26.0,9,1,201,31,59,0.525,13,26,0.5,18,33,0.545,0.636,7,15,0.467,2,20,22,19,6,2,9,12,82,2016
Y. Ndoye,AUS,24.0,49,14,941,129,226,0.571,0,1,0.0,129,225,0.573,0.571,128,177,0.723,112,231,343,40,22,56,84,96,386,2016
J. Nguidjol,AUS,21.0,4,0,10,0,4,0.0,0,2,0.0,0,2,0.0,0.0,0,0,0.0,0,1,1,0,0,0,4,4,0,2016
D. Nix,GRR,25.0,3,0,8,1,2,0.5,0,0,0.0,1,2,0.5,0.5,0,0,0.0,0,0,0,0,0,0,0,1,2,2016
L. Nogueira,RAP,23.0,11,6,277,45,79,0.57,3,12,0.25,42,67,0.627,0.589,16,21,0.762,24,49,73,32,8,19,24,35,109,2016
D. Nwaelele,SAN,31.0,16,10,471,69,173,0.399,34,92,0.37,35,81,0.432,0.497,38,45,0.844,7,59,66,38,11,7,33,36,210,2016
J. O'Brien,IDA,23.0,46,44,1657,262,536,0.489,43,144,0.299,219,392,0.559,0.529,83,113,0.735,46,195,241,128,69,14,77,87,650,2016
T. Oblesby,IOW,27.0,19,3,211,23,70,0.329,12,43,0.279,11,27,0.407,0.414,12,14,0.857,3,19,22,10,5,1,15,14,70,2016
K. Olekaibe,CAN,23.0,4,0,47,7,15,0.467,3,7,0.429,4,8,0.5,0.567,3,4,0.75,1,3,4,1,1,0,2,5,20,2016
D. Orton,SAN,25.0,20,20,471,97,178,0.545,1,1,1.0,96,177,0.542,0.548,68,98,0.694,20,80,100,31,19,53,65,92,263,2016
B. Palo,SFL,24.0,50,27,1347,158,348,0.454,26,57,0.456,132,291,0.454,0.491,246,314,0.783,18,106,124,142,33,3,104,128,588,2016
J. Pargo,OKL,36.0,2,0,42,16,29,0.552,6,14,0.429,10,15,0.667,0.655,0,0,0.0,1,2,3,5,1,0,5,4,38,2016
B. Parks,TEX,22.0,32,4,426,55,129,0.426,6,31,0.194,49,98,0.5,0.45,31,47,0.66,24,37,61,26,18,3,21,46,147,2016
T. Parks,DEL,24.0,2,0,18,2,5,0.4,0,1,0.0,2,4,0.5,0.4,0,0,0.0,0,1,1,1,0,0,3,0,4,2016
L. Patterson,TOT,24.0,19,15,512,86,199,0.432,18,70,0.257,68,129,0.527,0.477,54,69,0.783,16,59,75,81,18,4,59,59,244,2016
L. Patterson,CAN,24.0,9,8,208,40,84,0.476,8,28,0.286,32,56,0.571,0.524,20,27,0.741,12,20,32,32,8,1,26,29,108,2016
L. Patterson,AUS,24.0,10,7,304,46,115,0.4,10,42,0.238,36,73,0.493,0.443,34,42,0.81,4,39,43,49,10,3,33,30,136,2016
A. Payne,ERI,24.0,3,2,105,28,63,0.444,2,7,0.286,26,56,0.464,0.46,21,26,0.808,6,22,28,13,7,0,15,11,79,2016
C. Payne,OKL,21.0,2,2,68,18,41,0.439,6,14,0.429,12,27,0.444,0.512,5,6,0.833,1,6,7,14,4,1,7,7,47,2016
T. Petteway,FOR,23.0,49,23,1305,207,504,0.411,74,204,0.363,133,300,0.443,0.484,82,110,0.745,12,157,169,123,43,13,93,106,570,2016
W. Pitchford,RAP,23.0,5,1,72,4,17,0.235,1,8,0.125,3,9,0.333,0.265,2,4,0.5,4,18,22,0,1,1,4,7,11,2016
A. Pitts,GRR,27.0,2,0,15,1,1,1.0,0,0,0.0,1,1,1.0,1.0,0,0,0.0,0,0,0,0,0,0,2,3,2,2016
S. Pledger,TEX,25.0,12,1,258,35,88,0.398,16,55,0.291,19,33,0.576,0.489,3,8,0.375,8,25,33,11,3,4,15,37,89,2016
T. Pleiss,IDA,26.0,28,28,883,141,242,0.583,6,19,0.316,135,223,0.605,0.595,57,65,0.877,80,212,292,45,13,40,61,117,345,2016
S. Pointer,CAN,23.0,50,9,1013,140,316,0.443,10,58,0.172,130,258,0.504,0.459,57,90,0.633,37,190,227,49,48,70,58,111,347,2016
D. Polee Jr.,REN,24.0,23,0,91,16,34,0.471,5,13,0.385,11,21,0.524,0.544,11,14,0.786,0,10,10,0,3,2,12,9,48,2016
K. Post,RAP,23.0,36,10,413,46,79,0.582,0,0,0.0,46,79,0.582,0.582,8,13,0.615,33,54,87,6,3,12,29,59,100,2016
N. Powell,RAP,22.0,8,8,317,76,152,0.5,8,24,0.333,68,128,0.531,0.526,39,49,0.796,6,35,41,37,17,2,33,30,199,2016
P. Pressey,IDA,24.0,31,25,1102,153,356,0.43,50,149,0.336,103,207,0.498,0.5,68,96,0.708,28,112,140,212,63,9,112,74,424,2016
R. Putney,RIO,25.0,48,40,1503,301,674,0.447,122,339,0.36,179,335,0.534,0.537,99,144,0.688,77,313,390,91,53,110,115,168,823,2016
A. Quinn,RIO,24.0,1,0,9,3,4,0.75,2,3,0.667,1,1,1.0,1.0,1,1,1.0,0,4,4,0,0,0,0,0,9,2016
J. Railey,DEL,23.0,32,18,607,45,95,0.474,1,2,0.5,44,93,0.473,0.479,13,30,0.433,45,86,131,31,19,26,33,98,104,2016
L. Randolph,MAI,23.0,50,10,1539,273,524,0.521,59,149,0.396,214,375,0.571,0.577,137,166,0.825,47,197,244,130,55,4,83,108,742,2016
J. Reddic,CAN,23.0,43,22,932,153,284,0.539,1,2,0.5,152,282,0.539,0.54,79,118,0.669,90,139,229,33,15,17,56,98,386,2016
T. Releford,IDA,25.0,16,3,288,29,61,0.475,6,22,0.273,23,39,0.59,0.525,10,15,0.667,11,14,25,15,13,3,13,30,74,2016
J. Reynolds,TEX,27.0,14,0,169,25,62,0.403,1,11,0.091,24,51,0.471,0.411,7,14,0.5,15,23,38,4,6,1,11,27,58,2016
J. Richardson,SFL,22.0,4,4,153,35,74,0.473,11,28,0.393,24,46,0.522,0.547,12,17,0.706,6,12,18,15,10,5,8,11,93,2016
A. Richmond,REN,24.0,14,0,139,31,69,0.449,29,61,0.475,2,8,0.25,0.659,9,12,0.75,4,13,17,7,2,1,4,14,100,2016
D. Riley,IDA,25.0,33,3,475,48,103,0.466,0,2,0.0,48,101,0.475,0.466,9,14,0.643,23,83,106,21,10,44,29,93,105,2016
R. Roberts,RAP,24.0,24,24,797,174,282,0.617,0,0,0.0,174,282,0.617,0.617,87,121,0.719,87,204,291,32,18,36,49,73,435,2016
G. Robinson,FOR,22.0,1,1,41,4,13,0.308,0,2,0.0,4,11,0.364,0.308,3,4,0.75,3,8,11,2,2,0,0,1,11,2016
I. Romero,GRR,24.0,27,0,420,61,103,0.592,0,2,0.0,61,101,0.604,0.592,23,46,0.5,29,103,132,11,9,3,18,58,145,2016
T. Rozier,MAI,21.0,14,14,472,90,229,0.393,25,74,0.338,65,155,0.419,0.448,66,85,0.776,20,70,90,112,26,2,38,29,271,2016
R. Sampson,MAI,26.0,31,8,348,53,99,0.535,2,5,0.4,51,94,0.543,0.545,15,25,0.6,48,54,102,10,6,32,21,58,123,2016
D. Saunders,DEL,27.0,1,0,17,1,4,0.25,0,2,0.0,1,2,0.5,0.25,0,2,0.0,2,3,5,0,1,0,1,1,2,2016
W. Saunders,WES,22.0,33,4,593,51,119,0.429,2,8,0.25,49,111,0.441,0.437,42,63,0.667,33,87,120,56,26,5,25,60,146,2016
W. Saunders,TOT,22.0,38,4,653,54,129,0.419,2,9,0.222,52,120,0.433,0.426,44,65,0.677,35,93,128,60,27,6,30,66,154,2016
W. Saunders,AUS,22.0,5,0,60,3,10,0.3,0,1,0.0,3,9,0.333,0.3,2,2,1.0,2,6,8,4,1,1,5,6,8,2016
S. Scott,RAP,23.0,48,37,1390,165,414,0.399,45,141,0.319,120,273,0.44,0.453,65,88,0.739,30,157,187,273,76,5,118,112,440,2016
M. Sene,AUS,29.0,1,0,16,1,5,0.2,0,0,0.0,1,5,0.2,0.2,0,0,0.0,0,3,3,1,0,0,2,3,2,2016
J. Shaw,SAN,25.0,17,3,329,63,111,0.568,0,1,0.0,63,110,0.573,0.568,26,33,0.788,18,58,76,15,9,13,28,41,152,2016
D. Shumpert,LOS,25.0,22,1,331,25,48,0.521,0,2,0.0,25,46,0.543,0.521,11,28,0.393,40,69,109,18,16,21,24,62,61,2016
J. Siakam,DEL,23.0,5,0,81,7,13,0.538,0,0,0.0,7,13,0.538,0.538,8,10,0.8,16,13,29,5,5,3,3,19,22,2016
J. Sibert,ERI,23.0,44,21,1132,217,532,0.408,90,262,0.344,127,270,0.47,0.492,54,62,0.871,13,99,112,55,55,8,67,116,578,2016
X. Silas,BAK,28.0,27,25,920,165,373,0.442,71,182,0.39,94,191,0.492,0.538,99,110,0.9,9,79,88,55,28,9,36,84,500,2016
J. Simmons,AUS,26.0,4,4,138,22,51,0.431,3,13,0.231,19,38,0.5,0.461,17,22,0.773,3,8,11,14,3,3,17,14,64,2016
M. Simmons,FOR,28.0,49,24,1298,127,285,0.446,22,67,0.328,105,218,0.482,0.484,47,83,0.566,75,132,207,80,38,24,55,161,323,2016
H. Sims,GRR,25.0,40,38,1199,239,442,0.541,1,6,0.167,238,436,0.546,0.542,149,198,0.753,119,236,355,37,46,35,82,164,628,2016
S. Singh,TEX,20.0,19,2,150,13,30,0.433,0,0,0.0,13,30,0.433,0.433,3,6,0.5,10,18,28,2,2,2,9,33,29,2016
E. Singler,RAP,25.0,10,0,309,52,108,0.481,29,61,0.475,23,47,0.489,0.616,14,19,0.737,15,60,75,34,7,4,15,26,147,2016
E. Singler,IDA,25.0,36,8,795,91,226,0.403,58,150,0.387,33,76,0.434,0.531,21,24,0.875,22,93,115,46,24,6,33,58,261,2016
E. Singler,TOT,25.0,46,8,1104,143,334,0.428,87,211,0.412,56,123,0.455,0.558,35,43,0.814,37,153,190,80,31,10,48,84,408,2016
A. Smith,RAP,26.0,24,0,256,22,57,0.386,8,24,0.333,14,33,0.424,0.456,8,14,0.571,6,17,23,29,4,1,22,26,60,2016
G. Smith,RAP,25.0,17,12,477,80,156,0.513,0,5,0.0,80,151,0.53,0.513,54,88,0.614,33,103,136,41,18,5,24,48,214,2016
J. Smith,RIO,23.0,42,34,714,153,251,0.61,0,2,0.0,153,249,0.614,0.61,53,83,0.639,101,98,199,55,25,23,55,118,359,2016
K. Smith,LOS,23.0,31,1,422,30,95,0.316,10,38,0.263,20,57,0.351,0.368,19,25,0.76,6,45,51,77,17,2,37,37,89,2016
R. Smith,TOT,24.0,22,14,814,216,470,0.46,48,158,0.304,168,312,0.538,0.511,133,171,0.778,21,88,109,171,47,2,108,83,613,2016
R. Smith,IOW,24.0,1,1,38,10,23,0.435,2,7,0.286,8,16,0.5,0.478,1,3,0.333,1,4,5,2,0,0,7,3,23,2016
R. Smith,DEL,24.0,21,13,776,206,447,0.461,46,151,0.305,160,296,0.541,0.512,132,168,0.786,20,84,104,169,47,2,101,80,590,2016
N. Spikes,SFL,26.0,39,0,431,67,111,0.604,1,2,0.5,66,109,0.606,0.608,42,90,0.467,46,74,120,20,11,42,27,69,177,2016
J. Staten,DEL,23.0,15,9,377,40,87,0.46,1,3,0.333,39,84,0.464,0.466,20,25,0.8,4,31,35,62,12,0,22,30,101,2016
J. Staten,TOT,23.0,28,18,753,87,191,0.455,4,12,0.333,83,179,0.464,0.466,39,54,0.722,7,52,59,110,26,0,47,51,217,2016
J. Staten,SAN,23.0,13,9,376,47,104,0.452,3,9,0.333,44,95,0.463,0.466,19,29,0.655,3,21,24,48,14,0,25,21,116,2016
A. Stepheson,IOW,28.0,32,31,1060,205,354,0.579,0,3,0.0,205,351,0.584,0.579,84,173,0.486,152,276,428,33,14,42,73,90,494,2016
D. Stephens,TOT,25.0,38,29,913,154,285,0.54,35,105,0.333,119,180,0.661,0.602,55,75,0.733,57,157,214,28,39,48,31,70,398,2016
D. Stephens,IOW,25.0,11,8,378,66,120,0.55,18,43,0.419,48,77,0.623,0.625,27,37,0.73,23,58,81,11,17,14,9,21,177,2016
D. Stephens,CAN,25.0,27,21,535,88,165,0.533,17,62,0.274,71,103,0.689,0.585,28,38,0.737,34,99,133,17,22,34,22,49,221,2016
D. Stockton,REN,24.0,45,40,1411,291,652,0.446,82,234,0.35,209,418,0.5,0.509,143,181,0.79,28,111,139,320,50,10,115,135,807,2016
M. Stockton,CAN,26.0,50,18,1148,153,348,0.44,28,101,0.277,125,247,0.506,0.48,84,100,0.84,18,121,139,236,48,1,81,161,418,2016
J. Stokes,SFL,22.0,28,28,860,250,376,0.665,4,9,0.444,246,367,0.67,0.67,74,111,0.667,101,159,260,32,31,19,43,79,578,2016
A. Stringer,MAI,24.0,45,25,924,117,318,0.368,59,175,0.337,58,143,0.406,0.461,43,55,0.782,18,84,102,177,38,4,86,64,336,2016
B. Strong,WES,29.0,10,0,154,21,45,0.467,0,1,0.0,21,44,0.477,0.467,8,10,0.8,14,24,38,6,1,4,3,16,50,2016
S. Suggs,RAP,26.0,50,43,1801,315,714,0.441,132,315,0.419,183,399,0.459,0.534,136,153,0.889,15,154,169,94,36,10,115,123,898,2016
D. Summers,WES,28.0,3,3,117,31,57,0.544,4,11,0.364,27,46,0.587,0.579,10,13,0.769,10,21,31,6,6,1,6,9,76,2016
J. Summers,RIO,22.0,3,0,23,0,2,0.0,0,1,0.0,0,1,0.0,0.0,0,0,0.0,0,1,1,0,0,1,0,3,0,2016
L. Sutton,IDA,27.0,7,1,106,9,26,0.346,6,16,0.375,3,10,0.3,0.462,0,0,0.0,1,7,8,15,5,0,12,7,24,2016
K. Sykes,AUS,22.0,50,37,1549,239,536,0.446,29,92,0.315,210,444,0.473,0.473,114,145,0.786,19,162,181,157,38,5,100,138,621,2016
G. Talton,TOT,25.0,53,27,1361,164,406,0.404,48,134,0.358,116,272,0.426,0.463,62,76,0.816,19,130,149,224,40,1,86,93,438,2016
G. Talton,GRR,25.0,30,14,768,102,244,0.418,25,72,0.347,77,172,0.448,0.469,39,47,0.83,10,64,74,123,23,0,45,55,268,2016
G. Talton,DEL,25.0,23,13,593,62,162,0.383,23,62,0.371,39,100,0.39,0.454,23,29,0.793,9,66,75,101,17,1,41,38,170,2016
C. Tang,IOW,20.0,9,1,68,4,18,0.222,1,5,0.2,3,13,0.231,0.25,5,6,0.833,1,5,6,2,2,0,3,2,14,2016
A. Dixon-Tatum,MAI,24.0,16,0,218,18,53,0.34,0,0,0.0,18,53,0.34,0.34,11,14,0.786,29,36,65,0,1,12,9,34,47,2016
W. Tavares,CAN,23.0,2,0,38,2,4,0.5,0,0,0.0,2,4,0.5,0.5,4,4,1.0,3,11,14,0,1,2,6,9,8,2016
W. Tavares,BAK,23.0,2,1,45,6,11,0.545,0,0,0.0,6,11,0.545,0.545,0,1,0.0,4,7,11,0,0,10,4,7,12,2016
W. Tavares,AUS,23.0,25,16,544,97,146,0.664,0,0,0.0,97,146,0.664,0.664,54,77,0.701,84,134,218,12,12,85,45,77,248,2016
W. Tavares,TOT,23.0,29,17,627,105,161,0.652,0,0,0.0,105,161,0.652,0.652,58,82,0.707,91,152,243,12,13,97,55,93,268,2016
M. Teague,OKL,22.0,50,48,1636,290,701,0.414,68,175,0.389,222,526,0.422,0.462,139,203,0.685,16,125,141,295,35,13,149,119,787,2016
X. Thames,FOR,25.0,48,27,1204,146,365,0.4,53,157,0.338,93,208,0.447,0.473,68,92,0.739,18,112,130,146,49,7,56,84,413,2016
A. Thomas,GRR,22.0,2,1,50,4,12,0.333,2,7,0.286,2,5,0.4,0.417,0,0,0.0,0,8,8,0,0,1,1,3,10,2016
D. Thomas,AUS,24.0,47,35,1360,295,569,0.518,27,92,0.293,268,477,0.562,0.542,73,93,0.785,106,186,292,104,27,17,77,105,690,2016
M. Thomas,LOS,27.0,7,7,242,50,93,0.538,6,16,0.375,44,77,0.571,0.57,18,29,0.621,26,58,84,18,6,17,10,24,124,2016
M. Thompson,SAN,27.0,14,3,407,60,151,0.397,27,84,0.321,33,67,0.493,0.487,29,39,0.744,2,44,46,25,16,6,19,28,176,2016
S. Thompson,TOT,23.0,43,25,1183,135,294,0.459,19,73,0.26,116,221,0.525,0.491,46,64,0.719,36,94,130,52,41,9,49,76,335,2016
S. Thompson,GRR,23.0,16,10,423,31,84,0.369,3,21,0.143,28,63,0.444,0.387,15,21,0.714,10,33,43,18,12,5,14,23,80,2016
S. Thompson,DEL,23.0,27,15,760,104,210,0.495,16,52,0.308,88,158,0.557,0.533,31,43,0.721,26,61,87,34,29,4,35,53,255,2016
M. Thornton,MAI,22.0,12,6,325,59,129,0.457,23,64,0.359,36,65,0.554,0.547,22,31,0.71,4,21,25,30,6,4,15,13,163,2016
J. Threatt,RIO,22.0,42,4,937,167,384,0.435,30,97,0.309,137,287,0.477,0.474,165,234,0.705,38,83,121,108,50,4,81,69,529,2016
J. Tokoto,OKL,22.0,48,25,1276,204,443,0.46,16,64,0.25,188,379,0.496,0.479,111,156,0.712,68,127,195,97,74,26,89,140,535,2016
C. Toppert,REN,30.0,34,1,728,98,213,0.46,92,193,0.477,6,20,0.3,0.676,8,10,0.8,17,67,84,37,16,2,18,66,296,2016
A. Toupane,RAP,23.0,32,14,949,150,350,0.429,36,115,0.313,114,235,0.485,0.48,132,168,0.786,32,148,180,115,32,5,91,93,468,2016
J. Trawick,SFL,23.0,47,5,968,154,330,0.467,35,116,0.302,119,214,0.556,0.52,103,145,0.71,29,78,107,66,54,17,63,138,446,2016
T. Trice III,WES,23.0,49,48,1668,280,641,0.437,63,188,0.335,217,453,0.479,0.486,125,160,0.781,19,150,169,278,66,5,115,78,748,2016
R. Turner,GRR,24.0,21,2,359,29,78,0.372,22,51,0.431,7,27,0.259,0.513,6,11,0.545,2,29,31,10,8,2,11,32,86,2016
M. Tyndale,REN,30.0,48,14,1226,77,161,0.478,11,35,0.314,66,126,0.524,0.512,54,81,0.667,79,203,282,171,73,20,73,99,219,2016
C. Udofia,SAN,23.0,45,24,1149,112,234,0.479,0,1,0.0,112,233,0.481,0.479,43,88,0.489,99,149,248,67,44,43,58,145,267,2016
M. Udofia,AUS,25.0,9,0,74,4,17,0.235,2,10,0.2,2,7,0.286,0.294,0,0,0.0,2,10,12,4,0,0,4,8,10,2016
R. Upshaw,LOS,22.0,28,2,438,83,174,0.477,2,10,0.2,81,164,0.494,0.483,36,59,0.61,32,94,126,10,6,40,34,71,204,2016
D. Usher,TOT,23.0,9,2,107,12,40,0.3,7,20,0.35,5,20,0.25,0.388,9,14,0.643,3,10,13,6,0,0,3,9,40,2016
D. Usher,MAI,23.0,5,0,23,1,9,0.111,1,5,0.2,0,4,0.0,0.167,1,1,1.0,1,2,3,0,0,0,0,1,4,2016
D. Usher,DEL,23.0,4,2,84,11,31,0.355,6,15,0.4,5,16,0.313,0.452,8,13,0.615,2,8,10,6,0,0,3,8,36,2016
R. Vaughn,CAN,19.0,4,2,84,14,46,0.304,1,16,0.063,13,30,0.433,0.315,3,8,0.375,1,12,13,9,4,1,6,9,32,2016
A. Vereen,SAN,30.0,43,1,627,90,189,0.476,0,4,0.0,90,185,0.486,0.476,52,79,0.658,39,75,114,36,10,13,38,105,232,2016
B. Voiles,REN,26.0,5,0,24,4,5,0.8,2,2,1.0,2,3,0.667,1.0,0,0,0.0,2,3,5,1,1,0,2,4,10,2016
M. Wade,IOW,24.0,35,1,692,68,147,0.463,22,44,0.5,46,103,0.447,0.537,47,69,0.681,12,37,49,60,39,3,43,88,205,2016
C. Walden,MAI,23.0,41,21,1068,164,316,0.519,44,117,0.376,120,199,0.603,0.589,130,155,0.839,18,111,129,164,49,3,95,97,502,2016
A. Walker,FOR,22.0,13,2,131,16,25,0.64,0,0,0.0,16,25,0.64,0.64,5,9,0.556,4,13,17,2,5,18,6,19,37,2016
C. Walker,RIO,21.0,47,2,978,185,308,0.601,1,5,0.2,184,303,0.607,0.602,67,124,0.54,138,192,330,40,27,63,71,132,438,2016
D. Walker,WES,23.0,25,0,370,42,109,0.385,19,59,0.322,23,50,0.46,0.472,17,21,0.81,5,50,55,21,12,1,20,35,120,2016
T. Walker,IOW,26.0,11,8,247,27,50,0.54,0,1,0.0,27,49,0.551,0.54,6,18,0.333,21,67,88,4,1,21,15,24,60,2016
K. Ward,ERI,22.0,6,0,23,2,7,0.286,0,2,0.0,2,5,0.4,0.286,0,0,0.0,1,6,7,0,0,0,0,2,4,2016
J. Washburn,AUS,24.0,48,15,906,76,182,0.418,37,93,0.398,39,89,0.438,0.519,17,28,0.607,15,133,148,30,18,11,30,77,206,2016
B. Weber,SFL,23.0,28,9,805,121,258,0.469,20,49,0.408,101,209,0.483,0.508,37,51,0.725,20,127,147,117,59,4,52,67,299,2016
D. Wells,OKL,23.0,24,21,704,114,263,0.433,22,89,0.247,92,174,0.529,0.475,54,79,0.684,6,48,54,46,19,9,43,60,304,2016
B. Wesley,SFL,23.0,13,0,102,16,26,0.615,0,1,0.0,16,25,0.64,0.615,4,5,0.8,5,17,22,2,1,1,6,9,36,2016
T. Whisnant,IOW,23.0,50,33,1639,197,464,0.425,110,291,0.378,87,173,0.503,0.543,46,58,0.793,27,137,164,74,57,15,49,127,550,2016
L. White,TOT,23.0,3,2,66,10,26,0.385,4,11,0.364,6,15,0.4,0.462,1,2,0.5,0,6,6,1,2,1,3,3,25,2016
L. White,MAI,23.0,1,0,15,4,7,0.571,0,0,0.0,4,7,0.571,0.571,1,2,0.5,0,0,0,1,0,0,0,3,9,2016
L. White,DEL,23.0,2,2,51,6,19,0.316,4,11,0.364,2,8,0.25,0.421,0,0,0.0,0,6,6,0,2,1,3,0,16,2016
T. White,BAK,25.0,43,41,1603,324,664,0.488,103,245,0.42,221,419,0.527,0.566,104,137,0.759,40,197,237,112,48,7,43,88,855,2016
G. Whittington,SFL,22.0,27,26,964,138,321,0.43,47,137,0.343,91,184,0.495,0.503,50,67,0.746,25,190,215,72,56,27,60,85,373,2016
S. Whittington,FOR,24.0,40,37,1231,174,406,0.429,52,168,0.31,122,238,0.513,0.493,84,103,0.816,78,237,315,55,58,22,78,119,484,2016
N. Wiggins,RAP,24.0,10,0,102,16,49,0.327,4,16,0.25,12,33,0.364,0.367,4,7,0.571,5,12,17,4,3,1,6,9,40,2016
C. Wilcox,TOT,25.0,21,18,687,136,297,0.458,68,163,0.417,68,134,0.507,0.572,51,61,0.836,10,71,81,59,16,6,31,48,391,2016
C. Wilcox,CAN,25.0,14,12,439,87,200,0.435,46,109,0.422,41,91,0.451,0.55,34,41,0.829,6,46,52,40,10,3,20,31,254,2016
C. Wilcox,BAK,25.0,7,6,248,49,97,0.505,22,54,0.407,27,43,0.628,0.619,17,20,0.85,4,25,29,19,6,3,11,17,137,2016
A. Williams,RIO,23.0,38,12,508,44,72,0.611,0,0,0.0,44,72,0.611,0.611,36,58,0.621,43,77,120,13,11,25,26,79,124,2016
C. Williams,MAI,26.0,39,0,482,68,134,0.507,49,102,0.48,19,32,0.594,0.69,20,22,0.909,12,25,37,42,9,2,20,31,205,2016
E. Williams,SAN,26.0,21,21,861,210,428,0.491,35,102,0.343,175,326,0.537,0.532,142,180,0.789,19,123,142,125,24,4,62,47,597,2016
J. Williams,IDA,28.0,40,27,920,125,333,0.375,44,131,0.336,81,202,0.401,0.441,63,85,0.741,53,124,177,62,33,24,50,119,357,2016
L. Williams,FOR,27.0,8,0,48,5,16,0.313,0,8,0.0,5,8,0.625,0.313,6,6,1.0,0,8,8,2,1,0,4,4,16,2016
J. Wilson,TEX,25.0,48,36,1592,269,577,0.466,100,259,0.386,169,318,0.531,0.553,91,122,0.746,51,213,264,92,45,28,90,146,729,2016
C. Wood,DEL,20.0,32,22,922,207,391,0.529,22,87,0.253,185,304,0.609,0.558,118,167,0.707,86,216,302,20,29,35,45,84,554,2016
K. Woods,OKL,22.0,49,14,1067,86,179,0.48,23,60,0.383,63,119,0.529,0.545,36,53,0.679,44,215,259,44,29,35,45,55,231,2016
D. Wright,RAP,23.0,15,15,536,97,181,0.536,18,50,0.36,79,131,0.603,0.586,54,67,0.806,14,61,75,97,24,9,41,27,266,2016
J. Wright,TOT,26.0,37,19,1014,177,435,0.407,6,35,0.171,171,400,0.428,0.414,165,202,0.817,71,160,231,71,44,20,106,113,525,2016
J. Wright,IOW,26.0,30,19,899,162,390,0.415,5,29,0.172,157,361,0.435,0.422,142,174,0.816,61,136,197,60,38,19,98,101,471,2016
J. Wright,BAK,26.0,7,0,115,15,45,0.333,1,6,0.167,14,39,0.359,0.344,23,28,0.821,10,24,34,11,6,1,8,12,54,2016
K. Wright,WES,26.0,15,7,354,49,88,0.557,0,0,0.0,49,88,0.557,0.557,10,15,0.667,35,53,88,14,17,15,16,44,108,2016
K. Wright,TOT,26.0,35,7,530,60,119,0.504,0,1,0.0,60,118,0.508,0.504,13,23,0.565,58,77,135,24,23,20,29,70,133,2016
K. Wright,AUS,26.0,20,0,176,11,31,0.355,0,1,0.0,11,30,0.367,0.355,3,8,0.375,23,24,47,10,6,5,13,26,25,2016
J. Young,MAI,20.0,14,6,396,72,176,0.409,35,100,0.35,37,76,0.487,0.509,35,43,0.814,12,73,85,26,15,10,19,24,214,2016
J. Young,FOR,23.0,3,3,105,26,60,0.433,7,11,0.636,19,49,0.388,0.492,14,15,0.933,0,10,10,6,5,0,10,4,73,2016
K. Young,MAI,25.0,14,0,70,7,19,0.368,0,3,0.0,7,16,0.438,0.368,4,6,0.667,10,15,25,6,3,1,6,14,18,2016
T. Zanna,OKL,25.0,45,38,1299,210,452,0.465,12,41,0.293,198,411,0.482,0.478,202,282,0.716,144,312,456,50,49,14,90,124,634,2016
T. Zimmerman,IDA,24.0,6,0,75,10,33,0.303,6,19,0.316,4,14,0.286,0.394,3,4,0.75,3,6,9,7,2,0,11,12,29,2016
T. Zubcic,OKL,26.0,36,0,711,99,235,0.421,44,125,0.352,55,110,0.5,0.515,36,45,0.8,49,125,174,51,17,12,35,72,278,2016
A. Aboya,TOT,30.0,35,6,592,54,112,0.482,1,5,0.2,53,107,0.495,0.487,31,41,0.756,54,56,110,20,21,10,27,100,140,2015
A. Aboya,REN,30.0,7,5,161,13,24,0.542,1,2,0.5,12,22,0.545,0.563,5,8,0.625,16,15,31,4,10,3,7,30,32,2015
A. Aboya,LOS,30.0,28,1,431,41,88,0.466,0,3,0.0,41,85,0.482,0.466,26,33,0.788,38,41,79,16,11,7,20,70,108,2015
J. Adams,IOW,20.0,11,3,351,73,158,0.462,18,47,0.383,55,111,0.495,0.519,35,44,0.795,27,50,77,21,21,5,20,21,199,2015
A. Agudio,CAN,30.0,49,48,1109,131,298,0.44,73,173,0.422,58,125,0.464,0.562,56,71,0.789,7,74,81,103,26,0,64,67,391,2015
B. Ahearn,SAN,30.0,9,0,191,27,68,0.397,15,40,0.375,12,28,0.429,0.507,17,18,0.944,2,15,17,24,6,0,14,20,86,2015
J. Alexander,SAN,28.0,13,13,416,119,215,0.553,0,3,0.0,119,212,0.561,0.553,44,51,0.863,40,64,104,15,10,22,22,37,282,2015
X. Alexander,OKL,26.0,48,9,993,110,286,0.385,20,81,0.247,90,205,0.439,0.42,81,141,0.574,72,129,201,60,49,18,55,89,321,2015
C. Allen,IOW,26.0,30,5,683,113,270,0.419,42,105,0.4,71,165,0.43,0.496,43,52,0.827,14,53,67,50,9,6,39,59,311,2015
C. Allen,TOT,26.0,42,11,971,159,391,0.407,57,160,0.356,102,231,0.442,0.48,57,70,0.814,16,72,88,78,12,9,54,76,432,2015
C. Allen,SFL,26.0,12,6,288,46,121,0.38,15,55,0.273,31,66,0.47,0.442,14,18,0.778,2,19,21,28,3,3,15,17,121,2015
K. Anderson,AUS,21.0,26,26,1042,213,476,0.447,17,48,0.354,196,428,0.458,0.465,112,142,0.789,40,185,225,125,51,38,86,63,555,2015
R. Anderson,WES,25.0,14,0,245,32,82,0.39,0,1,0.0,32,81,0.395,0.39,13,30,0.433,21,34,55,10,8,6,9,29,77,2015
R. Anderson,TOT,25.0,29,0,475,72,157,0.459,4,10,0.4,68,147,0.463,0.471,30,53,0.566,37,57,94,17,12,11,15,64,178,2015
R. Anderson,TEX,25.0,6,0,105,14,29,0.483,4,9,0.444,10,20,0.5,0.552,3,6,0.5,8,7,15,5,0,2,2,16,35,2015
R. Anderson,OKL,25.0,9,0,125,26,46,0.565,0,0,0.0,26,46,0.565,0.565,14,17,0.824,8,16,24,2,4,3,4,19,66,2015
Z. Andrews,LOS,29.0,11,0,267,36,53,0.679,0,0,0.0,36,53,0.679,0.679,11,27,0.407,29,49,78,7,16,18,13,42,83,2015
T. Antetokounmpo,WES,22.0,47,47,1547,235,512,0.459,26,112,0.232,209,400,0.523,0.484,155,251,0.618,125,165,290,78,80,79,102,150,651,2015
K. Appling,ERI,22.0,10,5,317,54,106,0.509,0,2,0.0,54,104,0.519,0.509,67,81,0.827,5,34,39,47,11,1,24,37,175,2015
K. Appling,TOT,22.0,38,21,927,136,338,0.402,10,53,0.189,126,285,0.442,0.417,118,154,0.766,10,104,114,147,36,4,73,100,400,2015
K. Appling,LOS,22.0,28,16,610,82,232,0.353,10,51,0.196,72,181,0.398,0.375,51,73,0.699,5,70,75,100,25,3,49,63,225,2015
J. Atkinson,TEX,24.0,8,0,40,3,10,0.3,0,1,0.0,3,9,0.333,0.3,0,0,0.0,2,5,7,2,2,0,1,5,6,2015
M. Atkins,SFL,24.0,3,0,19,0,5,0.0,0,3,0.0,0,2,0.0,0.0,0,0,0.0,0,1,1,1,0,1,2,2,0,2015
M. Atkins,GRR,24.0,42,24,1060,157,347,0.452,54,156,0.346,103,191,0.539,0.53,52,62,0.839,56,136,192,43,45,5,47,81,420,2015
M. Atkins,TOT,24.0,45,24,1079,157,352,0.446,54,159,0.34,103,193,0.534,0.523,52,62,0.839,56,137,193,44,45,6,49,83,420,2015
K. Augustus,IDA,27.0,4,2,73,9,26,0.346,3,13,0.231,6,13,0.462,0.404,11,11,1.0,3,4,7,2,0,4,2,5,32,2015
C. Ayers,REN,23.0,29,21,831,111,251,0.442,78,196,0.398,33,55,0.6,0.598,29,36,0.806,22,69,91,55,28,0,15,34,329,2015
C. Babb,MAI,24.0,45,45,1562,233,539,0.432,119,317,0.375,114,222,0.514,0.543,107,135,0.793,36,212,248,122,40,9,46,85,692,2015
J. Bachynski,WES,25.0,18,8,342,51,102,0.5,0,0,0.0,51,102,0.5,0.5,17,32,0.531,34,62,96,4,5,40,30,48,119,2015
T. Bader,RIO,23.0,22,12,653,93,228,0.408,71,189,0.376,22,39,0.564,0.564,24,27,0.889,8,25,33,27,16,1,20,57,281,2015
M. Baker,SAN,35.0,19,6,250,38,78,0.487,3,9,0.333,35,69,0.507,0.506,7,8,0.875,9,31,40,35,13,0,14,23,86,2015
R. Balkman,TEX,30.0,32,7,962,210,344,0.61,8,29,0.276,202,315,0.641,0.622,83,129,0.643,108,186,294,39,67,29,63,112,511,2015
K. Barlow,GRR,23.0,45,22,982,114,282,0.404,47,129,0.364,67,153,0.438,0.488,49,60,0.817,17,106,123,74,43,4,35,99,324,2015
A. Barrett,WES,32.0,36,27,1107,169,411,0.411,51,153,0.333,118,258,0.457,0.473,61,77,0.792,19,82,101,148,34,2,66,57,450,2015
E. Barron,BAK,33.0,26,17,846,204,437,0.467,27,80,0.338,177,357,0.496,0.498,99,125,0.792,103,180,283,38,19,13,69,85,534,2015
K. Batts,ERI,23.0,43,33,996,166,379,0.438,1,2,0.5,165,377,0.438,0.439,82,118,0.695,84,154,238,23,16,19,42,112,415,2015
G. Beamon,TOT,23.0,18,0,212,17,45,0.378,4,21,0.19,13,24,0.542,0.422,14,18,0.778,12,26,38,14,11,0,11,23,52,2015
G. Beamon,TEX,23.0,6,0,64,10,19,0.526,1,5,0.2,9,14,0.643,0.553,3,5,0.6,7,5,12,6,3,0,4,9,24,2015
G. Beamon,OKL,23.0,12,0,148,7,26,0.269,3,16,0.188,4,10,0.4,0.327,11,13,0.846,5,21,26,8,8,0,7,14,28,2015
C. Behanan,RIO,22.0,13,1,120,23,47,0.489,0,1,0.0,23,46,0.5,0.489,12,21,0.571,21,22,43,3,10,1,14,18,58,2015
J. Benimon,IDA,23.0,44,38,1533,366,596,0.614,6,30,0.2,360,566,0.636,0.619,134,213,0.629,140,344,484,192,47,45,152,132,872,2015
D. Berry,MAI,23.0,15,3,306,36,79,0.456,9,31,0.29,27,48,0.563,0.513,26,33,0.788,3,36,39,37,9,3,11,24,107,2015
T. Betran,ERI,23.0,2,0,12,0,6,0.0,0,3,0.0,0,3,0.0,0.0,1,2,0.5,1,0,1,0,1,0,0,2,1,2015
S. Bhullar,REN,22.0,39,17,1006,173,238,0.727,0,0,0.0,173,238,0.727,0.727,57,95,0.6,115,227,342,33,10,151,57,124,403,2015
K. Birch,SFL,22.0,49,33,1292,218,310,0.703,0,0,0.0,218,310,0.703,0.703,114,170,0.671,171,299,470,61,31,87,61,109,550,2015
T. Bishop,RIO,25.0,50,30,1594,287,612,0.469,85,243,0.35,202,369,0.547,0.538,114,146,0.781,163,262,425,93,61,42,93,160,773,2015
T. Black,LOS,23.0,1,1,33,9,14,0.643,0,1,0.0,9,13,0.692,0.643,5,6,0.833,4,8,12,3,0,0,0,5,23,2015
V. Blue,LOS,22.0,49,47,1825,418,883,0.473,74,178,0.416,344,705,0.488,0.515,232,319,0.727,53,213,266,262,93,7,137,110,1142,2015
J. Bohannon,ERI,23.0,49,6,1186,173,343,0.504,2,10,0.2,171,333,0.514,0.507,93,138,0.674,142,264,406,63,24,40,63,159,441,2015
J. Bostic,GRR,27.0,15,0,269,34,82,0.415,14,35,0.4,20,47,0.426,0.5,18,22,0.818,6,45,51,21,11,2,16,27,100,2015
M. Bouldin,FOR,27.0,12,11,401,58,138,0.42,20,58,0.345,38,80,0.475,0.493,38,47,0.809,10,32,42,48,18,0,21,16,174,2015
J. Bowie,DEL,22.0,2,0,29,2,6,0.333,1,4,0.25,1,2,0.5,0.417,0,0,0.0,1,3,4,2,3,0,0,1,5,2015
A. Brown,BAK,22.0,17,0,314,42,106,0.396,15,44,0.341,27,62,0.435,0.467,16,21,0.762,18,40,58,17,7,34,16,45,115,2015
J. Brown,LOS,22.0,39,25,1362,311,681,0.457,87,222,0.392,224,459,0.488,0.521,242,289,0.837,55,103,158,87,39,7,100,85,951,2015
L. Brown,GRR,24.0,18,16,567,118,234,0.504,21,54,0.389,97,180,0.539,0.549,46,54,0.852,17,72,89,68,33,5,65,43,303,2015
M. Brown,MAI,23.0,1,1,8,2,4,0.5,1,2,0.5,1,2,0.5,0.625,2,2,1.0,0,1,1,0,1,0,0,0,7,2015
S. Brown,MAI,23.0,36,0,381,46,119,0.387,29,75,0.387,17,44,0.386,0.508,5,9,0.556,22,69,91,23,11,6,8,37,126,2015
W. Buford,TOT,25.0,36,10,775,112,238,0.471,35,85,0.412,77,153,0.503,0.544,20,27,0.741,15,101,116,38,27,6,42,64,279,2015
W. Buford,TEX,25.0,25,9,608,86,183,0.47,26,68,0.382,60,115,0.522,0.541,12,18,0.667,13,75,88,29,23,3,26,44,210,2015
W. Buford,CAN,25.0,11,1,167,26,55,0.473,9,17,0.529,17,38,0.447,0.555,8,9,0.889,2,26,28,9,4,3,16,20,69,2015
R. Bullock,BAK,23.0,4,4,141,35,69,0.507,12,26,0.462,23,43,0.535,0.594,13,16,0.813,9,30,39,11,6,5,5,6,95,2015
J. Burris,REN,22.0,3,0,20,1,8,0.125,1,7,0.143,0,1,0.0,0.188,0,0,0.0,1,4,5,0,0,0,0,3,3,2015
T. Bussey,IDA,23.0,38,11,777,106,292,0.363,30,100,0.3,76,192,0.396,0.414,38,50,0.76,10,54,64,89,30,6,70,56,280,2015
D. Buycks,OKL,25.0,10,10,344,73,171,0.427,20,52,0.385,53,119,0.445,0.485,16,25,0.64,11,57,68,62,21,5,30,23,182,2015
B. Caboclo,FOR,19.0,7,0,62,9,31,0.29,4,12,0.333,5,19,0.263,0.355,2,2,1.0,6,7,13,0,1,5,7,11,24,2015
J. Calliste,MAI,25.0,40,3,812,113,258,0.438,64,149,0.43,49,109,0.45,0.562,48,68,0.706,12,88,100,67,24,2,42,85,338,2015
I. Canaan,RIO,23.0,4,4,144,25,68,0.368,15,43,0.349,10,25,0.4,0.478,19,30,0.633,2,12,14,34,3,0,19,3,84,2015
C. Capela,RIO,20.0,38,32,928,253,421,0.601,0,3,0.0,253,418,0.605,0.601,102,171,0.596,151,217,368,29,29,113,70,98,608,2015
J. Caven,TOT,22.0,36,1,396,42,138,0.304,31,116,0.267,11,22,0.5,0.417,21,30,0.7,12,53,65,8,11,14,16,66,136,2015
J. Caven,REN,22.0,12,1,139,12,51,0.235,9,43,0.209,3,8,0.375,0.324,3,6,0.5,11,13,24,1,5,4,5,21,36,2015
J. Caven,DEL,22.0,24,0,257,30,87,0.345,22,73,0.301,8,14,0.571,0.471,18,24,0.75,1,40,41,7,6,10,11,45,100,2015
K. Chamberlain,REN,27.0,5,2,76,4,7,0.571,0,1,0.0,4,6,0.667,0.571,4,8,0.5,5,9,14,3,5,0,4,14,12,2015
P. Christopher,IOW,26.0,7,7,255,42,95,0.442,16,41,0.39,26,54,0.481,0.526,5,8,0.625,4,19,23,14,4,1,12,16,105,2015
S. Christon,OKL,22.0,44,40,1555,300,691,0.434,11,47,0.234,289,644,0.449,0.442,206,262,0.786,37,124,161,251,70,7,138,104,817,2015
E. Clark,RIO,27.0,6,5,206,59,131,0.45,16,48,0.333,43,83,0.518,0.511,23,27,0.852,7,41,48,9,4,21,19,19,157,2015
I. Clark,IDA,23.0,7,6,224,37,87,0.425,18,40,0.45,19,47,0.404,0.529,6,9,0.667,1,15,16,19,8,3,17,16,98,2015
J. Clarkson,LOS,22.0,5,5,180,46,92,0.5,4,18,0.222,42,74,0.568,0.522,17,21,0.81,7,18,25,39,4,1,17,10,113,2015
K. Clark,WES,29.0,16,0,202,16,68,0.235,8,38,0.211,8,30,0.267,0.294,0,3,0.0,5,13,18,19,14,0,9,18,40,2015
R. Conley,ERI,23.0,3,0,11,1,4,0.25,0,0,0.0,1,4,0.25,0.25,1,2,0.5,2,1,3,0,0,0,1,2,3,2015
J. Cooley,IDA,23.0,20,18,616,131,229,0.572,4,19,0.211,127,210,0.605,0.581,69,100,0.69,102,147,249,21,14,25,30,68,335,2015
B. Cotton,AUS,22.0,34,34,1368,264,560,0.471,90,201,0.448,174,359,0.485,0.552,144,160,0.9,41,118,159,158,43,5,87,75,762,2015
D. Coursey,ERI,22.0,50,44,1254,208,402,0.517,1,1,1.0,207,401,0.516,0.519,45,54,0.833,113,186,299,36,34,73,85,186,462,2015
N. Covington,IDA,29.0,5,2,126,15,36,0.417,7,18,0.389,8,18,0.444,0.514,8,10,0.8,3,13,16,13,6,2,8,12,45,2015
N. Covington,WES,29.0,8,0,177,25,71,0.352,9,32,0.281,16,39,0.41,0.415,5,6,0.833,3,14,17,22,6,0,9,23,64,2015
N. Covington,TOT,29.0,13,2,303,40,107,0.374,16,50,0.32,24,57,0.421,0.449,13,16,0.813,6,27,33,35,12,2,17,35,109,2015
A. Craft,SAN,23.0,50,50,1803,165,380,0.434,29,113,0.257,136,267,0.509,0.472,103,131,0.786,30,215,245,310,125,13,87,129,462,2015
C. Crawford,CAN,22.0,49,16,1323,160,423,0.378,77,237,0.325,83,186,0.446,0.469,39,54,0.722,24,165,189,166,48,7,79,106,436,2015
D. Crawford,ERI,24.0,50,50,1683,313,651,0.481,66,186,0.355,247,465,0.531,0.531,109,157,0.694,50,254,304,91,45,12,98,149,801,2015
J. Crawford,ERI,28.0,18,4,305,41,97,0.423,7,28,0.25,34,69,0.493,0.459,13,17,0.765,9,21,30,22,7,1,9,19,102,2015
J. Crawford,FOR,26.0,8,8,286,64,174,0.368,21,68,0.309,43,106,0.406,0.428,32,36,0.889,7,38,45,36,11,0,19,18,181,2015
M. Cummings,TOT,26.0,29,1,515,61,143,0.427,7,32,0.219,54,111,0.486,0.451,53,73,0.726,22,36,58,31,27,1,35,66,182,2015
M. Cummings,SFL,26.0,8,0,145,16,38,0.421,5,16,0.313,11,22,0.5,0.487,8,10,0.8,5,10,15,4,8,0,7,22,45,2015
M. Cummings,BAK,26.0,2,0,13,1,4,0.25,0,1,0.0,1,3,0.333,0.25,0,0,0.0,1,1,2,0,1,0,0,2,2,2015
M. Cummings,WES,26.0,19,1,357,44,101,0.436,2,15,0.133,42,86,0.488,0.446,45,63,0.714,16,25,41,27,18,1,28,42,135,2015
J. Cunningham,TOT,23.0,29,22,993,155,368,0.421,51,158,0.323,104,210,0.495,0.49,181,228,0.794,29,61,90,90,34,9,82,63,542,2015
J. Cunningham,IDA,23.0,11,6,348,61,139,0.439,19,61,0.311,42,78,0.538,0.507,87,112,0.777,11,25,36,35,8,4,26,29,228,2015
J. Cunningham,DEL,23.0,18,16,645,94,229,0.41,32,97,0.33,62,132,0.47,0.48,94,116,0.81,18,36,54,55,26,5,56,34,314,2015
S. Curry,ERI,24.0,43,42,1589,347,717,0.484,156,334,0.467,191,383,0.499,0.593,174,188,0.926,16,150,166,179,62,2,127,98,1024,2015
G. Datome,GRR,27.0,2,0,53,11,24,0.458,6,10,0.6,5,14,0.357,0.583,4,5,0.8,3,10,13,1,0,1,6,3,32,2015
A. Davis,SFL,27.0,49,14,801,102,251,0.406,39,133,0.293,63,118,0.534,0.484,54,73,0.74,13,108,121,35,31,9,50,81,297,2015
J. Davis,AUS,24.0,22,22,744,117,226,0.518,0,1,0.0,117,225,0.52,0.518,70,116,0.603,77,155,232,49,32,22,46,60,304,2015
A. Dawkins,MAI,23.0,7,7,251,39,102,0.382,26,80,0.325,13,22,0.591,0.51,9,11,0.818,5,13,18,17,6,2,18,22,113,2015
A. Dawkins,TOT,23.0,37,21,1265,225,514,0.438,149,352,0.423,76,162,0.469,0.583,93,117,0.795,13,80,93,101,26,7,74,100,692,2015
A. Dawkins,SFL,23.0,30,14,1014,186,412,0.451,123,272,0.452,63,140,0.45,0.601,84,106,0.792,8,67,75,84,20,5,56,78,579,2015
A. Daye,ERI,26.0,10,4,284,61,150,0.407,13,45,0.289,48,105,0.457,0.45,25,29,0.862,5,65,70,25,8,11,29,38,160,2015
J. Dentmon,TEX,29.0,13,13,499,76,177,0.429,36,82,0.439,40,95,0.421,0.531,24,27,0.889,15,43,58,82,13,2,29,37,212,2015
S. Dinwiddie,GRR,21.0,6,6,175,26,64,0.406,10,23,0.435,16,41,0.39,0.484,13,15,0.867,1,18,19,31,3,1,10,16,75,2015
Q. Doggett,IDA,24.0,8,7,146,23,44,0.523,0,0,0.0,23,44,0.523,0.523,11,19,0.579,14,29,43,5,2,2,5,13,57,2015
A. Dotson,IDA,23.0,3,0,24,1,6,0.167,0,2,0.0,1,4,0.25,0.167,0,0,0.0,2,2,4,1,2,1,2,2,2,2015
Z. Dragic,SFL,25.0,4,1,117,21,55,0.382,9,23,0.391,12,32,0.375,0.464,15,20,0.75,4,9,13,13,6,1,15,13,66,2015
L. Drew,SFL,24.0,42,41,1480,180,379,0.475,48,114,0.421,132,265,0.498,0.538,61,84,0.726,11,141,152,402,65,1,131,102,469,2015
M. Dunigan,CAN,23.0,24,18,729,110,193,0.57,0,0,0.0,110,193,0.57,0.57,59,79,0.747,54,117,171,24,21,33,50,90,279,2015
C. Early,WES,23.0,3,3,122,25,56,0.446,4,14,0.286,21,42,0.5,0.482,7,12,0.583,4,25,29,6,6,3,9,9,61,2015
J. Eddie,AUS,23.0,44,18,1151,182,412,0.442,127,281,0.452,55,131,0.42,0.596,78,89,0.876,16,134,150,41,31,10,58,81,569,2015
F. Edwin,SFL,23.0,49,33,1443,253,542,0.467,100,250,0.4,153,292,0.524,0.559,70,93,0.753,37,175,212,74,88,18,60,117,676,2015
A. Emmett,FOR,32.0,39,39,1307,338,648,0.522,60,162,0.37,278,486,0.572,0.568,147,191,0.77,62,148,210,103,66,9,94,50,883,2015
T. Ennis,BAK,20.0,9,9,302,67,140,0.479,15,45,0.333,52,95,0.547,0.532,17,21,0.81,18,21,39,48,16,2,23,29,166,2015
F. Ezeli,SAN,25.0,2,0,42,9,19,0.474,0,0,0.0,9,19,0.474,0.474,2,2,1.0,6,4,10,0,2,6,5,7,20,2015
C. Fair,FOR,23.0,50,20,1380,274,569,0.482,26,95,0.274,248,474,0.523,0.504,123,164,0.75,78,207,285,42,56,37,85,100,697,2015
J. Famous,TOT,26.0,27,20,872,174,308,0.565,1,2,0.5,173,306,0.565,0.567,82,111,0.739,152,251,403,14,17,32,63,80,431,2015
J. Famous,TEX,26.0,17,13,544,124,213,0.582,1,2,0.5,123,211,0.583,0.585,58,80,0.725,88,156,244,12,12,22,48,46,307,2015
J. Famous,IOW,26.0,10,7,328,50,95,0.526,0,0,0.0,50,95,0.526,0.526,24,31,0.774,64,95,159,2,5,10,15,34,124,2015
C. Felix,SAN,24.0,5,4,128,19,46,0.413,3,17,0.176,16,29,0.552,0.446,3,7,0.429,2,26,28,14,2,3,6,9,44,2015
B. Fields,TOT,26.0,47,26,1345,263,595,0.442,27,103,0.262,236,492,0.48,0.465,124,179,0.693,23,135,158,218,35,3,114,96,677,2015
B. Fields,IDA,26.0,15,10,424,88,191,0.461,4,34,0.118,84,157,0.535,0.471,45,63,0.714,11,36,47,81,10,1,28,27,225,2015
B. Fields,GRR,26.0,32,16,921,175,404,0.433,23,69,0.333,152,335,0.454,0.462,79,116,0.681,12,99,111,137,25,2,86,69,452,2015
G. Foster,FOR,25.0,1,0,1,0,0,0.0,0,0,0.0,0,0,0.0,0.0,0,0,0.0,0,0,0,0,1,0,1,2,0,2015
J. Franklin,LOS,23.0,21,8,717,126,261,0.483,41,121,0.339,85,140,0.607,0.561,111,140,0.793,23,163,186,136,31,6,77,79,404,2015
T. Frazier,MAI,24.0,41,40,1458,225,489,0.46,43,118,0.364,182,371,0.491,0.504,167,206,0.811,85,206,291,388,68,11,136,141,660,2015
W. Frisby,FOR,33.0,25,21,438,72,154,0.468,3,4,0.75,69,150,0.46,0.477,14,19,0.737,33,71,104,10,16,11,27,82,161,2015
F. Gaines,OKL,24.0,14,3,417,97,212,0.458,36,95,0.379,61,117,0.521,0.542,60,92,0.652,11,36,47,37,18,3,28,42,290,2015
L. Galloway,WES,23.0,19,19,699,115,257,0.447,39,109,0.358,76,148,0.514,0.523,44,53,0.83,21,91,112,46,51,8,29,56,313,2015
T. Gallon,DEL,24.0,10,6,191,26,59,0.441,1,8,0.125,25,51,0.49,0.449,5,9,0.556,13,34,47,17,12,4,21,27,58,2015
G. Gamble,DEL,24.0,21,3,423,62,152,0.408,35,89,0.393,27,63,0.429,0.523,4,7,0.571,10,45,55,18,15,9,20,45,163,2015
G. Gamble,TOT,24.0,22,3,429,62,153,0.405,35,90,0.389,27,63,0.429,0.52,4,7,0.571,10,46,56,18,15,9,20,46,163,2015
G. Gamble,LOS,24.0,1,0,6,0,1,0.0,0,1,0.0,0,0,0.0,0.0,0,0,0.0,0,1,1,0,0,0,0,1,0,2015
G. Gantt,AUS,23.0,13,1,118,11,30,0.367,6,20,0.3,5,10,0.5,0.467,5,7,0.714,3,7,10,1,3,0,4,7,33,2015
K. Gardner,SAN,21.0,29,0,313,47,119,0.395,13,35,0.371,34,84,0.405,0.45,30,38,0.789,9,30,39,60,23,3,30,32,137,2015
D. Garrett,IOW,26.0,30,29,1108,168,404,0.416,59,145,0.407,109,259,0.421,0.489,45,60,0.75,20,123,143,136,42,15,54,75,440,2015
D. Garrett,GRR,26.0,14,4,336,56,133,0.421,21,53,0.396,35,80,0.438,0.5,21,23,0.913,9,40,49,42,16,2,30,22,154,2015
D. Garrett,TOT,26.0,44,33,1444,224,537,0.417,80,198,0.404,144,339,0.425,0.492,66,83,0.795,29,163,192,178,58,17,84,97,594,2015
S. Gibson,IDA,25.0,50,36,1327,221,494,0.447,128,322,0.398,93,172,0.541,0.577,54,62,0.871,20,115,135,70,43,13,53,102,624,2015
T. Gilder,WES,30.0,18,6,452,69,151,0.457,5,22,0.227,64,129,0.496,0.474,34,46,0.739,14,77,91,25,15,10,26,36,177,2015
T. Gilder,TOT,30.0,20,6,470,70,154,0.455,5,22,0.227,65,132,0.492,0.471,34,46,0.739,14,78,92,27,15,10,26,39,179,2015
T. Gilder,AUS,30.0,2,0,18,1,3,0.333,0,0,0.0,1,3,0.333,0.333,0,0,0.0,0,1,1,2,0,0,0,3,2,2015
M. Ginyard,WES,27.0,18,6,383,55,108,0.509,7,19,0.368,48,89,0.539,0.542,18,25,0.72,26,53,79,36,16,2,33,27,135,2015
M. Goode,ERI,26.0,1,0,2,0,0,0.0,0,0,0.0,0,0,0.0,0.0,0,0,0.0,0,0,0,0,0,0,0,1,0,2015
A. Goodwin,BAK,20.0,9,9,298,71,161,0.441,13,45,0.289,58,116,0.5,0.481,49,75,0.653,19,37,56,19,15,2,24,23,204,2015
D. Gordon,DEL,24.0,41,40,1347,216,405,0.533,25,85,0.294,191,320,0.597,0.564,77,122,0.631,145,291,436,72,42,23,79,112,534,2015
E. Green,FOR,23.0,2,0,72,15,29,0.517,3,11,0.273,12,18,0.667,0.569,9,10,0.9,0,5,5,6,4,1,3,2,42,2015
J. Green,AUS,24.0,20,20,629,179,310,0.577,4,11,0.364,175,299,0.585,0.584,97,115,0.843,83,131,214,49,20,31,72,79,459,2015
E. Griffin,TEX,24.0,49,48,1723,310,681,0.455,98,266,0.368,212,415,0.511,0.527,215,279,0.771,82,243,325,93,63,118,120,192,933,2015
T. Griffin,SAN,28.0,46,21,1088,168,378,0.444,40,108,0.37,128,270,0.474,0.497,68,83,0.819,53,209,262,73,33,24,56,113,444,2015
J. Gutierrez,CAN,26.0,15,5,445,72,157,0.459,1,11,0.091,71,146,0.486,0.462,58,89,0.652,19,47,66,76,26,5,37,47,203,2015
F. Hall,IOW,24.0,43,20,782,89,217,0.41,30,87,0.345,59,130,0.454,0.479,23,42,0.548,38,107,145,20,23,17,31,92,231,2015
K. Hall,DEL,24.0,38,1,705,109,192,0.568,1,3,0.333,108,189,0.571,0.57,58,87,0.667,64,114,178,18,25,21,67,113,277,2015
K. Hall,TOT,24.0,44,1,763,120,213,0.563,1,3,0.333,119,210,0.567,0.566,60,90,0.667,71,128,199,20,28,22,70,118,301,2015
K. Hall,SAN,24.0,6,0,58,11,21,0.524,0,0,0.0,11,21,0.524,0.524,2,3,0.667,7,14,21,2,3,1,3,5,24,2015
M. Hall,TOT,29.0,40,6,787,103,262,0.393,32,98,0.327,71,164,0.433,0.454,22,29,0.759,5,102,107,116,23,2,54,54,260,2015
M. Hall,IOW,29.0,10,6,344,49,112,0.438,14,39,0.359,35,73,0.479,0.5,11,14,0.786,3,46,49,36,12,2,24,24,123,2015
M. Hall,FOR,29.0,30,0,443,54,150,0.36,18,59,0.305,36,91,0.396,0.42,11,15,0.733,2,56,58,80,11,0,30,30,137,2015
J. Hamilton,TOT,24.0,31,22,861,188,426,0.441,53,161,0.329,135,265,0.509,0.504,92,119,0.773,70,159,229,107,38,29,60,87,521,2015
J. Hamilton,REN,24.0,27,22,773,175,389,0.45,52,151,0.344,123,238,0.517,0.517,86,112,0.768,66,140,206,97,35,27,53,79,488,2015
J. Hamilton,IOW,24.0,4,0,88,13,37,0.351,1,10,0.1,12,27,0.444,0.365,6,7,0.857,4,19,23,10,3,2,7,8,33,2015
S. Hannah,GRR,29.0,9,0,123,20,51,0.392,13,29,0.448,7,22,0.318,0.52,6,8,0.75,5,10,15,22,8,0,19,15,59,2015
S. Hannah,TOT,29.0,22,2,366,47,133,0.353,26,76,0.342,21,57,0.368,0.451,9,12,0.75,11,24,35,46,23,0,43,37,129,2015
S. Hannah,REN,29.0,13,2,243,27,82,0.329,13,47,0.277,14,35,0.4,0.409,3,4,0.75,6,14,20,24,15,0,24,22,70,2015
B. Hansbrough,GRR,27.0,7,1,157,19,43,0.442,5,13,0.385,14,30,0.467,0.5,13,17,0.765,1,14,15,20,10,2,12,19,56,2015
J. Harris,SFL,27.0,9,0,82,7,12,0.583,3,6,0.5,4,6,0.667,0.708,1,2,0.5,4,5,9,1,5,0,3,5,18,2015
J. Harris,CAN,23.0,11,11,347,52,133,0.391,18,69,0.261,34,64,0.531,0.459,33,45,0.733,17,42,59,38,10,2,27,38,155,2015
M. Harris,LOS,25.0,15,15,564,147,315,0.467,19,60,0.317,128,255,0.502,0.497,72,88,0.818,23,83,106,71,21,3,50,21,385,2015
R. Harris,FOR,26.0,50,37,1218,150,383,0.392,100,265,0.377,50,118,0.424,0.522,50,71,0.704,28,188,216,77,50,19,47,103,450,2015
R. Hearn,TOT,23.0,30,4,540,62,161,0.385,32,92,0.348,30,69,0.435,0.484,37,41,0.902,15,65,80,23,16,6,27,85,193,2015
R. Hearn,REN,23.0,15,1,266,28,74,0.378,12,39,0.308,16,35,0.457,0.459,24,26,0.923,10,38,48,11,9,4,13,46,92,2015
R. Hearn,IDA,23.0,15,3,274,34,87,0.391,20,53,0.377,14,34,0.412,0.506,13,15,0.867,5,27,32,12,7,2,14,39,101,2015
P. Henderson-Niles,IOW,27.0,36,6,475,69,121,0.57,0,0,0.0,69,121,0.57,0.57,13,28,0.464,42,79,121,7,15,12,23,82,151,2015
X. Henry,LOS,23.0,2,2,73,15,33,0.455,5,10,0.5,10,23,0.435,0.53,17,19,0.895,2,4,6,6,2,1,6,9,52,2015
B. Heslip,REN,24.0,20,16,618,169,355,0.476,113,255,0.443,56,100,0.56,0.635,39,51,0.765,16,24,40,20,22,0,15,26,490,2015
C. Hines,IOW,25.0,3,0,6,0,2,0.0,0,2,0.0,0,0,0.0,0.0,0,0,0.0,0,0,0,0,0,0,0,1,0,2015
C. Hinkle,TOT,26.0,14,1,207,28,65,0.431,14,36,0.389,14,29,0.483,0.538,10,15,0.667,7,26,33,16,2,4,10,16,80,2015
C. Hinkle,LOS,26.0,6,0,30,3,9,0.333,1,5,0.2,2,4,0.5,0.389,2,2,1.0,1,2,3,1,0,1,3,0,9,2015
C. Hinkle,IDA,26.0,8,1,177,25,56,0.446,13,31,0.419,12,25,0.48,0.563,8,13,0.615,6,24,30,15,2,3,7,16,71,2015
D. Hobson,SAN,27.0,25,12,732,124,294,0.422,35,91,0.385,89,203,0.438,0.481,29,43,0.674,42,128,170,136,21,10,75,65,312,2015
J. Holiday,SAN,25.0,1,1,36,9,20,0.45,5,11,0.455,4,9,0.444,0.575,3,5,0.6,1,5,6,4,1,2,1,0,26,2015
K. Holsey,GRR,24.0,46,2,740,110,222,0.495,0,4,0.0,110,218,0.505,0.495,27,39,0.692,81,88,169,31,18,7,52,97,247,2015
S. Holt,CAN,23.0,49,44,1449,176,411,0.428,57,155,0.368,119,256,0.465,0.498,127,158,0.804,52,102,154,152,66,2,83,96,536,2015
S. Hopson,SFL,25.0,43,35,1381,315,598,0.527,56,160,0.35,259,438,0.591,0.574,139,176,0.79,45,156,201,144,45,15,114,107,825,2015
R. Howell,AUS,24.0,8,1,187,30,60,0.5,1,2,0.5,29,58,0.5,0.508,9,11,0.818,13,26,39,8,8,4,12,20,70,2015
J. Huestis,OKL,23.0,44,43,1457,162,435,0.372,85,269,0.316,77,166,0.464,0.47,44,67,0.657,46,203,249,50,28,69,47,86,453,2015
T. Hyman,FOR,27.0,31,12,539,44,101,0.436,0,0,0.0,44,101,0.436,0.436,14,41,0.341,53,90,143,15,18,38,29,87,102,2015
T. Hyman,TOT,27.0,44,17,769,72,157,0.459,0,1,0.0,72,156,0.462,0.459,23,60,0.383,86,133,219,22,30,62,52,136,167,2015
T. Hyman,LOS,27.0,13,5,230,28,56,0.5,0,1,0.0,28,55,0.509,0.5,9,19,0.474,33,43,76,7,12,24,23,49,65,2015
A. Ingram,LOS,29.0,28,10,716,86,192,0.448,52,117,0.444,34,75,0.453,0.583,33,38,0.868,16,93,109,32,38,6,16,63,257,2015
J. Inman,WES,27.0,7,0,80,12,28,0.429,0,0,0.0,12,28,0.429,0.429,6,11,0.545,13,13,26,5,1,1,3,10,30,2015
D. Jackson,WES,29.0,45,41,1388,282,620,0.455,4,23,0.174,278,597,0.466,0.458,155,216,0.718,110,237,347,97,40,15,95,175,723,2015
J. Jackson,BAK,22.0,37,18,907,176,356,0.494,21,62,0.339,155,294,0.527,0.524,132,161,0.82,26,105,131,180,55,7,89,80,505,2015
J. Jackson,TEX,24.0,38,13,626,105,171,0.614,0,2,0.0,105,169,0.621,0.614,40,85,0.471,76,96,172,22,32,72,48,122,250,2015
L. Jackson,WES,25.0,3,0,31,3,7,0.429,0,0,0.0,3,7,0.429,0.429,2,2,1.0,0,4,4,3,1,0,4,8,8,2015
L. Jackson,TOT,25.0,31,4,629,60,155,0.387,1,18,0.056,59,137,0.431,0.39,24,31,0.774,11,80,91,132,17,2,59,57,145,2015
L. Jackson,IDA,25.0,28,4,598,57,148,0.385,1,18,0.056,56,130,0.431,0.389,22,29,0.759,11,76,87,129,16,2,55,49,137,2015
B. James,TEX,29.0,2,2,58,10,20,0.5,0,1,0.0,10,19,0.526,0.5,3,6,0.5,7,13,20,2,1,10,2,4,23,2015
D. James,TEX,27.0,29,29,1042,188,429,0.438,38,124,0.306,150,305,0.492,0.483,116,153,0.758,58,233,291,93,30,30,73,87,530,2015
M. James,TEX,39.0,44,40,1542,295,662,0.446,94,234,0.402,201,428,0.47,0.517,74,94,0.787,19,159,178,303,34,6,129,150,758,2015
R. James,REN,25.0,46,43,1321,351,759,0.462,86,277,0.31,265,482,0.55,0.519,168,244,0.689,69,153,222,158,43,5,112,106,956,2015
C. Jefferson,MAI,24.0,2,0,49,8,13,0.615,2,2,1.0,6,11,0.545,0.692,3,5,0.6,4,16,20,0,1,6,3,7,21,2015
R. Hollis-Jefferson,DEL,23.0,35,4,584,72,154,0.468,9,32,0.281,63,122,0.516,0.497,30,54,0.556,37,64,101,54,40,14,43,60,183,2015
J. Jenkins,FOR,23.0,5,0,119,38,64,0.594,5,15,0.333,33,49,0.673,0.633,16,16,1.0,5,14,19,3,4,2,9,3,97,2015
J. Jenkins,TOT,23.0,11,4,312,73,137,0.533,19,48,0.396,54,89,0.607,0.602,33,34,0.971,6,35,41,16,10,2,24,12,198,2015
J. Jenkins,IDA,23.0,6,4,193,35,73,0.479,14,33,0.424,21,40,0.525,0.575,17,18,0.944,1,21,22,13,6,0,15,9,101,2015
M. Jenkins,OKL,28.0,14,5,394,62,131,0.473,32,71,0.451,30,60,0.5,0.595,39,46,0.848,11,49,60,44,16,0,28,40,195,2015
G. Jerrett,TOT,21.0,19,15,540,99,212,0.467,38,97,0.392,61,115,0.53,0.557,20,32,0.625,36,93,129,27,15,14,23,56,256,2015
G. Jerrett,OKL,21.0,10,9,255,55,113,0.487,24,63,0.381,31,50,0.62,0.593,12,18,0.667,14,41,55,11,6,4,11,28,146,2015
G. Jerrett,IDA,21.0,9,6,285,44,99,0.444,14,34,0.412,30,65,0.462,0.515,8,14,0.571,22,52,74,16,9,10,12,28,110,2015
A. Johnson,AUS,25.0,2,1,38,0,7,0.0,0,3,0.0,0,4,0.0,0.0,2,2,1.0,2,1,3,7,0,0,1,7,2,2015
C. Johnson,RIO,24.0,17,14,576,116,225,0.516,39,107,0.364,77,118,0.653,0.602,71,90,0.789,31,67,98,36,26,15,29,47,342,2015
G. Johnson,RIO,22.0,33,0,422,66,173,0.382,15,65,0.231,51,108,0.472,0.425,24,35,0.686,22,52,74,47,20,6,44,64,171,2015
I. Johnson,TEX,30.0,7,5,165,28,68,0.412,2,16,0.125,26,52,0.5,0.426,8,15,0.533,8,24,32,8,10,3,13,25,66,2015
J. Johnson,RIO,22.0,50,38,1490,267,558,0.478,92,247,0.372,175,311,0.563,0.561,129,173,0.746,92,132,224,86,37,32,75,120,755,2015
J. Johnson,CAN,26.0,47,1,942,146,311,0.469,8,38,0.211,138,273,0.505,0.482,89,102,0.873,18,88,106,119,19,4,75,69,389,2015
M. Johnson,DEL,24.0,21,1,433,81,207,0.391,45,123,0.366,36,84,0.429,0.5,27,36,0.75,5,39,44,19,11,4,22,31,234,2015
M. Johnson,TOT,24.0,37,4,703,126,324,0.389,74,207,0.357,52,117,0.444,0.503,32,41,0.78,15,83,98,32,19,6,37,53,358,2015
M. Johnson,REN,24.0,16,3,270,45,117,0.385,29,84,0.345,16,33,0.485,0.509,5,5,1.0,10,44,54,13,8,2,15,22,124,2015
N. Johnson,RIO,22.0,20,18,677,124,290,0.428,26,92,0.283,98,198,0.495,0.472,90,114,0.789,20,87,107,101,25,14,81,75,364,2015
O. Johnson,MAI,25.0,49,12,1283,281,637,0.441,138,368,0.375,143,269,0.532,0.549,64,94,0.681,93,237,330,62,31,45,50,105,764,2015
O. Johnson,AUS,25.0,43,35,1484,263,530,0.496,40,124,0.323,223,406,0.549,0.534,182,237,0.768,50,172,222,137,45,16,116,113,748,2015
T. Johnson,SFL,22.0,15,15,517,99,202,0.49,20,47,0.426,79,155,0.51,0.54,59,73,0.808,20,45,65,64,14,6,26,37,277,2015
D. Jones,FOR,34.0,19,15,556,94,175,0.537,15,39,0.385,79,136,0.581,0.58,70,98,0.714,15,50,65,32,15,9,25,53,273,2015
J. Jones,DEL,21.0,46,18,971,132,315,0.419,49,146,0.336,83,169,0.491,0.497,47,71,0.662,36,95,131,43,29,19,41,98,360,2015
S. Jones,SFL,22.0,49,30,1226,272,472,0.576,1,5,0.2,271,467,0.58,0.577,99,146,0.678,156,276,432,40,34,57,56,137,644,2015
M. Kabongo,TOT,23.0,18,15,447,52,131,0.397,7,35,0.2,45,96,0.469,0.424,41,74,0.554,10,60,70,58,21,0,30,41,152,2015
M. Kabongo,TEX,23.0,2,0,34,4,11,0.364,1,3,0.333,3,8,0.375,0.409,3,10,0.3,1,4,5,6,0,0,3,7,12,2015
M. Kabongo,FOR,23.0,16,15,413,48,120,0.4,6,32,0.188,42,88,0.477,0.425,38,64,0.594,9,56,65,52,21,0,27,34,140,2015
C. Karl,REN,31.0,7,7,253,38,98,0.388,22,57,0.386,16,41,0.39,0.5,19,26,0.731,12,49,61,63,8,2,24,31,117,2015
R. Kelly,LOS,23.0,1,1,45,8,18,0.444,3,9,0.333,5,9,0.556,0.528,11,12,0.917,0,4,4,2,0,1,3,5,30,2015
M. Kemp,CAN,23.0,21,1,358,59,113,0.522,9,23,0.391,50,90,0.556,0.562,18,30,0.6,23,29,52,14,14,7,16,40,145,2015
S. Kilpatrick,DEL,25.0,22,17,694,126,265,0.475,54,133,0.406,72,132,0.545,0.577,48,55,0.873,10,58,68,41,26,5,34,24,354,2015
S. Kilpatrick,TOT,25.0,44,27,1230,223,518,0.431,85,246,0.346,138,272,0.507,0.513,81,92,0.88,14,127,141,83,43,6,66,53,612,2015
S. Kilpatrick,SAN,25.0,22,10,536,97,253,0.383,31,113,0.274,66,140,0.471,0.445,33,37,0.892,4,69,73,42,17,1,32,29,258,2015
A. Kirk,CAN,23.0,41,37,1164,211,431,0.49,7,32,0.219,204,399,0.511,0.498,72,99,0.727,101,164,265,48,27,49,74,115,501,2015
M. Koshwal,BAK,27.0,50,49,1646,254,454,0.559,0,0,0.0,254,454,0.559,0.559,33,108,0.306,202,299,501,94,75,21,103,140,541,2015
O. Kuzmic,SAN,24.0,29,29,889,150,304,0.493,0,2,0.0,150,302,0.497,0.493,71,92,0.772,122,226,348,48,14,57,50,88,371,2015
D. Lamb,TEX,23.0,21,18,685,118,242,0.488,32,80,0.4,86,162,0.531,0.554,78,90,0.867,8,46,54,61,20,4,38,65,346,2015
D. Lamb,WES,23.0,14,13,560,82,209,0.392,19,67,0.284,63,142,0.444,0.438,65,74,0.878,10,52,62,33,8,1,26,47,248,2015
D. Lamb,TOT,23.0,35,31,1245,200,451,0.443,51,147,0.347,149,304,0.49,0.5,143,164,0.872,18,98,116,94,28,5,64,112,594,2015
R. Ledo,TEX,22.0,26,23,853,149,334,0.446,30,104,0.288,119,230,0.517,0.491,65,86,0.756,33,86,119,110,36,6,61,66,393,2015
M. Lee,DEL,24.0,20,18,561,79,198,0.399,31,81,0.383,48,117,0.41,0.477,38,46,0.826,11,57,68,109,23,0,60,50,227,2015
M. Lee,TOT,24.0,32,23,803,116,285,0.407,44,115,0.383,72,170,0.424,0.484,50,67,0.746,19,90,109,153,29,0,72,74,326,2015
M. Lee,GRR,24.0,12,5,242,37,87,0.425,13,34,0.382,24,53,0.453,0.5,12,21,0.571,8,33,41,44,6,0,12,24,99,2015
B. Lewis,FOR,27.0,3,0,27,0,10,0.0,0,7,0.0,0,3,0.0,0.0,3,4,0.75,0,4,4,2,0,0,1,3,3,2015
V. Lewis,TEX,31.0,2,0,21,0,7,0.0,0,1,0.0,0,6,0.0,0.0,0,0,0.0,3,3,6,0,2,0,0,3,0,2015
M. Little,OKL,27.0,22,19,699,100,244,0.41,39,104,0.375,61,140,0.436,0.49,55,65,0.846,20,64,84,66,20,5,42,55,294,2015
L. Loucks,TOT,24.0,19,0,270,20,53,0.377,12,27,0.444,8,26,0.308,0.491,9,11,0.818,4,30,34,54,8,3,35,26,61,2015
L. Loucks,MAI,24.0,9,0,91,8,22,0.364,6,11,0.545,2,11,0.182,0.5,0,0,0.0,2,9,11,20,1,1,9,8,22,2015
L. Loucks,ERI,24.0,10,0,179,12,31,0.387,6,16,0.375,6,15,0.4,0.484,9,11,0.818,2,21,23,34,7,2,26,18,39,2015
K. Lucas,IOW,25.0,35,35,1293,260,571,0.455,57,138,0.413,203,433,0.469,0.505,99,125,0.792,27,124,151,162,46,3,87,75,676,2015
C. Lufile,SFL,24.0,9,0,39,6,13,0.462,0,2,0.0,6,11,0.545,0.462,1,4,0.25,1,12,13,2,1,1,3,4,13,2015
C. Maduabum,FOR,23.0,4,3,68,9,16,0.563,0,0,0.0,9,16,0.563,0.563,1,4,0.25,8,8,16,0,0,6,7,11,19,2015
A. Majok,LOS,27.0,23,18,507,57,95,0.6,0,0,0.0,57,95,0.6,0.6,17,24,0.708,53,68,121,17,17,64,25,94,131,2015
R. Major,BAK,32.0,46,9,1105,140,280,0.5,41,100,0.41,99,180,0.55,0.573,80,97,0.825,48,107,155,68,57,28,26,104,401,2015
D. Marble,ERI,22.0,6,2,184,28,82,0.341,9,28,0.321,19,54,0.352,0.396,13,22,0.591,10,21,31,13,7,1,11,10,78,2015
K. Marshall,AUS,22.0,16,0,148,24,50,0.48,1,6,0.167,23,44,0.523,0.49,5,11,0.455,12,30,42,3,4,1,6,11,54,2015
T. Mayo,WES,23.0,24,2,490,67,180,0.372,16,63,0.254,51,117,0.436,0.417,48,56,0.857,8,48,56,25,17,2,46,43,198,2015
A. Mbodji,IDA,28.0,28,3,317,32,52,0.615,0,0,0.0,32,52,0.615,0.615,13,21,0.619,39,43,82,5,8,9,11,64,77,2015
J. McAdoo,SAN,22.0,33,31,1081,248,431,0.575,1,4,0.25,247,427,0.578,0.577,148,216,0.685,97,189,286,76,66,67,77,104,645,2015
M. McCall,IOW,23.0,30,3,319,35,91,0.385,9,34,0.265,26,57,0.456,0.434,8,9,0.889,4,23,27,35,8,1,19,31,87,2015
L. McDonald,ERI,23.0,12,1,194,23,75,0.307,12,33,0.364,11,42,0.262,0.387,9,10,0.9,0,7,7,7,6,2,11,26,67,2015
M. McGary,OKL,22.0,8,6,194,57,116,0.491,0,3,0.0,57,113,0.504,0.491,17,31,0.548,28,33,61,6,15,9,28,24,131,2015
R. McGruder,TOT,23.0,29,7,668,111,236,0.47,23,67,0.343,88,169,0.521,0.519,26,44,0.591,38,76,114,41,15,3,36,52,271,2015
R. McGruder,SFL,23.0,3,0,74,9,17,0.529,3,7,0.429,6,10,0.6,0.618,1,1,1.0,4,7,11,6,1,0,4,6,22,2015
R. McGruder,MAI,23.0,26,7,594,102,219,0.466,20,60,0.333,82,159,0.516,0.511,25,43,0.581,34,69,103,35,14,3,32,46,249,2015
T. McKie,AUS,22.0,5,0,30,2,10,0.2,0,6,0.0,2,4,0.5,0.2,0,2,0.0,2,4,6,3,0,0,2,4,4,2015
T. McKie,TOT,22.0,9,0,77,8,23,0.348,3,13,0.231,5,10,0.5,0.413,0,2,0.0,4,12,16,4,2,1,5,8,19,2015
T. McKie,CAN,22.0,4,0,47,6,13,0.462,3,7,0.429,3,6,0.5,0.577,0,0,0.0,2,8,10,1,2,1,3,4,15,2015
T. McKinney-Jones,FOR,24.0,16,16,491,75,166,0.452,13,48,0.271,62,118,0.525,0.491,35,49,0.714,17,58,75,35,14,0,17,34,198,2015
M. McLaughlin,ERI,24.0,4,0,58,10,29,0.345,2,4,0.5,8,25,0.32,0.379,5,9,0.556,3,4,7,5,3,0,6,3,27,2015
J. McNeal,BAK,27.0,26,21,863,174,396,0.439,30,82,0.366,144,314,0.459,0.477,120,149,0.805,22,86,108,122,55,11,68,106,498,2015
J. McRae,DEL,23.0,13,13,447,87,191,0.455,28,74,0.378,59,117,0.504,0.529,37,52,0.712,10,43,53,50,14,13,24,36,239,2015
L. Miles,DEL,23.0,10,1,202,34,75,0.453,1,3,0.333,33,72,0.458,0.46,22,43,0.512,9,22,31,27,6,1,22,15,91,2015
M. Milisavljevic,SAN,21.0,21,1,270,34,86,0.395,11,40,0.275,23,46,0.5,0.459,23,25,0.92,7,23,30,30,5,2,28,29,102,2015
D. Miller,OKL,24.0,22,0,303,35,67,0.522,0,2,0.0,35,65,0.538,0.522,9,21,0.429,21,23,44,26,11,11,24,22,79,2015
Q. Miller,TOT,22.0,18,10,509,140,286,0.49,38,107,0.355,102,179,0.57,0.556,110,124,0.887,47,100,147,33,25,57,34,72,428,2015
Q. Miller,REN,22.0,15,10,433,124,245,0.506,32,91,0.352,92,154,0.597,0.571,99,111,0.892,35,79,114,29,24,54,27,64,379,2015
Q. Miller,GRR,22.0,3,0,76,16,41,0.39,6,16,0.375,10,25,0.4,0.463,11,13,0.846,12,21,33,4,1,3,7,8,49,2015
E. Millsap,BAK,27.0,19,16,695,125,283,0.442,19,56,0.339,106,227,0.467,0.475,122,160,0.763,35,122,157,99,40,5,78,74,391,2015
A. Mitchell,RIO,22.0,49,30,1335,203,343,0.592,9,41,0.22,194,302,0.642,0.605,66,135,0.489,131,310,441,78,48,35,86,123,481,2015
D. Mitchell,WES,32.0,1,0,19,1,2,0.5,0,0,0.0,1,2,0.5,0.5,0,0,0.0,0,3,3,3,0,0,2,4,2,2015
T. Mitchell,GRR,22.0,6,4,149,20,35,0.571,0,2,0.0,20,33,0.606,0.571,9,12,0.75,13,30,43,4,3,5,5,13,49,2015
J. Moon,LOS,34.0,10,8,321,40,94,0.426,13,46,0.283,27,48,0.563,0.495,5,8,0.625,8,55,63,35,11,21,15,26,98,2015
C. Moore,BAK,24.0,8,0,120,14,38,0.368,1,4,0.25,13,34,0.382,0.382,2,6,0.333,9,24,33,10,3,6,4,18,31,2015
R. Moore,REN,25.0,7,2,144,17,49,0.347,7,21,0.333,10,28,0.357,0.418,13,15,0.867,8,5,13,17,8,1,8,8,54,2015
E. Moreland,REN,23.0,7,6,201,42,71,0.592,0,0,0.0,42,71,0.592,0.592,12,32,0.375,33,56,89,10,9,11,14,22,96,2015
B. Mullens,SFL,25.0,11,6,257,52,125,0.416,20,57,0.351,32,68,0.471,0.496,23,33,0.697,9,57,66,9,6,7,17,20,147,2015
X. Munford,BAK,22.0,47,15,1029,186,410,0.454,49,155,0.316,137,255,0.537,0.513,93,119,0.782,22,134,156,132,46,12,82,72,514,2015
E. Murphy,AUS,24.0,49,26,1113,229,478,0.479,70,185,0.378,159,293,0.543,0.552,52,75,0.693,57,215,272,76,28,44,74,168,580,2015
K. Murphy,IDA,24.0,16,15,556,118,245,0.482,28,86,0.326,90,159,0.566,0.539,98,121,0.81,11,59,70,64,17,5,66,52,362,2015
K. Murphy,GRR,24.0,16,2,456,92,187,0.492,14,44,0.318,78,143,0.545,0.529,38,49,0.776,9,51,60,29,16,2,40,33,236,2015
K. Murphy,TOT,24.0,32,17,1012,210,432,0.486,42,130,0.323,168,302,0.556,0.535,136,170,0.8,20,110,130,93,33,7,106,85,598,2015
T. Murry,TOT,25.0,23,15,670,113,269,0.42,17,67,0.254,96,202,0.475,0.452,53,71,0.746,25,116,141,137,36,10,67,62,296,2015
T. Murry,RIO,25.0,16,9,451,73,173,0.422,14,50,0.28,59,123,0.48,0.462,41,54,0.759,19,83,102,106,21,6,49,42,201,2015
T. Murry,IDA,25.0,7,6,219,40,96,0.417,3,17,0.176,37,79,0.468,0.432,12,17,0.706,6,33,39,31,15,4,18,20,95,2015
M. Muscala,FOR,23.0,6,2,179,29,61,0.475,1,2,0.5,28,59,0.475,0.484,18,21,0.857,20,32,52,10,4,6,11,17,77,2015
S. Napier,SFL,23.0,4,2,136,26,62,0.419,9,20,0.45,17,42,0.405,0.492,17,21,0.81,4,16,20,15,3,1,11,8,78,2015
L. Nogueira,FOR,22.0,4,0,80,12,28,0.429,0,1,0.0,12,27,0.444,0.429,9,18,0.5,17,23,40,3,3,8,3,7,33,2015
K. Olekaibe,CAN,22.0,28,0,308,41,104,0.394,14,50,0.28,27,54,0.5,0.462,3,8,0.375,11,21,32,17,13,3,13,32,99,2015
A. Onuaku,CAN,27.0,41,35,1420,294,473,0.622,0,1,0.0,294,472,0.623,0.622,131,270,0.485,180,321,501,57,34,36,88,115,719,2015
D. Orton,GRR,24.0,6,1,110,11,18,0.611,0,0,0.0,11,18,0.611,0.611,18,24,0.75,9,26,35,4,2,6,9,26,40,2015
R. Osby,MAI,24.0,18,15,512,121,250,0.484,20,61,0.328,101,189,0.534,0.524,47,74,0.635,31,96,127,37,7,6,33,42,309,2015
L. Owens,IOW,32.0,36,34,1249,174,369,0.472,70,166,0.422,104,203,0.512,0.566,44,57,0.772,59,134,193,66,65,17,56,122,462,2015
B. Palo,SFL,23.0,26,8,611,56,143,0.392,8,26,0.308,48,117,0.41,0.42,61,84,0.726,17,47,64,79,20,2,50,57,181,2015
B. Palo,TOT,23.0,42,18,915,84,214,0.393,13,43,0.302,71,171,0.415,0.423,101,139,0.727,25,72,97,112,29,2,79,93,282,2015
B. Palo,TEX,23.0,16,10,304,28,71,0.394,5,17,0.294,23,54,0.426,0.43,40,55,0.727,8,25,33,33,9,0,29,36,101,2015
B. Paul,CAN,23.0,43,24,1131,214,460,0.465,87,228,0.382,127,232,0.547,0.56,132,166,0.795,33,158,191,77,49,21,87,101,647,2015
A. Payne,TOT,23.0,17,8,466,84,174,0.483,3,23,0.13,81,151,0.536,0.491,49,69,0.71,42,99,141,35,11,17,35,56,220,2015
A. Payne,FOR,23.0,6,5,188,27,66,0.409,0,7,0.0,27,59,0.458,0.409,27,33,0.818,14,49,63,14,2,4,13,19,81,2015
A. Payne,AUS,23.0,11,3,278,57,108,0.528,3,16,0.188,54,92,0.587,0.542,22,36,0.611,28,50,78,21,9,13,22,37,139,2015
N. Pelle,DEL,21.0,4,0,42,9,12,0.75,0,0,0.0,9,12,0.75,0.75,3,4,0.75,3,9,12,0,1,9,3,9,21,2015
K. Perry,IOW,22.0,9,3,189,24,51,0.471,12,24,0.5,12,27,0.444,0.588,1,1,1.0,2,16,18,10,7,1,7,26,61,2015
C. Porter,FOR,36.0,45,8,786,91,169,0.538,0,1,0.0,91,168,0.542,0.538,34,57,0.596,82,133,215,28,53,13,28,94,216,2015
T. Porter,REN,26.0,46,5,986,224,554,0.404,105,279,0.376,119,275,0.433,0.499,113,133,0.85,40,86,126,207,61,0,106,54,666,2015
D. Powell,TOT,23.0,12,12,430,125,209,0.598,11,28,0.393,114,181,0.63,0.624,51,72,0.708,36,81,117,32,11,13,34,42,312,2015
D. Powell,TEX,23.0,8,8,302,90,150,0.6,11,25,0.44,79,125,0.632,0.637,35,49,0.714,24,51,75,26,6,10,21,29,226,2015
D. Powell,MAI,23.0,4,4,128,35,59,0.593,0,3,0.0,35,56,0.625,0.593,16,23,0.696,12,30,42,6,5,3,13,13,86,2015
C. Prather,BAK,23.0,45,30,1132,213,454,0.469,27,87,0.31,186,367,0.507,0.499,74,105,0.705,36,133,169,76,54,15,76,123,527,2015
P. Pressey,MAI,23.0,1,1,42,11,25,0.44,3,9,0.333,8,16,0.5,0.5,9,12,0.75,1,6,7,9,3,0,6,2,34,2015
B. Provost,ERI,24.0,15,1,317,33,73,0.452,12,37,0.324,21,36,0.583,0.534,18,21,0.857,9,16,25,24,12,2,18,23,96,2015
Q. Prowell,IDA,30.0,15,7,350,50,100,0.5,8,35,0.229,42,65,0.646,0.54,5,6,0.833,17,59,76,19,8,7,13,50,113,2015
R. Putney,RIO,24.0,24,2,238,56,115,0.487,21,50,0.42,35,65,0.538,0.578,17,24,0.708,25,36,61,10,10,21,26,48,150,2015
O. Reed,MAI,27.0,2,0,19,2,9,0.222,0,4,0.0,2,5,0.4,0.222,0,0,0.0,2,5,7,2,1,0,3,1,4,2015
W. Reed,TOT,24.0,47,38,1584,332,552,0.601,0,0,0.0,332,552,0.601,0.601,109,192,0.568,216,357,573,54,33,90,70,140,773,2015
W. Reed,IOW,24.0,17,17,648,145,248,0.585,0,0,0.0,145,248,0.585,0.585,46,79,0.582,72,133,205,23,13,28,21,42,336,2015
W. Reed,GRR,24.0,30,21,936,187,304,0.615,0,0,0.0,187,304,0.615,0.615,63,113,0.558,144,224,368,31,20,62,49,98,437,2015
G. Rice,TOT,24.0,37,14,1009,218,514,0.424,70,224,0.313,148,290,0.51,0.492,143,188,0.761,47,140,187,125,56,17,82,93,649,2015
G. Rice,RIO,24.0,23,13,677,154,384,0.401,56,185,0.303,98,199,0.492,0.474,107,138,0.775,34,106,140,92,42,12,53,62,471,2015
G. Rice,FOR,24.0,14,1,332,64,130,0.492,14,39,0.359,50,91,0.549,0.546,36,50,0.72,13,34,47,33,14,5,29,31,178,2015
A. Richmond,RIO,23.0,29,10,593,99,275,0.36,88,252,0.349,11,23,0.478,0.52,26,31,0.839,12,38,50,28,14,0,15,35,312,2015
R. Roberts,TOT,23.0,16,13,487,115,167,0.689,0,2,0.0,115,165,0.697,0.689,50,89,0.562,68,122,190,25,12,18,32,48,280,2015
R. Roberts,SAN,23.0,2,0,59,25,32,0.781,0,0,0.0,25,32,0.781,0.781,9,17,0.529,9,18,27,5,0,4,5,9,59,2015
R. Roberts,DEL,23.0,14,13,428,90,135,0.667,0,2,0.0,90,133,0.677,0.667,41,72,0.569,59,104,163,20,12,14,27,39,221,2015
R. Robinson,AUS,29.0,3,0,34,1,8,0.125,0,2,0.0,1,6,0.167,0.125,2,2,1.0,1,3,4,2,3,0,7,0,4,2015
T. Rubles,FOR,23.0,3,0,44,6,10,0.6,0,0,0.0,6,10,0.6,0.6,1,4,0.25,3,5,8,4,0,1,2,4,13,2015
V. Rudd,DEL,23.0,49,41,1529,277,642,0.431,76,251,0.303,201,391,0.514,0.491,149,194,0.768,61,270,331,123,44,18,96,148,779,2015
W. Russell,WES,32.0,31,20,932,100,278,0.36,45,118,0.381,55,160,0.344,0.441,57,70,0.814,6,43,49,126,29,1,61,56,302,2015
O. Samhan,TEX,26.0,18,6,219,18,56,0.321,2,9,0.222,16,47,0.34,0.339,4,6,0.667,28,20,48,7,9,6,12,38,42,2015
J. Sampson,DEL,21.0,2,2,63,11,30,0.367,2,8,0.25,9,22,0.409,0.4,6,9,0.667,3,6,9,3,2,2,1,2,30,2015
R. Sampson,MAI,25.0,49,40,935,123,232,0.53,4,13,0.308,119,219,0.543,0.539,37,59,0.627,118,163,281,40,16,90,38,122,287,2015
O. Sanchez,WES,26.0,33,26,822,121,290,0.417,15,49,0.306,106,241,0.44,0.443,44,69,0.638,68,139,207,38,25,23,59,108,301,2015
J. Sanders,GRR,26.0,1,0,1,0,0,0.0,0,0,0.0,0,0,0.0,0.0,0,0,0.0,0,0,0,0,0,0,0,0,0,2015
M. Schachtner,ERI,28.0,14,0,262,43,102,0.422,0,8,0.0,43,94,0.457,0.422,7,11,0.636,19,14,33,5,3,0,14,27,93,2015
M. Schachtner,TOT,28.0,24,0,343,52,130,0.4,4,24,0.167,48,106,0.453,0.415,10,15,0.667,24,27,51,7,4,0,15,38,118,2015
M. Schachtner,MAI,28.0,10,0,81,9,28,0.321,4,16,0.25,5,12,0.417,0.393,3,4,0.75,5,13,18,2,1,0,1,11,25,2015
D. Seeley,DEL,25.0,47,46,1646,307,631,0.487,103,235,0.438,204,396,0.515,0.568,196,226,0.867,44,150,194,242,73,7,141,112,913,2015
M. Sene,AUS,28.0,7,1,81,13,19,0.684,0,0,0.0,13,19,0.684,0.684,14,27,0.519,11,18,29,1,3,8,6,11,40,2015
W. Sheehey,TOT,23.0,17,3,435,59,125,0.472,15,39,0.385,44,86,0.512,0.532,26,28,0.929,17,37,54,25,9,2,11,27,159,2015
W. Sheehey,LOS,23.0,9,0,280,42,84,0.5,12,29,0.414,30,55,0.545,0.571,17,18,0.944,8,23,31,19,7,1,10,19,113,2015
W. Sheehey,FOR,23.0,8,3,155,17,41,0.415,3,10,0.3,14,31,0.452,0.451,9,10,0.9,9,14,23,6,2,1,1,8,46,2015
J. Simmons,AUS,25.0,50,28,1684,277,560,0.495,51,128,0.398,226,432,0.523,0.54,153,204,0.75,49,165,214,183,50,22,144,161,758,2015
M. Simmons,FOR,27.0,41,7,683,62,152,0.408,15,52,0.288,47,100,0.47,0.457,23,35,0.657,44,66,110,29,23,9,21,94,162,2015
C. Singleton,OKL,25.0,17,0,423,52,151,0.344,19,64,0.297,33,87,0.379,0.407,33,47,0.702,28,75,103,22,22,16,40,59,156,2015
J. Singleton,CAN,33.0,21,8,657,86,193,0.446,18,52,0.346,68,141,0.482,0.492,39,51,0.765,48,110,158,35,10,22,43,56,229,2015
P. Siva,ERI,24.0,38,38,1157,173,393,0.44,54,156,0.346,119,237,0.502,0.509,113,146,0.774,12,113,125,253,58,3,101,125,513,2015
M. Smart,MAI,20.0,1,1,29,1,12,0.083,0,8,0.0,1,4,0.25,0.083,4,6,0.667,0,5,5,7,4,1,4,2,6,2015
L. Smith,ERI,23.0,47,6,1145,136,292,0.466,46,116,0.397,90,176,0.511,0.545,27,42,0.643,39,121,160,104,47,1,49,73,345,2015
M. Smith,IOW,24.0,23,2,248,27,79,0.342,26,70,0.371,1,9,0.111,0.506,1,3,0.333,4,19,23,11,5,3,7,25,81,2015
N. Smith,DEL,26.0,9,6,233,42,92,0.457,5,18,0.278,37,74,0.5,0.484,10,14,0.714,6,22,28,30,10,0,17,18,99,2015
R. Smith,LOS,23.0,49,46,1774,353,668,0.528,13,49,0.265,340,619,0.549,0.538,170,233,0.73,182,358,540,48,48,33,111,157,889,2015
R. Smith,IOW,23.0,18,12,595,125,261,0.479,28,67,0.418,97,194,0.5,0.533,69,96,0.719,22,70,92,65,36,5,54,59,347,2015
R. Smith,FOR,23.0,7,0,175,39,71,0.549,2,11,0.182,37,60,0.617,0.563,26,42,0.619,3,13,16,41,12,1,21,16,106,2015
R. Smith,TOT,23.0,25,12,770,164,332,0.494,30,78,0.385,134,254,0.528,0.539,95,138,0.688,25,83,108,106,48,6,75,75,453,2015
R. Solomon,OKL,22.0,28,1,503,94,152,0.618,0,1,0.0,94,151,0.623,0.618,50,80,0.625,71,122,193,4,17,15,35,86,238,2015
T. Spurlock,CAN,23.0,4,1,82,5,21,0.238,3,12,0.25,2,9,0.222,0.31,3,6,0.5,0,11,11,0,4,1,4,6,16,2015
D. Stockton,REN,23.0,43,38,1311,305,661,0.461,99,249,0.398,206,412,0.5,0.536,155,188,0.824,49,130,179,406,106,3,146,145,864,2015
J. Stokes,IOW,21.0,23,14,737,140,227,0.617,0,0,0.0,140,227,0.617,0.617,67,96,0.698,92,167,259,26,15,19,45,45,347,2015
D. Strickland,LOS,24.0,10,1,146,26,52,0.5,0,3,0.0,26,49,0.531,0.5,13,19,0.684,10,11,21,18,9,0,7,16,65,2015
A. Stringer,MAI,23.0,43,13,987,112,259,0.432,76,177,0.429,36,82,0.439,0.579,35,45,0.778,24,79,103,112,33,1,54,87,335,2015
B. Strong,WES,28.0,50,27,1490,235,476,0.494,11,40,0.275,224,436,0.514,0.505,75,100,0.75,110,257,367,80,30,51,68,124,556,2015
D. Summers,WES,25.0,19,3,381,83,163,0.509,4,17,0.235,79,146,0.541,0.521,35,40,0.875,21,32,53,25,23,4,29,31,205,2015
D. Summers,TOT,25.0,42,6,869,164,341,0.481,18,63,0.286,146,278,0.525,0.507,90,115,0.783,65,65,130,44,40,8,60,72,436,2015
D. Summers,REN,25.0,23,3,488,81,178,0.455,14,46,0.304,67,132,0.508,0.494,55,75,0.733,44,33,77,19,17,4,31,41,231,2015
D. Sutton,SAN,28.0,41,5,1018,219,361,0.607,11,34,0.324,208,327,0.636,0.622,82,162,0.506,97,166,263,79,54,14,90,124,531,2015
M. Sutton,OKL,25.0,43,36,978,164,266,0.617,0,1,0.0,164,265,0.619,0.617,51,82,0.622,90,201,291,28,27,48,49,121,379,2015
J. Swing,CAN,24.0,11,0,152,15,33,0.455,6,12,0.5,9,21,0.429,0.545,8,12,0.667,4,16,20,9,9,0,12,18,44,2015
G. Talton,TOT,24.0,44,39,1497,202,534,0.378,66,183,0.361,136,351,0.387,0.44,102,125,0.816,56,139,195,354,60,3,135,99,572,2015
G. Talton,RIO,24.0,12,12,451,58,140,0.414,19,51,0.373,39,89,0.438,0.482,38,49,0.776,19,51,70,162,17,1,50,33,173,2015
G. Talton,FOR,24.0,32,27,1046,144,394,0.365,47,132,0.356,97,262,0.37,0.425,64,76,0.842,37,88,125,192,43,2,85,66,399,2015
T. Tate,IDA,22.0,25,5,358,35,86,0.407,9,32,0.281,26,54,0.481,0.459,25,37,0.676,19,52,71,20,6,3,21,56,104,2015
A. Dixon-Tatum,MAI,23.0,31,0,467,63,113,0.558,0,1,0.0,63,112,0.563,0.558,29,48,0.604,52,54,106,6,8,37,16,71,155,2015
J. Taylor,IDA,28.0,17,10,484,95,219,0.434,21,77,0.273,74,142,0.521,0.482,22,36,0.611,14,43,57,43,13,1,32,34,233,2015
J. Taylor,TOT,28.0,39,25,1090,185,458,0.404,49,178,0.275,136,280,0.486,0.457,62,93,0.667,25,82,107,109,34,6,83,69,481,2015
J. Taylor,MAI,28.0,22,15,606,90,239,0.377,28,101,0.277,62,138,0.449,0.435,40,57,0.702,11,39,50,66,21,5,51,35,248,2015
J. Taylor,AUS,25.0,4,1,105,15,45,0.333,5,16,0.313,10,29,0.345,0.389,12,16,0.75,2,12,14,6,3,1,4,10,47,2015
D. Teague,FOR,31.0,5,0,21,0,6,0.0,0,3,0.0,0,3,0.0,0.0,0,0,0.0,0,2,2,0,1,0,2,2,0,2015
M. Teague,OKL,21.0,44,21,1299,241,579,0.416,19,77,0.247,222,502,0.442,0.433,151,196,0.77,21,72,93,247,45,14,134,102,652,2015
H. Thabeet,GRR,27.0,48,42,1069,162,273,0.593,0,0,0.0,162,273,0.593,0.593,89,136,0.654,80,219,299,17,20,117,90,175,413,2015
X. Thames,FOR,24.0,18,0,348,53,120,0.442,7,25,0.28,46,95,0.484,0.471,14,19,0.737,11,25,36,37,14,2,12,20,127,2015
N. Tharpe,LOS,23.0,14,6,250,30,74,0.405,7,27,0.259,23,47,0.489,0.453,7,10,0.7,2,22,24,48,7,1,33,21,74,2015
A. Thomas,BAK,27.0,38,2,512,57,148,0.385,50,134,0.373,7,14,0.5,0.554,0,0,0.0,4,50,54,20,10,4,9,42,164,2015
A. Thomas,GRR,21.0,50,50,1806,358,832,0.43,118,316,0.373,240,516,0.465,0.501,114,133,0.857,34,209,243,80,40,12,95,87,948,2015
T. Thomas,IOW,28.0,16,2,299,34,100,0.34,2,21,0.095,32,79,0.405,0.35,20,32,0.625,13,52,65,13,9,17,24,27,90,2015
M. Thompson,SAN,26.0,47,41,1416,248,541,0.458,86,233,0.369,162,308,0.526,0.538,86,133,0.647,30,131,161,99,58,32,65,101,668,2015
J. Threatt,RIO,21.0,36,13,775,152,338,0.45,11,38,0.289,141,300,0.47,0.466,148,206,0.718,43,96,139,197,49,7,69,63,463,2015
Y. Togashi,TEX,21.0,24,1,207,18,42,0.429,10,22,0.455,8,20,0.4,0.548,4,6,0.667,3,7,10,24,4,0,11,20,50,2015
D. Tucker,REN,26.0,8,7,286,101,184,0.549,33,77,0.429,68,107,0.636,0.639,42,56,0.75,24,57,81,13,13,0,11,22,277,2015
J. Turner,LOS,22.0,36,16,785,103,226,0.456,2,7,0.286,101,219,0.461,0.46,59,100,0.59,29,67,96,128,47,11,66,58,267,2015
J. Tyler,MAI,26.0,4,0,50,3,12,0.25,0,0,0.0,3,12,0.25,0.25,2,2,1.0,9,12,21,1,0,9,5,8,8,2015
M. Udofia,AUS,24.0,34,7,360,26,61,0.426,14,35,0.4,12,26,0.462,0.541,10,18,0.556,11,21,32,27,7,3,14,34,76,2015
A. Ussery,WES,23.0,3,0,18,1,3,0.333,0,0,0.0,1,3,0.333,0.333,0,0,0.0,4,1,5,2,1,2,5,3,2,2015
R. Vaden,WES,29.0,6,1,84,11,31,0.355,6,20,0.3,5,11,0.455,0.452,0,1,0.0,1,5,6,6,2,0,3,7,28,2015
R. Vaden,TOT,29.0,24,11,437,50,121,0.413,36,87,0.414,14,34,0.412,0.562,10,14,0.714,4,30,34,37,17,1,23,43,146,2015
R. Vaden,BAK,29.0,18,10,353,39,90,0.433,30,67,0.448,9,23,0.391,0.6,10,13,0.769,3,25,28,31,15,1,20,36,118,2015
J. Vandenberg,WES,24.0,9,0,69,3,10,0.3,0,0,0.0,3,10,0.3,0.3,2,2,1.0,8,12,20,4,2,2,3,10,8,2015
E. Vargas,LOS,26.0,30,15,693,113,228,0.496,1,4,0.25,112,224,0.5,0.498,35,54,0.648,59,123,182,20,19,48,23,94,262,2015
J. Varnado,LOS,26.0,8,4,185,41,76,0.539,0,0,0.0,41,76,0.539,0.539,11,17,0.647,14,38,52,9,2,16,13,28,93,2015
A. Vereen,SAN,29.0,31,1,360,86,133,0.647,0,5,0.0,86,128,0.672,0.647,31,46,0.674,20,70,90,19,5,0,24,65,203,2015
N. Vonleh,FOR,19.0,2,0,27,6,17,0.353,2,3,0.667,4,14,0.286,0.412,0,0,0.0,4,5,9,1,3,2,4,6,14,2015
H. Walker,SFL,27.0,17,8,472,88,188,0.468,52,116,0.448,36,72,0.5,0.606,29,41,0.707,7,59,66,26,17,13,15,54,257,2015
D. Walker,AUS,22.0,34,0,376,36,84,0.429,11,36,0.306,25,48,0.521,0.494,19,22,0.864,6,44,50,32,9,3,21,36,102,2015
T. Walker,REN,25.0,15,4,193,19,29,0.655,0,0,0.0,19,29,0.655,0.655,3,8,0.375,13,34,47,8,7,23,7,25,41,2015
A. Warren,REN,27.0,14,3,282,27,78,0.346,17,59,0.288,10,19,0.526,0.455,10,11,0.909,11,19,30,10,21,0,7,24,81,2015
A. Warren,TOT,27.0,29,3,453,40,126,0.317,22,88,0.25,18,38,0.474,0.405,13,16,0.813,17,34,51,23,27,2,16,45,115,2015
A. Warren,SAN,27.0,15,0,171,13,48,0.271,5,29,0.172,8,19,0.421,0.323,3,5,0.6,6,15,21,13,6,2,9,21,34,2015
J. Warren,IOW,26.0,9,0,42,3,6,0.5,0,0,0.0,3,6,0.5,0.5,0,0,0.0,4,4,8,0,2,0,1,8,6,2015
T. Warren,BAK,21.0,9,9,319,98,180,0.544,10,35,0.286,88,145,0.607,0.572,35,48,0.729,28,35,63,14,14,5,20,17,241,2015
D. Waters,GRR,28.0,2,0,34,2,7,0.286,0,0,0.0,2,7,0.286,0.286,3,4,0.75,0,6,6,5,1,0,6,3,7,2015
C. Watford,REN,23.0,6,1,111,9,27,0.333,6,19,0.316,3,8,0.375,0.444,2,2,1.0,2,19,21,11,6,2,4,5,26,2015
C. Watford,MAI,23.0,27,26,760,109,277,0.394,34,111,0.306,75,166,0.452,0.455,72,95,0.758,46,118,164,41,17,13,52,45,324,2015
C. Watford,TOT,23.0,33,27,871,118,304,0.388,40,130,0.308,78,174,0.448,0.454,74,97,0.763,48,137,185,52,23,15,56,50,350,2015
M. Watt,SAN,25.0,9,0,130,17,45,0.378,0,2,0.0,17,43,0.395,0.378,8,18,0.444,19,19,38,6,1,11,10,18,42,2015
M. Wayns,DEL,23.0,19,4,474,86,200,0.43,13,49,0.265,73,151,0.483,0.463,26,32,0.813,6,38,44,98,11,2,29,34,211,2015
D. Wear,REN,24.0,43,31,1289,264,552,0.478,117,297,0.394,147,255,0.576,0.584,56,69,0.812,77,242,319,110,36,8,66,96,701,2015
S. Weingarten,CAN,26.0,21,0,272,26,62,0.419,11,23,0.478,15,39,0.385,0.508,3,3,1.0,14,24,38,5,4,2,11,38,66,2015
D. West,TEX,31.0,4,0,101,20,60,0.333,3,5,0.6,17,55,0.309,0.358,16,22,0.727,7,12,19,15,9,2,5,13,59,2015
D. White,ERI,23.0,4,0,26,0,7,0.0,0,3,0.0,0,4,0.0,0.0,3,4,0.75,4,1,5,0,0,0,2,4,3,2015
H. Whiteside,SFL,25.0,1,1,26,10,11,0.909,0,0,0.0,10,11,0.909,0.909,1,2,0.5,2,10,12,2,0,4,4,0,21,2015
H. Whiteside,IOW,25.0,3,3,86,30,35,0.857,0,0,0.0,30,35,0.857,0.857,6,9,0.667,13,34,47,1,2,16,7,13,66,2015
H. Whiteside,TOT,25.0,4,4,112,40,46,0.87,0,0,0.0,40,46,0.87,0.87,7,11,0.636,15,44,59,3,2,20,11,13,87,2015
T. White,RIO,24.0,42,7,721,113,302,0.374,52,163,0.319,61,139,0.439,0.46,42,59,0.712,9,87,96,112,16,4,74,79,320,2015
S. Whittington,FOR,23.0,1,0,18,2,4,0.5,0,0,0.0,2,4,0.5,0.5,1,2,0.5,1,3,4,1,0,0,2,2,5,2015
N. Wiggins,IDA,23.0,28,17,669,104,245,0.424,29,95,0.305,75,150,0.5,0.484,36,52,0.692,14,43,57,26,10,3,28,28,273,2015
C. Wilcox,FOR,24.0,5,0,122,26,49,0.531,9,20,0.45,17,29,0.586,0.622,5,9,0.556,2,15,17,8,3,1,5,3,66,2015
D. Wilkins,IOW,35.0,50,42,1891,358,781,0.458,53,160,0.331,305,621,0.491,0.492,239,301,0.794,62,222,284,179,71,28,107,122,1008,2015
C. Williams,MAI,23.0,3,0,58,6,23,0.261,1,6,0.167,5,17,0.294,0.283,1,2,0.5,1,5,6,19,0,2,5,8,14,2015
C. Williams,DEL,23.0,3,0,39,3,10,0.3,3,7,0.429,0,3,0.0,0.45,2,2,1.0,2,1,3,6,1,0,5,8,11,2015
C. Williams,TOT,23.0,6,0,97,9,33,0.273,4,13,0.308,5,20,0.25,0.333,3,4,0.75,3,6,9,25,1,2,10,16,25,2015
E. Williams,SAN,25.0,29,25,1045,230,485,0.474,46,123,0.374,184,362,0.508,0.522,113,155,0.729,17,121,138,214,34,2,87,49,619,2015
J. Williams,ERI,28.0,42,14,880,124,261,0.475,7,21,0.333,117,240,0.488,0.489,58,78,0.744,76,116,192,36,22,0,39,112,313,2015
L. Williams,GRR,26.0,33,16,893,109,295,0.369,39,122,0.32,70,173,0.405,0.436,78,94,0.83,14,82,96,50,40,0,38,67,335,2015
M. Williams,SFL,23.0,39,3,599,70,204,0.343,24,68,0.353,46,136,0.338,0.402,18,31,0.581,9,47,56,90,17,3,41,42,182,2015
R. Williams,OKL,28.0,13,8,416,80,156,0.513,30,61,0.492,50,95,0.526,0.609,29,44,0.659,13,56,69,43,14,2,31,21,219,2015
R. Williams,OKL,23.0,17,0,197,26,64,0.406,7,30,0.233,19,34,0.559,0.461,10,15,0.667,2,22,24,14,7,5,9,24,69,2015
J. Wilson,BAK,24.0,40,23,1046,157,369,0.425,52,148,0.351,105,221,0.475,0.496,63,80,0.788,47,170,217,83,21,38,59,104,429,2015
A. Witter,REN,23.0,22,0,315,35,79,0.443,15,47,0.319,20,32,0.625,0.538,1,8,0.125,17,41,58,16,11,22,10,39,86,2015
N. Wolters,GRR,23.0,12,8,378,79,158,0.5,5,17,0.294,74,141,0.525,0.516,20,29,0.69,17,47,64,86,12,4,23,23,183,2015
B. Woodfox,TEX,28.0,47,1,953,165,386,0.427,74,188,0.394,91,198,0.46,0.523,55,63,0.873,12,78,90,70,41,2,44,63,459,2015
R. Woolridge,GRR,24.0,37,10,513,45,121,0.372,3,22,0.136,42,99,0.424,0.384,13,24,0.542,37,98,135,7,10,5,17,50,106,2015
C. Wright,BAK,25.0,14,9,420,62,136,0.456,11,32,0.344,51,104,0.49,0.496,46,63,0.73,11,40,51,82,23,1,40,33,181,2015
J. Wright,DEL,25.0,11,0,186,24,69,0.348,2,9,0.222,22,60,0.367,0.362,32,45,0.711,9,25,34,13,6,1,12,26,82,2015
J. Wright,TOT,25.0,48,17,1275,260,509,0.511,3,17,0.176,257,492,0.522,0.514,174,242,0.719,117,174,291,87,51,33,99,151,697,2015
J. Wright,IDA,25.0,37,17,1089,236,440,0.536,1,8,0.125,235,432,0.544,0.538,142,197,0.721,108,149,257,74,45,32,87,125,615,2015
K. Wright,AUS,25.0,46,26,1001,109,201,0.542,0,1,0.0,109,200,0.545,0.542,52,81,0.642,137,173,310,45,29,48,41,114,270,2015
S. Wright,WES,23.0,1,0,6,1,2,0.5,0,0,0.0,1,2,0.5,0.5,1,1,1.0,0,0,0,0,0,0,0,1,3,2015
B. Young,TEX,23.0,19,4,353,34,87,0.391,8,24,0.333,26,63,0.413,0.437,39,47,0.83,8,42,50,42,24,4,21,27,115,2015
J. Young,MAI,19.0,17,17,559,124,268,0.463,68,154,0.442,56,114,0.491,0.59,49,64,0.766,17,65,82,34,25,8,44,35,365,2015
T. Zanna,OKL,24.0,50,40,1386,245,408,0.6,0,0,0.0,245,408,0.6,0.6,174,244,0.713,205,345,550,41,42,17,99,172,664,2015
T. Zimmerman,IDA,23.0,41,16,816,64,198,0.323,29,111,0.261,35,87,0.402,0.396,16,22,0.727,16,66,82,86,21,1,49,93,173,2015
A. Aboya,TOT,29.0,16,0,217,12,35,0.343,0,0,0.0,12,35,0.343,0.343,20,24,0.833,21,17,38,5,6,9,10,47,44,2014
A. Aboya,REN,29.0,2,0,31,1,3,0.333,0,0,0.0,1,3,0.333,0.333,2,2,1.0,2,3,5,1,0,4,1,11,4,2014
A. Aboya,FOR,29.0,14,0,186,11,32,0.344,0,0,0.0,11,32,0.344,0.344,18,22,0.818,19,14,33,4,6,5,9,36,40,2014
A. Agudio,CAN,29.0,47,31,1226,126,302,0.417,57,152,0.375,69,150,0.46,0.512,84,103,0.816,11,92,103,112,46,0,72,82,393,2014
C. Aiken,ERI,,6,1,102,12,23,0.522,0,2,0.0,12,21,0.571,0.522,4,6,0.667,10,13,23,1,2,5,4,12,28,2014
J. Akognon,DEL,27.0,15,9,418,86,201,0.428,41,101,0.406,45,100,0.45,0.53,21,25,0.84,13,37,50,63,24,0,34,30,234,2014
J. Alexander,SAN,27.0,14,6,351,84,161,0.522,0,1,0.0,84,160,0.525,0.522,24,30,0.8,34,64,98,16,8,13,29,34,192,2014
X. Alexander,TUL,25.0,39,15,997,114,261,0.437,24,75,0.32,90,186,0.484,0.483,69,113,0.611,59,149,208,83,42,12,46,101,321,2014
C. Allen,TOT,25.0,37,0,767,153,374,0.409,76,179,0.425,77,195,0.395,0.511,54,66,0.818,15,54,69,76,17,1,53,65,436,2014
C. Allen,SFL,25.0,7,0,123,20,44,0.455,9,20,0.45,11,24,0.458,0.557,11,12,0.917,1,6,7,7,3,0,5,10,60,2014
C. Allen,IOW,25.0,30,0,644,133,330,0.403,67,159,0.421,66,171,0.386,0.505,43,54,0.796,14,48,62,69,14,1,48,55,376,2014
J. Allen,SFL,,21,2,257,42,94,0.447,10,21,0.476,32,73,0.438,0.5,28,32,0.875,9,31,40,39,10,1,26,40,122,2014
C. Allmond,MAI,,21,0,178,17,75,0.227,16,59,0.271,1,16,0.063,0.333,5,5,1.0,3,17,20,11,3,0,7,4,55,2014
L. Anderson,SPR,,36,23,1080,167,345,0.484,30,98,0.306,137,247,0.555,0.528,146,199,0.734,37,163,200,84,57,4,81,82,510,2014
M. Anderson,TOT,,31,12,627,83,244,0.34,19,89,0.213,64,155,0.413,0.379,27,43,0.628,8,69,77,108,37,3,67,72,212,2014
M. Anderson,MAI,,23,10,482,59,179,0.33,18,75,0.24,41,104,0.394,0.38,19,29,0.655,6,59,65,81,25,3,50,52,155,2014
M. Anderson,ERI,,8,2,145,24,65,0.369,1,14,0.071,23,51,0.451,0.377,8,14,0.571,2,10,12,27,12,0,17,20,57,2014
R. Anderson,CAN,,9,7,204,29,68,0.426,5,26,0.192,24,42,0.571,0.463,3,5,0.6,4,27,31,12,8,1,14,16,66,2014
R. Anderson,TUL,24.0,33,22,718,87,183,0.475,0,1,0.0,87,182,0.478,0.475,42,81,0.519,94,101,195,29,28,17,43,107,216,2014
T. Antetokounmpo,DEL,21.0,50,42,1465,214,456,0.469,55,178,0.309,159,278,0.572,0.53,118,178,0.663,83,130,213,106,58,65,116,147,601,2014
H. Armstrong,SAN,29.0,32,23,839,137,245,0.559,1,3,0.333,136,242,0.562,0.561,110,148,0.743,85,152,237,62,22,56,89,115,385,2014
J. Atkinson,TEX,23.0,39,7,624,64,125,0.512,11,30,0.367,53,95,0.558,0.556,30,50,0.6,50,113,163,38,27,3,29,78,169,2014
C. Ayer,SFL,,31,0,349,37,87,0.425,1,4,0.25,36,83,0.434,0.431,40,69,0.58,35,48,83,1,5,14,25,82,115,2014
C. Babb,MAI,23.0,33,29,1239,126,331,0.381,81,229,0.354,45,102,0.441,0.503,63,80,0.788,32,171,203,111,39,12,42,77,396,2014
M. Baker,SAN,34.0,26,4,334,32,74,0.432,2,12,0.167,30,62,0.484,0.446,14,16,0.875,16,39,55,52,17,2,20,39,80,2014
B. Baptist,BAK,,42,6,798,120,280,0.429,23,90,0.256,97,190,0.511,0.47,36,57,0.632,61,115,176,48,26,18,50,87,299,2014
R. Bartholomew,TUL,,43,25,1179,186,370,0.503,3,14,0.214,183,356,0.514,0.507,153,209,0.732,143,210,353,58,39,14,84,142,528,2014
A. Baynes,AUS,27.0,2,2,66,19,38,0.5,0,0,0.0,19,38,0.5,0.5,7,9,0.778,10,11,21,7,1,5,4,10,45,2014
K. Bazemore,SAN,24.0,2,2,65,10,34,0.294,3,19,0.158,7,15,0.467,0.338,15,17,0.882,1,7,8,7,4,2,2,6,38,2014
D. Bell-Holter,MAI,,48,16,885,156,338,0.462,19,68,0.279,137,270,0.507,0.49,81,115,0.704,78,154,232,43,8,14,76,114,412,2014
C. Bennerman,AUS,,4,0,68,4,12,0.333,2,7,0.286,2,5,0.4,0.417,3,4,0.75,0,2,2,7,2,0,3,3,13,2014
T. Biggs,TOT,,31,6,572,100,211,0.474,1,7,0.143,99,204,0.485,0.476,24,42,0.571,36,63,99,24,10,3,38,62,225,2014
T. Biggs,REN,,28,6,510,86,185,0.465,1,6,0.167,85,179,0.475,0.468,19,32,0.594,31,50,81,20,9,3,35,57,192,2014
T. Biggs,CAN,,3,0,62,14,26,0.538,0,1,0.0,14,25,0.56,0.538,5,10,0.5,5,13,18,4,1,0,3,5,33,2014
T. Bishop,RIO,24.0,42,19,1041,176,370,0.476,75,199,0.377,101,171,0.591,0.577,51,77,0.662,109,177,286,48,43,34,47,118,478,2014
V. Blue,TOT,21.0,27,14,795,145,369,0.393,35,107,0.327,110,262,0.42,0.44,129,169,0.763,22,97,119,78,36,4,63,55,454,2014
V. Blue,MAI,21.0,1,0,25,5,12,0.417,1,2,0.5,4,10,0.4,0.458,2,4,0.5,1,1,2,4,0,0,5,0,13,2014
V. Blue,IDA,21.0,10,1,233,49,125,0.392,9,36,0.25,40,89,0.449,0.428,37,45,0.822,10,22,32,12,14,2,16,17,144,2014
V. Blue,DEL,21.0,16,13,537,91,232,0.392,25,69,0.362,66,163,0.405,0.446,90,120,0.75,11,74,85,62,22,2,42,38,297,2014
J. Boone,IOW,29.0,7,0,76,15,24,0.625,0,0,0.0,15,24,0.625,0.625,6,15,0.4,18,12,30,1,3,3,3,13,36,2014
D. Bost,IDA,,50,50,2027,262,724,0.362,110,376,0.293,152,348,0.437,0.438,124,171,0.725,57,246,303,418,104,12,162,147,758,2014
M. Bouldin,TOT,26.0,46,31,1417,213,497,0.429,77,218,0.353,136,279,0.487,0.506,87,114,0.763,30,159,189,165,55,7,117,90,590,2014
M. Bouldin,LOS,26.0,5,0,81,7,33,0.212,5,19,0.263,2,14,0.143,0.288,1,4,0.25,2,9,11,10,3,1,6,6,20,2014
M. Bouldin,FOR,26.0,18,13,556,87,198,0.439,28,75,0.373,59,123,0.48,0.51,31,47,0.66,10,61,71,67,16,3,52,32,233,2014
M. Bouldin,DEL,26.0,23,18,780,119,266,0.447,44,124,0.355,75,142,0.528,0.53,55,63,0.873,18,89,107,88,36,3,59,52,337,2014
B. Bowdry,ERI,,3,0,48,5,13,0.385,1,5,0.2,4,8,0.5,0.423,10,14,0.714,2,9,11,6,1,1,2,4,21,2014
M. Brooks,TOT,25.0,7,7,223,65,138,0.471,9,26,0.346,56,112,0.5,0.504,22,28,0.786,8,26,34,27,9,5,19,21,161,2014
M. Brooks,SAN,25.0,2,2,48,10,23,0.435,0,2,0.0,10,21,0.476,0.435,4,5,0.8,0,4,4,5,2,0,4,6,24,2014
M. Brooks,MAI,25.0,5,5,175,55,115,0.478,9,24,0.375,46,91,0.505,0.517,18,23,0.783,8,22,30,22,7,5,15,15,137,2014
G. Brown,CAN,,40,33,1183,168,339,0.496,43,119,0.361,125,220,0.568,0.559,113,147,0.769,31,112,143,103,43,15,67,102,492,2014
J. Brownlee,ERI,,46,33,1255,241,475,0.507,66,176,0.375,175,299,0.585,0.577,89,124,0.718,41,223,264,108,66,21,66,98,637,2014
L. Brown,DEL,23.0,12,12,420,89,190,0.468,20,47,0.426,69,143,0.483,0.521,41,51,0.804,10,53,63,83,20,2,40,32,239,2014
L. Brown,TOT,23.0,20,14,622,129,282,0.457,24,66,0.364,105,216,0.486,0.5,64,78,0.821,25,64,89,125,28,7,59,47,346,2014
L. Brown,SPR,23.0,8,2,202,40,92,0.435,4,19,0.211,36,73,0.493,0.457,23,27,0.852,15,11,26,42,8,5,19,15,107,2014
S. Brown,MAI,22.0,30,4,675,82,181,0.453,31,89,0.348,51,92,0.554,0.539,22,33,0.667,34,118,152,37,21,8,23,57,217,2014
T. Brown,MAI,,26,4,559,67,171,0.392,42,112,0.375,25,59,0.424,0.515,27,35,0.771,7,34,41,52,23,4,48,38,203,2014
R. Buckner,IOW,,4,0,49,8,12,0.667,0,0,0.0,8,12,0.667,0.667,2,3,0.667,9,16,25,3,1,2,2,10,18,2014
W. Buford,TOT,24.0,42,2,923,144,353,0.408,31,90,0.344,113,263,0.43,0.452,48,65,0.738,28,113,141,60,24,3,44,88,367,2014
W. Buford,SAN,24.0,32,1,708,114,278,0.41,24,72,0.333,90,206,0.437,0.453,40,53,0.755,23,83,106,45,21,3,38,68,292,2014
W. Buford,CAN,24.0,10,1,215,30,75,0.4,7,18,0.389,23,57,0.404,0.447,8,12,0.667,5,30,35,15,3,0,6,20,75,2014
B. Butch,TOT,,34,24,971,134,303,0.442,45,128,0.352,89,175,0.509,0.517,57,92,0.62,66,197,263,54,21,25,60,91,370,2014
B. Butch,FOR,,8,0,171,23,56,0.411,10,31,0.323,13,25,0.52,0.5,7,9,0.778,10,23,33,11,5,7,6,23,63,2014
B. Butch,BAK,,26,24,800,111,247,0.449,35,97,0.361,76,150,0.507,0.52,50,83,0.602,56,174,230,43,16,18,54,68,307,2014
D. Buycks,BAK,24.0,8,2,230,49,102,0.48,9,31,0.29,40,71,0.563,0.525,16,21,0.762,7,16,23,28,14,0,34,10,123,2014
D. Byars,BAK,29.0,15,12,440,68,140,0.486,25,60,0.417,43,80,0.538,0.575,12,24,0.5,20,47,67,27,13,0,14,24,173,2014
I. Canaan,RIO,22.0,18,17,613,124,284,0.437,58,157,0.369,66,127,0.52,0.539,86,106,0.811,18,54,72,147,13,3,54,39,392,2014
D. Caracter,IDA,25.0,26,11,592,130,244,0.533,0,0,0.0,130,244,0.533,0.533,52,73,0.712,67,112,179,30,16,16,55,84,312,2014
J. Carmichael,IOW,,37,28,854,132,263,0.502,0,1,0.0,132,262,0.504,0.502,89,127,0.701,71,160,231,30,32,52,52,103,353,2014
A. Carr,DEL,,10,0,140,35,88,0.398,9,23,0.391,26,65,0.4,0.449,28,41,0.683,1,8,9,19,12,0,21,21,107,2014
M. Charlo,REN,30.0,45,40,1434,213,446,0.478,23,75,0.307,190,371,0.512,0.503,121,150,0.807,85,265,350,105,58,45,98,115,570,2014
W. Cherry,CAN,,18,12,546,80,179,0.447,20,60,0.333,60,119,0.504,0.503,29,41,0.707,5,61,66,81,25,4,34,47,209,2014
P. Christopher,IOW,25.0,50,47,1668,241,454,0.531,79,177,0.446,162,277,0.585,0.618,117,132,0.886,48,152,200,109,47,3,82,110,678,2014
I. Clark,BAK,22.0,8,8,257,39,95,0.411,11,32,0.344,28,63,0.444,0.468,10,15,0.667,2,24,26,42,13,1,15,20,99,2014
B. Costner,LOS,,43,28,1147,202,477,0.423,75,219,0.342,127,258,0.492,0.502,146,192,0.76,46,214,260,94,35,28,84,126,625,2014
N. Covington,ERI,28.0,8,3,193,21,72,0.292,8,35,0.229,13,37,0.351,0.347,12,15,0.8,6,22,28,25,7,0,17,22,62,2014
R. Covington,RIO,23.0,42,41,1434,335,762,0.44,133,359,0.37,202,403,0.501,0.527,172,204,0.843,116,269,385,72,101,57,105,143,975,2014
J. Cowan,AUS,,48,12,818,123,233,0.528,1,8,0.125,122,225,0.542,0.53,39,57,0.684,96,151,247,30,18,16,56,66,286,2014
A. Crabbe,IDA,21.0,6,6,231,39,95,0.411,12,38,0.316,27,57,0.474,0.474,6,8,0.75,10,30,40,7,6,5,8,17,96,2014
J. Crowder,TEX,23.0,2,2,87,18,41,0.439,1,7,0.143,17,34,0.5,0.451,8,12,0.667,13,19,32,20,7,4,12,3,45,2014
M. Cummings,BAK,25.0,28,0,341,61,133,0.459,14,51,0.275,47,82,0.573,0.511,38,49,0.776,15,31,46,14,14,2,26,41,174,2014
J. Cunningham,BAK,22.0,22,19,685,106,269,0.394,34,103,0.33,72,166,0.434,0.457,118,147,0.803,22,54,76,109,29,3,84,50,364,2014
J. Curry,TOT,28.0,24,12,630,64,168,0.381,19,64,0.297,45,104,0.433,0.438,21,30,0.7,10,56,66,100,18,3,52,50,168,2014
J. Curry,SPR,28.0,10,7,273,30,83,0.361,4,25,0.16,26,58,0.448,0.386,9,14,0.643,5,23,28,37,6,2,22,23,73,2014
J. Curry,BAK,28.0,14,5,357,34,85,0.4,15,39,0.385,19,46,0.413,0.488,12,16,0.75,5,33,38,63,12,1,30,27,95,2014
S. Curry,SAN,23.0,38,37,1320,269,616,0.437,99,266,0.372,170,350,0.486,0.517,110,129,0.853,16,101,117,221,55,6,108,70,747,2014
A. Czyz,TOT,,37,12,861,154,319,0.483,16,48,0.333,138,271,0.509,0.508,92,140,0.657,90,153,243,37,36,16,65,82,416,2014
A. Czyz,FOR,,12,9,268,45,112,0.402,3,11,0.273,42,101,0.416,0.415,24,38,0.632,26,34,60,15,11,5,21,26,117,2014
A. Czyz,CAN,,25,3,593,109,207,0.527,13,37,0.351,96,170,0.565,0.558,68,102,0.667,64,119,183,22,25,11,44,56,299,2014
T. Daniels,RIO,22.0,48,37,1697,323,766,0.422,240,599,0.401,83,167,0.497,0.578,146,179,0.816,46,174,220,89,53,8,94,138,1032,2014
A. Davis,SFL,26.0,47,22,1093,169,362,0.467,44,139,0.317,125,223,0.561,0.528,90,118,0.763,53,128,181,50,43,10,83,91,472,2014
B. Davis,REN,,50,8,1006,169,342,0.494,0,3,0.0,169,339,0.499,0.494,139,206,0.675,134,171,305,57,42,27,113,162,477,2014
R. Davis,ERI,34.0,40,31,1203,192,425,0.452,46,115,0.4,146,310,0.471,0.506,93,110,0.845,23,161,184,97,35,14,76,103,523,2014
E. Dawson,AUS,29.0,21,18,658,118,242,0.488,5,16,0.313,113,226,0.5,0.498,54,75,0.72,73,133,206,42,26,28,44,53,295,2014
A. Daye,AUS,25.0,1,1,40,7,17,0.412,1,4,0.25,6,13,0.462,0.441,12,13,0.923,2,11,13,3,0,2,4,5,27,2014
N. De Colo,AUS,26.0,8,8,298,67,128,0.523,12,41,0.293,55,87,0.632,0.57,40,44,0.909,10,39,49,47,22,2,33,26,186,2014
D. Dedmon,SAN,24.0,15,15,505,102,189,0.54,0,1,0.0,102,188,0.543,0.54,24,35,0.686,66,137,203,19,23,35,31,69,228,2014
J. Demercy,BAK,,5,0,34,1,5,0.2,0,2,0.0,1,3,0.333,0.2,0,2,0.0,3,5,8,2,3,2,3,2,2,2014
I. Diogu,BAK,,42,33,1310,297,537,0.553,29,87,0.333,268,450,0.596,0.58,158,193,0.819,124,287,411,61,19,38,109,125,781,2014
Q. Douby,SFL,29.0,2,2,69,12,29,0.414,4,10,0.4,8,19,0.421,0.483,13,15,0.867,1,1,2,5,9,2,3,3,41,2014
C. Douglas-Roberts,TEX,27.0,7,7,237,42,88,0.477,11,22,0.5,31,66,0.47,0.54,37,43,0.86,7,26,33,20,8,4,20,16,132,2014
M. Downs,ERI,,25,21,833,147,331,0.444,62,171,0.363,85,160,0.531,0.538,39,45,0.867,16,91,107,85,29,20,48,67,395,2014
L. Drew,SFL,23.0,41,36,1458,170,359,0.474,53,129,0.411,117,230,0.509,0.547,73,103,0.709,23,118,141,287,68,3,105,91,466,2014
R. Dyer,TEX,,17,1,166,16,41,0.39,2,6,0.333,14,35,0.4,0.415,4,8,0.5,25,30,55,6,4,5,5,20,38,2014
D. Ebanks,TOT,24.0,45,38,1647,375,821,0.457,97,288,0.337,278,533,0.522,0.516,189,233,0.811,92,257,349,104,54,27,92,95,1036,2014
D. Ebanks,TEX,24.0,33,30,1237,284,636,0.447,70,227,0.308,214,409,0.523,0.502,156,193,0.808,80,215,295,81,44,26,68,71,794,2014
D. Ebanks,SPR,24.0,12,8,410,91,185,0.492,27,61,0.443,64,124,0.516,0.565,33,40,0.825,12,42,54,23,10,1,24,24,242,2014
S. Edwards,CAN,,46,38,1329,268,486,0.551,4,14,0.286,264,472,0.559,0.556,112,162,0.691,91,157,248,61,45,18,93,139,652,2014
M. Ehambe,IOW,,50,32,1369,251,564,0.445,169,399,0.424,82,165,0.497,0.595,71,86,0.826,10,173,183,45,37,4,52,76,742,2014
A. Ellis,RIO,,32,10,634,72,186,0.387,48,135,0.356,24,51,0.471,0.516,24,39,0.615,26,68,94,31,13,2,22,57,216,2014
J. Ellis,IDA,,46,13,863,75,155,0.484,0,4,0.0,75,151,0.497,0.484,30,38,0.789,115,125,240,48,32,9,35,111,180,2014
M. Ely,TEX,35.0,41,39,1183,252,416,0.606,0,0,0.0,252,416,0.606,0.606,145,192,0.755,75,150,225,52,30,56,79,115,649,2014
C. Emory,IOW,,5,0,18,2,9,0.222,0,4,0.0,2,5,0.4,0.222,2,2,1.0,1,2,3,1,2,0,3,5,6,2014
M. Eric,TEX,25.0,6,0,118,23,40,0.575,0,0,0.0,23,40,0.575,0.575,6,10,0.6,11,21,32,2,3,12,12,11,52,2014
R. Evans,SFL,,33,17,712,108,282,0.383,25,91,0.275,83,191,0.435,0.427,40,78,0.513,48,97,145,34,24,20,44,78,281,2014
V. Faverani,MAI,25.0,4,4,129,27,50,0.54,7,13,0.538,20,37,0.541,0.61,15,19,0.789,9,35,44,12,2,5,15,16,76,2014
C. Felix,CAN,23.0,9,9,259,34,74,0.459,7,21,0.333,27,53,0.509,0.507,24,37,0.649,7,40,47,18,13,3,24,27,99,2014
C. Fells,AUS,27.0,47,41,1680,335,706,0.475,99,263,0.376,236,443,0.533,0.545,79,100,0.79,40,185,225,140,81,42,107,93,848,2014
K. Fesenko,TOT,27.0,25,13,533,86,145,0.593,0,0,0.0,86,145,0.593,0.593,56,89,0.629,57,99,156,40,10,32,54,67,228,2014
K. Fesenko,DEL,27.0,16,5,282,45,72,0.625,0,0,0.0,45,72,0.625,0.625,26,43,0.605,30,48,78,16,9,22,33,44,116,2014
K. Fesenko,CAN,27.0,9,8,251,41,73,0.562,0,0,0.0,41,73,0.562,0.562,30,46,0.652,27,51,78,24,1,10,21,23,112,2014
J. Foote,SPR,26.0,50,34,1440,188,383,0.491,0,2,0.0,188,381,0.493,0.491,76,150,0.507,149,256,405,74,53,67,97,138,452,2014
G. Forbes,SPR,28.0,11,10,370,72,161,0.447,14,40,0.35,58,121,0.479,0.491,37,46,0.804,7,48,55,23,17,3,35,31,195,2014
K. Foster,REN,,15,0,127,16,42,0.381,4,13,0.308,12,29,0.414,0.429,9,14,0.643,13,18,31,7,6,5,14,25,45,2014
J. Franklin,FOR,22.0,16,0,450,74,171,0.433,24,65,0.369,50,106,0.472,0.503,81,92,0.88,21,69,90,69,28,3,47,38,253,2014
A. Freeman,IOW,,41,1,779,158,343,0.461,63,169,0.373,95,174,0.546,0.552,60,78,0.769,10,80,90,97,24,7,54,56,439,2014
W. Frisby,FOR,32.0,48,30,854,152,315,0.483,2,4,0.5,150,311,0.482,0.486,50,63,0.794,85,118,203,66,24,24,65,155,356,2014
A. Gaddy,MAI,,46,32,1251,160,327,0.489,47,112,0.42,113,215,0.526,0.561,49,85,0.576,48,99,147,231,37,9,106,125,416,2014
F. Gaines,MAI,23.0,48,34,1699,352,759,0.464,114,287,0.397,238,472,0.504,0.539,258,341,0.757,34,142,176,74,65,11,125,142,1076,2014
S. Gaines,REN,27.0,18,15,520,97,211,0.46,30,69,0.435,67,142,0.472,0.531,54,70,0.771,21,67,88,95,28,1,33,27,278,2014
T. Gallon,DEL,23.0,34,26,939,262,466,0.562,6,38,0.158,256,428,0.598,0.569,113,162,0.698,98,213,311,53,24,29,105,103,643,2014
G. Gamble,LOS,23.0,20,0,191,41,75,0.547,16,37,0.432,25,38,0.658,0.653,6,7,0.857,5,22,27,11,11,1,11,38,104,2014
G. Gantt,AUS,22.0,13,1,289,38,92,0.413,23,66,0.348,15,26,0.577,0.538,11,14,0.786,2,25,27,14,6,1,3,24,110,2014
K. Gardner,SAN,20.0,35,0,479,92,204,0.451,12,44,0.273,80,160,0.5,0.48,43,58,0.741,27,38,65,102,46,2,64,61,239,2014
A. Gilchrist,IOW,,46,0,792,137,245,0.559,1,12,0.083,136,233,0.584,0.561,102,154,0.662,76,144,220,14,14,56,55,116,377,2014
M. Gladness,REN,27.0,38,37,906,130,224,0.58,0,0,0.0,130,224,0.58,0.58,54,95,0.568,77,164,241,21,15,75,55,92,314,2014
R. Gobert,BAK,21.0,8,8,216,40,54,0.741,0,0,0.0,40,54,0.741,0.741,31,44,0.705,36,55,91,3,5,24,11,18,111,2014
A. Goodwin,BAK,19.0,5,2,177,44,89,0.494,10,26,0.385,34,63,0.54,0.551,34,42,0.81,8,18,26,6,7,0,21,17,132,2014
L. Goulbourne,SAN,,14,6,361,66,140,0.471,0,11,0.0,66,129,0.512,0.471,44,58,0.759,35,78,113,22,9,3,24,24,176,2014
J. Gutierrez,CAN,25.0,35,35,1146,164,356,0.461,9,24,0.375,155,332,0.467,0.473,151,197,0.766,34,166,200,243,43,9,96,126,488,2014
J. Hagins,RIO,,16,7,249,32,54,0.593,0,0,0.0,32,54,0.593,0.593,10,13,0.769,22,34,56,3,9,17,26,45,74,2014
P. Hairston,TEX,21.0,26,15,839,183,404,0.453,73,204,0.358,110,200,0.55,0.543,127,146,0.87,32,58,90,21,39,10,46,71,566,2014
J. Hamilton,SFL,23.0,39,39,1389,283,576,0.491,31,82,0.378,252,494,0.51,0.518,153,191,0.801,135,227,362,57,34,79,90,82,750,2014
R. Hamilton,IDA,,6,0,80,8,31,0.258,1,14,0.071,7,17,0.412,0.274,21,25,0.84,4,4,8,8,6,1,10,12,38,2014
S. Hannah,SAN,28.0,1,0,26,3,14,0.214,1,5,0.2,2,9,0.222,0.25,0,0,0.0,0,2,2,6,1,0,2,4,7,2014
A. Harris,CAN,28.0,3,0,16,2,5,0.4,0,1,0.0,2,4,0.5,0.4,2,3,0.667,0,2,2,1,0,0,4,3,6,2014
A. Harris,BAK,28.0,3,0,17,1,4,0.25,0,0,0.0,1,4,0.25,0.25,1,1,1.0,1,0,1,4,1,0,2,2,3,2014
A. Harris,TOT,28.0,14,0,195,28,63,0.444,2,6,0.333,26,57,0.456,0.46,11,19,0.579,5,16,21,32,7,0,31,25,69,2014
A. Harris,FOR,28.0,8,0,162,25,54,0.463,2,5,0.4,23,49,0.469,0.481,8,15,0.533,4,14,18,27,6,0,25,20,60,2014
E. Harris,LOS,24.0,1,1,28,6,10,0.6,0,1,0.0,6,9,0.667,0.6,6,7,0.857,1,1,2,2,0,1,2,6,18,2014
M. Harris,LOS,24.0,22,22,852,234,496,0.472,39,129,0.302,195,367,0.531,0.511,189,214,0.883,45,128,173,83,45,5,71,36,696,2014
R. Harris,FOR,25.0,40,0,678,81,209,0.388,59,154,0.383,22,55,0.4,0.529,26,47,0.553,29,101,130,33,30,14,26,49,247,2014
T. Harris,TOT,26.0,49,48,1514,197,462,0.426,81,214,0.379,116,248,0.468,0.514,113,148,0.764,53,177,230,110,69,20,106,170,588,2014
T. Harris,TEX,26.0,31,30,899,106,265,0.4,44,121,0.364,62,144,0.431,0.483,82,106,0.774,40,118,158,68,42,15,67,103,338,2014
T. Harris,BAK,26.0,18,18,615,91,197,0.462,37,93,0.398,54,104,0.519,0.556,31,42,0.738,13,59,72,42,27,5,39,67,250,2014
R. Hearn,IDA,22.0,41,36,1136,124,325,0.382,47,161,0.292,77,164,0.47,0.454,59,85,0.694,33,148,181,39,36,12,59,114,354,2014
B. Heath,REN,,32,23,968,142,336,0.423,42,110,0.382,100,226,0.442,0.485,69,100,0.69,24,90,114,183,51,3,92,69,395,2014
E. Henderson,IOW,,2,0,6,0,0,0.0,0,0,0.0,0,0,0.0,0.0,0,0,0.0,1,1,2,0,0,0,2,1,0,2014
J. Henriquez,RIO,,29,3,262,35,88,0.398,0,9,0.0,35,79,0.443,0.398,18,37,0.486,30,41,71,13,5,25,25,51,88,2014
T. Henry,FOR,,4,0,79,11,29,0.379,1,6,0.167,10,23,0.435,0.397,0,0,0.0,2,9,11,5,5,3,3,3,23,2014
X. Henry,LOS,22.0,2,2,49,13,34,0.382,2,10,0.2,11,24,0.458,0.412,6,9,0.667,1,3,4,3,7,0,3,2,34,2014
S. Hill,FOR,22.0,2,2,59,12,26,0.462,5,13,0.385,7,13,0.538,0.558,5,6,0.833,1,6,7,6,2,2,8,6,34,2014
R. Hite,CAN,30.0,25,2,576,63,165,0.382,25,77,0.325,38,88,0.432,0.458,28,38,0.737,19,60,79,33,22,7,25,72,179,2014
A. Hood,IDA,30.0,17,0,193,19,54,0.352,8,27,0.296,11,27,0.407,0.426,7,11,0.636,10,21,31,9,9,2,10,15,53,2014
D. Horner,SPR,25.0,29,29,915,160,333,0.48,18,58,0.31,142,275,0.516,0.508,97,120,0.808,50,128,178,31,19,20,49,64,435,2014
D. Horner,BAK,25.0,18,18,574,77,162,0.475,16,41,0.39,61,121,0.504,0.525,56,79,0.709,44,100,144,28,12,9,27,41,226,2014
D. Horner,TOT,25.0,47,47,1489,237,495,0.479,34,99,0.343,203,396,0.513,0.513,153,199,0.769,94,228,322,59,31,29,76,105,661,2014
J. Howard,AUS,,24,21,708,140,319,0.439,23,83,0.277,117,236,0.496,0.475,50,59,0.847,35,105,140,32,27,16,32,69,353,2014
R. Howard,FOR,,49,49,1690,343,725,0.473,7,25,0.28,336,700,0.48,0.478,312,374,0.834,43,169,212,210,78,2,132,142,1005,2014
R. Howell,IDA,23.0,20,20,692,160,283,0.565,0,3,0.0,160,280,0.571,0.565,40,65,0.615,84,127,211,52,27,14,50,57,360,2014
M. Hubbard,TOT,,42,12,879,150,319,0.47,20,68,0.294,130,251,0.518,0.502,46,71,0.648,71,196,267,47,25,33,63,106,366,2014
M. Hubbard,TEX,,31,11,648,107,224,0.478,9,42,0.214,98,182,0.538,0.498,37,55,0.673,56,148,204,39,18,22,44,86,260,2014
M. Hubbard,SPR,,11,1,231,43,95,0.453,11,26,0.423,32,69,0.464,0.511,9,16,0.563,15,48,63,8,7,11,19,20,106,2014
D. Hunt,RIO,,41,19,872,139,267,0.521,0,0,0.0,139,267,0.521,0.521,48,88,0.545,135,152,287,30,19,42,49,120,326,2014
C. Hunter,FOR,29.0,4,4,69,16,31,0.516,0,0,0.0,16,31,0.516,0.516,3,3,1.0,5,13,18,1,0,3,7,7,35,2014
K. Hunt,AUS,,10,1,111,15,36,0.417,0,0,0.0,15,36,0.417,0.417,8,13,0.615,11,12,23,5,5,2,9,16,38,2014
L. Hurdle,SPR,,29,7,444,51,152,0.336,24,72,0.333,27,80,0.338,0.414,11,15,0.733,5,28,33,36,19,3,18,32,137,2014
T. Hyman,LOS,26.0,42,20,794,126,245,0.514,0,0,0.0,126,245,0.514,0.514,44,90,0.489,117,152,269,35,46,83,50,132,296,2014
A. Ingram,LOS,28.0,45,11,1033,140,309,0.453,72,161,0.447,68,148,0.459,0.57,59,75,0.787,39,103,142,77,49,5,36,70,411,2014
J. Inman,DEL,26.0,16,14,417,60,125,0.48,5,13,0.385,55,112,0.491,0.5,28,46,0.609,29,71,100,18,9,12,23,40,153,2014
L. Jackson,ERI,24.0,36,22,1196,178,361,0.493,5,19,0.263,173,342,0.506,0.5,62,87,0.713,16,145,161,322,39,1,108,87,423,2014
P. Jackson,IDA,22.0,31,27,1286,315,701,0.449,91,261,0.349,224,440,0.509,0.514,182,247,0.737,19,93,112,193,60,4,124,83,903,2014
B. James,TEX,28.0,1,1,37,18,20,0.9,0,0,0.0,18,20,0.9,0.9,2,6,0.333,10,8,18,1,2,4,2,2,38,2014
D. James,TOT,26.0,41,31,1348,253,550,0.46,34,108,0.315,219,442,0.495,0.491,131,189,0.693,87,253,340,85,37,41,131,120,671,2014
D. James,TEX,26.0,14,14,508,108,233,0.464,20,45,0.444,88,188,0.468,0.506,60,83,0.723,42,116,158,37,13,11,44,47,296,2014
D. James,BAK,26.0,27,17,840,145,317,0.457,14,63,0.222,131,254,0.516,0.479,71,106,0.67,45,137,182,48,24,30,87,73,375,2014
R. James,REN,24.0,47,3,781,129,302,0.427,20,79,0.253,109,223,0.489,0.46,78,105,0.743,31,75,106,79,18,3,52,54,356,2014
S. Jardine,TUL,,23,1,448,78,189,0.413,7,24,0.292,71,165,0.43,0.431,17,31,0.548,11,43,54,104,21,1,53,42,180,2014
O. Jeffers,IOW,28.0,44,44,1658,327,666,0.491,26,89,0.292,301,577,0.522,0.511,240,329,0.729,120,315,435,160,95,8,152,116,920,2014
J. Jenkins,BAK,22.0,4,4,145,28,67,0.418,6,27,0.222,22,40,0.55,0.463,24,30,0.8,3,22,25,14,8,2,10,6,86,2014
T. Jennings,ERI,25.0,45,14,997,190,341,0.557,1,5,0.2,189,336,0.563,0.559,50,96,0.521,86,178,264,49,28,65,63,155,431,2014
G. Jerrett,TUL,20.0,27,25,790,147,341,0.431,48,132,0.364,99,209,0.474,0.501,67,82,0.817,36,129,165,20,17,21,35,73,409,2014
A. Johnson,BAK,,18,2,318,34,76,0.447,11,29,0.379,23,47,0.489,0.52,26,38,0.684,7,12,19,67,19,0,39,42,105,2014
C. Johnson,AUS,31.0,19,0,300,37,86,0.43,10,32,0.313,27,54,0.5,0.488,15,17,0.882,7,30,37,47,21,1,15,16,99,2014
C. Johnson,RIO,23.0,20,20,744,132,281,0.47,54,147,0.367,78,134,0.582,0.566,69,82,0.841,51,84,135,49,32,20,34,45,387,2014
D. Johnson-Odom,SPR,24.0,27,26,970,205,453,0.453,42,118,0.356,163,335,0.487,0.499,141,173,0.815,18,102,120,164,38,5,100,73,593,2014
J. Johnson,RIO,26.0,10,10,299,69,139,0.496,13,45,0.289,56,94,0.596,0.543,34,44,0.773,26,65,91,48,19,34,40,36,185,2014
J. Johnson,SPR,25.0,29,9,621,106,240,0.442,12,37,0.324,94,203,0.463,0.467,55,68,0.809,16,64,80,57,13,2,40,60,279,2014
O. Johnson,FOR,24.0,3,3,86,16,48,0.333,5,15,0.333,11,33,0.333,0.385,4,7,0.571,4,16,20,5,3,3,5,7,41,2014
R. Johnson,DEL,,7,5,131,14,33,0.424,0,0,0.0,14,33,0.424,0.424,9,12,0.75,10,21,31,3,3,3,10,25,37,2014
Z. Johnson,CAN,,2,0,35,4,8,0.5,1,4,0.25,3,4,0.75,0.563,1,1,1.0,0,3,3,1,1,0,2,5,10,2014
A. Jones,ERI,,7,3,125,15,42,0.357,2,7,0.286,13,35,0.371,0.381,15,21,0.714,4,16,20,11,4,1,5,12,47,2014
C. Jones,SAN,24.0,49,41,1750,343,746,0.46,63,158,0.399,280,588,0.476,0.502,204,240,0.85,49,151,200,166,64,4,125,140,953,2014
D. Jones,REN,,49,38,1464,242,474,0.511,43,106,0.406,199,368,0.541,0.556,142,201,0.706,67,168,235,81,64,33,121,128,669,2014
K. Jones,CAN,24.0,38,37,1159,275,545,0.505,1,6,0.167,274,539,0.508,0.506,91,121,0.752,118,186,304,28,27,11,50,99,642,2014
S. Jones,ERI,,17,16,413,64,127,0.504,1,2,0.5,63,125,0.504,0.508,23,30,0.767,35,69,104,23,10,25,27,64,152,2014
C. Kabongo,IDA,,8,3,184,32,67,0.478,4,12,0.333,28,55,0.509,0.507,14,25,0.56,5,28,33,15,3,1,21,20,82,2014
M. Kabongo,AUS,22.0,45,37,1357,143,312,0.458,22,58,0.379,121,254,0.476,0.494,105,147,0.714,34,142,176,211,51,2,90,77,413,2014
K. Kadji,RIO,,19,2,274,41,109,0.376,12,53,0.226,29,56,0.518,0.431,29,39,0.744,18,51,69,13,8,14,24,35,123,2014
S. Karasev,CAN,20.0,18,18,539,80,177,0.452,37,89,0.416,43,88,0.489,0.556,46,55,0.836,12,78,90,44,18,5,31,46,243,2014
T. Kelley,SFL,29.0,34,34,1313,233,497,0.469,81,188,0.431,152,309,0.492,0.55,112,134,0.836,12,99,111,173,46,5,74,55,659,2014
T. Kelley,AUS,29.0,10,8,342,51,111,0.459,15,31,0.484,36,80,0.45,0.527,25,31,0.806,3,25,28,51,14,2,23,22,142,2014
T. Kelley,TOT,29.0,44,42,1655,284,608,0.467,96,219,0.438,188,389,0.483,0.546,137,165,0.83,15,124,139,224,60,7,97,77,801,2014
R. Kelly,LOS,22.0,5,5,199,39,93,0.419,5,20,0.25,34,73,0.466,0.446,43,47,0.915,14,24,38,19,8,7,15,17,126,2014
M. Koshwal,BAK,26.0,49,16,960,153,287,0.533,0,0,0.0,153,287,0.533,0.533,48,103,0.466,125,178,303,60,40,17,81,98,354,2014
K. Kotzur,SAN,,37,12,699,122,205,0.595,0,1,0.0,122,204,0.598,0.595,29,47,0.617,84,124,208,28,9,13,28,50,273,2014
J. Kreft,TUL,,40,8,447,50,103,0.485,0,0,0.0,50,103,0.485,0.485,37,44,0.841,42,70,112,14,11,23,44,78,137,2014
O. Kuzmic,SAN,23.0,28,19,718,78,157,0.497,0,0,0.0,78,157,0.497,0.497,33,55,0.6,123,205,328,24,24,45,39,93,189,2014
M. Landry,REN,28.0,1,0,19,4,9,0.444,2,5,0.4,2,4,0.5,0.556,1,2,0.5,0,3,3,0,0,0,0,3,11,2014
S. Larkin,TEX,21.0,4,3,143,22,47,0.468,8,14,0.571,14,33,0.424,0.553,9,11,0.818,2,19,21,33,8,0,14,9,61,2014
R. Larry,REN,,4,0,97,9,24,0.375,0,0,0.0,9,24,0.375,0.375,7,9,0.778,12,13,25,1,2,2,7,10,25,2014
D. Lathan,RIO,,3,0,8,1,5,0.2,0,2,0.0,1,3,0.333,0.2,0,0,0.0,2,1,3,3,1,0,1,1,2,2014
D. Lauderdale,IDA,25.0,39,38,1142,135,200,0.675,0,0,0.0,135,200,0.675,0.675,23,44,0.523,100,240,340,24,15,119,38,121,293,2014
D. Lazare,IDA,,15,2,329,49,107,0.458,0,0,0.0,49,107,0.458,0.458,24,32,0.75,26,39,65,8,10,3,19,32,122,2014
D. Lazare,FOR,,20,8,389,51,122,0.418,0,2,0.0,51,120,0.425,0.418,15,24,0.625,20,52,72,18,15,6,23,29,117,2014
D. Lazare,TOT,,35,10,718,100,229,0.437,0,2,0.0,100,227,0.441,0.437,39,56,0.696,46,91,137,26,25,9,42,61,239,2014
R. Ledo,TEX,21.0,39,26,1156,197,469,0.42,44,134,0.328,153,335,0.457,0.467,80,112,0.714,64,168,232,114,37,7,85,87,518,2014
M. Lee,DEL,,22,0,388,65,142,0.458,14,43,0.326,51,99,0.515,0.507,5,9,0.556,20,45,65,19,12,8,26,21,149,2014
M. Lee,CAN,,23,0,364,46,97,0.474,1,14,0.071,45,83,0.542,0.479,25,35,0.714,21,49,70,15,11,9,19,34,118,2014
M. Lee,TOT,,45,0,752,111,239,0.464,15,57,0.263,96,182,0.527,0.496,30,44,0.682,41,94,135,34,23,17,45,55,267,2014
C. Leslie,TOT,22.0,44,12,1039,198,424,0.467,8,48,0.167,190,376,0.505,0.476,129,197,0.655,70,183,253,53,38,33,89,82,533,2014
C. Leslie,IDA,22.0,10,3,186,30,67,0.448,1,7,0.143,29,60,0.483,0.455,19,24,0.792,14,39,53,8,5,5,12,14,80,2014
C. Leslie,ERI,22.0,34,9,853,168,357,0.471,7,41,0.171,161,316,0.509,0.48,110,173,0.636,56,144,200,45,33,28,77,68,453,2014
B. Lewis,FOR,26.0,11,3,202,30,74,0.405,17,44,0.386,13,30,0.433,0.52,4,9,0.444,4,13,17,15,7,2,10,8,81,2014
D. Liggins,SFL,25.0,42,41,1674,195,500,0.39,78,239,0.326,117,261,0.448,0.468,130,166,0.783,36,263,299,201,109,27,129,152,598,2014
M. Little,TUL,26.0,50,47,1811,331,794,0.417,138,377,0.366,193,417,0.463,0.504,141,166,0.849,47,161,208,132,57,8,130,165,941,2014
T. Lockett,REN,,46,43,1296,195,405,0.481,47,111,0.423,148,294,0.503,0.54,69,95,0.726,67,186,253,92,50,25,84,118,506,2014
K. Lucas,IOW,24.0,29,20,842,148,330,0.448,40,116,0.345,108,214,0.505,0.509,102,122,0.836,17,68,85,146,32,1,53,47,438,2014
S. Machado,IDA,23.0,14,5,394,53,131,0.405,9,33,0.273,44,98,0.449,0.439,28,32,0.875,4,29,33,84,20,0,35,34,143,2014
S. Machado,TOT,23.0,27,6,662,88,233,0.378,16,63,0.254,72,170,0.424,0.412,63,76,0.829,15,56,71,125,27,3,57,52,255,2014
S. Machado,SAN,23.0,13,1,268,35,102,0.343,7,30,0.233,28,72,0.389,0.377,35,44,0.795,11,27,38,41,7,3,22,18,112,2014
J. Magette,LOS,24.0,50,47,1512,187,445,0.42,84,223,0.377,103,222,0.464,0.515,58,73,0.795,39,136,175,347,96,2,80,116,516,2014
R. Major,BAK,31.0,11,2,259,32,64,0.5,7,17,0.412,25,47,0.532,0.555,21,26,0.808,15,22,37,13,14,7,12,24,92,2014
K. Marshall,DEL,22.0,7,7,263,49,117,0.419,19,41,0.463,30,76,0.395,0.5,19,24,0.792,5,28,33,67,13,1,30,11,136,2014
Z. Marshall,MAI,,40,13,731,81,159,0.509,0,0,0.0,81,159,0.509,0.509,58,92,0.63,77,122,199,17,21,71,38,117,220,2014
A. Mason,SFL,,37,12,1020,179,373,0.48,13,52,0.25,166,321,0.517,0.497,70,94,0.745,61,123,184,72,49,29,58,97,441,2014
B. Massey,SPR,23.0,36,10,667,74,172,0.43,6,27,0.222,68,145,0.469,0.448,29,48,0.604,51,47,98,66,49,3,24,60,183,2014
R. McCallum,REN,22.0,7,7,250,55,119,0.462,11,28,0.393,44,91,0.484,0.508,19,28,0.679,11,13,24,30,14,2,16,19,140,2014
C. McCollum,IDA,22.0,2,0,41,17,36,0.472,1,9,0.111,16,27,0.593,0.486,2,2,1.0,2,5,7,7,3,0,6,5,37,2014
M. McConnell,TEX,,50,29,1626,169,407,0.415,54,168,0.321,115,239,0.481,0.482,120,143,0.839,34,104,138,322,68,2,111,146,512,2014
Q. McDowell,SPR,,22,4,288,27,68,0.397,9,27,0.333,18,41,0.439,0.463,14,18,0.778,14,32,46,11,10,1,12,32,77,2014
D. McGuire,TUL,,9,7,299,52,126,0.413,7,29,0.241,45,97,0.464,0.44,26,35,0.743,19,92,111,40,10,9,20,24,137,2014
D. McGuire,TOT,,31,25,1006,172,377,0.456,17,58,0.293,155,319,0.486,0.479,69,95,0.726,65,256,321,108,26,26,66,74,430,2014
D. McGuire,SAN,,22,18,707,120,251,0.478,10,29,0.345,110,222,0.495,0.498,43,60,0.717,46,164,210,68,16,17,46,50,293,2014
T. McKinney-Jones,FOR,23.0,47,44,1555,262,564,0.465,55,156,0.353,207,408,0.507,0.513,132,154,0.857,36,178,214,99,55,10,70,120,711,2014
J. McNeal,BAK,26.0,18,18,562,119,293,0.406,17,70,0.243,102,223,0.457,0.435,64,80,0.8,13,48,61,114,31,7,66,58,319,2014
G. Mekel,TEX,25.0,4,1,121,16,49,0.327,2,8,0.25,14,41,0.341,0.347,8,14,0.571,3,10,13,25,6,0,12,5,42,2014
F. Melo,TEX,23.0,21,4,280,45,93,0.484,0,0,0.0,45,93,0.484,0.484,20,36,0.556,29,48,77,12,7,16,28,58,110,2014
C. Melvin,ERI,,10,0,213,49,90,0.544,1,3,0.333,48,87,0.552,0.55,13,19,0.684,13,28,41,13,2,3,12,20,112,2014
D. Mency,DEL,,3,2,79,10,31,0.323,8,22,0.364,2,9,0.222,0.452,4,5,0.8,2,5,7,6,0,0,6,10,32,2014
E. Millsap,LOS,26.0,1,0,14,1,2,0.5,0,1,0.0,1,1,1.0,0.5,3,3,1.0,0,1,1,0,1,0,1,3,5,2014
T. Mitchell,FOR,24.0,30,7,854,227,526,0.432,60,182,0.33,167,344,0.485,0.489,91,118,0.771,50,98,148,90,32,33,103,79,605,2014
T. Mitchell,FOR,21.0,11,10,263,30,65,0.462,0,2,0.0,30,63,0.476,0.462,24,33,0.727,32,53,85,9,6,12,23,26,84,2014
J. Moon,LOS,33.0,15,14,491,75,159,0.472,34,80,0.425,41,79,0.519,0.579,31,38,0.816,5,98,103,52,32,40,23,33,215,2014
M. Moore,REN,38.0,8,3,165,18,36,0.5,0,0,0.0,18,36,0.5,0.5,12,15,0.8,12,21,33,6,1,1,18,30,48,2014
D. Morris,RIO,23.0,9,7,264,61,120,0.508,7,39,0.179,54,81,0.667,0.538,25,39,0.641,10,29,39,60,7,0,24,14,154,2014
A. Moultrie,DEL,23.0,8,1,226,33,73,0.452,0,0,0.0,33,73,0.452,0.452,18,23,0.783,5,31,36,13,8,2,15,18,84,2014
S. Muhammad,IOW,21.0,4,4,111,36,63,0.571,3,6,0.5,33,57,0.579,0.595,23,31,0.742,21,18,39,7,6,1,5,8,98,2014
K. Murphy,IDA,23.0,34,24,1222,312,644,0.484,61,158,0.386,251,486,0.516,0.532,183,215,0.851,35,146,181,57,38,8,79,81,868,2014
N. Murphy,TUL,,8,1,147,22,48,0.458,5,12,0.417,17,36,0.472,0.51,15,22,0.682,2,15,17,6,10,0,8,14,64,2014
R. Murray,AUS,34.0,46,40,1784,335,773,0.433,123,330,0.373,212,443,0.479,0.513,208,271,0.768,25,180,205,183,68,21,142,106,1001,2014
T. Murry,ERI,24.0,1,1,30,4,13,0.308,0,2,0.0,4,11,0.364,0.308,2,4,0.5,0,4,4,4,0,0,4,2,10,2014
H. N'Diaye,TOT,27.0,17,5,299,26,55,0.473,0,0,0.0,26,55,0.473,0.473,13,27,0.481,19,41,60,9,3,32,14,40,65,2014
H. N'Diaye,REN,27.0,2,2,56,5,11,0.455,0,0,0.0,5,11,0.455,0.455,3,8,0.375,4,8,12,2,1,7,4,6,13,2014
H. N'Diaye,DEL,27.0,15,3,243,21,44,0.477,0,0,0.0,21,44,0.477,0.477,10,19,0.526,15,33,48,7,2,25,10,34,52,2014
N. Nedovic,SAN,22.0,15,11,427,78,195,0.4,26,87,0.299,52,108,0.481,0.467,42,49,0.857,4,34,38,63,14,4,43,39,224,2014
A. Nelson,ERI,,2,0,8,0,2,0.0,0,0,0.0,0,2,0.0,0.0,0,0,0.0,0,0,0,0,0,0,2,6,0,2014
R. Nelson,DEL,,9,3,163,35,68,0.515,1,3,0.333,34,65,0.523,0.522,15,23,0.652,15,42,57,10,7,2,19,9,86,2014
R. Nelson,CAN,,31,0,324,29,82,0.354,11,36,0.306,18,46,0.391,0.421,17,28,0.607,7,16,23,35,9,0,25,34,86,2014
J. Nunnally,TOT,23.0,35,34,1177,217,465,0.467,97,235,0.413,120,230,0.522,0.571,103,124,0.831,25,131,156,124,34,6,87,80,634,2014
J. Nunnally,TEX,23.0,10,10,337,63,128,0.492,22,60,0.367,41,68,0.603,0.578,25,32,0.781,4,38,42,22,11,3,24,20,173,2014
J. Nunnally,BAK,23.0,25,24,840,154,337,0.457,75,175,0.429,79,162,0.488,0.568,78,92,0.848,21,93,114,102,23,3,63,60,461,2014
D. Nwaelele,SAN,29.0,46,43,1431,199,438,0.454,102,245,0.416,97,193,0.503,0.571,71,91,0.78,54,146,200,93,40,10,84,110,571,2014
J. O'Brien,BAK,,6,0,55,7,15,0.467,4,9,0.444,3,6,0.5,0.6,2,2,1.0,2,3,5,0,0,1,1,4,20,2014
T. Ohlbrecht,FOR,25.0,13,0,318,54,87,0.621,0,7,0.0,54,80,0.675,0.621,36,41,0.878,36,49,85,9,9,6,25,46,144,2014
T. Ohlbrecht,TOT,25.0,45,21,1067,205,370,0.554,11,50,0.22,194,320,0.606,0.569,121,150,0.807,120,193,313,42,24,26,111,167,542,2014
T. Ohlbrecht,RIO,25.0,32,21,749,151,283,0.534,11,43,0.256,140,240,0.583,0.553,85,109,0.78,84,144,228,33,15,20,86,121,398,2014
A. Onuaku,CAN,26.0,32,11,792,187,298,0.628,0,0,0.0,187,298,0.628,0.628,100,179,0.559,94,228,322,31,19,31,68,86,474,2014
A. Oriakhi,TOT,,43,26,802,119,239,0.498,0,3,0.0,119,236,0.504,0.498,70,91,0.769,97,169,266,8,15,37,50,131,308,2014
A. Oriakhi,SFL,,21,7,331,53,105,0.505,0,1,0.0,53,104,0.51,0.505,30,38,0.789,40,77,117,0,5,13,16,53,136,2014
A. Oriakhi,ERI,,22,19,471,66,134,0.493,0,2,0.0,66,132,0.5,0.493,40,53,0.755,57,92,149,8,10,24,34,78,172,2014
D. Orton,MAI,23.0,24,11,588,88,198,0.444,5,17,0.294,83,181,0.459,0.457,91,121,0.752,53,119,172,44,17,51,69,75,272,2014
R. Osby,MAI,23.0,12,12,330,68,152,0.447,19,45,0.422,49,107,0.458,0.51,39,67,0.582,21,56,77,17,8,5,34,39,194,2014
O. Outerbridge,TOT,,16,0,159,23,40,0.575,0,1,0.0,23,39,0.59,0.575,11,19,0.579,14,26,40,6,2,8,10,16,57,2014
O. Outerbridge,SFL,,5,0,27,3,5,0.6,0,1,0.0,3,4,0.75,0.6,4,6,0.667,1,5,6,0,0,3,4,2,10,2014
O. Outerbridge,SAN,,11,0,132,20,35,0.571,0,0,0.0,20,35,0.571,0.571,7,13,0.538,13,21,34,6,2,5,6,14,47,2014
L. Owens,TUL,31.0,7,5,204,25,68,0.368,2,20,0.1,23,48,0.479,0.382,11,16,0.688,11,22,33,14,11,7,10,14,63,2014
L. Owens,TOT,31.0,46,8,1051,158,352,0.449,32,114,0.281,126,238,0.529,0.494,65,100,0.65,57,155,212,101,44,20,71,96,413,2014
L. Owens,IOW,31.0,39,3,847,133,284,0.468,30,94,0.319,103,190,0.542,0.521,54,84,0.643,46,133,179,87,33,13,61,82,350,2014
K. Parrom,RIO,,46,6,1011,161,360,0.447,54,160,0.338,107,200,0.535,0.522,85,110,0.773,70,129,199,96,30,9,49,102,461,2014
B. Paul,CAN,22.0,2,0,21,3,8,0.375,3,4,0.75,0,4,0.0,0.563,1,2,0.5,0,4,4,3,2,0,3,0,10,2014
N. Pelle,DEL,20.0,35,6,457,78,152,0.513,0,3,0.0,78,149,0.523,0.513,38,61,0.623,35,72,107,7,14,49,41,101,194,2014
J. Peterson,SFL,,7,0,111,21,57,0.368,5,19,0.263,16,38,0.421,0.412,6,9,0.667,12,18,30,2,2,2,7,12,53,2014
D. Pittman,AUS,25.0,28,20,577,124,223,0.556,0,0,0.0,124,223,0.556,0.556,67,95,0.705,74,117,191,14,15,63,47,97,315,2014
E. Pittman,DEL,,8,0,165,31,64,0.484,9,26,0.346,22,38,0.579,0.555,9,20,0.45,7,22,29,9,6,1,12,21,80,2014
C. Porter,FOR,35.0,47,21,986,155,285,0.544,2,6,0.333,153,279,0.548,0.547,75,128,0.586,108,126,234,55,67,10,43,121,387,2014
T. Porter,REN,25.0,25,0,506,96,210,0.457,29,78,0.372,67,132,0.508,0.526,61,68,0.897,10,37,47,60,24,0,55,35,282,2014
T. Porter,TOT,25.0,42,0,809,136,317,0.429,39,118,0.331,97,199,0.487,0.491,86,99,0.869,21,64,85,90,38,0,85,59,397,2014
T. Porter,SFL,25.0,17,0,303,40,107,0.374,10,40,0.25,30,67,0.448,0.421,25,31,0.806,11,27,38,30,14,0,30,24,115,2014
K. Randall,CAN,,4,0,36,5,13,0.385,0,2,0.0,5,11,0.455,0.385,3,3,1.0,0,6,6,2,1,0,4,8,13,2014
K. Randall,TOT,,28,1,424,38,113,0.336,6,21,0.286,32,92,0.348,0.363,34,45,0.756,4,30,34,59,17,3,34,35,116,2014
K. Randall,FOR,,24,1,388,33,100,0.33,6,19,0.316,27,81,0.333,0.36,31,42,0.738,4,24,28,57,16,3,30,27,103,2014
W. Reed,TOT,23.0,49,33,1524,305,513,0.595,0,1,0.0,305,512,0.596,0.595,110,172,0.64,189,295,484,47,25,81,62,125,720,2014
W. Reed,SPR,23.0,44,33,1399,281,476,0.59,0,0,0.0,281,476,0.59,0.59,90,147,0.612,173,273,446,41,23,69,60,112,652,2014
W. Reed,REN,23.0,5,0,125,24,37,0.649,0,1,0.0,24,36,0.667,0.649,20,25,0.8,16,22,38,6,2,12,2,13,68,2014
G. Rice,IOW,23.0,19,19,531,109,235,0.464,39,111,0.351,70,124,0.565,0.547,70,87,0.805,38,79,117,37,32,16,35,32,327,2014
K. Rivers,REN,,45,19,1374,260,586,0.444,86,245,0.351,174,341,0.51,0.517,101,120,0.842,39,145,184,97,56,4,71,99,707,2014
A. Roberson,TUL,22.0,17,17,539,116,225,0.516,10,32,0.313,106,193,0.549,0.538,28,61,0.459,56,108,164,27,42,22,37,47,270,2014
T. Robinson,FOR,,1,0,4,0,1,0.0,0,0,0.0,0,1,0.0,0.0,0,0,0.0,0,0,0,0,0,0,0,0,0,2014
A. Rodriguez,SPR,,7,1,123,6,19,0.316,0,1,0.0,6,18,0.333,0.316,6,15,0.4,22,31,53,3,6,4,5,19,18,2014
S. Rojas,FOR,,50,37,1484,205,450,0.456,53,144,0.368,152,306,0.497,0.514,141,186,0.758,137,291,428,56,86,18,74,145,604,2014
K. Rush,LOS,33.0,12,9,304,44,113,0.389,17,47,0.362,27,66,0.409,0.465,13,21,0.619,15,30,45,20,15,2,16,32,118,2014
W. Russell,REN,31.0,14,2,297,39,85,0.459,12,25,0.48,27,60,0.45,0.529,15,20,0.75,2,16,18,62,5,2,27,16,105,2014
D. Salisbery,DEL,,12,0,249,39,100,0.39,9,37,0.243,30,63,0.476,0.435,15,20,0.75,7,40,47,27,16,1,25,22,102,2014
D. Saunders,DEL,25.0,43,41,1372,179,416,0.43,56,186,0.301,123,230,0.535,0.498,59,107,0.551,75,241,316,77,79,53,100,102,473,2014
D. Schrder,BAK,20.0,6,6,204,35,73,0.479,5,17,0.294,30,56,0.536,0.514,27,38,0.711,3,22,25,40,5,1,22,11,102,2014
A. Scott,BAK,,5,0,85,20,31,0.645,2,5,0.4,18,26,0.692,0.677,10,15,0.667,0,9,9,15,5,2,12,19,52,2014
M. Shakur,TOT,29.0,40,39,1385,241,506,0.476,40,126,0.317,201,380,0.529,0.516,161,198,0.813,41,135,176,247,72,13,112,120,683,2014
M. Shakur,ERI,29.0,17,17,548,92,187,0.492,13,36,0.361,79,151,0.523,0.527,51,67,0.761,17,45,62,91,18,4,45,48,248,2014
M. Shakur,TUL,29.0,23,22,837,149,319,0.467,27,90,0.3,122,229,0.533,0.509,110,131,0.84,24,90,114,156,54,9,67,72,435,2014
T. Shengelia,SPR,22.0,4,4,109,17,31,0.548,1,5,0.2,16,26,0.615,0.565,18,22,0.818,9,11,20,6,2,5,19,18,53,2014
J. Simmons,AUS,24.0,44,12,1019,169,322,0.525,25,88,0.284,144,234,0.615,0.564,70,99,0.707,69,131,200,61,44,16,49,92,433,2014
H. Sims,CAN,23.0,3,2,68,14,30,0.467,0,0,0.0,14,30,0.467,0.467,14,17,0.824,6,13,19,2,1,1,4,10,42,2014
E. Singler,IDA,23.0,22,4,620,106,224,0.473,57,120,0.475,49,104,0.471,0.6,42,49,0.857,21,82,103,26,15,10,33,53,311,2014
S. Singletary,TOT,28.0,23,21,607,71,170,0.418,14,41,0.341,57,129,0.442,0.459,65,77,0.844,11,57,68,92,40,4,54,63,221,2014
S. Singletary,TEX,28.0,20,20,562,65,156,0.417,13,36,0.361,52,120,0.433,0.458,65,76,0.855,11,55,66,81,38,4,48,58,208,2014
S. Singletary,ERI,28.0,3,1,45,6,14,0.429,1,5,0.2,5,9,0.556,0.464,0,1,0.0,0,2,2,11,2,0,6,5,13,2014
P. Siva,FOR,23.0,10,7,259,41,95,0.432,22,44,0.5,19,51,0.373,0.547,25,31,0.806,4,20,24,46,20,1,28,29,129,2014
C. Smith,ERI,26.0,23,8,478,62,175,0.354,16,64,0.25,46,111,0.414,0.4,47,60,0.783,20,57,77,42,8,1,38,38,187,2014
C. Smith,SFL,,8,4,226,52,87,0.598,0,0,0.0,52,87,0.598,0.598,30,39,0.769,14,40,54,12,9,4,16,26,134,2014
S. Smith,AUS,30.0,5,0,93,8,27,0.296,1,5,0.2,7,22,0.318,0.315,6,9,0.667,4,18,22,3,3,0,2,11,23,2014
J. Southerland,LOS,23.0,42,14,1200,250,502,0.498,65,201,0.323,185,301,0.615,0.563,51,77,0.662,71,203,274,40,34,36,43,125,616,2014
B. Spencer,TOT,,52,6,1239,219,572,0.383,77,268,0.287,142,304,0.467,0.45,69,89,0.775,18,142,160,178,63,10,116,96,584,2014
B. Spencer,RIO,,12,0,237,50,121,0.413,21,76,0.276,29,45,0.644,0.5,15,20,0.75,2,20,22,27,12,1,14,23,136,2014
B. Spencer,DEL,,15,4,386,80,207,0.386,28,94,0.298,52,113,0.46,0.454,17,27,0.63,6,50,56,60,26,2,36,27,205,2014
B. Spencer,CAN,,25,2,616,89,244,0.365,28,98,0.286,61,146,0.418,0.422,37,42,0.881,10,72,82,91,25,7,66,46,243,2014
C. Stinson,IOW,30.0,28,22,827,113,256,0.441,9,40,0.225,104,216,0.481,0.459,56,73,0.767,19,106,125,199,30,10,79,63,291,2014
D. Strickland,IDA,23.0,22,0,271,39,77,0.506,5,8,0.625,34,69,0.493,0.539,15,18,0.833,4,21,25,28,14,5,15,26,98,2014
B. Strong,IOW,27.0,6,0,31,4,10,0.4,0,3,0.0,4,7,0.571,0.4,0,1,0.0,2,10,12,0,1,1,2,6,8,2014
B. Strong,DEL,27.0,14,3,315,54,111,0.486,8,25,0.32,46,86,0.535,0.523,17,23,0.739,24,53,77,9,2,13,18,28,133,2014
B. Strong,AUS,27.0,9,0,101,12,25,0.48,2,7,0.286,10,18,0.556,0.52,6,8,0.75,6,16,22,4,0,1,5,12,32,2014
B. Strong,TOT,27.0,29,3,447,70,146,0.479,10,35,0.286,60,111,0.541,0.514,23,32,0.719,32,79,111,13,3,15,25,46,173,2014
C. Strong,BAK,,5,2,58,3,14,0.214,1,5,0.2,2,9,0.222,0.25,0,0,0.0,4,4,8,3,1,0,7,9,7,2014
P. Sturgess,TEX,,13,0,41,3,8,0.375,0,0,0.0,3,8,0.375,0.375,5,8,0.625,3,8,11,1,0,0,4,5,11,2014
S. Suggs,ERI,24.0,47,41,1726,317,667,0.475,120,298,0.403,197,369,0.534,0.565,115,137,0.839,31,151,182,100,52,6,97,104,869,2014
M. Sutton,TUL,24.0,48,4,714,136,250,0.544,0,1,0.0,136,249,0.546,0.544,68,93,0.731,76,171,247,11,17,61,43,110,340,2014
G. Talton,RIO,23.0,48,29,1292,165,409,0.403,59,189,0.312,106,220,0.482,0.476,84,101,0.832,30,121,151,339,48,2,97,94,473,2014
C. Tapley,TUL,,12,0,179,28,60,0.467,8,28,0.286,20,32,0.625,0.533,2,3,0.667,2,12,14,11,9,1,6,12,66,2014
J. Taylor,MAI,27.0,2,2,52,11,21,0.524,0,4,0.0,11,17,0.647,0.524,7,9,0.778,1,7,8,5,1,1,7,3,29,2014
K. Taylor,MAI,,9,4,155,18,52,0.346,9,27,0.333,9,25,0.36,0.433,11,12,0.917,0,9,9,20,8,0,17,8,56,2014
T. Taylor,SPR,23.0,2,1,51,6,20,0.3,0,2,0.0,6,18,0.333,0.3,6,7,0.857,1,6,7,8,3,0,12,5,18,2014
T. Taylor,MAI,23.0,23,11,666,131,267,0.491,5,37,0.135,126,230,0.548,0.5,60,83,0.723,14,80,94,115,29,1,97,43,327,2014
T. Taylor,TOT,23.0,25,12,717,137,287,0.477,5,39,0.128,132,248,0.532,0.486,66,90,0.733,15,86,101,123,32,1,109,48,345,2014
M. Teague,IOW,20.0,8,8,192,42,91,0.462,3,9,0.333,39,82,0.476,0.478,9,15,0.6,1,19,20,38,2,0,24,21,96,2014
A. Thomas,SPR,20.0,34,28,1195,224,488,0.459,55,118,0.466,169,370,0.457,0.515,62,82,0.756,33,113,146,42,30,6,54,72,565,2014
D. Thomas,BAK,,28,1,343,41,81,0.506,0,0,0.0,41,81,0.506,0.506,28,38,0.737,32,61,93,8,5,16,18,51,110,2014
M. Thomas,LOS,25.0,2,2,80,23,37,0.622,8,13,0.615,15,24,0.625,0.73,13,19,0.684,9,22,31,5,5,4,6,6,67,2014
M. Thomas,AUS,25.0,10,10,327,61,107,0.57,12,33,0.364,49,74,0.662,0.626,18,30,0.6,35,59,94,30,6,24,21,35,152,2014
M. Thomas,TOT,25.0,12,12,407,84,144,0.583,20,46,0.435,64,98,0.653,0.653,31,49,0.633,44,81,125,35,11,28,27,41,219,2014
T. Thomas,FOR,33.0,4,2,66,4,17,0.235,0,3,0.0,4,14,0.286,0.235,4,4,1.0,4,8,12,5,4,0,4,2,12,2014
M. Thompson,SAN,25.0,44,9,825,96,253,0.379,41,112,0.366,55,141,0.39,0.46,57,69,0.826,36,94,130,55,42,19,46,79,290,2014
K. Thornton,IDA,,25,7,354,82,150,0.547,1,1,1.0,81,149,0.544,0.55,31,43,0.721,44,79,123,5,9,6,17,40,196,2014
J. Turner,LOS,21.0,37,2,782,162,304,0.533,7,28,0.25,155,276,0.562,0.544,84,114,0.737,33,77,110,158,48,13,67,74,415,2014
J. Tyler,ERI,22.0,6,6,186,43,90,0.478,0,1,0.0,43,89,0.483,0.478,22,36,0.611,25,36,61,3,2,4,21,29,108,2014
M. Udofia,DEL,23.0,32,7,660,76,191,0.398,22,72,0.306,54,119,0.454,0.455,54,77,0.701,16,42,58,53,16,1,59,71,228,2014
B. Uzoh,TUL,25.0,22,22,689,113,262,0.431,4,17,0.235,109,245,0.445,0.439,41,53,0.774,24,81,105,101,33,5,43,39,271,2014
B. Uzoh,TOT,25.0,35,23,965,150,360,0.417,8,28,0.286,142,332,0.428,0.428,64,85,0.753,32,104,136,135,41,9,61,57,372,2014
B. Uzoh,CAN,25.0,13,1,276,37,98,0.378,4,11,0.364,33,87,0.379,0.398,23,32,0.719,8,23,31,34,8,4,18,18,101,2014
J. Varnado,IOW,25.0,22,22,697,116,230,0.504,0,0,0.0,116,230,0.504,0.504,78,119,0.655,62,180,242,18,14,103,64,88,310,2014
V. Wafer,BAK,28.0,5,3,145,25,55,0.455,10,19,0.526,15,36,0.417,0.545,13,17,0.765,3,6,9,13,3,0,15,9,73,2014
H. Walker,SFL,26.0,48,33,1418,258,577,0.447,98,275,0.356,160,302,0.53,0.532,90,132,0.682,52,217,269,85,56,48,64,160,704,2014
T. Walker,ERI,24.0,18,2,293,40,63,0.635,0,0,0.0,40,63,0.635,0.635,10,16,0.625,24,58,82,13,7,18,17,27,90,2014
T. Walker,TOT,24.0,43,19,934,115,182,0.632,0,0,0.0,115,182,0.632,0.632,23,39,0.59,78,189,267,33,18,105,43,79,253,2014
T. Walker,MAI,24.0,25,17,641,75,119,0.63,0,0,0.0,75,119,0.63,0.63,13,23,0.565,54,131,185,20,11,87,26,52,163,2014
M. Wayns,RIO,22.0,11,2,221,52,135,0.385,14,48,0.292,38,87,0.437,0.437,17,24,0.708,3,21,24,46,3,1,27,22,135,2014
S. Weingarten,TOT,25.0,41,1,612,93,212,0.439,38,109,0.349,55,103,0.534,0.528,28,38,0.737,32,71,103,14,16,6,44,102,252,2014
S. Weingarten,DEL,25.0,21,1,418,64,148,0.432,27,79,0.342,37,69,0.536,0.524,24,32,0.75,24,53,77,10,11,5,32,57,179,2014
S. Weingarten,CAN,25.0,20,0,194,29,64,0.453,11,30,0.367,18,34,0.529,0.539,4,6,0.667,8,18,26,4,5,1,12,45,73,2014
S. Welsh,DEL,,2,0,17,1,4,0.25,0,2,0.0,1,2,0.5,0.25,0,0,0.0,0,2,2,2,0,0,4,4,2,2014
C. Westbrook,TOT,,37,2,701,132,302,0.437,17,59,0.288,115,243,0.473,0.465,60,80,0.75,20,60,80,69,28,9,45,61,341,2014
C. Westbrook,SFL,,10,1,233,49,99,0.495,6,16,0.375,43,83,0.518,0.525,16,26,0.615,2,28,30,21,13,2,16,22,120,2014
C. Westbrook,AUS,,27,1,468,83,203,0.409,11,43,0.256,72,160,0.45,0.436,44,54,0.815,18,32,50,48,15,7,29,39,221,2014
D. White,ERI,22.0,44,0,655,124,238,0.521,11,41,0.268,113,197,0.574,0.544,30,51,0.588,50,76,126,25,31,12,36,55,289,2014
R. White,REN,22.0,4,4,99,11,30,0.367,3,9,0.333,8,21,0.381,0.417,10,16,0.625,3,14,17,11,6,1,5,14,35,2014
I. Wilkerson,TUL,,50,8,1097,163,434,0.376,39,138,0.283,124,296,0.419,0.421,69,86,0.802,32,81,113,95,28,3,76,102,434,2014
C. Williams,LOS,23.0,49,26,1451,275,544,0.506,97,220,0.441,178,324,0.549,0.595,58,71,0.817,67,160,227,94,61,27,55,129,705,2014
E. Williams,DEL,24.0,1,1,41,5,14,0.357,1,4,0.25,4,10,0.4,0.393,8,9,0.889,0,5,5,5,1,0,7,4,19,2014
L. Williams,SPR,25.0,30,3,640,70,222,0.315,34,129,0.264,36,93,0.387,0.392,23,34,0.676,15,48,63,14,20,1,19,56,197,2014
R. Williams,TUL,27.0,25,21,949,187,392,0.477,60,167,0.359,127,225,0.564,0.554,71,97,0.732,24,118,142,122,39,5,56,39,505,2014
R. Williams,DEL,22.0,33,26,918,113,244,0.463,23,82,0.28,90,162,0.556,0.51,71,94,0.755,20,71,91,43,25,24,46,83,320,2014
S. Williams,LOS,,23,21,724,160,351,0.456,64,153,0.418,96,198,0.485,0.547,87,108,0.806,37,124,161,39,18,48,37,88,471,2014
T. Williams,LOS,26.0,32,26,1143,230,546,0.421,85,223,0.381,145,323,0.449,0.499,111,175,0.634,21,139,160,204,46,7,88,39,656,2014
E. Wise,IOW,,2,0,8,0,1,0.0,0,0,0.0,0,1,0.0,0.0,0,0,0.0,1,1,2,0,0,0,1,3,0,2014
J. Wise,BAK,,17,0,334,48,123,0.39,9,23,0.391,39,100,0.39,0.427,38,48,0.792,4,42,46,64,14,1,28,36,143,2014
T. Woodbury,AUS,,11,6,219,44,94,0.468,6,20,0.3,38,74,0.514,0.5,21,29,0.724,8,19,27,14,8,2,22,23,115,2014
B. Woodfox,TEX,27.0,47,0,927,154,346,0.445,97,207,0.469,57,139,0.41,0.585,51,64,0.797,15,86,101,115,29,1,34,58,456,2014
C. Wright,MAI,25.0,41,41,1448,294,622,0.473,31,114,0.272,263,508,0.518,0.498,191,282,0.677,107,226,333,95,45,59,98,121,810,2014
K. Wyatt,SPR,,20,10,570,105,235,0.447,49,119,0.412,56,116,0.483,0.551,65,80,0.813,7,41,48,71,33,1,42,32,324,2014
S. Yeager,TEX,,27,0,300,58,110,0.527,25,47,0.532,33,63,0.524,0.641,19,27,0.704,14,31,45,16,17,3,22,34,160,2014
B. Young,RIO,,21,0,143,49,96,0.51,2,8,0.25,47,88,0.534,0.521,19,26,0.731,10,11,21,21,2,1,19,14,119,2014
B. Young,DEL,,8,1,127,49,91,0.538,0,3,0.0,49,88,0.557,0.538,16,29,0.552,4,20,24,17,7,1,16,13,114,2014
B. Young,TOT,,29,1,270,98,187,0.524,2,11,0.182,96,176,0.545,0.529,35,55,0.636,14,31,45,38,9,2,35,27,233,2014
L. Zeller,AUS,26.0,36,11,707,84,212,0.396,13,35,0.371,71,177,0.401,0.427,10,12,0.833,42,117,159,43,17,23,32,96,191,2014
Q. Acy,BAK,22.0,13,10,369,67,115,0.583,1,8,0.125,66,107,0.617,0.587,34,48,0.708,32,68,100,15,7,9,32,44,169,2013
K. Adeleke,SPR,,31,14,526,62,117,0.53,0,0,0.0,62,117,0.53,0.53,34,48,0.708,94,117,211,8,12,11,47,83,158,2013
J. Adrien,RIO,26.0,5,5,165,36,64,0.563,1,2,0.5,35,62,0.565,0.57,15,26,0.577,10,46,56,9,4,9,10,14,88,2013
A. Agudio,CAN,28.0,50,42,1558,164,423,0.388,85,210,0.405,79,213,0.371,0.488,107,123,0.87,14,85,99,96,32,1,73,72,520,2013
S. Alabi,IDA,24.0,18,6,280,40,78,0.513,0,0,0.0,40,78,0.513,0.513,8,15,0.533,41,58,99,4,8,16,17,35,88,2013
M. Almond,TOT,27.0,44,35,1463,282,565,0.499,46,124,0.371,236,441,0.535,0.54,170,217,0.783,34,107,141,50,34,14,105,95,780,2013
M. Almond,LOS,27.0,26,18,836,163,306,0.533,27,70,0.386,136,236,0.576,0.577,76,108,0.704,18,55,73,34,18,6,53,50,429,2013
M. Almond,IOW,27.0,18,17,627,119,259,0.459,19,54,0.352,100,205,0.488,0.496,94,109,0.862,16,52,68,16,16,8,52,45,351,2013
K. Anderson,CAN,,10,1,218,30,87,0.345,7,27,0.259,23,60,0.383,0.385,14,15,0.933,6,18,24,33,10,0,22,17,81,2013
M. Anderson,FOR,,18,5,383,42,115,0.365,0,8,0.0,42,107,0.393,0.365,29,41,0.707,30,40,70,22,18,11,25,42,113,2013
R. Anderson,TUL,23.0,44,17,912,105,214,0.491,0,1,0.0,105,213,0.493,0.491,52,107,0.486,103,112,215,55,22,23,46,98,262,2013
Z. Andrews,LOS,27.0,32,13,721,95,175,0.543,4,12,0.333,91,163,0.558,0.554,29,66,0.439,74,113,187,26,30,18,26,91,223,2013
H. Armstrong,SAN,28.0,29,24,764,140,223,0.628,0,0,0.0,140,223,0.628,0.628,109,157,0.694,65,133,198,24,29,65,73,111,389,2013
B. Austin,FOR,,10,0,38,4,14,0.286,0,4,0.0,4,10,0.4,0.286,8,8,1.0,4,3,7,0,1,0,3,2,16,2013
C. Ayer,TOT,,43,3,587,101,208,0.486,3,16,0.188,98,192,0.51,0.493,67,95,0.705,49,77,126,5,12,41,44,129,272,2013
C. Ayer,SFL,,6,0,59,10,18,0.556,0,0,0.0,10,18,0.556,0.556,2,4,0.5,4,5,9,0,0,4,4,15,22,2013
C. Ayer,MAI,,37,3,528,91,190,0.479,3,16,0.188,88,174,0.506,0.487,65,91,0.714,45,72,117,5,12,37,40,114,250,2013
R. Ayers,AUS,,21,0,305,31,81,0.383,21,58,0.362,10,23,0.435,0.512,3,5,0.6,8,34,42,20,9,4,7,24,86,2013
T. Baines,ERI,,49,4,1105,192,382,0.503,0,3,0.0,192,379,0.507,0.503,66,102,0.647,95,109,204,33,28,3,50,88,450,2013
M. Baker,SAN,33.0,47,23,1220,105,261,0.402,24,72,0.333,81,189,0.429,0.448,38,46,0.826,21,151,172,146,45,4,82,105,272,2013
A. Barrett,SFL,30.0,16,16,545,63,166,0.38,23,64,0.359,40,102,0.392,0.449,31,47,0.66,11,47,58,126,22,1,54,24,180,2013
A. Barrett,MAI,30.0,17,10,468,46,120,0.383,8,22,0.364,38,98,0.388,0.417,27,34,0.794,16,35,51,129,13,1,34,24,127,2013
A. Barrett,TOT,30.0,33,26,1013,109,286,0.381,31,86,0.36,78,200,0.39,0.435,58,81,0.716,27,82,109,255,35,2,88,48,307,2013
R. Bartholomew,TUL,,47,3,735,102,199,0.513,1,2,0.5,101,197,0.513,0.515,48,75,0.64,89,131,220,33,24,11,51,116,253,2013
W. Barton,IDA,22.0,4,4,151,24,65,0.369,6,23,0.261,18,42,0.429,0.415,13,15,0.867,0,21,21,12,4,3,11,3,67,2013
T. Baudinet,SPR,,9,0,86,10,29,0.345,6,20,0.3,4,9,0.444,0.448,0,0,0.0,4,7,11,12,1,1,7,13,26,2013
A. Baynes,AUS,26.0,11,11,296,63,120,0.525,0,0,0.0,63,120,0.525,0.525,27,37,0.73,39,57,96,12,6,11,24,40,153,2013
K. Bazemore,SAN,23.0,5,5,170,41,84,0.488,11,27,0.407,30,57,0.526,0.554,15,20,0.75,7,31,38,14,22,5,18,16,108,2013
O. Bellfield,ERI,,10,0,186,27,70,0.386,10,24,0.417,17,46,0.37,0.457,7,8,0.875,5,15,20,24,9,2,17,15,71,2013
K. Benson,ERI,24.0,24,18,533,99,215,0.46,0,0,0.0,99,215,0.46,0.46,42,66,0.636,46,112,158,24,14,40,41,70,240,2013
P. Beverley,RIO,24.0,3,3,112,14,41,0.341,7,19,0.368,7,22,0.318,0.427,6,6,1.0,4,16,20,21,6,1,11,10,41,2013
W. Blalock,REN,29.0,45,18,1044,80,197,0.406,16,42,0.381,64,155,0.413,0.447,53,77,0.688,35,85,120,145,46,6,57,57,229,2013
J. Boone,IOW,28.0,2,2,66,16,33,0.485,0,0,0.0,16,33,0.485,0.485,1,5,0.2,8,7,15,3,3,1,5,4,33,2013
B. Bowdry,ERI,,10,0,44,3,9,0.333,0,1,0.0,3,8,0.375,0.333,4,5,0.8,2,6,8,1,0,0,7,8,10,2013
S. Bozeman,TEX,,46,8,968,106,296,0.358,24,78,0.308,82,218,0.376,0.399,149,177,0.842,24,69,93,85,32,1,60,84,385,2013
C. Brackins,LOS,25.0,9,1,156,17,44,0.386,5,20,0.25,12,24,0.5,0.443,2,2,1.0,4,22,26,13,1,3,4,19,41,2013
B. Brooks,TUL,,4,0,28,1,7,0.143,0,2,0.0,1,5,0.2,0.143,1,1,1.0,1,1,2,4,0,0,4,3,3,2013
C. Brown,IDA,,26,6,630,115,277,0.415,29,96,0.302,86,181,0.475,0.468,60,79,0.759,20,69,89,51,20,9,47,52,319,2013
C. Brown,TOT,,32,6,725,126,312,0.404,33,109,0.303,93,203,0.458,0.457,67,91,0.736,24,84,108,60,22,9,57,55,352,2013
C. Brown,SAN,,6,0,95,11,35,0.314,4,13,0.308,7,22,0.318,0.371,7,12,0.583,4,15,19,9,2,0,10,3,33,2013
D. Brown,CAN,,24,0,272,26,66,0.394,10,26,0.385,16,40,0.4,0.47,23,27,0.852,12,19,31,13,8,1,12,22,85,2013
B. Butch,BAK,,47,47,1387,220,495,0.444,72,216,0.333,148,279,0.53,0.517,85,126,0.675,148,365,513,75,44,47,86,133,597,2013
R. Butler,TUL,33.0,31,23,1014,201,475,0.423,60,173,0.347,141,302,0.467,0.486,90,107,0.841,31,128,159,47,21,43,62,44,552,2013
P. Carter,IDA,,9,0,102,10,41,0.244,3,12,0.25,7,29,0.241,0.28,4,6,0.667,7,17,24,4,3,7,8,14,27,2013
P. Carter,TOT,,32,2,502,52,162,0.321,10,45,0.222,42,117,0.359,0.352,39,51,0.765,33,76,109,34,12,15,22,58,153,2013
P. Carter,SPR,,23,2,400,42,121,0.347,7,33,0.212,35,88,0.398,0.376,35,45,0.778,26,59,85,30,9,8,14,44,126,2013
M. Charlo,REN,29.0,9,3,282,41,74,0.554,8,25,0.32,33,49,0.673,0.608,16,19,0.842,23,46,69,18,14,11,14,19,106,2013
V. Claver,IDA,24.0,4,4,135,14,46,0.304,3,20,0.15,11,26,0.423,0.337,5,5,1.0,3,25,28,5,8,2,15,12,36,2013
A. Coleman,AUS,,12,7,362,58,117,0.496,4,20,0.2,54,97,0.557,0.513,21,36,0.583,10,51,61,27,15,5,21,18,141,2013
A. Coleman,TOT,,14,7,372,59,122,0.484,4,20,0.2,55,102,0.539,0.5,21,36,0.583,11,53,64,28,15,5,23,19,143,2013
A. Coleman,REN,,2,0,10,1,5,0.2,0,0,0.0,1,5,0.2,0.2,0,0,0.0,1,2,3,1,0,0,2,1,2,2013
D. Coleman,SFL,,6,6,116,14,41,0.341,0,0,0.0,14,41,0.341,0.341,8,10,0.8,13,17,30,2,3,3,1,10,36,2013
V. Cooksey,IOW,,18,1,248,24,77,0.312,3,9,0.333,21,68,0.309,0.331,30,32,0.938,5,10,15,47,15,0,27,21,81,2013
C. Cooper,BAK,,47,1,816,74,164,0.451,0,0,0.0,74,164,0.451,0.451,35,60,0.583,110,161,271,19,24,34,33,139,183,2013
N. Covington,ERI,27.0,47,38,1223,153,387,0.395,79,198,0.399,74,189,0.392,0.497,58,71,0.817,28,93,121,136,52,2,93,99,443,2013
J. Cowan,AUS,,4,3,103,16,32,0.5,0,1,0.0,16,31,0.516,0.5,2,4,0.5,11,24,35,3,0,1,4,11,34,2013
C. Crawford,SPR,,1,0,5,0,0,0.0,0,0,0.0,0,0,0.0,0.0,0,0,0.0,0,0,0,0,1,0,1,1,0,2013
W. Creekmore,TUL,,4,0,39,5,14,0.357,0,3,0.0,5,11,0.455,0.357,2,4,0.5,2,6,8,3,0,1,2,3,12,2013
J. Cunningham,TEX,21.0,15,13,518,68,203,0.335,19,74,0.257,49,129,0.38,0.382,75,104,0.721,10,34,44,45,18,2,39,27,230,2013
B. Cusworth,MAI,,3,0,11,0,0,0.0,0,0,0.0,0,0,0.0,0.0,0,0,0.0,0,2,2,2,0,1,0,2,0,2013
C. Daniels,TOT,,16,10,347,63,123,0.512,5,28,0.179,58,95,0.611,0.533,30,45,0.667,24,55,79,11,5,33,34,57,161,2013
C. Daniels,SAN,,3,1,66,8,18,0.444,0,2,0.0,8,16,0.5,0.444,5,9,0.556,6,11,17,0,1,7,8,13,21,2013
C. Daniels,RIO,,13,9,281,55,105,0.524,5,26,0.192,50,79,0.633,0.548,25,36,0.694,18,44,62,11,4,26,26,44,140,2013
E. Daniels,ERI,30.0,42,13,778,122,274,0.445,24,88,0.273,98,186,0.527,0.489,46,58,0.793,57,109,166,70,26,18,30,87,314,2013
C. Davis,SFL,,30,3,492,67,167,0.401,12,41,0.293,55,126,0.437,0.437,28,40,0.7,8,39,47,57,23,5,39,27,174,2013
M. Davis,SFL,24.0,49,30,1134,162,310,0.523,1,2,0.5,161,308,0.523,0.524,37,64,0.578,82,220,302,55,38,23,57,80,362,2013
N. De Colo,AUS,25.0,3,3,105,19,50,0.38,4,17,0.235,15,33,0.455,0.42,4,4,1.0,4,13,17,22,6,0,10,5,46,2013
S. Dennis,BAK,,45,8,993,172,391,0.44,15,59,0.254,157,332,0.473,0.459,98,137,0.715,34,108,142,177,71,20,106,99,457,2013
J. Dentmon,TOT,27.0,42,41,1554,312,746,0.418,115,318,0.362,197,428,0.46,0.495,223,271,0.823,34,128,162,160,59,4,141,112,962,2013
J. Dentmon,TEX,27.0,24,23,928,208,477,0.436,74,208,0.356,134,269,0.498,0.514,152,186,0.817,18,62,80,86,41,3,85,59,642,2013
J. Dentmon,AUS,27.0,18,18,626,104,269,0.387,41,110,0.373,63,159,0.396,0.463,71,85,0.835,16,66,82,74,18,1,56,53,320,2013
M. Dickey,LOS,,2,0,55,8,15,0.533,1,4,0.25,7,11,0.636,0.567,2,4,0.5,0,1,1,7,2,0,4,5,19,2013
M. Dickey,TOT,,8,1,146,19,37,0.514,2,9,0.222,17,28,0.607,0.541,7,11,0.636,1,5,6,13,7,0,14,11,47,2013
M. Dickey,TEX,,6,1,91,11,22,0.5,1,5,0.2,10,17,0.588,0.523,5,7,0.714,1,4,5,6,5,0,10,6,28,2013
D. Dodson,LOS,,6,0,35,2,12,0.167,1,6,0.167,1,6,0.167,0.208,0,0,0.0,1,5,6,2,1,0,2,2,5,2013
K. Dooling,REN,32.0,1,1,26,3,8,0.375,0,2,0.0,3,6,0.5,0.375,0,1,0.0,0,0,0,1,2,0,4,4,6,2013
C. Douglas-Roberts,TEX,26.0,11,11,423,79,160,0.494,15,38,0.395,64,122,0.525,0.541,75,83,0.904,8,50,58,49,21,7,37,21,248,2013
M. Downs,MAI,,48,43,1687,267,623,0.429,102,266,0.383,165,357,0.462,0.51,132,162,0.815,57,221,278,114,74,42,127,130,768,2013
R. Dupree,TOT,32.0,36,19,1134,189,416,0.454,1,8,0.125,188,408,0.461,0.456,86,128,0.672,78,195,273,110,45,8,66,122,465,2013
R. Dupree,REN,32.0,18,14,627,104,234,0.444,0,1,0.0,104,233,0.446,0.444,46,70,0.657,48,119,167,65,24,6,33,68,254,2013
R. Dupree,LOS,32.0,18,5,507,85,182,0.467,1,7,0.143,84,175,0.48,0.47,40,58,0.69,30,76,106,45,21,2,33,54,211,2013
S. Evans,IDA,,46,25,1132,231,457,0.505,0,1,0.0,231,456,0.507,0.505,102,176,0.58,138,249,387,33,46,26,93,127,564,2013
J. Ellis,IDA,,43,20,910,58,110,0.527,0,0,0.0,58,110,0.527,0.527,39,46,0.848,123,179,302,36,32,14,35,134,155,2013
M. Ely,TEX,34.0,37,35,981,157,313,0.502,0,1,0.0,157,312,0.503,0.502,82,115,0.713,67,177,244,32,16,31,65,85,396,2013
K. English,FOR,24.0,3,3,110,18,42,0.429,5,13,0.385,13,29,0.448,0.488,13,15,0.867,5,10,15,17,3,4,10,9,54,2013
M. Eric,CAN,24.0,50,17,1109,179,354,0.506,0,0,0.0,179,354,0.506,0.506,49,80,0.613,127,252,379,54,23,85,95,151,407,2013
C. Eyenga,TEX,23.0,30,8,908,173,392,0.441,15,57,0.263,158,335,0.472,0.46,78,132,0.591,39,129,168,33,25,57,82,71,439,2013
J. Famous,TOT,24.0,46,35,1187,173,369,0.469,0,2,0.0,173,367,0.471,0.469,95,129,0.736,154,181,335,21,13,30,62,107,441,2013
J. Famous,LOS,24.0,21,14,514,84,168,0.5,0,0,0.0,84,168,0.5,0.5,38,52,0.731,70,75,145,10,6,18,30,49,206,2013
J. Famous,IOW,24.0,25,21,673,89,201,0.443,0,2,0.0,89,199,0.447,0.443,57,77,0.74,84,106,190,11,7,12,32,58,235,2013
D. Farmer,REN,31.0,29,6,791,114,290,0.393,67,194,0.345,47,96,0.49,0.509,63,69,0.913,12,60,72,70,16,3,49,42,358,2013
M. Farrakhan,TOT,24.0,33,9,589,84,230,0.365,18,69,0.261,66,161,0.41,0.404,39,57,0.684,13,58,71,52,12,5,43,43,225,2013
M. Farrakhan,SFL,24.0,8,4,150,24,63,0.381,3,9,0.333,21,54,0.389,0.405,12,16,0.75,2,19,21,16,5,2,16,8,63,2013
M. Farrakhan,IOW,24.0,19,5,356,47,137,0.343,13,53,0.245,34,84,0.405,0.391,19,26,0.731,10,33,43,31,6,3,26,28,126,2013
M. Farrakhan,IDA,24.0,6,0,83,13,30,0.433,2,7,0.286,11,23,0.478,0.467,8,15,0.533,1,6,7,5,1,0,1,7,36,2013
G. Flowers,LOS,,46,41,1581,282,588,0.48,43,136,0.316,239,452,0.529,0.516,67,98,0.684,67,234,301,122,62,75,107,130,674,2013
K. Fogg,RIO,,37,10,664,70,190,0.368,36,107,0.336,34,83,0.41,0.463,62,77,0.805,16,79,95,58,29,5,37,71,238,2013
C. Fortson,LOS,24.0,46,46,1768,286,718,0.398,65,183,0.355,221,535,0.413,0.444,183,239,0.766,59,171,230,328,93,3,164,132,820,2013
S. Foster,BAK,,41,3,623,86,225,0.382,46,141,0.326,40,84,0.476,0.484,18,22,0.818,18,51,69,41,27,5,26,50,236,2013
W. Foster,TOT,,33,1,499,40,68,0.588,0,1,0.0,40,67,0.597,0.588,21,47,0.447,60,82,142,11,9,63,26,48,101,2013
W. Foster,SFL,,30,1,490,40,68,0.588,0,1,0.0,40,67,0.597,0.588,21,47,0.447,60,81,141,11,9,61,26,48,101,2013
W. Foster,MAI,,3,0,9,0,0,0.0,0,0,0.0,0,0,0.0,0.0,0,0,0.0,0,1,1,0,0,2,0,0,0,2013
T. Franklin,CAN,,42,8,654,114,224,0.509,0,5,0.0,114,219,0.521,0.509,80,106,0.755,44,40,84,29,17,10,34,64,308,2013
J. Freeland,IDA,25.0,2,2,74,18,36,0.5,0,0,0.0,18,36,0.5,0.5,5,6,0.833,4,17,21,7,0,0,2,7,41,2013
D. Garrett,BAK,24.0,8,6,261,54,110,0.491,13,21,0.619,41,89,0.461,0.55,17,21,0.81,7,17,24,58,13,1,23,11,138,2013
D. Gary,FOR,,11,0,102,4,28,0.143,2,12,0.167,2,16,0.125,0.179,8,12,0.667,1,3,4,16,8,1,10,5,18,2013
K. Gibson,CAN,,44,44,1453,241,569,0.424,65,159,0.409,176,410,0.429,0.481,183,216,0.847,21,122,143,157,30,5,99,100,730,2013
A. Gilchrist,IOW,,23,3,316,40,77,0.519,0,0,0.0,40,77,0.519,0.519,24,39,0.615,36,43,79,10,9,9,11,38,104,2013
M. Gladness,SAN,26.0,49,19,1075,130,257,0.506,0,0,0.0,130,257,0.506,0.506,48,88,0.545,104,196,300,19,17,114,48,109,308,2013
K. Goldcamp,ERI,,41,29,1005,144,296,0.486,0,3,0.0,144,293,0.491,0.486,45,66,0.682,101,167,268,66,33,14,53,82,333,2013
A. Goudelock,RIO,24.0,37,37,1359,302,615,0.491,76,188,0.404,226,427,0.529,0.553,111,132,0.841,23,129,152,215,49,5,109,57,791,2013
A. Goudelock,TOT,24.0,51,51,1881,411,864,0.476,96,260,0.369,315,604,0.522,0.531,157,188,0.835,30,170,200,263,59,7,143,81,1075,2013
A. Goudelock,SFL,24.0,14,14,522,109,249,0.438,20,72,0.278,89,177,0.503,0.478,46,56,0.821,7,41,48,48,10,2,34,24,284,2013
L. Goulbourne,SAN,,35,1,627,68,158,0.43,3,18,0.167,65,140,0.464,0.44,59,75,0.787,54,131,185,25,11,23,36,56,198,2013
G. Green,REN,,20,4,161,19,44,0.432,0,0,0.0,19,44,0.432,0.432,9,20,0.45,19,31,50,1,1,2,7,20,47,2013
G. Green,IDA,,5,0,34,4,15,0.267,0,1,0.0,4,14,0.286,0.267,2,3,0.667,5,6,11,0,1,1,1,4,10,2013
G. Green,TOT,,25,4,195,23,59,0.39,0,1,0.0,23,58,0.397,0.39,11,23,0.478,24,37,61,1,2,3,8,24,57,2013
J. Green,AUS,22.0,40,25,969,196,395,0.496,2,11,0.182,194,384,0.505,0.499,97,124,0.782,104,220,324,54,36,31,72,121,491,2013
O. Greene,REN,30.0,14,14,416,47,130,0.362,17,60,0.283,30,70,0.429,0.427,24,27,0.889,15,46,61,48,30,5,32,45,135,2013
O. Greene,LOS,30.0,29,17,873,109,265,0.411,52,136,0.382,57,129,0.442,0.509,58,79,0.734,16,83,99,77,52,10,65,99,328,2013
O. Greene,TOT,30.0,43,31,1289,156,395,0.395,69,196,0.352,87,199,0.437,0.482,82,106,0.774,31,129,160,125,82,15,97,144,463,2013
T. Griffin,SAN,26.0,48,44,1230,190,446,0.426,25,72,0.347,165,374,0.441,0.454,109,163,0.669,111,199,310,91,59,26,82,139,514,2013
J. Gutierrez,CAN,24.0,50,43,1565,188,439,0.428,12,52,0.231,176,387,0.455,0.442,135,173,0.78,36,209,245,235,89,14,144,178,523,2013
R. Hamilton,IDA,,18,3,354,56,141,0.397,25,62,0.403,31,79,0.392,0.486,30,39,0.769,9,23,32,47,19,0,41,47,167,2013
S. Hannah,SAN,27.0,49,47,1463,236,688,0.343,106,354,0.299,130,334,0.389,0.42,110,148,0.743,38,145,183,249,96,3,165,130,688,2013
L. Harangody,FOR,25.0,17,16,601,127,284,0.447,23,57,0.404,104,227,0.458,0.488,61,78,0.782,53,148,201,33,17,14,33,43,338,2013
D. Hardin,RIO,,10,4,132,16,29,0.552,0,0,0.0,16,29,0.552,0.552,13,20,0.65,13,31,44,4,2,10,11,29,45,2013
D. Harper,ERI,,50,1,1126,167,431,0.387,48,133,0.361,119,298,0.399,0.443,70,103,0.68,38,85,123,107,42,11,79,84,452,2013
J. Harper,IDA,23.0,48,20,1277,219,525,0.417,48,148,0.324,171,377,0.454,0.463,75,103,0.728,120,190,310,47,37,17,68,121,561,2013
A. Harris,FOR,27.0,35,17,901,135,314,0.43,7,25,0.28,128,289,0.443,0.441,37,61,0.607,23,83,106,153,25,3,69,71,314,2013
P. Harris,IOW,,47,31,1466,302,620,0.487,10,33,0.303,292,587,0.497,0.495,178,234,0.761,133,282,415,83,58,37,69,123,792,2013
T. Harris,RIO,25.0,12,7,357,56,113,0.496,23,49,0.469,33,64,0.516,0.597,15,26,0.577,23,63,86,40,13,1,30,30,150,2013
L. Hayward,LOS,26.0,14,1,442,83,164,0.506,20,48,0.417,63,116,0.543,0.567,37,47,0.787,34,78,112,31,13,5,23,32,223,2013
L. Head,TOT,,11,1,259,53,116,0.457,14,39,0.359,39,77,0.506,0.517,18,23,0.783,4,20,24,10,16,1,18,17,138,2013
L. Head,TEX,,5,1,153,31,71,0.437,9,25,0.36,22,46,0.478,0.5,11,16,0.688,3,12,15,7,11,0,13,8,82,2013
L. Head,AUS,,6,0,106,22,45,0.489,5,14,0.357,17,31,0.548,0.544,7,7,1.0,1,8,9,3,5,1,5,9,56,2013
C. Higgins,ERI,23.0,30,28,1077,202,435,0.464,47,127,0.37,155,308,0.503,0.518,103,117,0.88,27,102,129,75,40,8,53,67,554,2013
R. Hite,IOW,29.0,26,0,569,79,212,0.373,33,105,0.314,46,107,0.43,0.45,33,40,0.825,18,53,71,59,30,4,35,50,224,2013
D. Hobson,SAN,25.0,36,10,927,126,322,0.391,41,125,0.328,85,197,0.431,0.455,38,67,0.567,57,159,216,152,34,12,94,81,331,2013
J. Holiday,IDA,23.0,47,42,1629,290,689,0.421,77,187,0.412,213,502,0.424,0.477,155,190,0.816,57,191,248,118,114,55,96,98,812,2013
T. Honeycutt,RIO,22.0,8,2,146,29,56,0.518,8,18,0.444,21,38,0.553,0.589,15,17,0.882,10,33,43,12,15,6,15,18,81,2013
T. Honeycutt,REN,22.0,7,3,218,30,65,0.462,5,14,0.357,25,51,0.49,0.5,11,14,0.786,21,46,67,10,16,12,18,16,76,2013
T. Honeycutt,TOT,22.0,15,5,364,59,121,0.488,13,32,0.406,46,89,0.517,0.541,26,31,0.839,31,79,110,22,31,18,33,34,157,2013
D. Horner,SPR,24.0,31,19,969,133,293,0.454,31,83,0.373,102,210,0.486,0.507,73,92,0.793,79,121,200,39,27,12,51,68,370,2013
F. House,TEX,,44,9,1029,119,341,0.349,59,181,0.326,60,160,0.375,0.435,54,71,0.761,50,100,150,61,71,19,46,132,351,2013
R. Howard,FOR,,35,32,1203,230,501,0.459,5,18,0.278,225,483,0.466,0.464,205,242,0.847,18,125,143,165,48,4,96,112,670,2013
L. Hudson,AUS,28.0,11,10,403,66,151,0.437,35,82,0.427,31,69,0.449,0.553,33,35,0.943,13,43,56,40,27,4,34,38,200,2013
T. Hudson,SFL,36.0,14,12,369,60,148,0.405,17,54,0.315,43,94,0.457,0.463,18,21,0.857,8,29,37,51,3,0,27,10,155,2013
J. Hurtt,IOW,,43,28,1126,184,461,0.399,60,174,0.345,124,287,0.432,0.464,99,123,0.805,18,92,110,56,34,9,55,72,527,2013
T. Hyman,LOS,25.0,9,0,82,4,12,0.333,0,0,0.0,4,12,0.333,0.333,0,0,0.0,3,15,18,0,1,1,5,10,8,2013
T. Hyman,TUL,25.0,26,1,266,33,74,0.446,0,0,0.0,33,74,0.446,0.446,16,50,0.32,20,34,54,12,8,37,33,49,82,2013
T. Hyman,TOT,25.0,35,1,348,37,86,0.43,0,0,0.0,37,86,0.43,0.43,16,50,0.32,23,49,72,12,9,38,38,59,90,2013
D. Jackson,REN,27.0,19,12,532,102,201,0.507,0,3,0.0,102,198,0.515,0.507,58,83,0.699,36,91,127,23,25,10,37,66,262,2013
R. Jackson,TUL,22.0,3,3,114,33,55,0.6,5,14,0.357,28,41,0.683,0.645,13,13,1.0,2,20,22,25,1,0,8,7,84,2013
R. Jackson,AUS,23.0,48,34,1235,238,456,0.522,1,1,1.0,237,455,0.521,0.523,42,100,0.42,182,297,479,54,47,64,77,117,519,2013
D. James,BAK,25.0,44,43,1357,267,648,0.412,26,100,0.26,241,548,0.44,0.432,136,180,0.756,73,287,360,80,62,47,118,104,696,2013
M. James,TEX,37.0,2,2,68,14,29,0.483,4,9,0.444,10,20,0.5,0.552,5,8,0.625,0,2,2,8,5,0,4,3,37,2013
D. Jefferson,AUS,29.0,12,0,192,21,51,0.412,4,13,0.308,17,38,0.447,0.451,16,21,0.762,4,12,16,23,4,1,27,23,62,2013
D. Jefferson,TOT,29.0,24,0,377,33,85,0.388,7,23,0.304,26,62,0.419,0.429,26,42,0.619,7,34,41,47,14,2,38,45,99,2013
D. Jefferson,REN,29.0,12,0,185,12,34,0.353,3,10,0.3,9,24,0.375,0.397,10,21,0.476,3,22,25,24,10,1,11,22,37,2013
O. Jeffers,IOW,27.0,33,31,1086,175,360,0.486,8,23,0.348,167,337,0.496,0.497,126,170,0.741,53,125,178,122,55,4,79,78,484,2013
J. Jenkins,BAK,21.0,2,2,66,18,34,0.529,4,10,0.4,14,24,0.583,0.588,11,11,1.0,1,6,7,6,3,0,3,3,51,2013
T. Jennings,TOT,24.0,34,1,480,72,152,0.474,1,3,0.333,71,149,0.477,0.477,20,38,0.526,40,62,102,5,23,34,29,71,165,2013
T. Jennings,IOW,24.0,33,1,463,67,146,0.459,0,2,0.0,67,144,0.465,0.459,20,38,0.526,39,60,99,5,22,31,28,68,154,2013
T. Jennings,ERI,24.0,1,0,17,5,6,0.833,1,1,1.0,4,5,0.8,0.917,0,0,0.0,1,2,3,0,1,3,1,3,11,2013
C. Jerrells,MAI,,10,9,375,50,108,0.463,24,55,0.436,26,53,0.491,0.574,20,30,0.667,6,27,33,56,19,2,25,21,144,2013
C. Johnson,SAN,27.0,14,5,358,60,113,0.531,0,1,0.0,60,112,0.536,0.531,33,49,0.673,29,57,86,15,15,29,10,38,153,2013
C. Johnson,RIO,22.0,39,24,1049,143,335,0.427,78,205,0.38,65,130,0.5,0.543,49,66,0.742,58,105,163,30,58,13,37,73,413,2013
D. Johnson-Odom,LOS,23.0,13,13,518,91,207,0.44,24,61,0.393,67,146,0.459,0.498,67,82,0.817,12,55,67,67,17,3,39,21,273,2013
D. Johnson,TOT,,36,2,730,118,275,0.429,30,98,0.306,88,177,0.497,0.484,65,86,0.756,18,70,88,48,22,4,55,53,331,2013
D. Johnson,SFL,,1,0,8,1,2,0.5,0,0,0.0,1,2,0.5,0.5,0,0,0.0,1,0,1,0,0,0,0,0,2,2013
D. Johnson,CAN,,35,2,722,117,273,0.429,30,98,0.306,87,175,0.497,0.484,65,86,0.756,17,70,87,48,22,4,55,53,329,2013
J. Johnson,TOT,23.0,42,17,980,162,371,0.437,0,5,0.0,162,366,0.443,0.437,69,88,0.784,66,156,222,21,39,57,48,93,393,2013
J. Johnson,IDA,23.0,12,1,162,33,62,0.532,0,2,0.0,33,60,0.55,0.532,15,19,0.789,5,16,21,4,7,5,10,15,81,2013
J. Johnson,FOR,23.0,13,13,455,71,179,0.397,0,2,0.0,71,177,0.401,0.397,30,37,0.811,35,81,116,8,17,28,19,39,172,2013
J. Johnson,CAN,23.0,17,3,363,58,130,0.446,0,1,0.0,58,129,0.45,0.446,24,32,0.75,26,59,85,9,15,24,19,39,140,2013
J. Johnson,TOT,24.0,41,0,749,126,283,0.445,15,30,0.5,111,253,0.439,0.472,46,55,0.836,18,94,112,70,18,1,63,51,313,2013
J. Johnson,SPR,24.0,20,0,376,77,152,0.507,14,22,0.636,63,130,0.485,0.553,16,19,0.842,11,41,52,39,7,0,35,22,184,2013
J. Johnson,SAN,24.0,21,0,373,49,131,0.374,1,8,0.125,48,123,0.39,0.378,30,36,0.833,7,53,60,31,11,1,28,29,129,2013
O. Johnson,FOR,23.0,4,4,157,32,75,0.427,7,23,0.304,25,52,0.481,0.473,23,26,0.885,7,16,23,13,7,2,10,9,94,2013
C. Jones,SAN,23.0,50,33,1351,252,521,0.484,19,52,0.365,233,469,0.497,0.502,108,136,0.794,26,117,143,113,63,3,68,84,631,2013
D. Jones,SPR,24.0,9,8,280,51,121,0.421,11,38,0.289,40,83,0.482,0.467,29,39,0.744,8,29,37,44,17,7,32,28,142,2013
D. Jones,TEX,29.0,21,17,640,67,156,0.429,0,1,0.0,67,155,0.432,0.429,50,81,0.617,119,146,265,29,15,23,36,63,184,2013
K. Jones,CAN,23.0,12,12,450,116,219,0.53,4,12,0.333,112,207,0.541,0.539,33,44,0.75,59,75,134,14,16,10,21,31,269,2013
P. Jones,TUL,21.0,15,15,487,88,195,0.451,5,17,0.294,83,178,0.466,0.464,33,51,0.647,27,83,110,26,18,9,15,40,214,2013
P. Jones,LOS,,11,0,99,11,18,0.611,0,0,0.0,11,18,0.611,0.611,5,8,0.625,7,10,17,4,0,6,6,21,27,2013
T. Jones,RIO,21.0,24,15,741,167,349,0.479,30,101,0.297,137,248,0.552,0.521,93,134,0.694,57,160,217,59,36,32,42,50,457,2013
J. Jordan,TOT,26.0,42,36,1236,208,339,0.614,1,1,1.0,207,338,0.612,0.615,104,146,0.712,105,213,318,33,20,84,78,128,521,2013
J. Jordan,REN,26.0,24,20,732,119,202,0.589,0,0,0.0,119,202,0.589,0.589,75,97,0.773,66,128,194,20,11,59,54,85,313,2013
J. Jordan,LOS,26.0,18,16,504,89,137,0.65,1,1,1.0,88,136,0.647,0.653,29,49,0.592,39,85,124,13,9,25,24,43,208,2013
C. Joseph,AUS,21.0,26,26,1002,175,382,0.458,35,73,0.479,140,309,0.453,0.504,119,148,0.804,31,95,126,142,50,10,67,64,504,2013
K. Joseph,TOT,24.0,27,23,919,176,422,0.417,44,117,0.376,132,305,0.433,0.469,107,131,0.817,51,74,125,49,47,13,65,47,503,2013
K. Joseph,SPR,24.0,15,15,511,96,236,0.407,35,80,0.438,61,156,0.391,0.481,58,72,0.806,22,38,60,32,26,7,35,32,285,2013
K. Joseph,MAI,24.0,12,8,408,80,186,0.43,9,37,0.243,71,149,0.477,0.454,49,59,0.831,29,36,65,17,21,6,30,15,218,2013
C. Karl,IDA,29.0,50,50,1807,200,498,0.402,70,199,0.352,130,299,0.435,0.472,194,245,0.792,33,157,190,313,72,19,163,167,664,2013
T. Kelley,AUS,28.0,48,19,1335,209,463,0.451,45,115,0.391,164,348,0.471,0.5,105,135,0.778,10,109,119,235,41,10,133,103,568,2013
D. Kennedy,RIO,23.0,14,4,451,49,121,0.405,16,46,0.348,33,75,0.44,0.471,44,53,0.83,15,70,85,60,20,1,28,30,158,2013
D. Kennedy,ERI,23.0,35,35,1382,215,481,0.447,41,114,0.36,174,367,0.474,0.49,186,222,0.838,43,249,292,192,58,8,121,93,657,2013
D. Kennedy,TOT,23.0,49,39,1833,264,602,0.439,57,160,0.356,207,442,0.468,0.486,230,275,0.836,58,319,377,252,78,9,149,123,815,2013
A. Koch,BAK,,49,34,1402,154,308,0.5,16,47,0.34,138,261,0.529,0.526,127,154,0.825,100,161,261,70,42,25,69,100,451,2013
K. Kruger,LOS,,9,0,113,11,28,0.393,5,19,0.263,6,9,0.667,0.482,2,3,0.667,0,5,5,11,3,0,1,6,29,2013
D. Lamb,FOR,21.0,6,1,153,22,58,0.379,7,15,0.467,15,43,0.349,0.44,11,12,0.917,8,12,20,15,4,0,5,12,62,2013
J. Lamb,TUL,20.0,21,21,689,169,345,0.49,37,105,0.352,132,240,0.55,0.543,66,75,0.88,32,79,111,64,26,17,52,42,441,2013
M. Landry,REN,27.0,35,35,1289,204,466,0.438,128,299,0.428,76,167,0.455,0.575,43,56,0.768,30,146,176,34,34,34,54,100,579,2013
R. Larry,IDA,,1,0,7,0,3,0.0,0,0,0.0,0,3,0.0,0.0,0,0,0.0,0,1,1,0,0,0,0,1,0,2013
K. Lawson,IOW,,17,5,267,38,87,0.437,4,18,0.222,34,69,0.493,0.46,23,36,0.639,24,32,56,5,3,13,12,41,103,2013
T. Leslie,SAN,22.0,36,32,982,234,473,0.495,28,77,0.364,206,396,0.52,0.524,58,79,0.734,94,153,247,76,62,19,86,79,554,2013
J. Leuer,CAN,23.0,8,7,292,62,121,0.512,7,15,0.467,55,106,0.519,0.541,25,40,0.625,13,85,98,14,10,4,22,23,156,2013
V. Lewis,TEX,29.0,42,5,568,47,122,0.385,1,8,0.125,46,114,0.404,0.389,15,25,0.6,51,97,148,27,32,6,22,81,110,2013
D. Liggins,TUL,24.0,19,19,649,78,173,0.451,29,63,0.46,49,110,0.445,0.535,36,54,0.667,23,109,132,82,33,7,49,51,221,2013
M. Little,TUL,25.0,15,1,185,24,64,0.375,5,30,0.167,19,34,0.559,0.414,6,6,1.0,3,28,31,13,6,5,14,17,59,2013
J. Lucas,SFL,,4,0,63,10,27,0.37,1,4,0.25,9,23,0.391,0.389,0,0,0.0,0,6,6,7,1,0,3,5,21,2013
J. Lucas,IDA,,12,0,255,38,94,0.404,3,15,0.2,35,79,0.443,0.42,14,16,0.875,2,18,20,30,2,2,18,22,93,2013
J. Lucas,CAN,,3,0,47,7,14,0.5,1,5,0.2,6,9,0.667,0.536,2,2,1.0,0,3,3,9,0,0,3,3,17,2013
J. Lucas,TOT,,19,0,365,55,135,0.407,5,24,0.208,50,111,0.45,0.426,16,18,0.889,2,27,29,46,3,2,24,30,131,2013
S. Machado,TOT,22.0,28,9,672,77,205,0.376,25,77,0.325,52,128,0.406,0.437,71,89,0.798,11,60,71,144,28,5,76,49,250,2013
S. Machado,SAN,22.0,10,0,150,17,53,0.321,6,23,0.261,11,30,0.367,0.377,25,29,0.862,2,16,18,34,10,1,20,8,65,2013
S. Machado,RIO,22.0,18,9,522,60,152,0.395,19,54,0.352,41,98,0.418,0.457,46,60,0.767,9,44,53,110,18,4,56,41,185,2013
V. Macklin,RIO,26.0,22,4,526,134,242,0.554,0,1,0.0,134,241,0.556,0.554,54,89,0.607,57,66,123,23,11,19,41,48,322,2013
S. Mack,MAI,23.0,23,22,928,164,361,0.454,50,137,0.365,114,224,0.509,0.524,84,96,0.875,7,91,98,176,30,2,88,62,462,2013
R. Major,BAK,30.0,41,36,1189,186,401,0.464,13,54,0.241,173,347,0.499,0.48,172,217,0.793,41,94,135,55,52,34,49,106,557,2013
K. Marshall,BAK,21.0,9,9,279,31,99,0.313,6,27,0.222,25,72,0.347,0.343,18,26,0.692,5,22,27,68,11,0,30,20,86,2013
J. Mason,TEX,,1,0,13,1,2,0.5,0,0,0.0,1,2,0.5,0.5,0,2,0.0,0,2,2,0,0,0,0,1,2,2013
J. Mays,MAI,,5,4,158,23,62,0.371,1,2,0.5,22,60,0.367,0.379,15,21,0.714,26,22,48,9,12,7,14,12,62,2013
J. Mays,TOT,,47,45,1584,285,650,0.438,2,12,0.167,283,638,0.444,0.44,147,249,0.59,186,284,470,64,61,53,130,150,719,2013
J. Mays,SPR,,26,26,948,170,403,0.422,1,6,0.167,169,397,0.426,0.423,85,152,0.559,105,170,275,41,32,31,75,86,426,2013
J. Mays,SFL,,16,15,478,92,185,0.497,0,4,0.0,92,181,0.508,0.497,47,76,0.618,55,92,147,14,17,15,41,52,231,2013
D. McCamey,FOR,23.0,6,0,124,16,43,0.372,8,25,0.32,8,18,0.444,0.465,6,8,0.75,3,5,8,20,10,2,10,10,46,2013
D. McCamey,ERI,23.0,28,10,560,59,164,0.36,35,96,0.365,24,68,0.353,0.466,20,27,0.741,6,43,49,58,18,3,33,51,173,2013
D. McCamey,TOT,23.0,43,10,766,82,238,0.345,46,139,0.331,36,99,0.364,0.441,28,37,0.757,9,54,63,84,33,5,48,68,238,2013
D. McCamey,RIO,23.0,9,0,82,7,31,0.226,3,18,0.167,4,13,0.308,0.274,2,2,1.0,0,6,6,6,5,0,5,7,19,2013
R. McCants,TEX,28.0,4,3,138,31,63,0.492,12,24,0.5,19,39,0.487,0.587,5,9,0.556,0,14,14,8,9,1,10,12,79,2013
J. McClinton,REN,,3,2,38,0,13,0.0,0,5,0.0,0,8,0.0,0.0,2,3,0.667,0,4,4,2,0,0,1,6,2,2013
C. McFarland,TOT,,19,4,199,25,60,0.417,0,0,0.0,25,60,0.417,0.417,15,24,0.625,21,32,53,8,8,4,19,36,65,2013
C. McFarland,TEX,,9,0,61,10,21,0.476,0,0,0.0,10,21,0.476,0.476,1,4,0.25,9,5,14,5,3,0,7,15,21,2013
C. McFarland,SPR,,10,4,138,15,39,0.385,0,0,0.0,15,39,0.385,0.385,14,20,0.7,12,27,39,3,5,4,12,21,44,2013
L. McMorrow,IOW,,4,0,26,2,6,0.333,0,0,0.0,2,6,0.333,0.333,6,11,0.545,4,4,8,1,0,0,3,8,10,2013
J. McNeal,BAK,25.0,44,36,1335,277,632,0.438,77,197,0.391,200,435,0.46,0.499,165,204,0.809,21,112,133,241,72,22,162,119,796,2013
F. Melo,MAI,22.0,33,31,864,138,268,0.515,0,0,0.0,138,268,0.515,0.515,48,71,0.676,76,121,197,26,15,103,46,111,324,2013
K. Middleton,FOR,21.0,3,3,79,16,47,0.34,1,7,0.143,15,40,0.375,0.351,0,0,0.0,4,19,23,9,2,1,7,8,33,2013
D. Miller,IOW,22.0,11,8,299,39,84,0.464,21,41,0.512,18,43,0.419,0.589,10,13,0.769,7,31,38,18,6,7,15,32,109,2013
Q. Miller,IOW,20.0,23,14,559,92,235,0.391,23,68,0.338,69,167,0.413,0.44,54,72,0.75,43,114,157,28,18,32,45,56,261,2013
E. Millsap,LOS,25.0,44,37,1514,257,616,0.417,30,86,0.349,227,530,0.428,0.442,220,292,0.753,52,218,270,158,86,15,118,138,764,2013
C. Mitchell,SFL,,6,0,60,8,22,0.364,3,9,0.333,5,13,0.385,0.432,3,4,0.75,0,2,2,4,3,2,4,4,22,2013
T. Mitchell,FOR,23.0,48,45,1693,397,941,0.422,102,322,0.317,295,619,0.477,0.476,153,213,0.718,108,200,308,128,68,35,117,141,1049,2013
J. Moon,LOS,32.0,15,11,485,41,120,0.342,12,46,0.261,29,74,0.392,0.392,13,16,0.813,17,86,103,32,34,32,17,26,107,2013
R. Moore,SPR,,37,13,884,132,312,0.423,51,132,0.386,81,180,0.45,0.505,24,29,0.828,12,73,85,87,35,4,60,87,339,2013
B. Morningstar,TOT,,27,0,409,47,123,0.382,18,49,0.367,29,74,0.392,0.455,7,11,0.636,8,34,42,38,21,0,32,28,119,2013
B. Morningstar,CAN,,11,0,186,21,47,0.447,7,15,0.467,14,32,0.438,0.521,2,4,0.5,3,15,18,17,9,0,11,15,51,2013
B. Morningstar,TUL,,16,0,223,26,76,0.342,11,34,0.324,15,42,0.357,0.414,5,7,0.714,5,19,24,21,12,0,21,13,68,2013
D. Morris,LOS,22.0,2,2,70,11,31,0.355,2,11,0.182,9,20,0.45,0.387,6,11,0.545,3,9,12,11,2,0,3,3,30,2013
D. Morrison,IOW,,12,5,224,20,69,0.29,8,26,0.308,12,43,0.279,0.348,20,26,0.769,6,23,29,7,7,0,16,18,68,2013
D. Motiejunas,RIO,22.0,7,7,241,59,114,0.518,4,23,0.174,55,91,0.604,0.535,20,32,0.625,16,52,68,21,6,3,17,17,142,2013
A. Moultrie,SFL,22.0,7,3,184,30,64,0.469,0,1,0.0,30,63,0.476,0.469,8,12,0.667,17,26,43,11,4,3,14,11,68,2013
I. Muhammad,BAK,,11,0,205,35,72,0.486,2,6,0.333,33,66,0.5,0.5,11,28,0.393,29,26,55,29,6,4,13,33,83,2013
K. Murphy,REN,22.0,14,12,401,70,157,0.446,14,40,0.35,56,117,0.479,0.49,31,40,0.775,10,33,43,23,13,6,28,34,185,2013
N. Murphy,IOW,,41,14,766,89,224,0.397,3,16,0.188,86,208,0.413,0.404,58,79,0.734,27,84,111,80,56,8,54,82,239,2013
T. Murry,RIO,23.0,46,30,1079,139,305,0.456,26,72,0.361,113,233,0.485,0.498,79,115,0.687,31,86,117,127,74,7,92,68,383,2013
R. Nelson,LOS,,1,0,15,0,0,0.0,0,0,0.0,0,0,0.0,0.0,0,0,0.0,1,1,2,3,0,0,1,1,0,2013
D. Nichols,SFL,28.0,49,49,1764,335,717,0.467,75,207,0.362,260,510,0.51,0.52,173,203,0.852,66,197,263,115,68,39,153,119,918,2013
J. Nunnally,BAK,22.0,49,8,966,168,391,0.43,71,175,0.406,97,216,0.449,0.52,99,112,0.884,35,110,145,90,37,9,61,75,506,2013
D. Nwaelele,SAN,28.0,30,0,548,73,175,0.417,42,107,0.393,31,68,0.456,0.537,33,38,0.868,12,64,76,37,15,4,34,61,221,2013
P. O'Bryant,REN,26.0,4,0,93,19,31,0.613,0,1,0.0,19,30,0.633,0.613,3,8,0.375,3,21,24,3,1,4,12,10,41,2013
G. Odufuwa,TEX,,42,4,706,61,117,0.521,0,0,0.0,61,117,0.521,0.521,41,68,0.603,78,119,197,26,17,31,32,83,163,2013
C. Oguchi,MAI,,24,17,547,71,170,0.418,44,107,0.411,27,63,0.429,0.547,30,37,0.811,10,45,55,33,14,5,38,30,216,2013
T. Ohlbrecht,RIO,24.0,32,29,852,164,271,0.605,1,16,0.063,163,255,0.639,0.607,99,122,0.811,93,143,236,23,36,52,55,104,428,2013
A. Onuaku,CAN,25.0,38,32,901,195,346,0.564,0,0,0.0,195,346,0.564,0.564,90,159,0.566,136,224,360,27,24,35,82,108,480,2013
D. Orton,TUL,22.0,29,29,819,124,232,0.534,1,2,0.5,123,230,0.535,0.537,114,169,0.675,63,164,227,54,31,64,86,126,363,2013
J. Owens,IDA,,42,23,752,95,204,0.466,0,0,0.0,95,204,0.466,0.466,35,56,0.625,73,119,192,18,19,21,43,55,225,2013
D. Partin,FOR,,33,16,554,83,227,0.366,33,112,0.295,50,115,0.435,0.438,14,19,0.737,8,44,52,37,24,3,25,41,213,2013
D. Pittman,SFL,24.0,15,12,373,70,149,0.47,0,0,0.0,70,149,0.47,0.47,46,60,0.767,58,74,132,5,14,25,32,47,186,2013
M. Plumlee,FOR,24.0,15,12,457,75,164,0.457,0,0,0.0,75,164,0.457,0.457,18,36,0.5,54,99,153,18,12,28,37,36,168,2013
C. Polk,SPR,,32,8,755,108,289,0.374,56,150,0.373,52,139,0.374,0.471,30,33,0.909,8,58,66,51,17,0,42,70,302,2013
E. Polynice,LOS,,1,0,5,0,3,0.0,0,1,0.0,0,2,0.0,0.0,1,2,0.5,0,0,0,1,0,0,2,1,1,2013
C. Porter,FOR,34.0,34,3,472,65,127,0.512,0,1,0.0,65,126,0.516,0.512,36,57,0.632,51,75,126,26,23,5,22,73,166,2013
T. Porter,RIO,24.0,15,0,231,31,83,0.373,11,37,0.297,20,46,0.435,0.44,15,18,0.833,4,16,20,44,4,0,19,9,88,2013
T. Porter,REN,24.0,20,9,485,69,191,0.361,19,66,0.288,50,125,0.4,0.411,33,35,0.943,12,23,35,74,16,0,42,29,190,2013
T. Porter,TOT,24.0,35,9,716,100,274,0.365,30,103,0.291,70,171,0.409,0.42,48,53,0.906,16,39,55,118,20,0,61,38,278,2013
G. Pruitt,TOT,26.0,38,8,792,81,230,0.352,34,110,0.309,47,120,0.392,0.426,40,55,0.727,12,79,91,81,49,3,48,52,236,2013
G. Pruitt,SFL,26.0,34,7,738,76,219,0.347,32,106,0.302,44,113,0.389,0.42,38,51,0.745,11,71,82,78,47,3,46,48,222,2013
G. Pruitt,MAI,26.0,4,1,54,5,11,0.455,2,4,0.5,3,7,0.429,0.545,2,4,0.5,1,8,9,3,2,0,2,4,14,2013
C. Quinn,TUL,29.0,25,23,810,123,259,0.475,29,78,0.372,94,181,0.519,0.531,43,48,0.896,9,55,64,152,33,6,42,61,318,2013
A. Rautins,TUL,26.0,48,31,1424,223,507,0.44,152,348,0.437,71,159,0.447,0.59,48,62,0.774,21,114,135,115,48,5,103,93,646,2013
O. Reed,MAI,25.0,44,1,792,90,194,0.464,27,85,0.318,63,109,0.578,0.534,31,49,0.633,70,136,206,54,37,10,43,47,238,2013
W. Reed,SPR,22.0,48,30,1407,307,551,0.557,0,1,0.0,307,550,0.558,0.557,94,186,0.505,161,211,372,35,26,85,68,137,708,2013
D. Rice,TEX,30.0,25,25,773,135,352,0.384,83,237,0.35,52,115,0.452,0.501,38,52,0.731,34,138,172,32,27,16,31,59,391,2013
G. Rice,RIO,22.0,42,25,996,190,387,0.491,67,174,0.385,123,213,0.577,0.578,100,133,0.752,77,185,262,78,37,31,69,85,547,2013
A. Richardson,TOT,,39,33,1120,196,434,0.452,42,110,0.382,154,324,0.475,0.5,84,109,0.771,67,117,184,64,61,47,74,95,518,2013
A. Richardson,REN,,6,4,149,20,49,0.408,6,14,0.429,14,35,0.4,0.469,21,24,0.875,10,16,26,10,5,6,10,15,67,2013
A. Richardson,FOR,,33,29,971,176,385,0.457,36,96,0.375,140,289,0.484,0.504,63,85,0.741,57,101,158,54,56,41,64,80,451,2013
J. Rivers,MAI,,14,4,234,17,57,0.298,0,8,0.0,17,49,0.347,0.298,8,10,0.8,4,20,24,20,16,6,12,33,42,2013
C. Roberts,TOT,,42,35,1387,212,486,0.436,51,158,0.323,161,328,0.491,0.489,131,166,0.789,72,103,175,96,43,18,64,82,606,2013
C. Roberts,TEX,,16,16,557,101,226,0.447,28,85,0.329,73,141,0.518,0.509,57,71,0.803,41,55,96,31,23,6,25,29,287,2013
C. Roberts,AUS,,26,19,830,111,260,0.427,23,73,0.315,88,187,0.471,0.471,74,95,0.779,31,48,79,65,20,12,39,53,319,2013
S. Rojas,FOR,,50,2,1164,156,347,0.45,30,89,0.337,126,258,0.488,0.493,61,87,0.701,126,185,311,54,64,20,53,142,403,2013
R. Rossiter,CAN,,43,16,680,102,204,0.5,3,11,0.273,99,193,0.513,0.507,51,67,0.761,77,112,189,29,20,17,59,111,258,2013
A. Ruoff,TOT,,37,1,946,112,268,0.418,54,148,0.365,58,120,0.483,0.519,34,43,0.791,24,87,111,56,39,9,46,72,312,2013
A. Ruoff,IOW,,13,0,309,50,97,0.515,24,57,0.421,26,40,0.65,0.639,13,18,0.722,2,26,28,18,13,2,18,22,137,2013
A. Ruoff,CAN,,24,1,637,62,171,0.363,30,91,0.33,32,80,0.4,0.45,21,25,0.84,22,61,83,38,26,7,28,50,175,2013
W. Russell,FOR,30.0,11,11,375,60,142,0.423,16,47,0.34,44,95,0.463,0.479,32,46,0.696,5,35,40,66,13,0,36,17,168,2013
W. Russell,TOT,30.0,32,26,1039,129,372,0.347,27,103,0.262,102,269,0.379,0.383,95,120,0.792,22,87,109,207,31,1,103,52,380,2013
W. Russell,REN,30.0,21,15,664,69,230,0.3,11,56,0.196,58,174,0.333,0.324,63,74,0.851,17,52,69,141,18,1,67,35,212,2013
R. Sacre,LOS,23.0,7,7,229,29,66,0.439,0,0,0.0,29,66,0.439,0.439,22,24,0.917,15,44,59,4,3,10,11,17,80,2013
R. Sampson,REN,23.0,23,0,208,20,44,0.455,0,1,0.0,20,43,0.465,0.455,13,15,0.867,22,26,48,4,5,11,10,33,53,2013
S. Samuels,REN,24.0,32,31,1185,237,491,0.483,0,2,0.0,237,489,0.485,0.483,158,252,0.627,100,228,328,64,16,35,97,108,632,2013
S. Samuels,CAN,24.0,2,2,75,17,30,0.567,0,0,0.0,17,30,0.567,0.567,7,12,0.583,7,14,21,5,3,3,5,5,41,2013
S. Samuels,TOT,24.0,34,33,1260,254,521,0.488,0,2,0.0,254,519,0.489,0.488,165,264,0.625,107,242,349,69,19,38,102,113,673,2013
J. Sanders,AUS,,49,48,1608,211,464,0.455,70,188,0.372,141,276,0.511,0.53,54,70,0.771,59,145,204,136,63,8,88,109,546,2013
D. Saunders,TOT,24.0,38,12,819,122,277,0.44,38,120,0.317,84,157,0.535,0.509,53,94,0.564,47,112,159,40,54,58,56,80,335,2013
D. Saunders,SFL,24.0,27,8,575,100,217,0.461,28,81,0.346,72,136,0.529,0.525,43,74,0.581,33,86,119,28,42,41,41,57,271,2013
D. Saunders,RIO,24.0,11,4,244,22,60,0.367,10,39,0.256,12,21,0.571,0.45,10,20,0.5,14,26,40,12,12,17,15,23,64,2013
C. Scott,SPR,,48,35,1410,188,479,0.392,109,295,0.369,79,184,0.429,0.506,70,83,0.843,44,225,269,86,66,48,50,137,555,2013
M. Scott,BAK,24.0,7,7,228,47,93,0.505,0,2,0.0,47,91,0.516,0.505,33,41,0.805,26,32,58,10,5,0,15,18,127,2013
J. Selby,TOT,21.0,23,8,644,120,306,0.392,23,85,0.271,97,221,0.439,0.43,62,82,0.756,18,90,108,88,21,3,45,31,325,2013
J. Selby,REN,21.0,2,0,68,18,41,0.439,0,6,0.0,18,35,0.514,0.439,8,9,0.889,2,11,13,14,5,1,7,5,44,2013
J. Selby,MAI,21.0,10,0,214,45,102,0.441,9,33,0.273,36,69,0.522,0.485,14,19,0.737,5,19,24,28,6,1,11,14,113,2013
J. Selby,CAN,21.0,11,8,362,57,163,0.35,14,46,0.304,43,117,0.368,0.393,40,54,0.741,11,60,71,46,10,1,27,12,168,2013
M. Shakur,ERI,28.0,7,7,265,45,102,0.441,6,17,0.353,39,85,0.459,0.471,24,30,0.8,10,21,31,39,16,2,24,22,120,2013
T. Shengelia,SPR,21.0,10,10,366,87,165,0.527,15,41,0.366,72,124,0.581,0.573,54,80,0.675,30,52,82,40,23,10,45,37,243,2013
X. Silas,MAI,25.0,33,13,1001,125,328,0.381,37,122,0.303,88,206,0.427,0.438,112,129,0.868,19,88,107,99,37,5,61,74,399,2013
H. Sims,ERI,22.0,41,38,1303,257,511,0.503,1,3,0.333,256,508,0.504,0.504,157,197,0.797,101,256,357,90,26,62,109,148,672,2013
M. Singletary,TOT,,49,22,1231,172,399,0.431,58,143,0.406,114,256,0.445,0.504,92,114,0.807,71,168,239,94,36,12,71,72,494,2013
M. Singletary,RIO,,27,9,647,92,208,0.442,37,83,0.446,55,125,0.44,0.531,53,69,0.768,35,78,113,54,18,8,34,39,274,2013
M. Singletary,ERI,,22,13,584,80,191,0.419,21,60,0.35,59,131,0.45,0.474,39,45,0.867,36,90,126,40,18,4,37,33,220,2013
S. Singletary,TEX,27.0,42,42,1468,195,464,0.42,41,111,0.369,154,353,0.436,0.464,115,142,0.81,31,151,182,236,72,4,101,130,546,2013
D. Sloan,SFL,25.0,10,10,362,86,176,0.489,7,23,0.304,79,153,0.516,0.509,44,57,0.772,12,53,65,74,18,0,27,19,223,2013
G. Smith,RIO,22.0,3,0,70,17,32,0.531,0,0,0.0,17,32,0.531,0.531,3,5,0.6,12,16,28,7,4,0,4,13,37,2013
N. Smith,IDA,24.0,2,2,76,18,44,0.409,2,7,0.286,16,37,0.432,0.432,7,9,0.778,4,7,11,11,2,0,9,7,45,2013
T. Smith,FOR,,29,14,633,83,150,0.553,0,1,0.0,83,149,0.557,0.553,32,68,0.471,67,95,162,39,23,45,49,78,198,2013
S. Sonderleiter,TOT,,10,3,118,10,29,0.345,0,0,0.0,10,29,0.345,0.345,4,6,0.667,12,10,22,3,1,0,7,21,24,2013
S. Sonderleiter,REN,,4,0,46,5,14,0.357,0,0,0.0,5,14,0.357,0.357,4,6,0.667,8,2,10,2,1,0,5,10,14,2013
S. Sonderleiter,FOR,,6,3,72,5,15,0.333,0,0,0.0,5,15,0.333,0.333,0,0,0.0,4,8,12,1,0,0,2,11,10,2013
C. Stanback,ERI,,12,2,196,27,71,0.38,16,37,0.432,11,34,0.324,0.493,3,4,0.75,12,23,35,11,7,3,6,16,73,2013
J. Stone,IOW,24.0,6,1,102,5,22,0.227,3,11,0.273,2,11,0.182,0.295,7,9,0.778,4,19,23,18,3,4,11,7,20,2013
A. Stover,LOS,,25,5,371,20,40,0.5,0,1,0.0,20,39,0.513,0.5,5,13,0.385,22,37,59,8,8,33,16,45,45,2013
B. Strong,IOW,26.0,46,21,963,100,225,0.444,13,22,0.591,87,203,0.429,0.473,36,69,0.522,90,148,238,48,23,34,38,86,249,2013
G. Stutz,MAI,,17,3,219,40,73,0.548,1,2,0.5,39,71,0.549,0.555,13,20,0.65,27,44,71,8,1,11,11,46,94,2013
P. Sullivan,AUS,,47,4,1115,176,369,0.477,0,2,0.0,176,367,0.48,0.477,49,64,0.766,67,206,273,49,24,66,76,133,401,2013
D. Summers,MAI,25.0,29,16,961,199,464,0.429,39,123,0.317,160,341,0.469,0.471,86,107,0.804,62,157,219,37,33,22,68,81,523,2013
D. Summers,IDA,23.0,50,41,1568,305,707,0.431,47,132,0.356,258,575,0.449,0.465,143,189,0.757,63,142,205,95,60,13,104,99,800,2013
D. Sumner,ERI,,1,0,4,0,1,0.0,0,0,0.0,0,1,0.0,0.0,0,0,0.0,0,2,2,0,0,0,0,1,0,2013
D. Sutton,TUL,26.0,48,29,1331,182,357,0.51,2,10,0.2,180,347,0.519,0.513,122,198,0.616,118,180,298,73,77,12,79,185,488,2013
S. Taggart,SPR,,13,5,262,37,95,0.389,0,5,0.0,37,90,0.411,0.389,31,38,0.816,38,24,62,4,5,9,21,45,105,2013
S. Tarver,IDA,,30,1,629,70,211,0.332,16,65,0.246,54,146,0.37,0.37,60,86,0.698,26,83,109,49,22,8,32,46,216,2013
S. Tarver,TOT,,46,8,1085,138,357,0.387,26,103,0.252,112,254,0.441,0.423,87,127,0.685,42,140,182,69,54,10,57,82,389,2013
S. Tarver,SFL,,16,7,456,68,146,0.466,10,38,0.263,58,108,0.537,0.5,27,41,0.659,16,57,73,20,32,2,25,36,173,2013
C. Tatum,BAK,,8,0,147,20,57,0.351,8,28,0.286,12,29,0.414,0.421,7,10,0.7,2,12,14,28,14,3,12,12,55,2013
J. Taylor,MAI,26.0,8,5,259,78,160,0.488,12,33,0.364,66,127,0.52,0.525,27,32,0.844,12,15,27,15,20,3,16,13,195,2013
M. Taylor,LOS,27.0,26,2,511,94,198,0.475,29,82,0.354,65,116,0.56,0.548,39,58,0.672,10,31,41,58,39,2,54,74,256,2013
T. Taylor,TUL,,50,24,1129,115,272,0.423,28,69,0.406,87,203,0.429,0.474,91,114,0.798,15,68,83,159,31,2,73,125,349,2013
T. Taylor,SPR,22.0,8,8,300,76,163,0.466,12,33,0.364,64,130,0.492,0.503,33,42,0.786,7,26,33,60,14,0,38,16,197,2013
G. Temple,REN,26.0,9,9,324,43,97,0.443,20,51,0.392,23,46,0.5,0.546,26,38,0.684,6,38,44,52,11,8,28,34,132,2013
A. Thomas,BAK,25.0,30,0,407,44,135,0.326,41,118,0.347,3,17,0.176,0.478,0,0,0.0,9,41,50,9,15,2,9,41,129,2013
I. Thomas,TEX,,13,6,190,26,61,0.426,0,3,0.0,26,58,0.448,0.426,10,19,0.526,23,32,55,7,6,7,12,30,62,2013
J. Thomas,SPR,,6,2,136,12,37,0.324,1,4,0.25,11,33,0.333,0.338,0,0,0.0,12,12,24,2,1,4,7,5,25,2013
M. Thomas,LOS,24.0,1,1,41,5,10,0.5,0,0,0.0,5,10,0.5,0.5,3,4,0.75,5,12,17,4,3,1,1,4,13,2013
M. Thomas,TOT,24.0,2,2,80,9,18,0.5,0,0,0.0,9,18,0.5,0.5,3,4,0.75,10,22,32,8,4,2,5,7,21,2013
M. Thomas,SAN,24.0,1,1,39,4,8,0.5,0,0,0.0,4,8,0.5,0.5,0,0,0.0,5,10,15,4,1,1,4,3,8,2013
T. Thomas,FOR,32.0,11,2,323,37,72,0.514,6,10,0.6,31,62,0.5,0.556,10,11,0.909,21,46,67,34,12,0,11,11,90,2013
H. Thompson,TUL,21.0,48,10,966,157,351,0.447,21,73,0.288,136,278,0.489,0.477,52,72,0.722,56,128,184,42,30,7,56,67,387,2013
M. Thompson,SFL,24.0,36,24,1026,155,391,0.396,60,188,0.319,95,203,0.468,0.473,53,73,0.726,18,80,98,67,30,14,55,70,423,2013
M. Thompson,ERI,24.0,12,12,443,41,130,0.315,20,61,0.328,21,69,0.304,0.392,21,29,0.724,8,45,53,32,22,8,15,28,123,2013
M. Thompson,TOT,24.0,48,36,1469,196,521,0.376,80,249,0.321,116,272,0.426,0.453,74,102,0.725,26,125,151,99,52,22,70,98,546,2013
H. Thorns,MAI,,12,0,154,11,51,0.216,5,18,0.278,6,33,0.182,0.265,3,6,0.5,1,14,15,32,8,0,17,13,30,2013
B. Toombs,FOR,,2,0,11,2,5,0.4,0,0,0.0,2,5,0.4,0.4,0,0,0.0,0,2,2,0,0,0,0,0,4,2013
C. Tucker,SPR,,13,1,236,35,83,0.422,12,29,0.414,23,54,0.426,0.494,3,9,0.333,10,35,45,20,8,7,12,22,85,2013
D. Tucker,REN,24.0,41,26,1237,235,499,0.471,32,109,0.294,203,390,0.521,0.503,120,183,0.656,54,173,227,68,44,8,65,84,622,2013
J. Tyler,SAN,21.0,12,5,331,89,162,0.549,0,2,0.0,89,160,0.556,0.549,31,51,0.608,43,62,105,12,9,4,52,46,209,2013
M. Tyndale,MAI,27.0,13,11,411,44,106,0.415,8,21,0.381,36,85,0.424,0.453,28,46,0.609,21,53,74,42,25,6,15,19,124,2013
M. Tyndale,TOT,27.0,47,15,1359,160,362,0.442,29,79,0.367,131,283,0.463,0.482,120,197,0.609,44,186,230,172,85,10,113,90,469,2013
M. Tyndale,SFL,27.0,34,4,948,116,256,0.453,21,58,0.362,95,198,0.48,0.494,92,151,0.609,23,133,156,130,60,4,98,71,345,2013
E. Ubiles,TOT,26.0,25,2,490,86,203,0.424,11,45,0.244,75,158,0.475,0.451,25,31,0.806,10,36,46,36,11,9,31,9,208,2013
E. Ubiles,SPR,26.0,11,2,245,39,82,0.476,7,19,0.368,32,63,0.508,0.518,14,15,0.933,1,9,10,18,7,4,15,6,99,2013
E. Ubiles,SAN,26.0,14,0,245,47,121,0.388,4,26,0.154,43,95,0.453,0.405,11,16,0.688,9,27,36,18,4,5,16,3,109,2013
B. Uzoh,SPR,24.0,50,47,1670,261,638,0.409,17,61,0.279,244,577,0.423,0.422,91,143,0.636,61,151,212,262,66,17,120,113,630,2013
S. VanderMeer,MAI,,27,11,349,40,99,0.404,0,0,0.0,40,99,0.404,0.404,15,34,0.441,40,52,92,7,11,48,22,36,95,2013
S. Vanzant,SPR,,11,1,167,14,37,0.378,4,15,0.267,10,22,0.455,0.432,4,4,1.0,4,12,16,20,8,1,15,16,36,2013
J. Varnado,SFL,24.0,23,22,702,137,239,0.573,0,0,0.0,137,239,0.573,0.573,60,103,0.583,74,154,228,21,23,77,69,101,334,2013
A. Vereen,TUL,27.0,3,1,33,2,8,0.25,0,0,0.0,2,8,0.25,0.25,3,6,0.5,2,8,10,1,2,0,1,5,7,2013
B. Voiles,SFL,23.0,30,0,334,31,93,0.333,20,64,0.313,11,29,0.379,0.441,10,17,0.588,16,34,50,20,12,7,12,43,92,2013
H. Walker,AUS,25.0,3,0,60,12,29,0.414,6,14,0.429,6,15,0.4,0.517,0,0,0.0,3,8,11,2,5,1,3,7,30,2013
B. Wallace,FOR,,44,19,1058,136,309,0.44,34,94,0.362,102,215,0.474,0.495,44,74,0.595,95,185,280,54,29,62,46,103,350,2013
A. Wangmene,AUS,23.0,17,0,72,3,16,0.188,0,0,0.0,3,16,0.188,0.188,1,2,0.5,5,14,19,3,0,1,9,17,7,2013
J. Warren,FOR,,2,0,16,1,3,0.333,1,1,1.0,0,2,0.0,0.5,0,0,0.0,0,3,3,0,0,0,0,5,3,2013
M. Wayns,RIO,21.0,9,3,198,37,83,0.446,13,34,0.382,24,49,0.49,0.524,25,29,0.862,4,21,25,27,10,1,28,23,112,2013
K. Weaver,TOT,26.0,37,12,1040,140,317,0.442,37,111,0.333,103,206,0.5,0.5,92,110,0.836,27,132,159,112,47,15,66,88,409,2013
K. Weaver,CAN,26.0,16,12,531,71,164,0.433,15,49,0.306,56,115,0.487,0.479,58,69,0.841,14,72,86,70,25,8,28,36,215,2013
K. Weaver,AUS,26.0,21,0,509,69,153,0.451,22,62,0.355,47,91,0.516,0.523,34,41,0.829,13,60,73,42,22,7,38,52,194,2013
D. West,TEX,29.0,8,8,227,27,77,0.351,2,10,0.2,25,67,0.373,0.364,26,29,0.897,4,26,30,35,18,0,26,18,82,2013
H. Whiteside,RIO,23.0,29,0,308,64,120,0.533,0,1,0.0,64,119,0.538,0.533,36,53,0.679,49,88,137,5,9,59,24,36,164,2013
H. Whiteside,TOT,23.0,36,3,423,92,162,0.568,0,1,0.0,92,161,0.571,0.568,52,78,0.667,67,124,191,7,14,69,34,49,236,2013
H. Whiteside,SFL,23.0,7,3,115,28,42,0.667,0,0,0.0,28,42,0.667,0.667,16,25,0.64,18,36,54,2,5,10,10,13,72,2013
R. White,RIO,21.0,16,8,409,64,144,0.444,1,10,0.1,63,134,0.47,0.448,54,82,0.659,24,67,91,53,14,12,42,56,183,2013
I. Wilkerson,TUL,,28,0,207,21,61,0.344,2,10,0.2,19,51,0.373,0.361,8,9,0.889,3,15,18,22,3,0,25,17,52,2013
T. Wilkerson,AUS,,36,23,873,185,350,0.529,0,7,0.0,185,343,0.539,0.529,67,107,0.626,96,185,281,20,12,41,68,120,437,2013
S. Williams,TEX,26.0,30,13,637,80,177,0.452,2,6,0.333,78,171,0.456,0.458,24,41,0.585,47,113,160,19,17,59,51,90,186,2013
W. Witherspoon,TOT,,26,4,379,32,92,0.348,14,50,0.28,18,42,0.429,0.424,45,69,0.652,12,37,49,19,20,6,21,60,123,2013
W. Witherspoon,RIO,,15,2,182,17,50,0.34,10,31,0.323,7,19,0.368,0.44,27,39,0.692,0,17,17,13,9,3,12,33,71,2013
W. Witherspoon,ERI,,11,2,197,15,42,0.357,4,19,0.211,11,23,0.478,0.405,18,30,0.6,12,20,32,6,11,3,9,27,52,2013
A. Wright,REN,28.0,19,9,573,75,197,0.381,37,107,0.346,38,90,0.422,0.475,28,38,0.737,18,81,99,31,23,7,31,48,215,2013
C. Wright,MAI,24.0,39,38,1369,284,553,0.514,15,41,0.366,269,512,0.525,0.527,130,200,0.65,136,223,359,78,62,58,95,136,713,2013
C. Wright,IOW,23.0,42,42,1548,262,595,0.44,29,95,0.305,233,500,0.466,0.465,122,164,0.744,25,146,171,284,67,13,130,81,675,2013
T. Wroten,REN,19.0,11,3,291,66,159,0.415,15,46,0.326,51,113,0.451,0.462,40,73,0.548,11,18,29,40,15,2,26,26,187,2013
J. Abrams,MAI,,9,3,99,18,38,0.474,6,17,0.353,12,21,0.571,0.553,5,6,0.833,5,9,14,5,2,1,3,14,47,2012
A. Agudio,CAN,27.0,43,25,1278,159,329,0.483,82,152,0.539,77,177,0.435,0.608,98,117,0.838,14,100,114,94,27,2,56,68,498,2012
R. Aguilar,BAK,24.0,6,0,69,6,18,0.333,0,0,0.0,6,18,0.333,0.333,1,9,0.111,11,14,25,1,1,2,4,14,13,2012
B. Ahearn,REN,27.0,37,37,1387,270,576,0.469,113,276,0.409,157,300,0.523,0.567,227,236,0.962,20,75,95,187,39,3,119,115,880,2012
D. Akinyooye,SPR,,20,0,285,36,84,0.429,3,14,0.214,33,70,0.471,0.446,14,20,0.7,24,34,58,4,3,6,13,34,89,2012
J. Akognon,CAN,25.0,3,0,72,17,35,0.486,6,11,0.545,11,24,0.458,0.571,8,8,1.0,1,3,4,7,4,1,3,7,48,2012
S. Alabi,BAK,23.0,9,8,192,35,74,0.473,0,0,0.0,35,74,0.473,0.473,12,16,0.75,18,51,69,7,7,17,18,34,82,2012
X. Alexander,TUL,23.0,42,9,918,103,250,0.412,10,39,0.256,93,211,0.441,0.432,48,104,0.462,55,84,139,75,36,15,59,98,264,2012
R. Allen,TOT,,13,8,252,39,74,0.527,1,2,0.5,38,72,0.528,0.534,23,27,0.852,22,48,70,5,2,4,14,30,102,2012
R. Allen,TEX,,11,8,227,35,69,0.507,1,2,0.5,34,67,0.507,0.514,20,23,0.87,22,40,62,5,2,3,13,26,91,2012
R. Allen,AUS,,2,0,25,4,5,0.8,0,0,0.0,4,5,0.8,0.8,3,4,0.75,0,8,8,0,0,1,1,4,11,2012
C. Allmond,FOR,,12,7,413,60,170,0.353,34,99,0.343,26,71,0.366,0.453,32,41,0.78,11,25,36,29,6,0,19,18,186,2012
M. Almond,MAI,26.0,29,28,1099,244,449,0.543,32,69,0.464,212,380,0.558,0.579,158,199,0.794,31,144,175,41,22,8,71,60,678,2012
R. Alston,LOS,35.0,4,0,31,2,6,0.333,2,5,0.4,0,1,0.0,0.5,0,2,0.0,0,3,3,6,1,0,2,3,6,2012
M. Ambres,IDA,,18,2,356,78,181,0.431,17,44,0.386,61,137,0.445,0.478,14,22,0.636,20,57,77,16,11,6,23,59,187,2012
A. Anderson,CAN,29.0,8,7,264,60,109,0.55,12,33,0.364,48,76,0.632,0.606,40,50,0.8,7,30,37,24,7,1,30,24,172,2012
A. Anderson,MAI,26.0,5,2,98,10,22,0.455,0,0,0.0,10,22,0.455,0.455,4,4,1.0,0,5,5,8,1,1,16,8,24,2012
G. Anderson,LOS,,6,4,173,19,36,0.528,2,7,0.286,17,29,0.586,0.556,10,15,0.667,8,19,27,10,6,1,14,14,50,2012
J. Anderson,SFL,,9,0,121,22,41,0.537,4,8,0.5,18,33,0.545,0.585,14,17,0.824,0,10,10,14,1,0,16,8,62,2012
J. Anderson,IOW,,13,3,312,48,107,0.449,1,5,0.2,47,102,0.461,0.453,38,50,0.76,8,39,47,48,5,4,40,23,135,2012
J. Anderson,TOT,,22,3,433,70,148,0.473,5,13,0.385,65,135,0.481,0.49,52,67,0.776,8,49,57,62,6,4,56,31,197,2012
M. Anderson,DAK,,46,22,1093,189,398,0.475,16,54,0.296,173,344,0.503,0.495,87,131,0.664,68,154,222,43,32,55,79,126,481,2012
R. Anderson,SFL,,12,0,175,27,59,0.458,15,31,0.484,12,28,0.429,0.585,17,18,0.944,4,21,25,7,10,1,7,24,86,2012
Z. Andrews,LOS,26.0,44,42,1121,172,266,0.647,0,0,0.0,172,266,0.647,0.647,65,120,0.542,117,205,322,42,47,34,55,126,409,2012
S. Asumnu,RIO,,40,14,811,191,338,0.565,0,0,0.0,191,338,0.565,0.565,57,112,0.509,107,87,194,31,23,5,48,98,439,2012
C. Ayer,REN,,46,25,775,109,225,0.484,0,3,0.0,109,222,0.491,0.484,98,131,0.748,65,117,182,15,16,35,56,155,316,2012
K. Azubuike,TEX,28.0,7,0,89,17,38,0.447,4,6,0.667,13,32,0.406,0.5,7,11,0.636,10,14,24,5,2,0,8,11,45,2012
L. Babbitt,IDA,22.0,3,3,106,24,53,0.453,9,19,0.474,15,34,0.441,0.538,6,8,0.75,9,18,27,9,3,1,6,6,63,2012
D. Bailey,IDA,,36,31,997,119,277,0.43,24,71,0.338,95,206,0.461,0.473,72,92,0.783,22,71,93,208,36,1,83,89,334,2012
T. Baines,ERI,,30,19,895,191,384,0.497,0,3,0.0,191,381,0.501,0.497,82,120,0.683,77,104,181,39,17,16,50,65,464,2012
M. Baker,DAK,32.0,50,50,1773,215,492,0.437,42,109,0.385,173,383,0.452,0.48,147,165,0.891,46,232,278,289,81,7,125,163,619,2012
J. Banks,FOR,,6,0,84,10,19,0.526,0,0,0.0,10,19,0.526,0.526,0,0,0.0,6,0,6,3,0,2,4,8,20,2012
M. Banks,IDA,30.0,19,4,492,102,197,0.518,24,52,0.462,78,145,0.538,0.579,112,132,0.848,2,31,33,95,23,2,61,61,340,2012
B. Barkdoll,TUL,,29,3,212,15,33,0.455,0,0,0.0,15,33,0.455,0.455,5,7,0.714,14,30,44,5,4,3,6,37,35,2012
T. Baudinet,TOT,,37,10,664,100,220,0.455,40,106,0.377,60,114,0.526,0.545,26,32,0.813,9,63,72,42,18,2,32,48,266,2012
T. Baudinet,IOW,,19,7,365,54,114,0.474,19,48,0.396,35,66,0.53,0.557,17,22,0.773,2,41,43,20,6,1,20,29,144,2012
T. Baudinet,FOR,,18,3,299,46,106,0.434,21,58,0.362,25,48,0.521,0.533,9,10,0.9,7,22,29,22,12,1,12,19,122,2012
D. Bell,AUS,,1,0,4,0,3,0.0,0,0,0.0,0,3,0.0,0.0,0,0,0.0,1,1,2,0,1,0,0,0,0,2012
K. Benson,SFL,23.0,20,19,613,122,243,0.502,0,1,0.0,122,242,0.504,0.502,60,88,0.682,56,100,156,10,16,30,53,76,304,2012
T. Biggs,CAN,,38,23,992,204,445,0.458,9,39,0.231,195,406,0.48,0.469,72,96,0.75,70,122,192,32,13,25,78,106,489,2012
J. Blake,CAN,,11,7,227,30,61,0.492,4,9,0.444,26,52,0.5,0.525,14,25,0.56,17,26,43,4,4,7,8,24,78,2012
M. Blakely,SFL,,21,18,697,135,253,0.534,2,10,0.2,133,243,0.547,0.538,67,115,0.583,60,86,146,69,46,24,76,71,339,2012
M. Blakely,IOW,,14,9,392,69,138,0.5,1,3,0.333,68,135,0.504,0.504,49,90,0.544,31,48,79,27,18,21,40,51,188,2012
M. Blakely,TOT,,35,27,1089,204,391,0.522,3,13,0.231,201,378,0.532,0.526,116,205,0.566,91,134,225,96,64,45,116,122,527,2012
W. Blalock,REN,28.0,35,13,934,84,192,0.438,11,42,0.262,73,150,0.487,0.466,56,82,0.683,37,84,121,163,40,6,59,70,235,2012
E. Bledsoe,BAK,22.0,2,0,43,9,18,0.5,1,2,0.5,8,16,0.5,0.528,6,10,0.6,0,3,3,17,1,0,6,5,25,2012
T. Bobbitt,IDA,32.0,46,32,1397,221,477,0.463,99,273,0.363,122,204,0.598,0.567,72,88,0.818,11,122,133,81,83,12,58,147,613,2012
L. Bonner,AUS,,10,0,75,8,25,0.32,3,12,0.25,5,13,0.385,0.38,0,0,0.0,6,16,22,2,3,2,3,13,19,2012
C. Bozeman,TOT,28.0,22,14,710,95,220,0.432,19,59,0.322,76,161,0.472,0.475,55,76,0.724,21,93,114,103,18,4,48,61,264,2012
C. Bozeman,REN,28.0,15,11,499,66,164,0.402,14,45,0.311,52,119,0.437,0.445,37,56,0.661,14,60,74,82,12,4,32,45,183,2012
C. Bozeman,MAI,28.0,7,3,211,29,56,0.518,5,14,0.357,24,42,0.571,0.563,18,20,0.9,7,33,40,21,6,0,16,16,81,2012
S. Bozeman,AUS,,12,1,247,28,66,0.424,6,13,0.462,22,53,0.415,0.47,34,48,0.708,4,19,23,36,11,0,22,22,96,2012
C. Brackins,MAI,24.0,7,7,238,52,105,0.495,10,33,0.303,42,72,0.583,0.543,18,24,0.75,9,56,65,19,5,11,12,14,132,2012
J. Brady,TOT,,29,5,566,80,164,0.488,21,59,0.356,59,105,0.562,0.552,30,41,0.732,28,76,104,33,15,9,22,62,211,2012
J. Brady,LOS,,14,5,304,39,82,0.476,11,29,0.379,28,53,0.528,0.543,12,19,0.632,12,36,48,21,12,5,12,29,101,2012
J. Brady,IDA,,15,0,262,41,82,0.5,10,30,0.333,31,52,0.596,0.561,18,22,0.818,16,40,56,12,3,4,10,33,110,2012
S. Braimoh,RIO,,15,2,248,45,86,0.523,8,26,0.308,37,60,0.617,0.57,24,31,0.774,26,35,61,8,13,6,18,40,122,2012
T. Brazelton,ERI,,20,9,583,72,187,0.385,13,44,0.295,59,143,0.413,0.42,26,37,0.703,9,37,46,105,25,0,52,64,183,2012
D. Brown,ERI,33.0,4,0,74,8,21,0.381,4,12,0.333,4,9,0.444,0.476,5,6,0.833,0,8,8,4,1,0,5,6,25,2012
G. Brown,FOR,,19,7,499,77,180,0.428,16,53,0.302,61,127,0.48,0.472,61,87,0.701,26,50,76,23,19,4,28,39,231,2012
J. Brown,SPR,,39,17,790,97,208,0.466,0,0,0.0,97,208,0.466,0.466,26,42,0.619,94,126,220,22,13,17,37,112,220,2012
J. Brownlee,MAI,,50,17,1173,163,365,0.447,32,108,0.296,131,257,0.51,0.49,43,54,0.796,57,188,245,71,44,26,55,110,401,2012
M. Brown,RIO,,41,12,975,149,311,0.479,47,136,0.346,102,175,0.583,0.555,74,107,0.692,58,134,192,51,26,23,63,99,419,2012
B. Butch,BAK,,17,17,464,82,191,0.429,33,89,0.371,49,102,0.48,0.516,63,83,0.759,42,124,166,24,9,12,25,37,260,2012
D. Butler,AUS,,37,29,1098,146,339,0.431,42,111,0.378,104,228,0.456,0.493,75,91,0.824,54,118,172,73,34,11,35,70,409,2012
D. Buycks,TUL,22.0,28,2,751,165,332,0.497,26,74,0.351,139,258,0.539,0.536,68,88,0.773,23,53,76,74,35,1,59,41,424,2012
D. Byars,BAK,27.0,25,22,802,127,295,0.431,49,145,0.338,78,150,0.52,0.514,77,94,0.819,29,100,129,51,26,5,50,49,380,2012
D. Calegari,TOT,,44,9,693,93,218,0.427,36,104,0.346,57,114,0.5,0.509,25,41,0.61,47,108,155,21,22,22,30,94,247,2012
D. Calegari,MAI,,33,9,567,77,179,0.43,25,78,0.321,52,101,0.515,0.5,24,39,0.615,43,87,130,17,20,19,24,77,203,2012
D. Calegari,ERI,,11,0,126,16,39,0.41,11,26,0.423,5,13,0.385,0.551,1,2,0.5,4,21,25,4,2,3,6,17,44,2012
T. Campbell,CAN,,50,36,1547,204,488,0.418,73,176,0.415,131,312,0.42,0.493,151,180,0.839,29,124,153,259,45,6,98,140,632,2012
D. Caracter,TOT,23.0,13,6,262,71,119,0.597,2,2,1.0,69,117,0.59,0.605,14,26,0.538,27,57,84,14,4,9,29,34,158,2012
D. Caracter,RIO,23.0,5,2,82,24,44,0.545,1,1,1.0,23,43,0.535,0.557,7,11,0.636,10,17,27,4,0,1,11,16,56,2012
D. Caracter,LOS,23.0,4,1,94,29,43,0.674,0,0,0.0,29,43,0.674,0.674,4,8,0.5,11,19,30,5,2,4,7,14,62,2012
D. Caracter,IDA,23.0,4,3,86,18,32,0.563,1,1,1.0,17,31,0.548,0.578,3,7,0.429,6,21,27,5,2,4,11,4,40,2012
P. Carter,IDA,,34,21,799,126,264,0.477,26,66,0.394,100,198,0.505,0.527,90,114,0.789,52,132,184,52,34,16,63,111,368,2012
R. Carter,IOW,,6,0,85,12,31,0.387,1,7,0.143,11,24,0.458,0.403,7,9,0.778,6,13,19,6,4,1,9,16,32,2012
M. Charlo,REN,28.0,34,23,1132,112,244,0.459,9,22,0.409,103,222,0.464,0.477,107,141,0.759,82,183,265,100,41,31,71,108,340,2012
K. Clark,AUS,,1,0,3,1,1,1.0,0,0,0.0,1,1,1.0,1.0,0,0,0.0,0,1,1,0,0,0,0,0,2,2012
R. Clayton,REN,,4,0,41,1,5,0.2,0,1,0.0,1,4,0.25,0.2,4,6,0.667,0,3,3,1,1,0,2,5,6,2012
K. Coble,FOR,,5,0,35,2,7,0.286,0,1,0.0,2,6,0.333,0.286,3,5,0.6,3,5,8,1,1,0,1,6,7,2012
T. Cohn,SPR,,13,1,222,34,69,0.493,7,17,0.412,27,52,0.519,0.543,10,13,0.769,10,17,27,10,9,0,22,14,85,2012
A. Coleman,LOS,29.0,6,1,36,3,5,0.6,0,0,0.0,3,5,0.6,0.6,0,0,0.0,1,3,4,0,0,3,6,6,6,2012
D. Coleman,SFL,,49,44,1685,189,443,0.427,40,116,0.345,149,327,0.456,0.472,40,62,0.645,52,208,260,238,108,32,78,127,458,2012
S. Coleman,RIO,24.0,13,4,219,38,77,0.494,18,45,0.4,20,32,0.625,0.61,13,24,0.542,14,36,50,6,6,14,8,34,107,2012
M. Collins,LOS,27.0,28,12,791,112,243,0.461,4,20,0.2,108,223,0.484,0.469,53,89,0.596,31,69,100,129,28,10,51,49,281,2012
B. Colon,TUL,,11,0,181,12,28,0.429,0,0,0.0,12,28,0.429,0.429,6,13,0.462,17,27,44,5,8,4,12,29,30,2012
W. Conroy,RIO,29.0,23,12,737,92,247,0.372,22,79,0.278,70,168,0.417,0.417,84,117,0.718,16,78,94,207,29,0,78,60,290,2012
V. Cooksey,RIO,,6,0,89,17,40,0.425,2,10,0.2,15,30,0.5,0.45,18,22,0.818,0,10,10,13,5,0,11,8,54,2012
V. Cooksey,TOT,,38,25,908,102,261,0.391,14,53,0.264,88,208,0.423,0.418,117,162,0.722,23,76,99,184,42,1,100,82,335,2012
V. Cooksey,TEX,,32,25,819,85,221,0.385,12,43,0.279,73,178,0.41,0.412,99,140,0.707,23,66,89,171,37,1,89,74,281,2012
D. Cooper,MAI,,10,4,232,11,42,0.262,2,12,0.167,9,30,0.3,0.286,7,9,0.778,1,22,23,39,3,0,13,13,31,2012
B. Costner,LOS,,32,27,1037,202,453,0.446,82,206,0.398,120,247,0.486,0.536,165,217,0.76,29,134,163,66,16,16,78,97,651,2012
N. Covington,TOT,26.0,23,6,435,59,132,0.447,20,53,0.377,39,79,0.494,0.523,27,33,0.818,2,43,45,59,16,1,38,36,165,2012
N. Covington,SFL,26.0,10,2,148,20,49,0.408,7,23,0.304,13,26,0.5,0.48,8,10,0.8,0,12,12,18,6,0,12,13,55,2012
N. Covington,IOW,26.0,13,4,287,39,83,0.47,13,30,0.433,26,53,0.491,0.548,19,23,0.826,2,31,33,41,10,1,26,23,110,2012
W. Creekmore,TUL,,9,0,61,3,14,0.214,0,0,0.0,3,14,0.214,0.214,1,2,0.5,4,10,14,1,3,4,4,15,7,2012
L. Cunningham,LOS,,5,0,27,1,6,0.167,0,4,0.0,1,2,0.5,0.167,1,2,0.5,1,4,5,2,1,0,5,5,3,2012
R. Cunningham,DAK,,2,0,4,0,1,0.0,0,0,0.0,0,1,0.0,0.0,0,0,0.0,0,2,2,0,0,0,0,0,0,2012
J. Curry,SPR,26.0,40,40,1506,236,591,0.399,83,201,0.413,153,390,0.392,0.47,136,164,0.829,36,136,172,250,76,10,112,115,691,2012
A. Daniels,TEX,36.0,24,19,807,88,213,0.413,6,35,0.171,82,178,0.461,0.427,121,147,0.823,9,72,81,208,32,6,67,34,303,2012
C. Daniels,ERI,,14,14,440,85,156,0.545,15,33,0.455,70,123,0.569,0.593,50,71,0.704,34,86,120,33,6,30,49,55,235,2012
K. Dartez,IDA,31.0,1,1,13,0,2,0.0,0,0,0.0,0,2,0.0,0.0,0,0,0.0,0,1,1,0,1,0,2,3,0,2012
C. Davis,TOT,,33,2,577,86,173,0.497,20,55,0.364,66,118,0.559,0.555,34,50,0.68,17,51,68,48,20,1,31,42,226,2012
C. Davis,REN,,15,2,268,35,75,0.467,7,18,0.389,28,57,0.491,0.513,15,21,0.714,7,21,28,21,12,0,17,26,92,2012
C. Davis,IDA,,18,0,309,51,98,0.52,13,37,0.351,38,61,0.623,0.587,19,29,0.655,10,30,40,27,8,1,14,16,134,2012
J. Davis,AUS,31.0,9,0,150,22,54,0.407,6,19,0.316,16,35,0.457,0.463,14,21,0.667,10,29,39,8,2,1,11,23,64,2012
M. Davis,TEX,,7,1,84,7,11,0.636,0,0,0.0,7,11,0.636,0.636,5,8,0.625,8,11,19,2,0,4,10,32,19,2012
R. Davis,MAI,32.0,11,7,277,37,94,0.394,7,25,0.28,30,69,0.435,0.431,13,19,0.684,3,33,36,35,9,7,27,23,94,2012
E. Dawson,AUS,27.0,29,27,842,205,368,0.557,2,4,0.5,203,364,0.558,0.56,86,110,0.782,92,214,306,68,36,47,64,93,498,2012
G. Daye,FOR,,4,0,58,7,23,0.304,3,9,0.333,4,14,0.286,0.37,14,18,0.778,4,7,11,10,2,0,7,6,31,2012
J. Dentmon,AUS,26.0,40,40,1490,300,641,0.468,93,217,0.429,207,424,0.488,0.541,221,255,0.867,29,120,149,219,62,2,155,111,914,2012
E. Devendorf,TOT,,39,0,675,146,277,0.527,30,67,0.448,116,210,0.552,0.581,80,109,0.734,12,49,61,42,25,5,41,76,402,2012
E. Devendorf,REN,,26,0,424,109,196,0.556,23,49,0.469,86,147,0.585,0.615,45,62,0.726,9,31,40,30,16,2,31,49,286,2012
E. Devendorf,IDA,,13,0,251,37,81,0.457,7,18,0.389,30,63,0.476,0.5,35,47,0.745,3,18,21,12,9,3,10,27,116,2012
M. Dove,DAK,,43,25,1228,234,381,0.614,1,3,0.333,233,378,0.616,0.615,140,194,0.722,99,186,285,49,68,65,73,150,609,2012
D. Downey,FOR,,8,1,181,36,75,0.48,5,12,0.417,31,63,0.492,0.513,9,11,0.818,2,10,12,31,12,1,15,11,86,2012
A. Drevo,IOW,,50,37,1372,218,461,0.473,49,140,0.35,169,321,0.526,0.526,86,99,0.869,97,218,315,103,40,38,97,148,571,2012
R. Dyer,TEX,,49,35,1262,175,387,0.452,13,50,0.26,162,337,0.481,0.469,56,88,0.636,149,219,368,24,48,36,55,129,419,2012
J. Dyson,TUL,24.0,44,44,1497,254,613,0.414,55,193,0.285,199,420,0.474,0.459,220,292,0.753,47,109,156,172,73,10,154,143,783,2012
D. Ebanks,LOS,22.0,3,0,96,21,38,0.553,3,6,0.5,18,32,0.563,0.592,10,13,0.769,7,11,18,4,6,0,9,2,55,2012
S. Edwards,CAN,,5,1,35,4,11,0.364,0,1,0.0,4,10,0.4,0.364,1,4,0.25,4,2,6,0,1,2,1,4,9,2012
M. Efevberha,IOW,27.0,37,31,1085,275,578,0.476,30,91,0.33,245,487,0.503,0.502,150,178,0.843,36,132,168,80,35,21,95,92,730,2012
M. Ehambe,IOW,,46,26,1240,217,501,0.433,98,233,0.421,119,268,0.444,0.531,56,67,0.836,16,109,125,44,33,4,53,62,588,2012
O. Eldridge,BAK,,42,20,1072,231,521,0.443,57,190,0.3,174,331,0.526,0.498,116,154,0.753,40,108,148,131,56,12,100,91,635,2012
J. Ellis,IDA,,5,5,122,5,21,0.238,0,0,0.0,5,21,0.238,0.238,6,8,0.75,15,19,34,2,3,5,4,20,16,2012
S. Ely,DAK,,50,14,1165,133,312,0.426,69,167,0.413,64,145,0.441,0.537,77,88,0.875,15,101,116,87,42,8,64,82,412,2012
A. Emmett,REN,29.0,35,32,1286,296,568,0.521,49,117,0.419,247,451,0.548,0.564,167,210,0.795,48,146,194,113,58,7,102,63,808,2012
B. Evans,SFL,,5,2,75,9,24,0.375,0,1,0.0,9,23,0.391,0.375,7,10,0.7,4,5,9,13,3,0,7,2,25,2012
B. Ewing,IOW,,37,17,910,103,245,0.42,7,27,0.259,96,218,0.44,0.435,68,83,0.819,17,107,124,173,19,7,65,72,281,2012
P. Ewing,TOT,27.0,30,15,704,91,221,0.412,17,62,0.274,74,159,0.465,0.45,63,76,0.829,25,105,130,56,32,18,53,95,262,2012
P. Ewing,SFL,27.0,11,3,273,37,96,0.385,8,36,0.222,29,60,0.483,0.427,23,27,0.852,12,34,46,31,12,4,24,33,105,2012
P. Ewing,IOW,27.0,19,12,431,54,125,0.432,9,26,0.346,45,99,0.455,0.468,40,49,0.816,13,71,84,25,20,14,29,62,157,2012
C. Eyenga,CAN,22.0,12,11,313,50,113,0.442,2,14,0.143,48,99,0.485,0.451,18,32,0.563,8,44,52,14,12,11,23,24,120,2012
C. Eyenga,TOT,22.0,18,15,510,81,171,0.474,7,27,0.259,74,144,0.514,0.494,24,44,0.545,15,67,82,26,12,19,31,36,193,2012
C. Eyenga,LOS,22.0,6,4,197,31,58,0.534,5,13,0.385,26,45,0.578,0.578,6,12,0.5,7,23,30,12,0,8,8,12,73,2012
J. Famous,TOT,23.0,16,15,471,89,180,0.494,0,0,0.0,89,180,0.494,0.494,45,63,0.714,60,96,156,11,11,10,39,39,223,2012
J. Famous,IOW,23.0,8,8,236,54,98,0.551,0,0,0.0,54,98,0.551,0.551,26,35,0.743,35,53,88,6,5,3,21,16,134,2012
J. Famous,FOR,23.0,8,7,235,35,82,0.427,0,0,0.0,35,82,0.427,0.427,19,28,0.679,25,43,68,5,6,7,18,23,89,2012
M. Farrakhan,BAK,23.0,39,11,730,114,291,0.392,31,84,0.369,83,207,0.401,0.445,93,136,0.684,15,49,64,131,28,5,78,52,352,2012
N. Fazekas,REN,26.0,6,6,174,48,82,0.585,1,3,0.333,47,79,0.595,0.591,14,20,0.7,15,34,49,8,2,9,9,18,111,2012
E. Fjeld,MAI,,3,0,25,2,6,0.333,0,0,0.0,2,6,0.333,0.333,2,2,1.0,2,3,5,2,0,1,0,4,6,2012
G. Flowers,LOS,,16,1,139,23,57,0.404,4,9,0.444,19,48,0.396,0.439,8,12,0.667,10,15,25,7,6,11,5,20,58,2012
J. Foote,SPR,24.0,39,38,1274,234,425,0.551,0,0,0.0,234,425,0.551,0.551,119,215,0.553,153,196,349,51,20,43,99,111,587,2012
S. Ford,ERI,30.0,6,4,146,22,52,0.423,0,2,0.0,22,50,0.44,0.423,10,15,0.667,16,17,33,7,0,11,13,24,54,2012
C. Fortson,TOT,23.0,31,16,1072,179,380,0.471,42,106,0.396,137,274,0.5,0.526,133,167,0.796,28,112,140,192,66,3,79,74,533,2012
C. Fortson,RIO,23.0,2,2,77,13,35,0.371,4,12,0.333,9,23,0.391,0.429,10,14,0.714,7,7,14,21,4,0,9,5,40,2012
C. Fortson,LOS,23.0,29,14,995,166,345,0.481,38,94,0.404,128,251,0.51,0.536,123,153,0.804,21,105,126,171,62,3,70,69,493,2012
W. Foster,TOT,,24,5,348,43,82,0.524,0,2,0.0,43,80,0.538,0.524,27,60,0.45,59,74,133,10,2,59,31,39,113,2012
W. Foster,SFL,,3,1,12,1,4,0.25,0,0,0.0,1,4,0.25,0.25,0,0,0.0,2,3,5,2,0,2,0,1,2,2012
W. Foster,RIO,,3,0,31,3,8,0.375,0,0,0.0,3,8,0.375,0.375,3,4,0.75,4,4,8,1,0,4,2,3,9,2012
W. Foster,IDA,,18,4,305,39,70,0.557,0,2,0.0,39,68,0.574,0.557,24,56,0.429,53,67,120,7,2,53,29,35,102,2012
T. Franklin,CAN,,35,2,670,98,177,0.554,0,0,0.0,98,177,0.554,0.554,75,110,0.682,48,65,113,36,23,11,53,80,271,2012
C. Gadson,IDA,31.0,9,6,270,47,97,0.485,12,26,0.462,35,71,0.493,0.546,36,43,0.837,8,17,25,46,7,2,19,18,142,2012
D. Gadzuric,TEX,33.0,12,10,308,60,113,0.531,0,0,0.0,60,113,0.531,0.531,24,40,0.6,54,82,136,12,7,12,27,49,144,2012
K. Galloway,IDA,,14,5,270,25,65,0.385,0,5,0.0,25,60,0.417,0.385,10,17,0.588,7,40,47,57,15,10,36,25,60,2012
C. Garcia,FOR,23.0,13,1,304,55,113,0.487,0,0,0.0,55,113,0.487,0.487,44,92,0.478,37,53,90,11,12,7,30,51,154,2012
C. Garcia,TOT,23.0,36,24,1000,184,369,0.499,0,4,0.0,184,365,0.504,0.499,129,246,0.524,89,152,241,30,24,19,108,136,497,2012
C. Garcia,SFL,23.0,23,23,696,129,256,0.504,0,4,0.0,129,252,0.512,0.504,85,154,0.552,52,99,151,19,12,12,78,85,343,2012
O. George,LOS,29.0,49,6,983,155,287,0.54,1,4,0.25,154,283,0.544,0.542,62,87,0.713,115,152,267,42,40,20,43,133,373,2012
T. George,AUS,,2,0,30,1,2,0.5,0,0,0.0,1,2,0.5,0.5,6,10,0.6,1,2,3,0,2,5,4,7,8,2012
M. Gerrity,ERI,,18,4,409,51,108,0.472,0,2,0.0,51,106,0.481,0.472,30,44,0.682,5,40,45,79,16,2,26,39,132,2012
M. Gerrity,TOT,,34,4,620,69,153,0.451,0,5,0.0,69,148,0.466,0.451,37,58,0.638,7,54,61,113,24,2,42,51,175,2012
M. Gerrity,MAI,,16,0,211,18,45,0.4,0,3,0.0,18,42,0.429,0.4,7,14,0.5,2,14,16,34,8,0,16,12,43,2012
K. Gibson,CAN,,44,28,1052,156,387,0.403,59,163,0.362,97,224,0.433,0.479,66,84,0.786,18,140,158,66,26,4,58,72,437,2012
T. Gilder,SFL,27.0,34,31,1259,236,468,0.504,2,4,0.5,234,464,0.504,0.506,180,214,0.841,95,167,262,79,49,42,104,100,654,2012
M. Gladness,DAK,25.0,4,0,83,14,20,0.7,0,0,0.0,14,20,0.7,0.7,3,4,0.75,4,17,21,2,2,7,3,11,31,2012
K. Goldcamp,ERI,,44,25,1310,254,431,0.589,0,3,0.0,254,428,0.593,0.589,108,156,0.692,141,230,371,61,29,43,66,126,616,2012
A. Gonzalez,DAK,,1,0,3,0,1,0.0,0,0,0.0,0,1,0.0,0.0,0,0,0.0,1,0,1,0,0,0,0,0,0,2012
A. Goods,FOR,,10,8,294,37,91,0.407,13,30,0.433,24,61,0.393,0.478,24,30,0.8,2,20,22,24,7,1,28,16,111,2012
A. Goods,DAK,,8,8,284,46,114,0.404,18,42,0.429,28,72,0.389,0.482,27,32,0.844,0,22,22,20,7,0,26,12,137,2012
A. Goods,TOT,,18,16,578,83,205,0.405,31,72,0.431,52,133,0.391,0.48,51,62,0.823,2,42,44,44,14,1,54,28,248,2012
A. Goudelock,LOS,23.0,1,1,47,11,24,0.458,2,10,0.2,9,14,0.643,0.5,0,0,0.0,0,4,4,7,2,0,6,3,24,2012
J. Graham,ERI,29.0,9,8,301,72,131,0.55,0,4,0.0,72,127,0.567,0.55,43,49,0.878,9,52,61,28,7,1,25,32,187,2012
J. Graham,BAK,,5,0,89,12,20,0.6,0,0,0.0,12,20,0.6,0.6,2,3,0.667,3,7,10,13,6,1,11,14,26,2012
S. Graham,FOR,29.0,10,9,294,56,104,0.538,7,17,0.412,49,87,0.563,0.572,24,26,0.923,5,30,35,24,6,1,33,36,143,2012
Z. Graham,REN,,43,23,1023,151,329,0.459,43,113,0.381,108,216,0.5,0.524,124,143,0.867,32,107,139,40,18,8,60,69,469,2012
A. Graves,CAN,,27,3,637,87,216,0.403,24,64,0.375,63,152,0.414,0.458,41,54,0.759,13,40,53,46,10,4,40,64,239,2012
J. Graves,ERI,30.0,1,0,2,0,0,0.0,0,0,0.0,0,0,0.0,0.0,0,0,0.0,0,0,0,0,0,0,0,0,0,2012
D. Green,ERI,29.0,11,11,364,69,145,0.476,5,30,0.167,64,115,0.557,0.493,21,26,0.808,9,46,55,19,17,8,27,36,164,2012
D. Green,TOT,29.0,21,12,586,102,220,0.464,6,36,0.167,96,184,0.522,0.477,36,46,0.783,21,69,90,36,31,11,43,54,246,2012
D. Green,IDA,29.0,10,1,222,33,75,0.44,1,6,0.167,32,69,0.464,0.447,15,20,0.75,12,23,35,17,14,3,16,18,82,2012
G. Green,LOS,26.0,22,13,673,157,327,0.48,60,131,0.458,97,196,0.495,0.572,47,56,0.839,14,87,101,36,25,7,51,49,421,2012
J. Green,LOS,,3,0,12,0,4,0.0,0,2,0.0,0,2,0.0,0.0,0,0,0.0,0,2,2,0,0,0,0,0,0,2012
J. Green,ERI,,19,0,402,54,134,0.403,16,52,0.308,38,82,0.463,0.463,10,13,0.769,9,38,47,19,16,4,14,39,134,2012
J. Green,TOT,,22,0,414,54,138,0.391,16,54,0.296,38,84,0.452,0.449,10,13,0.769,9,40,49,19,16,4,14,39,134,2012
O. Greene,LOS,29.0,40,36,1197,137,334,0.41,35,128,0.273,102,206,0.495,0.463,57,84,0.679,35,101,136,182,66,17,97,142,366,2012
T. Griffin,DAK,25.0,30,5,550,66,173,0.382,16,49,0.327,50,124,0.403,0.428,38,61,0.623,37,97,134,25,23,9,31,60,186,2012
A. Gurley,BAK,,1,0,6,0,1,0.0,0,0,0.0,0,1,0.0,0.0,2,2,1.0,0,0,0,0,0,1,1,1,2,2012
B. Hamilton,TOT,,42,9,1006,124,272,0.456,3,18,0.167,121,254,0.476,0.461,133,201,0.662,62,119,181,65,56,19,65,121,384,2012
B. Hamilton,SFL,,21,0,479,69,152,0.454,2,11,0.182,67,141,0.475,0.461,66,98,0.673,31,67,98,43,29,11,37,62,206,2012
B. Hamilton,LOS,,21,9,527,55,120,0.458,1,7,0.143,54,113,0.478,0.463,67,103,0.65,31,52,83,22,27,8,28,59,178,2012
J. Hamilton,IDA,21.0,6,2,144,22,50,0.44,6,17,0.353,16,33,0.485,0.5,8,9,0.889,4,28,32,12,4,2,4,9,58,2012
V. Hamilton,IOW,,6,0,94,8,32,0.25,2,5,0.4,6,27,0.222,0.281,0,2,0.0,3,10,13,14,11,1,7,9,18,2012
Z. Hamilton,SPR,36.0,12,1,207,26,63,0.413,0,0,0.0,26,63,0.413,0.413,30,43,0.698,24,36,60,5,4,3,18,35,82,2012
S. Hannah,DAK,26.0,29,27,933,192,427,0.45,92,226,0.407,100,201,0.498,0.557,57,64,0.891,21,89,110,140,62,3,88,95,533,2012
L. Harangody,CAN,24.0,16,16,576,119,245,0.486,26,63,0.413,93,182,0.511,0.539,47,61,0.77,44,157,201,18,6,13,35,50,311,2012
J. Harden,DAK,,13,0,110,8,19,0.421,0,0,0.0,8,19,0.421,0.421,3,5,0.6,14,10,24,4,2,0,3,13,19,2012
A. Harris,BAK,26.0,6,0,139,27,59,0.458,2,6,0.333,25,53,0.472,0.475,12,22,0.545,2,16,18,29,6,0,15,12,68,2012
D. Harrison,REN,29.0,8,8,162,41,55,0.745,0,0,0.0,41,55,0.745,0.745,12,30,0.4,22,17,39,5,3,10,16,33,94,2012
M. Harris,CAN,22.0,17,12,559,119,253,0.47,18,44,0.409,101,209,0.483,0.506,108,126,0.857,16,118,134,56,28,7,51,36,364,2012
P. Harris,MAI,,20,7,507,81,187,0.433,6,26,0.231,75,161,0.466,0.449,61,96,0.635,25,99,124,52,21,11,41,51,229,2012
P. Harris,IOW,,6,0,163,42,76,0.553,0,4,0.0,42,72,0.583,0.553,15,26,0.577,8,23,31,13,7,5,15,14,99,2012
P. Harris,TOT,,26,7,670,123,263,0.468,6,30,0.2,117,233,0.502,0.479,76,122,0.623,33,122,155,65,28,16,56,65,328,2012
R. Harris,FOR,23.0,41,4,751,70,198,0.354,39,125,0.312,31,73,0.425,0.452,42,69,0.609,26,104,130,32,51,16,36,58,221,2012
T. Harris,RIO,24.0,7,3,174,43,76,0.566,12,28,0.429,31,48,0.646,0.645,21,28,0.75,13,29,42,33,15,2,14,30,119,2012
F. Hassell,CAN,,39,6,805,166,303,0.548,0,0,0.0,166,303,0.548,0.548,81,97,0.835,127,143,270,12,30,23,56,114,413,2012
E. Hayes,CAN,,6,0,69,3,20,0.15,2,11,0.182,1,9,0.111,0.2,2,2,1.0,1,0,1,6,3,0,2,2,10,2012
K. Hayes,MAI,,44,32,1453,270,603,0.448,35,87,0.402,235,516,0.455,0.477,179,201,0.891,14,167,181,230,31,7,105,45,754,2012
L. Hayward,TUL,25.0,3,3,103,28,50,0.56,4,8,0.5,24,42,0.571,0.6,12,14,0.857,6,11,17,8,1,1,10,15,72,2012
J. Hazell,BAK,,9,0,164,27,63,0.429,17,39,0.436,10,24,0.417,0.563,24,29,0.828,2,21,23,16,7,0,10,12,95,2012
X. Henry,IOW,20.0,1,0,20,5,12,0.417,0,0,0.0,5,12,0.417,0.417,3,5,0.6,1,0,1,1,2,0,1,4,13,2012
C. Higgins,ERI,22.0,5,5,189,21,61,0.344,4,10,0.4,17,51,0.333,0.377,17,22,0.773,4,17,21,8,3,5,19,9,63,2012
L. Hill,TOT,,38,34,1212,195,402,0.485,34,83,0.41,161,319,0.505,0.527,65,92,0.707,84,193,277,83,43,66,48,94,489,2012
L. Hill,TEX,,5,4,169,29,63,0.46,1,7,0.143,28,56,0.5,0.468,4,9,0.444,11,22,33,10,6,5,8,16,63,2012
L. Hill,MAI,,33,30,1043,166,339,0.49,33,76,0.434,133,263,0.506,0.538,61,83,0.735,73,171,244,73,37,61,40,78,426,2012
M. Hill,SPR,,6,0,52,2,13,0.154,1,5,0.2,1,8,0.125,0.192,2,2,1.0,0,4,4,9,2,0,8,6,7,2012
D. Hobson,FOR,24.0,8,6,221,30,72,0.417,6,24,0.25,24,48,0.5,0.458,19,23,0.826,10,31,41,16,5,0,14,12,85,2012
T. Honeycutt,REN,21.0,10,1,128,23,55,0.418,6,16,0.375,17,39,0.436,0.473,7,16,0.438,12,17,29,9,9,5,12,18,59,2012
D. Horner,SPR,23.0,25,20,786,148,314,0.471,22,59,0.373,126,255,0.494,0.506,107,124,0.863,71,142,213,39,20,14,65,76,425,2012
J. Horne,SFL,,18,2,362,51,119,0.429,8,27,0.296,43,92,0.467,0.462,15,17,0.882,16,37,53,15,6,12,22,42,125,2012
R. Howard,FOR,,31,27,1019,193,405,0.477,9,26,0.346,184,379,0.485,0.488,147,186,0.79,21,106,127,85,44,5,75,108,542,2012
L. Hudson,AUS,27.0,5,2,145,33,62,0.532,15,32,0.469,18,30,0.6,0.653,7,9,0.778,4,26,30,21,12,6,6,11,88,2012
L. Humphrey,RIO,,50,15,1299,166,406,0.409,127,306,0.415,39,100,0.39,0.565,64,82,0.78,24,68,92,92,42,1,55,63,523,2012
C. Hunter,FOR,27.0,4,4,90,17,39,0.436,0,1,0.0,17,38,0.447,0.436,9,11,0.818,6,15,21,0,1,6,3,11,43,2012
L. Hurdle,SPR,,49,19,1558,222,612,0.363,110,314,0.35,112,298,0.376,0.453,91,109,0.835,20,144,164,130,69,6,64,130,645,2012
A. Ingram,LOS,26.0,6,0,169,23,51,0.451,18,33,0.545,5,18,0.278,0.627,9,11,0.818,0,21,21,15,3,0,7,13,73,2012
R. Jackson,TUL,21.0,1,1,41,10,27,0.37,0,5,0.0,10,22,0.455,0.37,2,3,0.667,1,6,7,8,0,0,2,2,22,2012
T. Jackson,FOR,,45,20,987,118,319,0.37,14,63,0.222,104,256,0.406,0.392,66,81,0.815,20,111,131,137,63,4,61,92,316,2012
D. James,TUL,,26,1,534,90,209,0.431,5,20,0.25,85,189,0.45,0.443,44,62,0.71,48,77,125,34,27,14,34,48,229,2012
M. James,ERI,36.0,7,6,264,53,116,0.457,15,37,0.405,38,79,0.481,0.522,27,35,0.771,5,21,26,32,8,0,31,22,148,2012
D. Jefferson,TOT,28.0,15,0,243,23,57,0.404,2,16,0.125,21,41,0.512,0.421,20,25,0.8,1,23,24,44,10,2,29,36,68,2012
D. Jefferson,SFL,28.0,10,0,161,13,33,0.394,2,13,0.154,11,20,0.55,0.424,16,19,0.842,1,13,14,26,8,0,23,23,44,2012
D. Jefferson,IDA,28.0,5,0,82,10,24,0.417,0,3,0.0,10,21,0.476,0.417,4,6,0.667,0,10,10,18,2,2,6,13,24,2012
B. Jenkins,ERI,,23,10,568,67,166,0.404,20,66,0.303,47,100,0.47,0.464,47,52,0.904,11,41,52,63,25,3,34,46,201,2012
W. Jenkins,IDA,,24,9,532,61,165,0.37,18,68,0.265,43,97,0.443,0.424,40,54,0.741,18,55,73,32,12,6,28,53,180,2012
Y. Jianlian,TEX,24.0,2,2,73,18,38,0.474,0,1,0.0,18,37,0.486,0.474,10,17,0.588,8,16,24,5,2,4,6,3,46,2012
A. Johnson,LOS,,3,0,5,1,3,0.333,0,1,0.0,1,2,0.5,0.333,0,0,0.0,0,1,1,0,0,0,0,1,2,2012
A. Johnson,IDA,22.0,6,2,159,28,73,0.384,1,5,0.2,27,68,0.397,0.39,9,16,0.563,11,16,27,41,9,0,15,7,66,2012
C. Johnson,AUS,29.0,20,12,589,62,158,0.392,16,48,0.333,46,110,0.418,0.443,24,29,0.828,7,52,59,113,21,1,48,50,164,2012
D. Johnson,TOT,,47,17,1059,102,225,0.453,9,46,0.196,93,179,0.52,0.473,35,60,0.583,100,116,216,66,50,43,29,142,248,2012
D. Johnson,SPR,,36,13,838,92,187,0.492,6,32,0.188,86,155,0.555,0.508,31,47,0.66,85,96,181,39,37,33,20,120,221,2012
D. Johnson,BAK,,11,4,221,10,38,0.263,3,14,0.214,7,24,0.292,0.303,4,13,0.308,15,20,35,27,13,10,9,22,27,2012
D. Johnson,TEX,,45,32,1371,209,485,0.431,53,161,0.329,156,324,0.481,0.486,111,133,0.835,42,136,178,100,51,7,73,74,582,2012
J. Johnson,DAK,23.0,45,2,975,158,364,0.434,13,44,0.295,145,320,0.453,0.452,86,106,0.811,15,93,108,124,28,4,85,86,415,2012
R. Johnson,IOW,,3,0,37,8,17,0.471,0,2,0.0,8,15,0.533,0.471,0,1,0.0,1,3,4,1,3,2,1,3,16,2012
T. Johnson,BAK,27.0,11,0,305,55,118,0.466,0,1,0.0,55,117,0.47,0.466,31,36,0.861,4,32,36,63,5,0,30,27,141,2012
T. Johnson,RIO,,44,31,1187,196,432,0.454,34,115,0.296,162,317,0.511,0.493,90,128,0.703,69,177,246,106,44,32,115,118,516,2012
C. Jones,FOR,22.0,48,34,1395,262,583,0.449,37,86,0.43,225,497,0.453,0.481,113,137,0.825,28,96,124,90,39,7,70,89,674,2012
D. Jones,REN,35.0,7,0,63,3,14,0.214,3,14,0.214,0,0,0.321,0.0,2,3,0.667,0,3,3,5,1,0,5,1,11,2012
D. Jones,TEX,23.0,3,0,66,10,30,0.333,1,6,0.167,9,24,0.375,0.35,19,23,0.826,2,6,8,7,6,0,2,4,40,2012
J. Jordan,ERI,25.0,5,5,163,33,68,0.485,0,1,0.0,33,67,0.493,0.485,24,29,0.828,14,29,43,8,2,14,9,23,90,2012
C. Joseph,AUS,20.0,14,12,461,67,146,0.459,11,30,0.367,56,116,0.483,0.497,48,52,0.923,16,56,72,72,18,8,28,26,193,2012
D. Kennedy,ERI,22.0,44,44,1643,236,528,0.447,51,135,0.378,185,393,0.471,0.495,167,205,0.815,74,246,320,193,72,12,113,108,690,2012
A. Kent,MAI,28.0,50,23,1048,114,188,0.606,1,1,1.0,113,187,0.604,0.609,67,116,0.578,94,130,224,29,19,69,45,142,296,2012
T. Kent,CAN,,7,2,163,12,36,0.333,3,10,0.3,9,26,0.346,0.375,8,12,0.667,3,13,16,12,10,1,11,21,35,2012
P. Knowles,SPR,,31,0,519,87,230,0.378,39,130,0.3,48,100,0.48,0.463,13,17,0.765,21,50,71,34,34,3,21,58,226,2012
A. Koch,BAK,,46,44,1279,96,225,0.427,1,15,0.067,95,210,0.452,0.429,104,125,0.832,91,182,273,66,34,31,64,101,297,2012
R. Larry,IDA,,45,19,955,142,252,0.563,4,16,0.25,138,236,0.585,0.571,46,77,0.597,79,159,238,29,23,20,51,91,334,2012
D. Lazare,FOR,,44,44,1562,285,611,0.466,0,5,0.0,285,606,0.47,0.466,114,156,0.731,93,217,310,80,43,14,116,122,684,2012
M. Lee,SFL,21.0,7,7,193,27,80,0.338,0,13,0.0,27,67,0.403,0.338,17,18,0.944,7,22,29,41,13,1,17,23,71,2012
T. Leslie,BAK,21.0,10,3,203,47,92,0.511,2,6,0.333,45,86,0.523,0.522,6,10,0.6,20,12,32,14,3,3,15,22,102,2012
K. Lewis,RIO,,50,38,1406,212,515,0.412,123,317,0.388,89,198,0.449,0.531,80,104,0.769,36,113,149,79,63,4,70,104,627,2012
M. Lewis,TUL,,46,45,1665,292,512,0.57,0,3,0.0,292,509,0.574,0.57,109,212,0.514,163,420,583,143,42,42,126,116,693,2012
J. Lin,ERI,23.0,1,1,44,9,17,0.529,0,3,0.0,9,14,0.643,0.529,10,11,0.909,1,10,11,12,2,1,5,2,28,2012
L. Lyons,TOT,,40,16,1064,209,409,0.511,30,93,0.323,179,316,0.566,0.548,108,138,0.783,84,225,309,55,31,18,71,93,556,2012
L. Lyons,DAK,,14,0,324,52,104,0.5,7,20,0.35,45,84,0.536,0.534,24,33,0.727,22,56,78,15,10,3,24,35,135,2012
L. Lyons,AUS,,26,16,740,157,305,0.515,23,73,0.315,134,232,0.578,0.552,84,105,0.8,62,169,231,40,21,15,47,58,421,2012
V. Macklin,FOR,25.0,10,10,341,59,112,0.527,0,0,0.0,59,112,0.527,0.527,27,59,0.458,55,88,143,25,10,9,27,26,145,2012
C. Maduabum,BAK,20.0,1,0,3,0,1,0.0,0,0,0.0,0,1,0.0,0.0,0,0,0.0,0,0,0,0,0,1,0,1,0,2012
R. Major,BAK,29.0,46,46,1461,229,430,0.533,3,14,0.214,226,416,0.543,0.536,239,303,0.789,60,154,214,106,69,41,82,114,700,2012
C. Mangrum,TEX,,4,0,47,4,8,0.5,2,5,0.4,2,3,0.667,0.625,0,0,0.0,0,2,2,1,3,0,5,6,10,2012
H. Marshall,CAN,,6,0,114,12,31,0.387,1,9,0.111,11,22,0.5,0.403,8,10,0.8,0,9,9,13,6,3,7,9,33,2012
C. Martin,IOW,27.0,9,6,249,44,97,0.454,15,31,0.484,29,66,0.439,0.531,30,37,0.811,7,33,40,11,8,2,23,31,133,2012
A. Mason,SFL,,45,40,1623,314,638,0.492,38,103,0.369,276,535,0.516,0.522,116,141,0.823,53,167,220,136,42,40,116,165,782,2012
C. Matthews,REN,,5,0,71,7,25,0.28,5,17,0.294,2,8,0.25,0.38,2,2,1.0,1,4,5,6,1,0,4,7,21,2012
B. McCauley,FOR,,14,3,257,21,66,0.318,8,24,0.333,13,42,0.31,0.379,5,5,1.0,18,26,44,20,8,2,14,22,55,2012
C. McCrommon,ERI,,11,6,276,35,74,0.473,9,21,0.429,26,53,0.491,0.534,10,14,0.714,9,32,41,12,10,7,12,23,89,2012
T. McCullough,REN,,11,7,229,39,79,0.494,7,27,0.259,32,52,0.615,0.538,11,36,0.306,7,29,36,15,8,4,18,33,96,2012
S. McDowell,SFL,,1,0,5,1,2,0.5,0,0,0.0,1,2,0.5,0.5,0,0,0.0,0,1,1,2,0,0,0,1,2,2012
M. McKay,AUS,,10,8,262,34,93,0.366,4,17,0.235,30,76,0.395,0.387,26,31,0.839,12,23,35,22,10,2,18,18,98,2012
K. McLeod,CAN,32.0,18,14,524,87,206,0.422,25,63,0.397,62,143,0.434,0.483,56,78,0.718,3,47,50,80,25,10,46,57,255,2012
K. McLeod,TOT,32.0,32,28,932,143,371,0.385,34,108,0.315,109,263,0.414,0.431,123,162,0.759,8,69,77,157,39,15,82,93,443,2012
K. McLeod,ERI,32.0,14,14,408,56,165,0.339,9,45,0.2,47,120,0.392,0.367,67,84,0.798,5,22,27,77,14,5,36,36,188,2012
B. McShepard,SFL,,16,8,375,56,123,0.455,3,15,0.2,53,108,0.491,0.467,29,35,0.829,25,80,105,10,10,14,20,32,144,2012
D. Milligan,CAN,,48,43,1146,155,303,0.512,0,4,0.0,155,299,0.518,0.512,67,142,0.472,132,255,387,47,32,67,95,168,377,2012
E. Millsap,LOS,24.0,41,33,1353,253,566,0.447,49,123,0.398,204,443,0.46,0.49,241,313,0.77,61,199,260,133,78,9,119,125,796,2012
A. Mitchell,RIO,,11,3,226,18,52,0.346,6,28,0.214,12,24,0.5,0.404,18,29,0.621,4,19,23,49,7,1,33,35,60,2012
C. Mitchell,SFL,,23,10,770,161,357,0.451,57,146,0.39,104,211,0.493,0.531,72,84,0.857,29,51,80,44,26,3,57,50,451,2012
A. Moody,SFL,,6,1,79,11,32,0.344,4,10,0.4,7,22,0.318,0.406,1,3,0.333,1,7,8,7,5,1,6,4,27,2012
J. Moon,LOS,31.0,12,10,452,80,165,0.485,19,48,0.396,61,117,0.521,0.542,33,42,0.786,11,83,94,38,22,16,16,24,212,2012
M. Moore,IDA,36.0,33,32,926,134,242,0.554,0,0,0.0,134,242,0.554,0.554,96,115,0.835,67,175,242,38,11,35,75,128,364,2012
B. Morningstar,TUL,,48,20,1330,170,403,0.422,46,120,0.383,124,283,0.438,0.479,75,84,0.893,21,83,104,106,42,7,69,80,461,2012
D. Morris,LOS,21.0,1,0,28,7,16,0.438,1,3,0.333,6,13,0.462,0.469,6,7,0.857,0,1,1,4,1,0,3,3,21,2012
M. Morris,RIO,22.0,11,9,333,85,186,0.457,12,47,0.255,73,139,0.525,0.489,46,63,0.73,29,62,91,12,14,5,26,25,228,2012
O. Muonelo,AUS,,3,0,39,6,13,0.462,3,7,0.429,3,6,0.5,0.577,2,2,1.0,0,3,3,3,2,1,2,6,17,2012
N. Murphy,IOW,,49,13,1236,192,376,0.511,3,10,0.3,189,366,0.516,0.515,142,184,0.772,80,181,261,87,55,12,76,120,529,2012
R. Murray,AUS,32.0,3,1,70,14,21,0.667,5,9,0.556,9,12,0.75,0.786,4,5,0.8,0,8,8,6,0,3,5,1,37,2012
H. N'Diaye,MAI,25.0,13,13,363,41,65,0.631,0,0,0.0,41,65,0.631,0.631,7,27,0.259,22,42,64,8,6,42,11,34,89,2012
H. N'Diaye,IOW,25.0,10,3,173,19,35,0.543,0,0,0.0,19,35,0.543,0.543,12,18,0.667,15,21,36,8,2,21,14,26,50,2012
H. N'Diaye,TOT,25.0,23,16,536,60,100,0.6,0,0,0.0,60,100,0.6,0.6,19,45,0.422,37,63,100,16,8,63,25,60,139,2012
D. Neitzel,TEX,,30,7,614,61,167,0.365,11,41,0.268,50,126,0.397,0.398,28,34,0.824,6,43,49,120,18,0,51,62,161,2012
J. Neuhaus,FOR,,7,1,93,10,20,0.5,0,0,0.0,10,20,0.5,0.5,2,5,0.4,12,10,22,2,2,4,5,13,22,2012
A. Newell,CAN,,1,1,27,1,6,0.167,0,3,0.0,1,3,0.333,0.167,0,0,0.0,1,5,6,0,2,0,3,3,2,2012
A. Nolen,LOS,,2,0,34,2,7,0.286,2,4,0.5,0,3,0.0,0.429,0,2,0.0,1,1,2,7,1,0,2,3,6,2012
Y. Ogunoye,SFL,,20,1,273,9,24,0.375,0,0,0.0,9,24,0.375,0.375,13,18,0.722,11,21,32,4,6,8,5,19,31,2012
N. Ojougboh,TUL,,23,8,500,57,126,0.452,0,1,0.0,57,125,0.456,0.452,23,35,0.657,34,93,127,20,10,38,27,50,137,2012
C. Okwandu,RIO,,13,4,151,10,37,0.27,0,0,0.0,10,37,0.27,0.27,8,15,0.533,14,30,44,5,3,13,10,38,28,2012
A. Oliver,REN,,5,0,85,11,28,0.393,4,12,0.333,7,16,0.438,0.464,7,7,1.0,4,8,12,5,2,0,5,7,33,2012
D. O'Neil,BAK,,2,0,33,3,9,0.333,0,1,0.0,3,8,0.375,0.333,3,3,1.0,4,0,4,2,0,0,5,6,9,2012
G. Ostertag,TEX,38.0,10,1,134,18,33,0.545,0,0,0.0,18,33,0.545,0.545,7,14,0.5,20,30,50,6,1,5,10,16,43,2012
L. Owens,TUL,29.0,32,26,1143,157,369,0.425,30,101,0.297,127,268,0.474,0.466,66,76,0.868,38,108,146,113,59,42,72,91,410,2012
D. Palmer,TOT,25.0,43,11,797,121,229,0.528,3,14,0.214,118,215,0.549,0.535,65,90,0.722,82,153,235,12,8,25,58,127,310,2012
D. Palmer,REN,25.0,18,3,272,33,63,0.524,0,1,0.0,33,62,0.532,0.524,23,30,0.767,17,51,68,4,0,7,14,48,89,2012
D. Palmer,BAK,25.0,25,8,525,88,166,0.53,3,13,0.231,85,153,0.556,0.539,42,60,0.7,65,102,167,8,8,18,44,79,221,2012
J. Pattillo,BAK,,49,8,1258,276,525,0.526,0,6,0.0,276,519,0.532,0.526,157,214,0.734,111,243,354,81,64,42,106,102,709,2012
J. Peterson,TEX,,5,0,111,12,39,0.308,3,16,0.188,9,23,0.391,0.346,0,1,0.0,7,22,29,3,4,3,5,10,27,2012
P. Petty,REN,,2,0,7,0,2,0.0,0,2,0.0,0,0,0.0,0.0,0,0,0.0,0,0,0,0,0,0,2,2,0,2012
M. Phillips,TOT,,38,9,845,115,260,0.442,8,41,0.195,107,219,0.489,0.458,57,85,0.671,91,146,237,27,35,22,43,87,295,2012
M. Phillips,FOR,,12,6,360,49,116,0.422,8,36,0.222,41,80,0.513,0.457,26,37,0.703,34,61,95,15,13,10,16,38,132,2012
M. Phillips,ERI,,26,3,485,66,144,0.458,0,5,0.0,66,139,0.475,0.458,31,48,0.646,57,85,142,12,22,12,27,49,163,2012
C. Pigram,MAI,,36,15,938,161,368,0.438,60,162,0.37,101,206,0.49,0.519,54,70,0.771,10,67,77,89,34,5,56,74,436,2012
E. Polynice,LOS,,17,5,251,44,88,0.5,6,20,0.3,38,68,0.559,0.534,7,12,0.583,12,29,41,33,9,4,23,12,101,2012
W. Pratt,SFL,,11,0,209,36,76,0.474,0,6,0.0,36,70,0.514,0.474,23,32,0.719,11,13,24,8,8,1,17,30,95,2012
B. Price,DAK,,5,0,36,3,8,0.375,2,3,0.667,1,5,0.2,0.5,5,9,0.556,3,3,6,5,2,0,3,6,13,2012
G. Pruitt,SFL,25.0,39,20,1134,142,345,0.412,54,167,0.323,88,178,0.494,0.49,77,108,0.713,14,76,90,152,56,5,73,83,415,2012
J. Randle,TOT,,15,10,401,75,150,0.5,19,55,0.345,56,95,0.589,0.563,46,51,0.902,5,33,38,63,12,0,56,31,215,2012
J. Randle,TEX,,1,0,17,3,9,0.333,1,3,0.333,2,6,0.333,0.389,0,0,0.0,0,1,1,3,1,0,2,1,7,2012
J. Randle,MAI,,14,10,384,72,141,0.511,18,52,0.346,54,89,0.607,0.574,46,51,0.902,5,32,37,60,11,0,54,30,208,2012
O. Reed,AUS,24.0,22,0,297,58,96,0.604,13,31,0.419,45,65,0.692,0.672,14,22,0.636,42,36,78,15,16,1,15,27,143,2012
R. Reid,TUL,25.0,25,25,791,127,248,0.512,0,0,0.0,127,248,0.512,0.512,43,61,0.705,74,139,213,30,24,22,53,80,297,2012
M. Relphorde,CAN,,9,6,250,41,95,0.432,7,28,0.25,34,67,0.507,0.468,16,29,0.552,13,34,47,12,9,0,16,24,105,2012
J. Reynolds,MAI,,3,2,108,11,30,0.367,5,12,0.417,6,18,0.333,0.45,9,10,0.9,4,9,13,6,5,0,6,8,36,2012
N. Richardson,TUL,,2,0,6,0,1,0.0,0,0,0.0,0,1,0.0,0.0,0,0,0.0,0,0,0,0,0,0,0,0,0,2012
C. Roberts,TEX,,35,24,974,150,335,0.448,36,116,0.31,114,219,0.521,0.501,83,98,0.847,42,104,146,70,49,25,56,71,419,2012
M. Roberts,ERI,,4,0,28,1,7,0.143,0,0,0.0,1,7,0.143,0.143,2,5,0.4,1,4,5,0,1,0,0,5,4,2012
T. Roberts,LOS,,11,3,145,30,55,0.545,0,2,0.0,30,53,0.566,0.545,16,29,0.552,17,26,43,8,2,10,17,26,76,2012
S. Robinson,IOW,,8,0,119,19,38,0.5,1,4,0.25,18,34,0.529,0.513,9,17,0.529,14,27,41,7,0,4,10,14,48,2012
A. Rodriguez,SPR,,7,0,50,1,2,0.5,0,0,0.0,1,2,0.5,0.5,3,6,0.5,5,13,18,2,2,2,3,11,5,2012
M. Rogers,TEX,,29,6,507,77,174,0.443,0,4,0.0,77,170,0.453,0.443,52,63,0.825,48,81,129,14,22,33,47,72,206,2012
S. Rojas,FOR,,30,7,528,67,147,0.456,1,7,0.143,66,140,0.471,0.459,43,58,0.741,61,94,155,6,30,5,39,84,178,2012
Q. Ross,CAN,30.0,10,7,270,27,67,0.403,7,13,0.538,20,54,0.37,0.455,16,21,0.762,10,29,39,13,7,2,8,24,77,2012
B. Rush,TUL,,14,13,321,43,110,0.391,9,43,0.209,34,67,0.507,0.432,25,30,0.833,7,49,56,15,8,6,21,20,120,2012
K. Rush,LOS,31.0,7,0,132,14,32,0.438,9,18,0.5,5,14,0.357,0.578,5,5,1.0,2,9,11,9,6,5,6,16,42,2012
W. Russell,FOR,29.0,16,16,600,81,198,0.409,8,34,0.235,73,164,0.445,0.429,86,98,0.878,10,51,61,159,30,1,59,36,256,2012
J. Sampson,TEX,28.0,2,2,63,14,23,0.609,0,0,0.0,14,23,0.609,0.609,0,2,0.0,14,16,30,4,0,3,2,5,28,2012
J. Sanders,AUS,,43,17,1049,133,276,0.482,42,101,0.416,91,175,0.52,0.558,26,33,0.788,42,103,145,97,36,8,47,76,334,2012
P. Sanders,DAK,,5,0,44,3,14,0.214,1,5,0.2,2,9,0.222,0.25,2,2,1.0,0,1,1,4,1,0,3,4,9,2012
D. Saunders,RIO,23.0,29,21,853,112,235,0.477,32,102,0.314,80,133,0.602,0.545,52,86,0.605,61,131,192,56,57,67,37,80,308,2012
D. Scales,SFL,,9,7,149,8,20,0.4,0,1,0.0,8,19,0.421,0.4,2,3,0.667,6,15,21,1,2,6,4,23,18,2012
E. Scott,REN,,10,0,168,13,51,0.255,9,41,0.22,4,10,0.4,0.343,0,0,0.0,7,23,30,12,3,5,5,25,35,2012
J. Selby,REN,20.0,8,4,273,66,139,0.475,20,44,0.455,46,95,0.484,0.547,49,61,0.803,8,42,50,39,13,1,32,19,201,2012
J. Sensley,AUS,,9,2,225,33,80,0.413,12,32,0.375,21,48,0.438,0.488,9,15,0.6,10,34,44,18,8,4,10,21,87,2012
J. Sensley,TOT,,14,7,377,63,146,0.432,22,59,0.373,41,87,0.471,0.507,20,32,0.625,16,65,81,29,9,11,22,40,168,2012
J. Sensley,RIO,,5,5,152,30,66,0.455,10,27,0.37,20,39,0.513,0.53,11,17,0.647,6,31,37,11,1,7,12,19,81,2012
F. Session,LOS,,2,0,2,0,0,0.0,0,0,0.0,0,0,0.0,0.0,0,0,0.0,0,0,0,0,0,0,0,1,0,2012
X. Silas,MAI,24.0,40,22,935,128,319,0.401,26,89,0.292,102,230,0.443,0.442,110,141,0.78,20,99,119,59,27,9,64,96,392,2012
B. Simmons,REN,31.0,21,18,683,105,207,0.507,20,47,0.426,85,160,0.531,0.556,54,64,0.844,53,106,159,54,16,10,38,86,284,2012
J. Simmons,AUS,,5,1,62,7,17,0.412,0,2,0.0,7,15,0.467,0.412,5,12,0.417,2,5,7,3,1,1,6,8,19,2012
A. Simpson,IOW,,8,4,156,24,49,0.49,0,1,0.0,24,48,0.5,0.49,7,11,0.636,3,40,43,13,6,5,9,22,55,2012
D. Sims,MAI,,5,0,91,19,52,0.365,0,5,0.0,19,47,0.404,0.365,3,9,0.333,7,25,32,7,1,3,7,6,41,2012
D. Sims,REN,,8,1,182,17,55,0.309,5,24,0.208,12,31,0.387,0.355,16,18,0.889,2,7,9,23,7,0,10,4,55,2012
D. Sloan,ERI,24.0,9,9,318,70,141,0.496,6,20,0.3,64,121,0.529,0.518,39,49,0.796,6,36,42,60,11,1,25,15,185,2012
A. Smith,FOR,,10,9,217,20,44,0.455,0,0,0.0,20,44,0.455,0.455,4,11,0.364,32,45,77,6,2,2,10,21,44,2012
G. Smith,RIO,21.0,26,21,732,185,277,0.668,0,1,0.0,185,276,0.67,0.668,61,108,0.565,61,142,203,41,25,30,60,73,431,2012
J. Smith,SPR,24.0,39,35,1365,256,583,0.439,81,222,0.365,175,361,0.485,0.509,151,187,0.807,42,149,191,150,83,27,102,133,744,2012
T. Smith,DAK,,38,23,743,129,234,0.551,0,2,0.0,129,232,0.556,0.551,37,71,0.521,76,112,188,35,42,46,63,124,295,2012
T. Snow,MAI,,9,7,229,27,59,0.458,7,14,0.5,20,45,0.444,0.517,6,9,0.667,4,19,23,38,9,0,13,12,67,2012
S. Sonderleiter,FOR,,25,2,351,42,93,0.452,0,1,0.0,42,92,0.457,0.452,19,22,0.864,23,42,65,17,9,8,28,56,103,2012
K. Spain,ERI,,49,29,1310,215,483,0.445,89,222,0.401,126,261,0.483,0.537,81,100,0.81,58,204,262,70,42,19,60,158,600,2012
E. Spates,SPR,,34,5,469,71,170,0.418,9,41,0.22,62,129,0.481,0.444,33,43,0.767,39,75,114,16,26,14,24,80,184,2012
M. Stallworth,MAI,,3,0,33,2,10,0.2,0,8,0.0,2,2,1.0,0.2,0,2,0.0,0,2,2,2,1,0,1,3,4,2012
G. Stiemsma,SFL,26.0,4,4,144,13,26,0.5,0,0,0.0,13,26,0.5,0.5,10,15,0.667,15,28,43,4,5,18,10,18,36,2012
C. Stinson,IOW,28.0,28,26,898,127,284,0.447,7,18,0.389,120,266,0.451,0.46,56,75,0.747,24,107,131,165,45,7,97,61,317,2012
C. Stokes,MAI,,1,0,21,0,3,0.0,0,2,0.0,0,1,0.0,0.0,2,2,1.0,1,2,3,0,0,0,0,3,2,2012
L. Stokes,ERI,,15,1,262,34,69,0.493,0,7,0.0,34,62,0.548,0.493,24,39,0.615,6,31,37,22,7,3,21,28,92,2012
J. Stone,IDA,23.0,3,2,69,7,16,0.438,3,7,0.429,4,9,0.444,0.531,5,8,0.625,3,13,16,21,4,1,7,3,22,2012
T. Strickland,TOT,27.0,15,0,206,23,70,0.329,6,21,0.286,17,49,0.347,0.371,20,26,0.769,11,26,37,6,3,0,4,26,72,2012
T. Strickland,LOS,27.0,3,0,41,2,12,0.167,0,3,0.0,2,9,0.222,0.167,7,8,0.875,0,3,3,0,1,0,2,5,11,2012
T. Strickland,CAN,27.0,12,0,165,21,58,0.362,6,18,0.333,15,40,0.375,0.414,13,18,0.722,11,23,34,6,2,0,2,21,61,2012
B. Strong,IOW,25.0,48,21,1088,157,286,0.549,0,0,0.0,157,286,0.549,0.549,69,104,0.663,79,166,245,48,20,76,57,91,383,2012
J. Strowbridge,RIO,,14,4,282,44,114,0.386,16,43,0.372,28,71,0.394,0.456,19,25,0.76,6,22,28,49,11,1,27,28,123,2012
M. Sturns,SPR,,1,0,4,0,3,0.0,0,1,0.0,0,2,0.0,0.0,0,0,0.0,1,0,1,0,1,0,2,1,0,2012
D. Summers,MAI,22.0,12,5,304,49,109,0.45,4,16,0.25,45,93,0.484,0.468,28,35,0.8,8,30,38,11,11,1,32,34,130,2012
C. Sumpter,TUL,,27,15,545,61,157,0.389,15,49,0.306,46,108,0.426,0.436,14,17,0.824,36,76,112,29,19,22,49,69,151,2012
J. Tarver,RIO,,17,11,379,35,89,0.393,11,44,0.25,24,45,0.533,0.455,13,22,0.591,8,46,54,54,18,5,25,43,94,2012
S. Tarver,IDA,,45,39,1331,207,408,0.507,28,79,0.354,179,329,0.544,0.542,66,104,0.635,45,166,211,98,58,11,56,85,508,2012
J. Taylor,RIO,25.0,14,9,370,74,174,0.425,17,54,0.315,57,120,0.475,0.474,34,46,0.739,9,36,45,28,11,7,35,34,199,2012
A. Thomas,BAK,24.0,50,5,1029,126,312,0.404,107,269,0.398,19,43,0.442,0.575,8,11,0.727,12,72,84,25,18,5,25,69,367,2012
D. Thomas,IOW,,5,0,83,8,20,0.4,0,0,0.0,8,20,0.4,0.4,3,9,0.333,6,16,22,1,3,1,4,6,19,2012
D. Thomas,TOT,,16,8,323,36,73,0.493,0,0,0.0,36,73,0.493,0.493,20,36,0.556,23,60,83,14,12,6,14,45,92,2012
D. Thomas,REN,,11,8,240,28,53,0.528,0,0,0.0,28,53,0.528,0.528,17,27,0.63,17,44,61,13,9,5,10,39,73,2012
I. Thomas,TEX,,16,1,252,46,96,0.479,0,1,0.0,46,95,0.484,0.479,17,31,0.548,20,47,67,7,9,8,8,39,109,2012
J. Thomas,SPR,,9,7,218,34,72,0.472,1,11,0.091,33,61,0.541,0.479,14,21,0.667,14,19,33,5,4,10,14,19,83,2012
L. Thomas,AUS,23.0,19,19,613,108,197,0.548,0,0,0.0,108,197,0.548,0.548,71,97,0.732,75,72,147,31,14,7,29,62,287,2012
M. Thomas,TOT,23.0,25,16,804,138,223,0.619,0,1,0.0,138,222,0.622,0.619,60,92,0.652,78,149,227,34,19,57,43,54,336,2012
M. Thomas,RIO,23.0,2,2,80,17,32,0.531,0,0,0.0,17,32,0.531,0.531,4,6,0.667,10,13,23,3,2,8,3,3,38,2012
M. Thomas,LOS,23.0,19,13,612,104,160,0.65,0,0,0.0,104,160,0.65,0.65,53,78,0.679,60,117,177,26,15,39,32,45,261,2012
M. Thomas,AUS,23.0,4,1,112,17,31,0.548,0,1,0.0,17,30,0.567,0.548,3,8,0.375,8,19,27,5,2,10,8,6,37,2012
T. Thomas,TOT,31.0,47,18,1224,184,381,0.483,25,80,0.313,159,301,0.528,0.516,52,69,0.754,65,235,300,130,56,3,90,55,445,2012
T. Thomas,REN,31.0,30,18,981,157,320,0.491,22,68,0.324,135,252,0.536,0.525,35,46,0.761,49,181,230,110,42,2,73,43,371,2012
T. Thomas,CAN,31.0,17,0,243,27,61,0.443,3,12,0.25,24,49,0.49,0.467,17,23,0.739,16,54,70,20,14,1,17,12,74,2012
M. Thompson,ERI,23.0,26,23,935,125,312,0.401,61,149,0.409,64,163,0.393,0.498,47,73,0.644,27,79,106,47,40,29,32,68,358,2012
T. Thompson,AUS,,13,7,285,31,76,0.408,7,24,0.292,24,52,0.462,0.454,45,51,0.882,5,15,20,15,5,0,13,21,114,2012
J. Tinsley,LOS,33.0,8,8,272,27,86,0.314,6,23,0.261,21,63,0.333,0.349,19,25,0.76,6,19,25,61,19,1,23,27,79,2012
M. Tisdale,TOT,,20,10,405,53,114,0.465,2,5,0.4,51,109,0.468,0.474,11,16,0.688,30,68,98,10,4,29,30,63,119,2012
M. Tisdale,MAI,,8,1,109,14,34,0.412,0,0,0.0,14,34,0.412,0.412,2,2,1.0,6,23,29,1,1,13,11,19,30,2012
M. Tisdale,FOR,,12,9,296,39,80,0.488,2,5,0.4,37,75,0.493,0.5,9,14,0.643,24,45,69,9,3,16,19,44,89,2012
J. Trapani,MAI,,6,0,93,8,29,0.276,2,12,0.167,6,17,0.353,0.31,1,2,0.5,8,14,22,2,1,2,7,10,19,2012
A. Tucker,TEX,27.0,23,21,692,115,259,0.444,25,69,0.362,90,190,0.474,0.492,79,102,0.775,35,47,82,40,18,1,26,19,334,2012
M. Tveidt,IOW,,44,23,967,109,238,0.458,33,82,0.402,76,156,0.487,0.527,39,52,0.75,33,86,119,44,20,13,35,74,290,2012
J. Tyler,DAK,20.0,5,5,146,33,56,0.589,0,1,0.0,33,55,0.6,0.589,12,17,0.706,11,28,39,0,2,7,14,25,78,2012
E. Ubiles,DAK,25.0,41,41,1409,322,640,0.503,50,148,0.338,272,492,0.553,0.542,110,146,0.753,53,153,206,128,41,12,87,36,804,2012
B. Uzoh,RIO,23.0,20,18,613,107,224,0.478,6,25,0.24,101,199,0.508,0.491,77,98,0.786,47,70,117,78,27,3,41,43,297,2012
R. Vaden,TUL,26.0,36,30,1154,169,391,0.432,79,177,0.446,90,214,0.421,0.533,44,56,0.786,12,87,99,88,34,11,50,100,461,2012
D. Vandervieren,SFL,,8,3,117,10,20,0.5,0,0,0.0,10,20,0.5,0.5,3,6,0.5,8,20,28,4,5,7,11,26,23,2012
D. Vandervieren,AUS,,10,4,206,22,38,0.579,0,0,0.0,22,38,0.579,0.579,7,12,0.583,22,40,62,12,5,4,16,26,51,2012
D. Vandervieren,TOT,,18,7,323,32,58,0.552,0,0,0.0,32,58,0.552,0.552,10,18,0.556,30,60,90,16,10,11,27,52,74,2012
J. Vanderbeken,BAK,,28,12,565,54,154,0.351,42,118,0.356,12,36,0.333,0.487,0,0,0.0,19,75,94,36,14,23,22,71,150,2012
S. VanderMeer,RIO,,18,8,291,53,112,0.473,1,11,0.091,52,101,0.515,0.478,33,41,0.805,43,48,91,11,6,26,18,43,140,2012
A. Vereen,TEX,26.0,50,13,1064,182,357,0.51,3,12,0.25,179,345,0.519,0.514,117,153,0.765,90,118,208,47,21,9,56,139,484,2012
A. Walker,IDA,35.0,44,17,1102,169,468,0.361,39,191,0.204,130,277,0.469,0.403,41,96,0.427,54,162,216,103,25,14,93,118,418,2012
B. Wallace,BAK,,6,3,119,10,32,0.313,2,9,0.222,8,23,0.348,0.344,2,6,0.333,5,18,23,8,4,4,5,16,24,2012
T. Walton,FOR,,12,5,282,25,60,0.417,0,2,0.0,25,58,0.431,0.417,21,31,0.677,7,17,24,36,6,1,10,23,71,2012
T. Walton,DAK,,9,4,180,14,38,0.368,3,8,0.375,11,30,0.367,0.408,12,16,0.75,3,14,17,9,5,1,6,14,43,2012
T. Walton,CAN,,5,0,46,1,8,0.125,0,1,0.0,1,7,0.143,0.125,2,2,1.0,0,2,2,6,1,0,1,5,4,2012
T. Walton,TOT,,26,9,508,40,106,0.377,3,11,0.273,37,95,0.389,0.392,35,49,0.714,10,33,43,51,12,2,17,42,118,2012
B. Wanamaker,AUS,,15,2,291,32,70,0.457,0,3,0.0,32,67,0.478,0.457,19,22,0.864,9,23,32,33,8,3,21,16,83,2012
W. Warren,RIO,22.0,11,0,238,41,97,0.423,15,43,0.349,26,54,0.481,0.5,56,62,0.903,4,20,24,35,7,1,30,16,153,2012
G. Washington,ERI,,7,0,88,6,20,0.3,0,1,0.0,6,19,0.316,0.3,0,0,0.0,7,3,10,3,4,10,6,14,12,2012
S. Welsh,AUS,,19,4,328,46,108,0.426,14,47,0.298,32,61,0.525,0.491,51,69,0.739,5,40,45,43,12,1,28,47,157,2012
L. Westbrook,TEX,,7,0,102,19,44,0.432,0,5,0.0,19,39,0.487,0.432,9,10,0.9,4,10,14,8,4,1,7,11,47,2012
B. White,IOW,,3,0,25,2,6,0.333,1,1,1.0,1,5,0.2,0.417,1,2,0.5,1,3,4,2,1,0,1,6,6,2012
H. Whiteside,REN,22.0,11,5,208,37,71,0.521,0,0,0.0,37,71,0.521,0.521,12,35,0.343,31,40,71,4,6,33,16,29,86,2012
T. White,IDA,21.0,18,10,462,93,190,0.489,20,49,0.408,73,141,0.518,0.542,30,47,0.638,18,42,60,24,13,3,13,26,236,2012
D. Williams,TEX,,11,0,170,19,57,0.333,5,17,0.294,14,40,0.35,0.377,7,9,0.778,1,16,17,28,9,1,16,17,50,2012
J. Williams,SPR,21.0,6,6,194,23,51,0.451,0,0,0.0,23,51,0.451,0.451,17,32,0.531,16,31,47,6,6,10,11,18,63,2012
J. Williams,LOS,27.0,1,0,3,0,0,0.0,0,0,0.0,0,0,0.0,0.0,0,0,0.0,0,0,0,0,0,0,0,1,0,2012
L. Williams,TUL,,25,5,329,42,107,0.393,5,12,0.417,37,95,0.389,0.416,11,21,0.524,15,21,36,25,19,3,17,20,100,2012
L. Williams,SPR,23.0,49,48,1764,290,664,0.437,61,176,0.347,229,488,0.469,0.483,125,199,0.628,106,184,290,99,70,20,92,161,766,2012
S. Williams,TEX,25.0,27,25,779,152,301,0.505,3,9,0.333,149,292,0.51,0.51,104,134,0.776,81,160,241,27,23,68,64,84,411,2012
J. Wise,BAK,,41,39,1249,191,413,0.462,25,74,0.338,166,339,0.49,0.493,162,200,0.81,17,150,167,257,48,17,96,114,569,2012
C. Withers,TOT,,40,19,948,153,278,0.55,0,4,0.0,153,274,0.558,0.55,74,116,0.638,96,160,256,42,33,21,70,113,380,2012
C. Withers,SFL,,8,4,240,45,76,0.592,0,3,0.0,45,73,0.616,0.592,22,31,0.71,15,39,54,17,11,7,16,24,112,2012
C. Withers,DAK,,32,15,708,108,202,0.535,0,1,0.0,108,201,0.537,0.535,52,85,0.612,81,121,202,25,22,14,54,89,268,2012
T. Woodbury,AUS,,50,22,1230,211,473,0.446,47,127,0.37,164,346,0.474,0.496,76,101,0.752,37,134,171,46,31,7,76,94,545,2012
B. Woodfox,TEX,25.0,46,14,1213,244,560,0.436,86,191,0.45,158,369,0.428,0.513,122,138,0.884,17,60,77,89,37,0,71,53,696,2012
A. Wright,REN,27.0,10,5,321,65,142,0.458,23,58,0.397,42,84,0.5,0.539,24,33,0.727,13,43,56,29,18,1,21,37,177,2012
C. Wright,DAK,23.0,9,9,261,71,113,0.628,1,2,0.5,70,111,0.631,0.633,21,40,0.525,23,49,72,10,7,12,21,34,164,2012
C. Wright,TOT,23.0,13,12,386,99,172,0.576,1,2,0.5,98,170,0.576,0.578,33,57,0.579,42,73,115,12,9,18,33,48,232,2012
C. Wright,MAI,23.0,4,3,125,28,59,0.475,0,0,0.0,28,59,0.475,0.475,12,17,0.706,19,24,43,2,2,6,12,14,68,2012
J. Wright,LOS,,3,2,46,4,10,0.4,0,0,0.0,4,10,0.4,0.4,0,2,0.0,0,2,2,7,2,0,3,1,8,2012
J. Wright,AUS,24.0,16,14,450,109,173,0.63,1,5,0.2,108,168,0.643,0.633,23,40,0.575,52,76,128,30,18,13,21,44,242,2012
L. Zeller,AUS,24.0,24,9,599,95,211,0.45,25,74,0.338,70,137,0.511,0.509,3,4,0.75,35,91,126,30,9,15,19,58,218,2012
J. Abu-Shamala,SFL,,1,0,4,1,2,0.5,0,0,0.0,1,2,0.5,0.5,0,0,0.0,0,1,1,0,0,0,0,1,2,2011
W. Adams,SFL,,10,5,215,28,69,0.406,9,27,0.333,19,42,0.452,0.471,5,6,0.833,3,18,21,21,10,0,12,15,70,2011
J. Adrien,TOT,24.0,27,21,884,177,324,0.546,0,2,0.0,177,322,0.55,0.546,140,194,0.722,95,213,308,41,28,39,77,75,494,2011
J. Adrien,RIO,24.0,22,20,757,155,282,0.55,0,2,0.0,155,280,0.554,0.55,128,170,0.753,85,183,268,34,26,34,60,66,438,2011
J. Adrien,ERI,24.0,5,1,127,22,42,0.524,0,0,0.0,22,42,0.524,0.524,12,24,0.5,10,30,40,7,2,5,17,9,56,2011
B. Ahearn,ERI,26.0,31,25,1044,153,377,0.406,68,192,0.354,85,185,0.459,0.496,150,156,0.962,7,77,84,179,34,5,107,77,524,2011
S. Alabi,ERI,22.0,22,16,410,62,120,0.517,0,0,0.0,62,120,0.517,0.517,35,49,0.714,36,81,117,8,11,40,26,72,159,2011
C. Aldrich,TUL,22.0,21,21,615,86,158,0.544,0,0,0.0,86,158,0.544,0.544,45,56,0.804,54,127,181,27,10,55,37,82,217,2011
J. Alexander,TEX,24.0,47,46,1936,374,758,0.493,17,55,0.309,357,703,0.508,0.505,186,235,0.791,109,310,419,144,38,68,147,158,951,2011
R. Allen,TEX,,13,2,124,27,53,0.509,0,2,0.0,27,51,0.529,0.509,6,9,0.667,14,22,36,2,3,3,7,24,60,2011
C. Allmond,FOR,,47,7,864,126,340,0.371,86,243,0.354,40,97,0.412,0.497,25,37,0.676,13,72,85,37,18,1,15,47,363,2011
L. Allred,UTA,29.0,7,4,162,22,45,0.489,0,0,0.0,22,45,0.489,0.489,6,11,0.545,13,36,49,7,2,4,9,14,50,2011
A. Anderson,NMX,28.0,10,9,374,69,130,0.531,19,50,0.38,50,80,0.625,0.604,54,66,0.818,12,46,58,50,13,1,34,36,211,2011
A. Anderson,TOT,25.0,41,27,1335,124,293,0.423,48,136,0.353,76,157,0.484,0.505,57,84,0.679,18,116,134,160,40,11,104,120,353,2011
A. Anderson,RIO,25.0,17,12,520,44,125,0.352,15,54,0.278,29,71,0.408,0.412,28,43,0.651,9,21,30,62,8,5,39,66,131,2011
A. Anderson,MAI,25.0,24,15,815,80,168,0.476,33,82,0.402,47,86,0.547,0.574,29,41,0.707,9,95,104,98,32,6,65,54,222,2011
G. Anderson,TOT,,24,5,234,27,59,0.458,2,11,0.182,25,48,0.521,0.475,13,16,0.813,18,20,38,8,8,0,18,18,69,2011
G. Anderson,SPR,,10,4,146,18,36,0.5,2,9,0.222,16,27,0.593,0.528,8,9,0.889,8,15,23,6,7,0,12,8,46,2011
G. Anderson,REN,,7,0,30,2,4,0.5,0,0,0.0,2,4,0.5,0.5,0,0,0.0,5,3,8,0,0,0,2,2,4,2011
G. Anderson,NMX,,7,1,58,7,19,0.368,0,2,0.0,7,17,0.412,0.368,5,7,0.714,5,2,7,2,1,0,4,8,19,2011
J. Anderson,AUS,21.0,7,7,176,42,94,0.447,9,26,0.346,33,68,0.485,0.495,10,14,0.714,13,21,34,14,7,4,25,19,103,2011
M. Anderson,DAK,,50,22,1433,235,460,0.511,7,28,0.25,228,432,0.528,0.518,127,178,0.713,90,177,267,65,61,59,76,150,604,2011
S. Asumnu,RIO,,17,0,162,32,58,0.552,0,7,0.0,32,51,0.627,0.552,8,15,0.533,18,14,32,6,6,5,9,18,72,2011
C. Atchley,RIO,,26,1,542,65,139,0.468,35,84,0.417,30,55,0.545,0.594,30,37,0.811,42,63,105,17,12,47,31,91,195,2011
C. Atchley,IOW,,19,13,328,34,78,0.436,4,11,0.364,30,67,0.448,0.462,27,31,0.871,20,46,66,10,8,19,19,59,99,2011
C. Atchley,TOT,,45,14,870,99,217,0.456,39,95,0.411,60,122,0.492,0.546,57,68,0.838,62,109,171,27,20,66,50,150,294,2011
C. Ayer,DAK,,20,6,444,90,185,0.486,0,3,0.0,90,182,0.495,0.486,66,82,0.805,47,70,117,4,5,27,35,80,246,2011
L. Babbitt,IDA,21.0,14,9,406,96,187,0.513,15,40,0.375,81,147,0.551,0.553,74,84,0.881,29,74,103,21,12,8,25,35,281,2011
D. Bailey,SFL,,37,35,1122,136,330,0.412,38,108,0.352,98,222,0.441,0.47,95,116,0.819,26,95,121,203,41,3,100,120,405,2011
M. Baker,DAK,31.0,25,19,701,92,216,0.426,10,35,0.286,82,181,0.453,0.449,58,63,0.921,43,83,126,123,27,3,51,95,252,2011
S. Banks,IDA,26.0,23,1,470,75,167,0.449,16,53,0.302,59,114,0.518,0.497,53,73,0.726,18,35,53,28,13,2,33,26,219,2011
J. Beal,TOT,,44,7,1001,125,293,0.427,36,98,0.367,89,195,0.456,0.488,63,78,0.808,19,61,80,112,22,8,60,62,349,2011
J. Beal,ERI,,15,7,460,54,132,0.409,13,44,0.295,41,88,0.466,0.458,29,35,0.829,9,25,34,49,10,1,18,20,150,2011
J. Beal,AUS,,29,0,541,71,161,0.441,23,54,0.426,48,107,0.449,0.512,34,43,0.791,10,36,46,63,12,7,42,42,199,2011
D. Bell,BAK,,41,13,644,79,170,0.465,20,47,0.426,59,123,0.48,0.524,37,47,0.787,27,76,103,27,23,4,45,86,215,2011
M. Blakely,TOT,,49,19,1233,287,459,0.625,3,18,0.167,284,441,0.644,0.629,159,250,0.636,146,165,311,60,72,39,88,165,736,2011
M. Blakely,IOW,,24,6,653,166,239,0.695,2,7,0.286,164,232,0.707,0.699,78,117,0.667,67,91,158,24,29,23,36,82,412,2011
M. Blakely,BAK,,25,13,580,121,220,0.55,1,11,0.091,120,209,0.574,0.552,81,133,0.609,79,74,153,36,43,16,52,83,324,2011
E. Boateng,AUS,,22,5,377,48,87,0.552,0,1,0.0,48,86,0.558,0.552,11,23,0.478,37,71,108,10,4,21,29,64,107,2011
E. Boateng,TOT,,40,16,649,83,163,0.509,0,1,0.0,83,162,0.512,0.509,29,57,0.509,70,121,191,17,7,35,56,110,195,2011
E. Boateng,IDA,,18,11,272,35,76,0.461,0,0,0.0,35,76,0.461,0.461,18,34,0.529,33,50,83,7,3,14,27,46,88,2011
T. Bobbitt,SPR,31.0,9,8,316,42,118,0.356,25,78,0.321,17,40,0.425,0.462,11,13,0.846,1,30,31,24,9,3,26,23,120,2011
T. Bobbitt,IDA,31.0,14,14,442,72,158,0.456,41,92,0.446,31,66,0.47,0.585,20,24,0.833,8,50,58,34,26,2,19,29,205,2011
T. Bobbitt,TOT,31.0,23,22,758,114,276,0.413,66,170,0.388,48,106,0.453,0.533,31,37,0.838,9,80,89,58,35,5,45,52,325,2011
J. Bohannon,IOW,23.0,12,0,58,6,9,0.667,2,2,1.0,4,7,0.571,0.778,3,4,0.75,0,7,7,2,5,1,5,9,17,2011
J. Bostic,NMX,23.0,48,24,1336,182,425,0.428,46,132,0.348,136,293,0.464,0.482,187,228,0.82,75,145,220,120,42,9,94,139,597,2011
M. Bouldin,TUL,23.0,9,1,199,22,58,0.379,4,15,0.267,18,43,0.419,0.414,19,25,0.76,6,17,23,28,8,4,12,26,67,2011
C. Brackins,SPR,23.0,18,13,677,143,325,0.44,19,77,0.247,124,248,0.5,0.469,56,77,0.727,34,121,155,35,15,16,30,49,361,2011
A. Bradley,MAI,20.0,9,6,290,57,126,0.452,10,27,0.37,47,99,0.475,0.492,30,35,0.857,7,36,43,47,27,3,39,29,154,2011
J. Brady,UTA,,46,4,546,76,139,0.547,7,20,0.35,69,119,0.58,0.572,16,26,0.615,55,102,157,22,21,7,37,75,175,2011
B. Brooks,TUL,,33,4,521,55,121,0.455,8,29,0.276,47,92,0.511,0.488,19,21,0.905,12,40,52,99,18,7,44,36,137,2011
J. Brown,SPR,,32,15,461,49,124,0.395,0,0,0.0,49,124,0.395,0.395,25,38,0.658,46,50,96,16,7,13,26,69,123,2011
J. Bryant,BAK,,12,6,244,16,32,0.5,0,0,0.0,16,32,0.5,0.5,8,18,0.444,22,52,74,10,3,13,16,39,40,2011
D. Byars,BAK,26.0,30,25,996,196,431,0.455,63,157,0.401,133,274,0.485,0.528,70,100,0.7,51,114,165,58,32,7,59,77,525,2011
B. Byerson,SFL,,5,0,49,10,15,0.667,0,0,0.0,10,15,0.667,0.667,3,12,0.25,7,3,10,2,1,4,4,11,23,2011
P. Caldwell,TEX,,8,0,53,5,15,0.333,2,10,0.2,3,5,0.6,0.4,5,5,1.0,1,6,7,11,3,0,6,5,17,2011
D. Caracter,BAK,22.0,3,1,60,9,21,0.429,0,0,0.0,9,21,0.429,0.429,8,18,0.444,3,15,18,1,0,2,13,17,26,2011
D. Carroll,DAK,24.0,6,6,215,38,91,0.418,0,2,0.0,38,89,0.427,0.418,34,42,0.81,21,20,41,12,7,3,21,27,110,2011
T. Carr,ERI,,25,6,425,50,119,0.42,5,25,0.2,45,94,0.479,0.441,20,28,0.714,8,42,50,38,17,0,31,38,125,2011
T. Carter,TUL,,31,13,823,115,283,0.406,50,134,0.373,65,149,0.436,0.495,70,87,0.805,9,52,61,120,23,0,58,60,350,2011
M. Charlo,REN,27.0,47,14,1246,132,289,0.457,10,47,0.213,122,242,0.504,0.474,101,134,0.754,75,176,251,80,51,41,61,103,375,2011
W. Chism,FOR,,27,16,537,84,174,0.483,0,2,0.0,84,172,0.488,0.483,61,79,0.772,64,85,149,27,21,22,36,78,229,2011
K. Clark,TEX,,26,8,331,33,72,0.458,2,5,0.4,31,67,0.463,0.472,19,33,0.576,19,44,63,18,11,8,19,67,87,2011
L. Clinch,TOT,,35,6,704,109,292,0.373,25,91,0.275,84,201,0.418,0.416,39,55,0.709,19,52,71,65,30,8,67,72,282,2011
L. Clinch,MAI,,7,0,104,15,44,0.341,6,19,0.316,9,25,0.36,0.409,5,6,0.833,0,8,8,13,9,0,11,9,41,2011
L. Clinch,AUS,,28,6,600,94,248,0.379,19,72,0.264,75,176,0.426,0.417,34,49,0.694,19,44,63,52,21,8,56,63,241,2011
A. Coleman,AUS,,34,15,918,166,396,0.419,18,73,0.247,148,323,0.458,0.442,106,154,0.688,52,100,152,72,51,5,59,72,456,2011
D. Coleman,TOT,,48,29,1451,179,406,0.441,44,125,0.352,135,281,0.48,0.495,34,53,0.642,68,205,273,146,75,21,80,107,436,2011
D. Coleman,SFL,,19,4,439,69,159,0.434,25,59,0.424,44,100,0.44,0.513,11,19,0.579,20,61,81,41,25,7,28,37,174,2011
D. Coleman,NMX,,29,25,1012,110,247,0.445,19,66,0.288,91,181,0.503,0.484,23,34,0.676,48,144,192,105,50,14,52,70,262,2011
S. Collins,MAI,23.0,5,0,130,19,48,0.396,6,21,0.286,13,27,0.481,0.458,16,19,0.842,2,6,8,16,6,0,11,7,60,2011
D. Cooper,DAK,,44,23,1231,129,338,0.382,29,111,0.261,100,227,0.441,0.425,101,129,0.783,18,100,118,179,44,3,79,57,388,2011
B. Costner,UTA,,49,44,1314,250,569,0.439,60,186,0.323,190,383,0.496,0.492,179,261,0.686,79,211,290,93,17,37,106,168,739,2011
M. Cousin,AUS,24.0,46,45,1406,251,482,0.521,0,1,0.0,251,481,0.522,0.521,183,220,0.832,145,251,396,38,17,52,80,145,685,2011
J. Cripe,MAI,,14,0,120,5,21,0.238,0,0,0.0,5,21,0.238,0.238,2,2,1.0,9,9,18,5,4,3,8,19,12,2011
J. Cripe,TOT,,28,9,369,32,66,0.485,0,1,0.0,32,65,0.492,0.485,7,10,0.7,25,25,50,13,5,11,18,62,71,2011
J. Cripe,NMX,,14,9,249,27,45,0.6,0,1,0.0,27,44,0.614,0.6,5,8,0.625,16,16,32,8,1,8,10,43,59,2011
J. Crittenton,DAK,23.0,21,5,598,109,258,0.422,4,22,0.182,105,236,0.445,0.43,83,138,0.601,19,74,93,141,52,2,93,59,305,2011
K. Cuffe,SPR,,10,0,170,26,60,0.433,0,0,0.0,26,60,0.433,0.433,25,31,0.806,13,20,33,4,1,4,14,21,77,2011
J. Curry,SPR,25.0,44,42,1485,243,571,0.426,53,145,0.366,190,426,0.446,0.472,145,173,0.838,29,146,175,156,73,4,119,122,684,2011
J. Dabbert,IDA,29.0,21,0,215,39,68,0.574,0,3,0.0,39,65,0.6,0.574,25,39,0.641,28,42,70,8,5,19,17,53,103,2011
A. Daniels,TEX,35.0,38,37,1449,160,357,0.448,34,80,0.425,126,277,0.455,0.496,197,227,0.868,15,168,183,327,55,2,90,65,551,2011
E. Daniels,ERI,28.0,12,6,371,72,135,0.533,10,36,0.278,62,99,0.626,0.57,17,19,0.895,26,64,90,36,20,12,20,41,171,2011
J. Davidson,IDA,26.0,30,21,905,189,364,0.519,0,2,0.0,189,362,0.522,0.519,82,108,0.759,72,232,304,23,13,44,58,66,460,2011
B. Davis,UTA,,9,8,230,29,71,0.408,0,1,0.0,29,70,0.414,0.408,19,28,0.679,21,34,55,8,7,5,16,26,77,2011
C. Davis,REN,,34,1,415,51,131,0.389,11,29,0.379,40,102,0.392,0.431,22,30,0.733,17,60,77,34,14,4,22,44,135,2011
E. Davis,ERI,21.0,2,0,35,7,12,0.583,0,0,0.0,7,12,0.583,0.583,6,6,1.0,2,8,10,1,0,6,4,1,20,2011
M. Davis,NMX,,9,2,68,3,9,0.333,0,0,0.0,3,9,0.333,0.333,3,4,0.75,5,13,18,1,2,5,7,19,9,2011
E. Dawson,AUS,26.0,14,0,254,43,94,0.457,0,2,0.0,43,92,0.467,0.457,18,26,0.692,25,46,71,19,15,12,22,46,104,2011
S. Dennis,BAK,,48,16,1079,173,386,0.448,14,48,0.292,159,338,0.47,0.466,143,187,0.765,36,108,144,184,68,14,101,95,503,2011
J. Dentmon,TEX,25.0,50,35,1753,316,648,0.488,94,219,0.429,222,429,0.517,0.56,227,269,0.844,47,127,174,201,70,5,129,161,953,2011
R. Diggs,DAK,,9,0,109,11,30,0.367,0,3,0.0,11,27,0.407,0.367,11,15,0.733,6,23,29,1,1,6,12,12,33,2011
Z. Dowdell,TUL,26.0,18,18,528,95,230,0.413,14,45,0.311,81,185,0.438,0.443,57,72,0.792,6,32,38,82,43,2,32,45,261,2011
R. Dupree,UTA,30.0,33,31,1079,198,424,0.467,6,23,0.261,192,401,0.479,0.474,98,160,0.613,49,139,188,98,33,13,67,119,500,2011
J. Dyson,TUL,23.0,47,10,1266,242,554,0.437,65,196,0.332,177,358,0.494,0.495,180,226,0.796,31,114,145,108,74,16,125,123,729,2011
D. Ebanks,BAK,21.0,6,0,166,37,74,0.5,2,10,0.2,35,64,0.547,0.514,23,31,0.742,16,30,46,10,9,4,16,24,99,2011
G. Edwards,SPR,,39,13,995,167,324,0.515,0,3,0.0,167,321,0.52,0.515,96,130,0.738,70,148,218,36,30,37,77,110,430,2011
S. Edwards,NMX,,45,43,1512,278,505,0.55,3,7,0.429,275,498,0.552,0.553,191,259,0.737,107,198,305,72,43,35,117,145,750,2011
J. Eglseder,MAI,,2,0,20,2,7,0.286,0,0,0.0,2,7,0.286,0.286,0,0,0.0,0,2,2,0,0,0,0,5,4,2011
M. Ehambe,TOT,,19,7,477,72,172,0.419,50,101,0.495,22,71,0.31,0.564,33,39,0.846,12,35,47,15,10,1,15,38,227,2011
M. Ehambe,IOW,,9,7,256,41,85,0.482,26,51,0.51,15,34,0.441,0.635,17,19,0.895,7,19,26,6,7,0,8,16,125,2011
M. Ehambe,AUS,,10,0,221,31,87,0.356,24,50,0.48,7,37,0.189,0.494,16,20,0.8,5,16,21,9,3,1,7,22,102,2011
S. Ely,IOW,,13,0,251,33,69,0.478,15,34,0.441,18,35,0.514,0.587,17,22,0.773,3,24,27,12,5,2,9,21,98,2011
A. Emmett,REN,28.0,5,0,97,16,42,0.381,2,5,0.4,14,37,0.378,0.405,10,16,0.625,1,19,20,9,3,0,6,3,44,2011
C. English,FOR,,39,0,532,47,147,0.32,18,66,0.273,29,81,0.358,0.381,32,45,0.711,7,29,36,90,8,0,48,30,144,2011
J. Evans,UTA,23.0,2,2,64,9,17,0.529,0,0,0.0,9,17,0.529,0.529,3,5,0.6,7,10,17,7,1,7,1,6,21,2011
P. Ewing,REN,26.0,26,25,875,135,320,0.422,21,64,0.328,114,256,0.445,0.455,119,151,0.788,64,155,219,86,43,32,74,91,410,2011
P. Ewing,TOT,26.0,49,48,1731,291,658,0.442,43,129,0.333,248,529,0.469,0.475,243,302,0.805,121,342,463,163,73,51,138,173,868,2011
P. Ewing,SFL,26.0,23,23,856,156,338,0.462,22,65,0.338,134,273,0.491,0.494,124,151,0.821,57,187,244,77,30,19,64,82,458,2011
C. Eyenga,ERI,21.0,15,13,390,76,143,0.531,11,39,0.282,65,104,0.625,0.57,22,33,0.667,22,49,71,15,13,15,27,27,185,2011
B. Fall,MAI,,17,0,249,29,48,0.604,0,0,0.0,29,48,0.604,0.604,18,36,0.5,30,38,68,3,0,32,9,44,76,2011
M. Faye,RIO,,47,40,1194,171,380,0.45,83,214,0.388,88,166,0.53,0.559,61,82,0.744,78,190,268,64,48,38,72,112,486,2011
N. Fazekas,REN,25.0,12,12,309,71,134,0.53,0,2,0.0,71,132,0.538,0.53,33,52,0.635,35,55,90,10,12,6,18,23,175,2011
A. Ferguson,SFL,,9,0,86,9,16,0.563,0,0,0.0,9,16,0.563,0.563,4,8,0.5,2,11,13,2,0,9,3,15,22,2011
J. Flynn,SFL,21.0,2,2,56,5,15,0.333,2,8,0.25,3,7,0.429,0.4,4,7,0.571,3,3,6,21,2,0,13,3,16,2011
A. Ford,ERI,29.0,7,1,32,2,7,0.286,0,0,0.0,2,7,0.286,0.286,3,4,0.75,2,0,2,3,1,2,1,7,7,2011
C. Fortson,REN,22.0,6,1,41,3,7,0.429,0,0,0.0,3,7,0.429,0.429,3,7,0.429,0,2,2,4,1,0,2,2,9,2011
T. Gaffney,UTA,,35,34,1002,149,275,0.542,4,14,0.286,145,261,0.556,0.549,64,97,0.66,85,165,250,81,50,81,44,60,366,2011
R. Gaines,TEX,30.0,4,0,51,2,6,0.333,0,0,0.0,2,6,0.333,0.333,0,2,0.0,0,2,2,3,1,0,2,10,4,2011
T. Gallon,MAI,20.0,35,30,1027,185,373,0.496,1,7,0.143,184,366,0.503,0.497,109,158,0.69,99,165,264,60,34,44,121,115,480,2011
T. Gallon,BAK,20.0,11,0,188,31,67,0.463,2,9,0.222,29,58,0.5,0.478,17,22,0.773,14,41,55,5,6,8,15,37,81,2011
T. Gallon,TOT,20.0,46,30,1215,216,440,0.491,3,16,0.188,213,424,0.502,0.494,126,180,0.7,113,206,319,65,40,52,136,152,561,2011
C. Garcia,UTA,22.0,9,1,95,20,43,0.465,0,2,0.0,20,41,0.488,0.465,13,25,0.52,10,14,24,5,1,2,9,17,53,2011
C. Garcia,TOT,22.0,11,1,111,21,46,0.457,0,2,0.0,21,44,0.477,0.457,17,30,0.567,12,16,28,5,2,2,10,20,59,2011
C. Garcia,IOW,22.0,2,0,16,1,3,0.333,0,0,0.0,1,3,0.333,0.333,4,5,0.8,2,2,4,0,1,0,1,3,6,2011
T. Gardner,AUS,25.0,12,10,339,56,138,0.406,19,61,0.311,37,77,0.481,0.475,18,29,0.621,2,25,27,24,10,1,28,30,149,2011
T. Gardner,TOT,25.0,19,10,423,62,162,0.383,23,74,0.311,39,88,0.443,0.454,22,35,0.629,3,33,36,32,12,1,33,41,169,2011
T. Gardner,REN,25.0,7,0,84,6,24,0.25,4,13,0.308,2,11,0.182,0.333,4,6,0.667,1,8,9,8,2,0,5,11,20,2011
M. Gerrity,DAK,,11,3,141,10,40,0.25,0,5,0.0,10,35,0.286,0.25,4,9,0.444,4,14,18,31,6,2,14,19,24,2011
J. Giddens,NMX,25.0,17,11,612,95,196,0.485,11,36,0.306,84,160,0.525,0.513,20,28,0.714,32,62,94,37,14,12,33,36,221,2011
M. Gilstrap,RIO,,5,0,41,7,16,0.438,2,7,0.286,5,9,0.556,0.5,2,3,0.667,3,9,12,2,0,1,6,5,18,2011
M. Gladness,TOT,24.0,36,14,524,73,132,0.553,0,0,0.0,73,132,0.553,0.553,31,55,0.564,59,99,158,8,10,55,37,77,177,2011
M. Gladness,RIO,24.0,19,6,197,31,52,0.596,0,0,0.0,31,52,0.596,0.596,11,20,0.55,26,36,62,1,6,21,14,30,73,2011
M. Gladness,DAK,24.0,17,8,327,42,80,0.525,0,0,0.0,42,80,0.525,0.525,20,35,0.571,33,63,96,7,4,34,23,47,104,2011
K. Goldcamp,ERI,,42,18,722,117,195,0.6,0,0,0.0,117,195,0.6,0.6,36,56,0.643,82,101,183,35,16,35,43,89,270,2011
L. Goldwire,SFL,,12,5,333,52,133,0.391,18,55,0.327,34,78,0.436,0.459,42,52,0.808,10,45,55,49,21,0,36,37,164,2011
V. Goodridge,TOT,,48,37,1022,141,265,0.532,0,0,0.0,141,265,0.532,0.532,61,82,0.744,89,143,232,28,19,85,61,169,343,2011
V. Goodridge,SPR,,33,28,766,123,219,0.562,0,0,0.0,123,219,0.562,0.562,51,69,0.739,72,105,177,24,14,54,53,130,297,2011
V. Goodridge,MAI,,15,9,256,18,46,0.391,0,0,0.0,18,46,0.391,0.391,10,13,0.769,17,38,55,4,5,31,8,39,46,2011
A. Goods,TOT,,39,34,1266,220,536,0.41,89,235,0.379,131,301,0.435,0.493,162,183,0.885,19,134,153,85,29,3,91,54,691,2011
A. Goods,FOR,,1,0,4,0,0,0.0,0,0,0.0,0,0,0.0,0.0,0,0,0.0,0,0,0,0,0,0,1,0,0,2011
A. Goods,DAK,,38,34,1262,220,536,0.41,89,235,0.379,131,301,0.435,0.493,162,183,0.885,19,134,153,85,29,3,90,54,691,2011
D. Govens,REN,,2,0,4,0,1,0.0,0,0,0.0,0,1,0.0,0.0,0,0,0.0,0,1,1,1,1,0,0,2,0,2011
K. Grant,SFL,,50,34,1422,185,422,0.438,49,127,0.386,136,295,0.461,0.496,46,64,0.719,47,198,245,80,59,11,60,122,465,2011
D. Green,TOT,23.0,17,15,630,121,267,0.453,41,93,0.441,80,174,0.46,0.53,58,73,0.795,42,85,127,43,23,17,47,47,341,2011
D. Green,REN,23.0,16,15,598,114,253,0.451,36,83,0.434,78,170,0.459,0.522,58,73,0.795,40,80,120,41,22,16,47,41,322,2011
D. Green,AUS,23.0,1,0,32,7,14,0.5,5,10,0.5,2,4,0.5,0.679,0,0,0.0,2,5,7,2,1,1,0,6,19,2011
O. Greene,UTA,28.0,36,35,1260,205,468,0.438,54,146,0.37,151,322,0.469,0.496,133,188,0.707,33,159,192,180,70,18,129,150,597,2011
J. Gunter,ERI,,3,0,23,4,7,0.571,0,0,0.0,4,7,0.571,0.571,4,4,1.0,2,7,9,1,0,0,3,1,12,2011
J. Gunter,TOT,,37,13,631,67,143,0.469,0,0,0.0,67,143,0.469,0.469,22,33,0.667,57,93,150,29,17,22,37,81,156,2011
J. Gunter,SPR,,34,13,608,63,136,0.463,0,0,0.0,63,136,0.463,0.463,18,29,0.621,55,86,141,28,17,22,34,80,144,2011
D. Hadley,IDA,33.0,42,13,664,35,128,0.273,10,44,0.227,25,84,0.298,0.313,50,64,0.781,23,68,91,65,20,4,50,75,130,2011
M. Hall,DAK,26.0,17,13,532,62,149,0.416,13,39,0.333,49,110,0.445,0.46,31,37,0.838,51,81,132,25,17,5,18,49,168,2011
B. Hamilton,UTA,,50,2,1119,141,310,0.455,11,39,0.282,130,271,0.48,0.473,119,227,0.524,79,156,235,84,86,11,107,153,412,2011
V. Hamilton,TOT,,16,4,428,78,167,0.467,12,27,0.444,66,140,0.471,0.503,52,71,0.732,8,58,66,53,21,1,47,33,220,2011
V. Hamilton,DAK,,12,3,328,57,128,0.445,8,22,0.364,49,106,0.462,0.477,44,57,0.772,7,45,52,38,16,1,37,21,166,2011
V. Hamilton,AUS,,4,1,100,21,39,0.538,4,5,0.8,17,34,0.5,0.59,8,14,0.571,1,13,14,15,5,0,10,12,54,2011
R. Hampton,TEX,,19,7,365,48,91,0.527,5,19,0.263,43,72,0.597,0.555,0,3,0.0,24,59,83,15,12,12,18,58,101,2011
S. Hannah,IOW,25.0,40,12,797,110,321,0.343,43,152,0.283,67,169,0.396,0.41,41,56,0.732,28,53,81,89,61,2,58,90,304,2011
A. Harris,UTA,25.0,7,0,107,19,55,0.345,0,5,0.0,19,50,0.38,0.345,6,9,0.667,5,15,20,20,2,0,8,11,44,2011
A. Harris,TOT,25.0,41,15,968,197,435,0.453,9,44,0.205,188,391,0.481,0.463,82,106,0.774,32,116,148,148,28,5,88,101,485,2011
A. Harris,SFL,25.0,34,15,861,178,380,0.468,9,39,0.231,169,341,0.496,0.48,76,97,0.784,27,101,128,128,26,5,80,90,441,2011
P. Harris,MAI,,22,9,542,83,174,0.477,12,34,0.353,71,140,0.507,0.511,59,81,0.728,47,105,152,21,20,18,42,74,237,2011
T. Harris,RIO,23.0,50,14,1318,188,388,0.485,75,202,0.371,113,186,0.608,0.581,89,120,0.742,58,174,232,151,71,14,108,158,540,2011
K. Hayes,MAI,,43,4,818,106,264,0.402,21,68,0.309,85,196,0.434,0.441,77,94,0.819,19,52,71,97,27,4,47,34,310,2011
M. Haynes,IOW,,48,17,996,174,410,0.424,80,202,0.396,94,208,0.452,0.522,77,111,0.694,60,112,172,48,22,21,60,114,505,2011
C. Holm,DAK,,3,0,57,8,19,0.421,0,0,0.0,8,19,0.421,0.421,8,10,0.8,11,14,25,3,2,1,5,7,24,2011
R. Holmes,ERI,,2,0,9,1,1,1.0,1,1,1.0,0,0,1.5,0.0,3,4,0.75,0,1,1,0,0,0,0,2,6,2011
J. Horton,TOT,,12,7,298,16,53,0.302,1,10,0.1,15,43,0.349,0.311,14,26,0.538,2,26,28,45,8,0,20,31,47,2011
J. Horton,RIO,,3,0,35,1,7,0.143,0,4,0.0,1,3,0.333,0.143,1,4,0.25,0,4,4,3,0,0,1,1,3,2011
J. Horton,NMX,,9,7,263,15,46,0.326,1,6,0.167,14,40,0.35,0.337,13,22,0.591,2,22,24,42,8,0,19,30,44,2011
R. Howard,FOR,,8,1,225,34,69,0.493,4,15,0.267,30,54,0.556,0.522,17,25,0.68,6,27,33,14,8,0,10,23,89,2011
M. Hubbard,TOT,,42,25,1097,164,341,0.481,26,72,0.361,138,269,0.513,0.519,61,93,0.656,83,167,250,47,54,33,49,135,415,2011
M. Hubbard,NMX,,35,25,970,144,296,0.486,21,61,0.344,123,235,0.523,0.522,53,79,0.671,69,138,207,44,50,30,41,113,362,2011
M. Hubbard,AUS,,7,0,127,20,45,0.444,5,11,0.455,15,34,0.441,0.5,8,14,0.571,14,29,43,3,4,3,8,22,53,2011
T. Hughes,NMX,,1,1,12,2,4,0.5,0,0,0.0,2,4,0.5,0.5,0,0,0.0,1,1,2,1,0,1,0,2,4,2011
C. Hunter,FOR,26.0,7,0,146,35,69,0.507,0,1,0.0,35,68,0.515,0.507,28,38,0.737,11,34,45,6,3,3,12,27,98,2011
L. Hurdle,TOT,,50,14,1268,195,444,0.439,86,220,0.391,109,224,0.487,0.536,103,128,0.805,21,88,109,89,46,3,41,108,579,2011
L. Hurdle,SPR,,14,5,391,60,121,0.496,31,60,0.517,29,61,0.475,0.624,35,40,0.875,11,27,38,31,9,1,16,24,186,2011
L. Hurdle,IDA,,36,9,877,135,323,0.418,55,160,0.344,80,163,0.491,0.503,68,88,0.773,10,61,71,58,37,2,25,84,393,2011
I. Ibok,NMX,,13,4,127,7,16,0.438,0,0,0.0,7,16,0.438,0.438,3,4,0.75,12,13,25,1,2,6,19,29,17,2011
A. Ingram,UTA,25.0,50,29,1460,210,465,0.452,101,222,0.455,109,243,0.449,0.56,131,150,0.873,25,138,163,100,43,1,60,109,652,2011
C. Jackson,TOT,24.0,50,50,1723,223,494,0.451,42,128,0.328,181,366,0.495,0.494,169,270,0.626,65,212,277,364,104,11,165,142,657,2011
C. Jackson,IDA,24.0,36,36,1300,165,347,0.476,24,82,0.293,141,265,0.532,0.51,134,209,0.641,49,170,219,271,75,5,123,104,488,2011
C. Jackson,ERI,24.0,14,14,423,58,147,0.395,18,46,0.391,40,101,0.396,0.456,35,61,0.574,16,42,58,93,29,6,42,38,169,2011
L. Jackson,IDA,29.0,18,12,572,81,191,0.424,22,62,0.355,59,129,0.457,0.482,82,96,0.854,29,63,92,75,33,5,45,34,266,2011
A. Jalloh,NMX,,38,25,939,131,301,0.435,13,43,0.302,118,258,0.457,0.457,194,239,0.812,25,82,107,126,46,7,118,130,469,2011
M. Janning,TOT,,41,10,1108,139,321,0.433,64,154,0.416,75,167,0.449,0.533,54,69,0.783,48,104,152,109,47,11,71,83,396,2011
M. Janning,RIO,,21,2,558,74,170,0.435,38,98,0.388,36,72,0.5,0.547,25,28,0.893,27,55,82,58,22,4,30,44,211,2011
M. Janning,MAI,,20,8,550,65,151,0.43,26,56,0.464,39,95,0.411,0.517,29,41,0.707,21,49,70,51,25,7,41,39,185,2011
D. Jefferson,UTA,27.0,2,0,42,4,12,0.333,1,5,0.2,3,7,0.429,0.375,4,6,0.667,0,0,0,10,2,0,4,8,13,2011
D. Jefferson,TOT,27.0,10,8,275,22,60,0.367,3,16,0.188,19,44,0.432,0.392,48,60,0.8,6,23,29,37,13,0,26,32,95,2011
D. Jefferson,IDA,27.0,8,8,233,18,48,0.375,2,11,0.182,16,37,0.432,0.396,44,54,0.815,6,23,29,27,11,0,22,24,82,2011
O. Jeffers,IOW,25.0,38,37,1451,282,585,0.482,14,45,0.311,268,540,0.496,0.494,223,305,0.731,95,249,344,117,73,8,107,103,801,2011
W. Jenkins,IDA,,50,15,1157,128,303,0.422,34,110,0.309,94,193,0.487,0.479,87,102,0.853,57,147,204,75,28,13,61,107,377,2011
A. Johnson,IDA,21.0,9,1,249,71,119,0.597,3,11,0.273,68,108,0.63,0.609,19,24,0.792,9,29,38,27,7,3,19,26,164,2011
B. Johnson,DAK,,25,2,490,52,156,0.333,11,54,0.204,41,102,0.402,0.369,37,45,0.822,13,39,52,53,26,0,42,57,152,2011
C. Johnson,AUS,28.0,46,46,1563,198,448,0.442,58,146,0.397,140,302,0.464,0.507,110,149,0.738,34,148,182,274,69,5,106,137,564,2011
C. Johnson,DAK,25.0,35,34,1115,231,447,0.517,1,3,0.333,230,444,0.518,0.518,105,143,0.734,92,230,322,46,28,97,89,127,568,2011
D. Johnson,TEX,,27,11,676,128,259,0.494,30,85,0.353,98,174,0.563,0.552,52,58,0.897,31,65,96,42,21,3,32,52,338,2011
I. Johnson,ERI,26.0,49,42,1534,420,777,0.541,7,37,0.189,413,740,0.558,0.545,258,334,0.772,101,282,383,157,88,25,157,191,1105,2011
J. Johnson,IOW,23.0,8,8,257,53,99,0.535,3,17,0.176,50,82,0.61,0.551,45,49,0.918,17,54,71,34,8,20,24,29,154,2011
T. Johnson,BAK,26.0,39,39,1403,365,731,0.499,21,65,0.323,344,666,0.517,0.514,243,298,0.815,27,137,164,175,34,5,138,101,994,2011
M. Joiner,AUS,,47,2,784,88,230,0.383,37,120,0.308,51,110,0.464,0.463,39,48,0.813,42,106,148,42,18,22,38,124,252,2011
D. Jones,TEX,22.0,10,10,376,58,133,0.436,10,26,0.385,48,107,0.449,0.474,61,71,0.859,11,41,52,50,16,5,38,33,187,2011
T. Kelley,AUS,26.0,11,2,258,34,79,0.43,11,24,0.458,23,55,0.418,0.5,24,27,0.889,6,14,20,37,4,0,28,26,103,2011
W. Kemp,DAK,,16,7,318,21,65,0.323,3,13,0.231,18,52,0.346,0.346,7,11,0.636,8,24,32,42,14,2,24,28,52,2011
A. Kent,FOR,27.0,50,10,913,102,228,0.447,0,0,0.0,102,228,0.447,0.447,46,88,0.523,79,108,187,33,25,43,57,130,250,2011
B. Knox,DAK,,5,1,65,7,16,0.438,0,0,0.0,7,16,0.438,0.438,1,3,0.333,5,9,14,0,1,2,3,11,15,2011
A. Koch,BAK,,22,2,479,47,101,0.465,10,31,0.323,37,70,0.529,0.515,33,43,0.767,19,79,98,27,18,13,22,52,137,2011
C. Kramer,FOR,,42,25,1242,184,342,0.538,18,49,0.367,166,293,0.567,0.564,181,221,0.819,27,135,162,114,77,22,60,121,567,2011
K. Kruger,UTA,,35,34,1228,135,333,0.405,69,183,0.377,66,150,0.44,0.509,138,169,0.817,13,77,90,153,33,1,68,77,477,2011
O. Lafayette,FOR,26.0,21,18,704,111,288,0.385,26,86,0.302,85,202,0.421,0.431,96,112,0.857,22,66,88,76,41,3,52,63,344,2011
M. Landry,REN,25.0,49,48,1737,302,707,0.427,106,275,0.385,196,432,0.454,0.502,130,178,0.73,58,156,214,98,56,29,87,146,840,2011
S. Lasme,MAI,28.0,10,0,202,23,56,0.411,1,7,0.143,22,49,0.449,0.42,23,37,0.622,20,40,60,7,8,6,16,25,70,2011
G. Lawal,IOW,22.0,10,0,203,35,75,0.467,0,1,0.0,35,74,0.473,0.467,42,68,0.618,18,42,60,0,2,8,19,33,112,2011
D. Lazare,FOR,,50,50,1688,314,664,0.473,0,1,0.0,314,663,0.474,0.473,183,243,0.753,121,225,346,60,45,25,112,132,811,2011
B. Leggett,SPR,,24,6,421,41,105,0.39,2,5,0.4,39,100,0.39,0.4,14,29,0.483,33,52,85,11,8,9,18,31,98,2011
K. Lewis,TOT,,49,20,1017,130,342,0.38,50,154,0.325,80,188,0.426,0.453,59,76,0.776,21,69,90,66,39,1,59,98,369,2011
K. Lewis,TEX,,40,18,883,119,299,0.398,44,132,0.333,75,167,0.449,0.472,51,65,0.785,18,60,78,54,36,1,51,86,333,2011
K. Lewis,RIO,,9,2,134,11,43,0.256,6,22,0.273,5,21,0.238,0.326,8,11,0.727,3,9,12,12,3,0,8,12,36,2011
M. Lewis,TUL,,49,3,1188,163,317,0.514,0,0,0.0,163,317,0.514,0.514,62,134,0.463,98,172,270,85,39,17,71,119,388,2011
N. Linhart,ERI,,47,41,1566,189,410,0.461,56,152,0.368,133,258,0.516,0.529,61,82,0.744,66,205,271,136,80,28,94,121,495,2011
J. Lin,REN,22.0,20,10,636,126,264,0.477,14,36,0.389,112,228,0.491,0.504,94,131,0.718,28,87,115,87,41,6,54,53,360,2011
C. Lofton,IOW,,34,20,1178,194,405,0.479,94,221,0.425,100,184,0.543,0.595,50,60,0.833,11,108,119,77,73,3,36,64,532,2011
J. Lomers,IDA,,5,1,51,8,13,0.615,0,0,0.0,8,13,0.615,0.615,3,4,0.75,5,6,11,1,0,0,2,15,19,2011
L. Longar,UTA,,3,2,45,3,4,0.75,0,0,0.0,3,4,0.75,0.75,1,4,0.25,2,5,7,2,0,2,3,7,7,2011
K. Lyde,TOT,30.0,15,1,176,22,33,0.667,0,0,0.0,22,33,0.667,0.667,9,18,0.5,11,13,24,13,2,9,15,48,53,2011
K. Lyde,SFL,30.0,8,0,96,12,18,0.667,0,0,0.0,12,18,0.667,0.667,6,12,0.5,8,6,14,9,0,3,9,27,30,2011
K. Lyde,NMX,30.0,7,1,80,10,15,0.667,0,0,0.0,10,15,0.667,0.667,3,6,0.5,3,7,10,4,2,6,6,21,23,2011
L. Lyons,AUS,,34,27,1007,173,360,0.481,51,130,0.392,122,230,0.53,0.551,109,157,0.694,48,157,205,56,29,8,60,106,506,2011
C. Maduabum,BAK,19.0,3,0,21,1,4,0.25,0,0,0.0,1,4,0.25,0.25,0,1,0.0,0,1,1,1,0,3,1,3,2,2011
R. Major,DAK,28.0,49,48,1719,272,530,0.513,4,19,0.211,268,511,0.524,0.517,221,293,0.754,99,171,270,85,66,35,59,124,769,2011
S. Marshall,SFL,23.0,48,10,1126,197,495,0.398,54,167,0.323,143,328,0.436,0.453,84,115,0.73,51,104,155,50,30,6,72,88,532,2011
A. Mason,SFL,,15,14,529,93,181,0.514,2,13,0.154,91,168,0.542,0.519,39,53,0.736,33,90,123,50,24,17,40,43,227,2011
T. Mason-Griffin,SFL,,5,0,58,4,21,0.19,1,2,0.5,3,19,0.158,0.214,4,4,1.0,5,6,11,9,2,0,2,4,13,2011
A. Mbodji,UTA,24.0,4,0,61,6,7,0.857,0,0,0.0,6,7,0.857,0.857,8,10,0.8,4,10,14,1,0,6,3,11,20,2011
R. McCants,TEX,26.0,10,2,205,54,98,0.551,16,38,0.421,38,60,0.633,0.633,20,31,0.645,6,23,29,20,6,1,17,32,144,2011
C. McCray,SFL,26.0,38,33,1119,125,282,0.443,17,63,0.27,108,219,0.493,0.473,100,114,0.877,30,134,164,144,53,9,66,105,367,2011
S. McDowell,AUS,,3,0,54,8,17,0.471,2,5,0.4,6,12,0.5,0.529,1,2,0.5,0,3,3,6,0,0,3,6,19,2011
S. McDowell,TOT,,48,8,1012,139,371,0.375,50,142,0.352,89,229,0.389,0.442,44,57,0.772,17,42,59,107,34,2,67,60,372,2011
S. McDowell,SFL,,13,0,256,39,109,0.358,10,30,0.333,29,79,0.367,0.404,12,14,0.857,4,13,17,26,9,0,21,11,100,2011
S. McDowell,NMX,,32,8,702,92,245,0.376,38,107,0.355,54,138,0.391,0.453,31,41,0.756,13,26,39,75,25,2,43,43,253,2011
C. McFarland,SPR,,26,21,586,107,204,0.525,0,1,0.0,107,203,0.527,0.525,59,79,0.747,41,109,150,28,12,26,66,80,273,2011
J. McNeal,RIO,23.0,47,47,1620,282,616,0.458,68,188,0.362,214,428,0.5,0.513,279,348,0.802,35,150,185,207,60,12,165,136,911,2011
C. Medlock,UTA,,2,0,12,2,8,0.25,0,4,0.0,2,4,0.5,0.25,0,0,0.0,0,0,0,1,1,0,1,1,4,2011
A. Miles,REN,27.0,17,17,587,90,176,0.511,0,5,0.0,90,171,0.526,0.511,77,98,0.786,21,49,70,149,42,4,45,48,257,2011
E. Millsap,TUL,23.0,50,44,1431,241,548,0.44,33,97,0.34,208,451,0.461,0.47,246,325,0.757,60,205,265,130,61,17,111,144,761,2011
T. Mitchell,ERI,,50,20,1654,338,631,0.536,0,4,0.0,338,627,0.539,0.536,140,181,0.773,108,175,283,115,67,26,95,191,816,2011
B. Mullens,TUL,21.0,14,14,388,86,162,0.531,1,4,0.25,85,158,0.538,0.534,36,49,0.735,35,60,95,14,10,20,29,40,209,2011
O. Muonelo,FOR,,19,0,225,29,85,0.341,10,31,0.323,19,54,0.352,0.4,12,16,0.75,12,24,36,10,3,1,6,14,80,2011
P. Mutombo,BAK,,4,1,97,11,22,0.5,6,17,0.353,5,5,1.0,0.636,1,2,0.5,2,10,12,1,0,1,3,7,29,2011
D. Naymick,BAK,,48,33,1364,161,296,0.544,0,0,0.0,161,296,0.544,0.544,90,110,0.818,114,250,364,38,36,106,60,158,412,2011
H. N'Diaye,DAK,24.0,11,2,201,14,32,0.438,0,1,0.0,14,31,0.452,0.438,16,24,0.667,14,32,46,4,3,29,16,37,44,2011
S. Novak,REN,27.0,2,0,58,13,19,0.684,9,14,0.643,4,5,0.8,0.921,2,5,0.4,2,11,13,2,0,0,4,8,37,2011
P. O'Bryant,REN,24.0,31,25,679,130,258,0.504,3,9,0.333,127,249,0.51,0.51,48,65,0.738,67,158,225,40,24,57,64,108,311,2011
C. Oguchi,MAI,,32,17,835,105,278,0.378,52,149,0.349,53,129,0.411,0.471,63,78,0.808,13,88,101,49,16,8,40,58,325,2011
Y. Ogunoye,SFL,,14,6,386,34,67,0.507,0,0,0.0,34,67,0.507,0.507,7,14,0.5,29,43,72,17,5,14,10,21,75,2011
N. Ojougboh,UTA,,43,1,706,76,151,0.503,0,2,0.0,76,149,0.51,0.503,47,69,0.681,53,125,178,37,20,50,50,96,199,2011
A. Onuaku,RIO,23.0,5,0,43,10,20,0.5,0,0,0.0,10,20,0.5,0.5,3,6,0.5,11,8,19,1,2,1,5,8,23,2011
D. Orton,NMX,20.0,2,2,42,8,18,0.444,0,1,0.0,8,17,0.471,0.444,4,4,1.0,3,13,16,4,1,2,4,3,20,2011
L. Owens,TUL,28.0,43,42,1321,206,432,0.477,37,111,0.333,169,321,0.526,0.52,83,113,0.735,69,146,215,129,53,21,97,110,532,2011
K. Palmer,AUS,,50,18,1268,199,434,0.459,40,148,0.27,159,286,0.556,0.505,198,234,0.846,78,174,252,67,69,28,91,117,636,2011
P. Patterson,RIO,21.0,9,9,315,61,110,0.555,1,7,0.143,60,103,0.583,0.559,42,56,0.75,28,65,93,10,14,14,17,29,165,2011
J. Peterson,NMX,,36,10,852,187,409,0.457,37,102,0.363,150,307,0.489,0.502,73,111,0.658,103,110,213,31,22,11,65,83,484,2011
M. Phillips,FOR,,50,22,1359,248,461,0.538,6,26,0.231,242,435,0.556,0.544,113,143,0.79,185,282,467,39,80,37,63,170,615,2011
D. Pittman,SFL,22.0,22,22,612,128,239,0.536,0,0,0.0,128,239,0.536,0.536,63,115,0.548,75,105,180,26,9,38,52,86,319,2011
D. Raivio,TOT,,38,14,768,94,209,0.45,21,55,0.382,73,154,0.474,0.5,14,16,0.875,16,33,49,122,33,0,39,36,223,2011
D. Raivio,FOR,,13,13,376,41,99,0.414,12,28,0.429,29,71,0.408,0.475,6,8,0.75,5,19,24,53,16,0,18,19,100,2011
D. Raivio,ERI,,25,1,392,53,110,0.482,9,27,0.333,44,83,0.53,0.523,8,8,1.0,11,14,25,69,17,0,21,17,123,2011
N. Raivio,NMX,,21,10,382,36,92,0.391,15,33,0.455,21,59,0.356,0.473,22,34,0.647,20,38,58,44,15,1,26,40,109,2011
R. Reid,TUL,24.0,48,33,1075,146,290,0.503,0,1,0.0,146,289,0.505,0.503,115,154,0.747,101,177,278,50,35,22,74,139,407,2011
S. Reynolds,SPR,,46,45,1577,193,434,0.445,47,142,0.331,146,292,0.5,0.499,168,201,0.836,27,149,176,270,88,4,118,100,601,2011
M. Rice,SFL,,21,0,533,101,220,0.459,23,49,0.469,78,171,0.456,0.511,14,20,0.7,12,32,44,45,12,3,32,27,239,2011
A. Richardson,TOT,,43,28,1302,241,498,0.484,4,20,0.2,237,478,0.496,0.488,93,133,0.699,118,183,301,60,44,61,75,126,579,2011
A. Richardson,REN,,30,27,932,178,373,0.477,4,17,0.235,174,356,0.489,0.483,69,92,0.75,81,124,205,49,31,42,47,95,429,2011
A. Richardson,NMX,,13,1,370,63,125,0.504,0,3,0.0,63,122,0.516,0.504,24,41,0.585,37,59,96,11,13,19,28,31,150,2011
C. Roberts,TOT,,11,0,261,27,64,0.422,6,23,0.261,21,41,0.512,0.469,19,20,0.95,18,36,54,16,15,7,12,28,79,2011
C. Roberts,TEX,,10,0,248,25,60,0.417,6,23,0.261,19,37,0.514,0.467,19,20,0.95,16,36,52,16,15,6,11,25,75,2011
C. Roberts,IDA,,1,0,13,2,4,0.5,0,0,0.0,2,4,0.5,0.5,0,0,0.0,2,0,2,0,0,1,1,3,4,2011
D. Robinson,ERI,,18,4,400,80,166,0.482,4,17,0.235,76,149,0.51,0.494,53,70,0.757,12,29,41,71,18,0,39,49,217,2011
S. Robinson,TOT,,25,2,383,91,169,0.538,12,43,0.279,79,126,0.627,0.574,37,53,0.698,38,62,100,13,14,10,22,32,231,2011
S. Robinson,RIO,,3,0,30,11,17,0.647,2,2,1.0,9,15,0.6,0.706,5,7,0.714,1,7,8,2,2,1,2,3,29,2011
S. Robinson,IOW,,22,2,353,80,152,0.526,10,41,0.244,70,111,0.631,0.559,32,46,0.696,37,55,92,11,12,9,20,29,202,2011
R. Roby,RIO,,50,31,1392,290,617,0.47,66,206,0.32,224,411,0.545,0.524,129,194,0.665,67,160,227,102,65,31,137,131,775,2011
M. Rogers,TEX,,49,14,887,141,286,0.493,1,12,0.083,140,274,0.511,0.495,79,109,0.725,79,131,210,13,24,55,60,134,362,2011
M. Rolle,MAI,,15,7,390,90,177,0.508,0,4,0.0,90,173,0.52,0.508,31,53,0.585,35,48,83,20,22,18,30,57,211,2011
W. Russell,FOR,28.0,37,37,1282,227,486,0.467,18,56,0.321,209,430,0.486,0.486,184,221,0.833,26,94,120,293,67,0,134,85,656,2011
S. Samuels,ERI,22.0,2,0,47,8,16,0.5,0,0,0.0,8,16,0.5,0.5,13,17,0.765,1,7,8,4,4,1,3,4,29,2011
L. Sanders,FOR,22.0,2,2,54,7,19,0.368,0,1,0.0,7,18,0.389,0.368,7,9,0.778,6,14,20,1,4,5,6,10,21,2011
D. Scales,TOT,,25,5,296,32,74,0.432,0,0,0.0,32,74,0.432,0.432,13,18,0.722,26,27,53,1,7,9,10,59,77,2011
D. Scales,SFL,,6,0,67,9,26,0.346,0,0,0.0,9,26,0.346,0.346,0,2,0.0,5,5,10,0,0,0,1,15,18,2011
D. Scales,DAK,,19,5,229,23,48,0.479,0,0,0.0,23,48,0.479,0.479,13,16,0.813,21,22,43,1,7,9,9,44,59,2011
J. Scheyer,RIO,,16,11,544,79,180,0.439,33,97,0.34,46,83,0.554,0.531,30,44,0.682,20,42,62,65,19,6,38,27,221,2011
M. Seck,TEX,,18,0,65,9,14,0.643,0,0,0.0,9,14,0.643,0.643,3,4,0.75,5,12,17,1,1,5,7,21,21,2011
M. Shakur,RIO,26.0,23,23,838,137,281,0.488,24,75,0.32,113,206,0.549,0.53,86,121,0.711,21,86,107,116,44,7,60,57,384,2011
W. Sharpe,NMX,24.0,24,8,544,91,213,0.427,12,45,0.267,79,168,0.47,0.455,48,65,0.738,33,81,114,38,22,25,43,75,242,2011
W. Sharpe,IDA,24.0,3,3,116,25,54,0.463,1,2,0.5,24,52,0.462,0.472,8,14,0.571,10,19,29,4,0,3,10,13,59,2011
W. Sharpe,DAK,24.0,18,9,373,63,167,0.377,1,7,0.143,62,160,0.388,0.38,24,38,0.632,32,72,104,16,10,12,34,51,151,2011
W. Sharpe,TOT,24.0,45,20,1033,179,434,0.412,14,54,0.259,165,380,0.434,0.429,80,117,0.684,75,172,247,58,32,40,87,139,452,2011
G. Siler,IOW,24.0,4,1,65,7,12,0.583,0,0,0.0,7,12,0.583,0.583,4,8,0.5,6,14,20,1,0,3,8,19,18,2011
B. Simmons,REN,30.0,10,8,357,57,108,0.528,13,40,0.325,44,68,0.647,0.588,27,32,0.844,17,75,92,22,13,3,25,45,154,2011
C. Sims,IOW,27.0,42,42,1341,255,456,0.559,0,2,0.0,255,454,0.562,0.559,190,253,0.751,150,253,403,43,17,49,124,142,700,2011
D. Sims,MAI,,48,45,1661,396,783,0.506,51,129,0.395,345,654,0.528,0.538,133,196,0.679,102,269,371,71,53,34,100,131,976,2011
D. Sloan,REN,23.0,49,33,1358,202,418,0.483,18,57,0.316,184,361,0.51,0.505,104,144,0.722,31,134,165,214,37,1,80,64,526,2011
A. Smith,REN,,3,0,17,0,3,0.0,0,0,0.0,0,3,0.0,0.0,3,4,0.75,3,1,4,0,0,0,2,4,3,2011
I. Smith,RIO,22.0,8,5,264,44,98,0.449,4,16,0.25,40,82,0.488,0.469,8,16,0.5,7,27,34,63,12,10,29,24,100,2011
J. Smith,MAI,,48,45,1624,251,537,0.467,105,243,0.432,146,294,0.497,0.565,48,54,0.889,22,111,133,241,49,9,123,88,655,2011
J. Smith,SPR,23.0,46,6,1108,188,396,0.475,61,153,0.399,127,243,0.523,0.552,154,196,0.786,20,111,131,126,55,14,99,116,591,2011
K. Spain,ERI,,44,17,996,129,312,0.413,45,131,0.344,84,181,0.464,0.486,53,66,0.803,39,117,156,60,36,13,50,100,356,2011
E. Spates,TOT,,52,5,965,132,338,0.391,45,136,0.331,87,202,0.431,0.457,72,101,0.713,64,158,222,45,25,13,41,134,381,2011
E. Spates,SPR,,17,0,396,64,157,0.408,18,51,0.353,46,106,0.434,0.465,18,24,0.75,33,68,101,18,14,5,19,60,164,2011
E. Spates,MAI,,35,5,569,68,181,0.376,27,85,0.318,41,96,0.427,0.45,54,77,0.701,31,90,121,27,11,8,22,74,217,2011
P. Stevenson,TUL,,2,0,33,1,2,0.5,0,0,0.0,1,2,0.5,0.5,1,1,1.0,2,5,7,1,0,1,3,5,3,2011
C. Stinson,IOW,27.0,48,48,2059,375,747,0.502,5,31,0.161,370,716,0.517,0.505,173,227,0.762,59,216,275,472,66,10,218,135,928,2011
L. Stokes,ERI,,22,5,431,42,78,0.538,1,5,0.2,41,73,0.562,0.545,21,41,0.512,7,59,66,46,12,1,36,33,106,2011
S. Stoudamire,REN,28.0,33,1,687,111,252,0.44,24,71,0.338,87,181,0.481,0.488,50,59,0.847,8,35,43,57,15,2,25,44,296,2011
S. Stoudamire,IDA,28.0,9,5,257,42,93,0.452,9,24,0.375,33,69,0.478,0.5,26,28,0.929,2,14,16,33,4,1,11,29,119,2011
S. Stoudamire,TOT,28.0,42,6,944,153,345,0.443,33,95,0.347,120,250,0.48,0.491,76,87,0.874,10,49,59,90,19,3,36,73,415,2011
D. Strawberry,REN,25.0,20,7,588,86,201,0.428,19,54,0.352,67,147,0.456,0.475,88,118,0.746,12,52,64,52,20,4,55,59,279,2011
P. Sullivan,RIO,,50,19,1054,199,332,0.599,5,8,0.625,194,324,0.599,0.607,68,110,0.618,97,154,251,57,24,47,82,139,471,2011
I. Swann,RIO,,3,0,45,4,17,0.235,4,14,0.286,0,3,0.0,0.353,10,11,0.909,1,5,6,5,1,1,5,8,22,2011
R. Sykes,SFL,,49,41,1564,257,500,0.514,0,1,0.0,257,499,0.515,0.514,166,230,0.722,120,182,302,48,29,86,120,144,680,2011
P. Sy,UTA,22.0,23,11,506,56,132,0.424,3,20,0.15,53,112,0.473,0.436,70,95,0.737,20,59,79,29,7,1,42,54,185,2011
S. Tarver,IDA,,49,33,1324,188,393,0.478,31,98,0.316,157,295,0.532,0.518,79,105,0.752,78,142,220,68,47,8,60,112,486,2011
K. Taylor,IOW,,8,0,147,13,48,0.271,8,31,0.258,5,17,0.294,0.354,4,4,1.0,4,10,14,9,6,0,2,10,38,2011
K. Taylor,BAK,,37,2,713,107,287,0.373,74,199,0.372,33,88,0.375,0.502,18,22,0.818,14,61,75,43,21,3,26,45,306,2011
K. Taylor,TOT,,45,2,860,120,335,0.358,82,230,0.357,38,105,0.362,0.481,22,26,0.846,18,71,89,52,27,3,28,55,344,2011
M. Taylor,IOW,25.0,13,9,338,48,110,0.436,20,52,0.385,28,58,0.483,0.527,16,25,0.64,10,38,48,33,18,2,22,41,132,2011
G. Temple,RIO,24.0,9,3,256,38,91,0.418,22,57,0.386,16,34,0.471,0.538,14,23,0.609,9,22,31,29,7,3,16,22,112,2011
G. Temple,ERI,24.0,15,13,552,75,183,0.41,31,86,0.36,44,97,0.454,0.495,42,53,0.792,23,76,99,42,19,10,39,49,223,2011
G. Temple,TOT,24.0,24,16,808,113,274,0.412,53,143,0.371,60,131,0.458,0.509,56,76,0.737,32,98,130,71,26,13,55,71,335,2011
C. Terry,TEX,,1,1,37,3,10,0.3,2,7,0.286,1,3,0.333,0.4,5,8,0.625,1,3,4,2,1,0,4,5,13,2011
H. Thabeet,RIO,23.0,6,5,167,24,39,0.615,0,0,0.0,24,39,0.615,0.615,12,21,0.571,14,34,48,4,5,16,10,18,60,2011
D. Thomas,REN,,46,3,558,51,85,0.6,0,0,0.0,51,85,0.6,0.6,21,36,0.583,43,102,145,14,20,22,27,86,123,2011
L. Thomas,AUS,22.0,46,46,1374,225,450,0.5,1,12,0.083,224,438,0.511,0.501,130,185,0.703,113,140,253,52,31,13,74,135,581,2011
R. Thompson,UTA,,42,8,1030,181,357,0.507,20,60,0.333,161,297,0.542,0.535,78,105,0.743,34,84,118,56,36,8,44,64,460,2011
J. Tiller,IDA,,5,2,81,11,21,0.524,1,2,0.5,10,19,0.526,0.548,3,4,0.75,10,7,17,9,4,0,4,11,26,2011
D. Tucker,TOT,22.0,50,24,1597,309,684,0.452,65,195,0.333,244,489,0.499,0.499,177,272,0.651,76,189,265,131,66,19,134,136,860,2011
D. Tucker,TEX,22.0,1,0,17,3,4,0.75,0,0,0.0,3,4,0.75,0.75,4,7,0.571,1,6,7,0,1,0,1,2,10,2011
D. Tucker,NMX,22.0,49,24,1580,306,680,0.45,65,195,0.333,241,485,0.497,0.498,173,265,0.653,75,183,258,131,65,19,133,134,850,2011
L. Ulmer,MAI,,2,0,22,2,10,0.2,0,0,0.0,2,10,0.2,0.2,3,4,0.75,1,2,3,0,2,1,2,3,7,2011
C. Underwood,SFL,,20,1,234,34,78,0.436,0,0,0.0,34,78,0.436,0.436,21,26,0.808,15,23,38,7,4,2,17,19,89,2011
B. Uzoh,SPR,22.0,4,3,133,28,46,0.609,0,2,0.0,28,44,0.636,0.609,8,13,0.615,6,26,32,23,9,4,12,9,64,2011
R. Vaden,TUL,25.0,45,17,1260,175,425,0.412,74,189,0.392,101,236,0.428,0.499,45,63,0.714,10,96,106,100,40,15,72,104,469,2011
S. VanderMeer,IOW,,37,8,524,60,159,0.377,6,24,0.25,54,135,0.4,0.396,30,45,0.667,56,90,146,28,12,44,28,85,156,2011
A. Walker,IDA,34.0,43,39,1437,263,598,0.44,85,243,0.35,178,355,0.501,0.511,76,123,0.618,75,197,272,147,25,26,115,123,687,2011
B. Wallace,BAK,,39,22,1016,145,312,0.465,55,149,0.369,90,163,0.552,0.553,39,68,0.574,66,199,265,85,33,58,45,93,384,2011
W. Warren,BAK,21.0,15,5,411,87,192,0.453,28,70,0.4,59,122,0.484,0.526,86,105,0.819,14,46,60,86,15,1,44,37,288,2011
K. Weaver,AUS,24.0,9,4,274,36,89,0.404,15,35,0.429,21,54,0.389,0.489,32,41,0.78,15,30,45,26,9,10,19,25,119,2011
K. Weaver,TOT,24.0,30,24,1054,151,350,0.431,52,124,0.419,99,226,0.438,0.506,113,138,0.819,45,123,168,99,36,33,81,88,467,2011
K. Weaver,IOW,24.0,21,20,780,115,261,0.441,37,89,0.416,78,172,0.453,0.511,81,97,0.835,30,93,123,73,27,23,62,63,348,2011
L. Westbrook,MAI,,9,2,129,14,43,0.326,3,12,0.25,11,31,0.355,0.36,13,14,0.929,0,13,13,11,0,0,8,16,44,2011
L. Westbrook,DAK,,8,0,135,25,58,0.431,11,17,0.647,14,41,0.341,0.526,17,18,0.944,2,12,14,6,5,0,8,8,78,2011
L. Westbrook,TOT,,17,2,264,39,101,0.386,14,29,0.483,25,72,0.347,0.455,30,32,0.938,2,25,27,17,5,0,16,24,122,2011
M. West,MAI,26.0,42,42,1436,212,403,0.526,35,96,0.365,177,307,0.577,0.569,117,181,0.646,29,194,223,121,73,26,117,127,576,2011
C. Wheeler,IDA,,37,17,1008,171,334,0.512,9,32,0.281,162,302,0.536,0.525,147,189,0.778,85,183,268,41,28,14,71,104,498,2011
H. Whiteside,REN,21.0,14,3,148,27,53,0.509,0,0,0.0,27,53,0.509,0.509,7,17,0.412,15,23,38,1,3,30,13,22,61,2011
T. Whitted,SPR,,45,6,946,132,350,0.377,43,152,0.283,89,198,0.449,0.439,39,52,0.75,28,63,91,58,19,5,51,57,346,2011
G. Williamson,TUL,,21,4,318,30,70,0.429,2,12,0.167,28,58,0.483,0.443,18,36,0.5,8,18,26,38,14,11,22,33,80,2011
G. Williamson,TOT,,30,7,510,47,108,0.435,3,17,0.176,44,91,0.484,0.449,42,67,0.627,16,29,45,56,19,16,41,53,139,2011
G. Williamson,AUS,,9,3,192,17,38,0.447,1,5,0.2,16,33,0.485,0.461,24,31,0.774,8,11,19,18,5,5,19,20,59,2011
L. Williams,TUL,,41,26,1102,225,352,0.639,0,1,0.0,225,351,0.641,0.639,90,124,0.726,131,220,351,20,24,40,51,99,540,2011
L. Williams,SPR,22.0,23,19,748,96,215,0.447,22,72,0.306,74,143,0.517,0.498,35,71,0.493,21,64,85,41,28,7,37,64,249,2011
M. Williams,SPR,,4,0,57,2,6,0.333,0,0,0.0,2,6,0.333,0.333,3,8,0.375,8,17,25,5,2,0,5,16,7,2011
S. Williams,TEX,24.0,49,46,1643,268,476,0.563,8,19,0.421,260,457,0.569,0.571,160,230,0.696,168,292,460,56,41,143,155,189,704,2011
T. Williams,SPR,23.0,3,3,123,29,68,0.426,10,20,0.5,19,48,0.396,0.5,16,20,0.8,2,32,34,32,4,2,9,11,84,2011
R. Wilmont,FOR,,47,47,1510,228,599,0.381,91,292,0.312,137,307,0.446,0.457,126,169,0.746,13,132,145,65,78,5,73,117,673,2011
C. Winder,MAI,,11,6,283,38,102,0.373,10,38,0.263,28,64,0.438,0.422,30,40,0.75,14,35,49,36,14,3,30,28,116,2011
J. Wise,BAK,,50,36,1497,235,482,0.488,55,148,0.372,180,334,0.539,0.545,193,244,0.791,28,126,154,250,57,23,145,155,718,2011
R. Wittman,FOR,,21,2,385,56,119,0.471,37,80,0.463,19,39,0.487,0.626,1,1,1.0,6,43,49,9,10,5,9,27,150,2011
B. Woodfox,TEX,24.0,50,13,1030,197,433,0.455,62,164,0.378,135,269,0.502,0.527,92,104,0.885,17,63,80,67,34,1,51,44,548,2011
A. Zahn,FOR,,4,0,48,8,15,0.533,0,0,0.0,8,15,0.533,0.533,7,12,0.583,5,5,10,0,2,0,3,9,23,2011
A. Zampier,NMX,,1,0,3,0,0,0.0,0,0,0.0,0,0,0.0,0.0,0,0,0.0,0,0,0,0,0,0,0,2,0,2011
L. Zeller,BAK,23.0,49,36,1159,118,310,0.381,79,219,0.361,39,91,0.429,0.508,23,31,0.742,49,172,221,63,15,35,21,155,338,2011
W. Adams,TUL,,9,2,202,20,50,0.4,1,10,0.1,19,40,0.475,0.41,1,2,0.5,3,25,28,27,15,0,14,16,42,2010
M. Ager,MAI,25.0,22,19,757,117,246,0.476,33,78,0.423,84,168,0.5,0.543,76,105,0.724,14,86,100,75,20,5,59,44,343,2010
A. Agudio,ABQ,25.0,50,43,1604,259,559,0.463,96,220,0.436,163,339,0.481,0.549,141,183,0.77,23,104,127,138,49,1,94,77,755,2010
B. Ahearn,TOT,25.0,30,23,1144,167,416,0.401,76,210,0.362,91,206,0.442,0.493,167,176,0.949,16,78,94,156,36,5,94,76,577,2010
B. Ahearn,ERI,25.0,13,13,586,94,217,0.433,48,109,0.44,46,108,0.426,0.544,98,102,0.961,8,51,59,87,16,4,51,35,334,2010
B. Ahearn,BAK,25.0,17,10,558,73,199,0.367,28,101,0.277,45,98,0.459,0.437,69,74,0.932,8,27,35,69,20,1,43,41,243,2010
A. Ajinca,MAI,21.0,22,21,571,113,207,0.546,0,3,0.0,113,204,0.554,0.546,95,127,0.748,64,102,166,9,9,68,66,85,321,2010
J. Alexander,FOR,23.0,6,3,162,24,60,0.4,2,5,0.4,22,55,0.4,0.417,13,22,0.591,9,19,28,11,5,4,15,17,63,2010
J. Allen,SPR,,1,0,19,2,8,0.25,0,0,0.0,2,8,0.25,0.25,3,4,0.75,3,0,3,1,0,1,1,0,7,2010
S. Alleyne,ABQ,,15,7,251,23,44,0.523,0,0,0.0,23,44,0.523,0.523,2,8,0.25,15,43,58,3,2,33,18,25,48,2010
L. Allred,IDA,28.0,30,28,936,178,359,0.496,0,0,0.0,178,359,0.496,0.496,34,51,0.667,77,192,269,38,15,11,43,89,390,2010
M. Almond,TOT,24.0,42,39,1614,323,640,0.505,66,173,0.382,257,467,0.55,0.556,323,398,0.812,62,159,221,71,37,5,129,102,1035,2010
M. Almond,SPR,24.0,22,20,896,178,359,0.496,31,83,0.373,147,276,0.533,0.539,202,241,0.838,36,79,115,32,17,1,76,58,589,2010
M. Almond,MAI,24.0,20,19,718,145,281,0.516,35,90,0.389,110,191,0.576,0.578,121,157,0.771,26,80,106,39,20,4,53,44,446,2010
M. Ambres,IDA,,50,30,1447,285,651,0.438,75,208,0.361,210,443,0.474,0.495,81,112,0.723,148,257,405,84,39,33,97,163,726,2010
A. Aminu,BAK,,9,9,299,64,119,0.538,0,0,0.0,64,119,0.538,0.538,46,59,0.78,34,49,83,10,17,11,14,34,174,2010
A. Aminu,TOT,,46,31,1269,245,473,0.518,0,1,0.0,245,472,0.519,0.518,136,202,0.673,127,196,323,26,46,37,73,128,626,2010
A. Aminu,ERI,,37,22,970,181,354,0.511,0,1,0.0,181,353,0.513,0.511,90,143,0.629,93,147,240,16,29,26,59,94,452,2010
A. Anderson,RIO,24.0,40,40,1577,242,497,0.487,19,79,0.241,223,418,0.533,0.506,144,190,0.758,29,133,162,245,50,23,123,104,647,2010
R. Anderson,FOR,,8,2,249,51,112,0.455,11,36,0.306,40,76,0.526,0.504,16,24,0.667,5,25,30,5,9,2,16,20,129,2010
R. Anderson,TOT,,24,2,560,103,243,0.424,40,105,0.381,63,138,0.457,0.506,31,46,0.674,13,63,76,16,18,4,32,38,277,2010
R. Anderson,IOW,,16,0,311,52,131,0.397,29,69,0.42,23,62,0.371,0.508,15,22,0.682,8,38,46,11,9,2,16,18,148,2010
S. Asumnu,RIO,,39,10,737,131,236,0.555,0,2,0.0,131,234,0.56,0.555,44,95,0.463,54,86,140,40,21,5,47,72,306,2010
C. Atchley,IOW,,8,2,100,17,36,0.472,0,5,0.0,17,31,0.548,0.472,4,7,0.571,14,12,26,4,1,5,9,23,38,2010
C. Atchley,DAK,,33,11,564,94,181,0.519,0,3,0.0,94,178,0.528,0.519,42,56,0.75,52,78,130,23,14,30,48,104,230,2010
C. Atchley,TOT,,41,13,664,111,217,0.512,0,8,0.0,111,209,0.531,0.512,46,63,0.73,66,90,156,27,15,35,57,127,268,2010
C. Austrie,SPR,,5,0,95,14,36,0.389,4,11,0.364,10,25,0.4,0.444,6,6,1.0,1,9,10,8,1,0,6,4,38,2010
C. Ayer,TOT,,16,1,216,34,73,0.466,0,0,0.0,34,73,0.466,0.466,15,21,0.714,18,25,43,4,5,7,10,35,83,2010
C. Ayer,SPR,,13,1,195,30,62,0.484,0,0,0.0,30,62,0.484,0.484,15,21,0.714,13,23,36,4,5,6,10,31,75,2010
C. Ayer,UTA,,3,0,21,4,11,0.364,0,0,0.0,4,11,0.364,0.364,0,0,0.0,5,2,7,0,0,1,0,4,8,2010
R. Ayers,FOR,,50,34,1390,185,393,0.471,92,202,0.455,93,191,0.487,0.588,24,29,0.828,37,138,175,51,44,21,42,87,486,2010
D. Bailey,SFL,,48,48,1665,209,508,0.411,51,158,0.323,158,350,0.451,0.462,153,181,0.845,32,128,160,316,63,1,152,122,622,2010
M. Baker,DAK,30.0,49,49,1528,224,491,0.456,35,89,0.393,189,402,0.47,0.492,115,136,0.846,64,217,281,210,81,1,103,147,598,2010
S. Barnette,IOW,,25,1,431,63,145,0.434,11,33,0.333,52,112,0.464,0.472,38,45,0.844,27,39,66,17,11,7,23,46,175,2010
S. Barnette,TOT,,29,2,487,69,160,0.431,11,34,0.324,58,126,0.46,0.466,38,45,0.844,29,45,74,23,15,10,27,55,187,2010
S. Barnette,RIO,,4,1,56,6,15,0.4,0,1,0.0,6,14,0.429,0.4,0,0,0.0,2,6,8,6,4,3,4,9,12,2010
A. Barrett,IDA,27.0,26,26,985,187,385,0.486,42,119,0.353,145,266,0.545,0.54,87,102,0.853,15,51,66,174,24,2,75,44,503,2010
E. Barron,IOW,28.0,47,47,1491,298,610,0.489,7,22,0.318,291,588,0.495,0.494,160,210,0.762,166,313,479,57,35,36,88,143,763,2010
E. Basden,AUS,26.0,38,22,1282,168,373,0.45,62,155,0.4,106,218,0.486,0.534,80,109,0.734,43,126,169,72,64,10,64,107,478,2010
R. Beck,DAK,,42,42,1319,287,529,0.543,73,164,0.445,214,365,0.586,0.612,103,120,0.858,20,110,130,100,45,9,99,73,750,2010
D. Bell,DAK,,48,41,1367,190,475,0.4,96,216,0.444,94,259,0.363,0.501,134,153,0.876,19,99,118,131,50,2,86,100,610,2010
R. Benson,REN,25.0,49,49,1494,274,524,0.523,0,0,0.0,274,524,0.523,0.523,143,243,0.588,167,310,477,84,63,95,112,142,691,2010
R. Bergersen,IDA,,32,18,664,91,226,0.403,55,141,0.39,36,85,0.424,0.524,22,30,0.733,11,37,48,45,28,5,47,70,259,2010
B. Billbe,SPR,,6,0,75,8,14,0.571,0,0,0.0,8,14,0.571,0.571,2,6,0.333,2,14,16,4,1,0,4,14,18,2010
J. Binnie,DAK,,18,0,264,41,106,0.387,13,37,0.351,28,69,0.406,0.448,16,27,0.593,11,20,31,14,15,2,8,25,111,2010
T. Blair,BAK,,7,2,176,15,28,0.536,0,0,0.0,15,28,0.536,0.536,3,11,0.273,14,34,48,5,1,14,4,21,33,2010
W. Blalock,REN,26.0,28,28,954,123,282,0.436,23,68,0.338,100,214,0.467,0.477,60,80,0.75,13,76,89,206,36,1,81,59,329,2010
W. Blalock,MAI,26.0,25,17,699,78,185,0.422,17,66,0.258,61,119,0.513,0.468,40,49,0.816,14,64,78,141,28,2,53,54,213,2010
W. Blalock,TOT,26.0,53,45,1653,201,467,0.43,40,134,0.299,161,333,0.483,0.473,100,129,0.775,27,140,167,347,64,3,134,113,542,2010
T. Bobbitt,TOT,30.0,37,13,1019,182,389,0.468,90,205,0.439,92,184,0.5,0.584,47,55,0.855,9,90,99,67,62,10,42,104,501,2010
T. Bobbitt,SPR,30.0,7,7,264,50,106,0.472,25,55,0.455,25,51,0.49,0.59,11,16,0.688,2,18,20,20,11,1,11,30,136,2010
T. Bobbitt,MAI,30.0,30,6,755,132,283,0.466,65,150,0.433,67,133,0.504,0.581,36,39,0.923,7,72,79,47,51,9,31,74,365,2010
L. Bonner,AUS,,16,2,148,22,50,0.44,14,33,0.424,8,17,0.471,0.58,6,9,0.667,11,14,25,6,5,3,6,40,64,2010
J. Booyer,FOR,,2,0,9,0,4,0.0,0,0,0.0,0,4,0.0,0.0,0,4,0.0,1,1,2,0,1,0,1,2,0,2010
J. Bowen,TOT,26.0,41,21,1043,160,354,0.452,6,22,0.273,154,332,0.464,0.46,61,94,0.649,76,128,204,56,26,17,43,87,387,2010
J. Bowen,SFL,26.0,11,0,256,50,102,0.49,6,14,0.429,44,88,0.5,0.52,17,24,0.708,22,29,51,13,5,6,12,18,123,2010
J. Bowen,AUS,26.0,30,21,787,110,252,0.437,0,8,0.0,110,244,0.451,0.437,44,70,0.629,54,99,153,43,21,11,31,69,264,2010
J. Brady,UTA,,44,5,610,78,143,0.545,9,21,0.429,69,122,0.566,0.577,26,45,0.578,50,113,163,32,21,5,27,81,191,2010
R. Bright,AUS,,6,0,47,4,9,0.444,1,2,0.5,3,7,0.429,0.5,0,2,0.0,2,10,12,1,3,1,0,7,9,2010
C. Brown,TUL,,30,13,912,147,306,0.48,48,103,0.466,99,203,0.488,0.559,80,95,0.842,5,69,74,71,20,3,43,54,422,2010
K. Brumbaugh,BAK,,7,5,220,40,81,0.494,9,22,0.409,31,59,0.525,0.549,22,24,0.917,8,39,47,20,7,3,25,29,111,2010
K. Brumbaugh,TOT,,30,23,938,168,361,0.465,41,112,0.366,127,249,0.51,0.522,99,121,0.818,46,127,173,76,39,13,100,103,476,2010
K. Brumbaugh,SFL,,23,18,718,128,280,0.457,32,90,0.356,96,190,0.505,0.514,77,97,0.794,38,88,126,56,32,10,75,74,365,2010
J. Bryant,ERI,,49,40,1451,275,554,0.496,0,1,0.0,275,553,0.497,0.496,106,136,0.779,104,361,465,83,25,73,98,184,656,2010
B. Butch,BAK,,39,38,1322,249,520,0.479,73,206,0.354,176,314,0.561,0.549,118,171,0.69,118,346,464,66,38,36,71,145,689,2010
M. Campbell,SPR,27.0,43,39,985,205,380,0.539,0,0,0.0,205,380,0.539,0.539,59,103,0.573,106,220,326,40,17,34,102,130,469,2010
P. Campbell,SFL,,7,0,99,19,45,0.422,8,23,0.348,11,22,0.5,0.511,1,2,0.5,1,9,10,7,3,0,4,9,47,2010
P. Carroll,IOW,,50,50,1465,205,451,0.455,75,177,0.424,130,274,0.474,0.538,60,73,0.822,43,116,159,65,46,9,54,119,545,2010
D. Carter,DAK,,2,0,13,2,4,0.5,0,0,0.0,2,4,0.5,0.5,0,0,0.0,0,5,5,0,0,0,2,3,4,2010
J. Carter,FOR,,4,0,15,1,3,0.333,0,0,0.0,1,3,0.333,0.333,0,0,0.0,1,3,4,1,0,0,3,2,2,2010
R. Carter,AUS,,15,4,247,39,99,0.394,6,28,0.214,33,71,0.465,0.424,12,22,0.545,10,26,36,7,15,2,13,32,96,2010
M. Charlo,REN,26.0,50,50,1417,186,381,0.488,9,39,0.231,177,342,0.518,0.5,107,144,0.743,91,175,266,137,71,32,95,121,488,2010
E. Clark,IOW,22.0,3,3,103,24,48,0.5,0,0,0.0,24,48,0.5,0.5,14,20,0.7,8,19,27,6,2,3,3,3,62,2010
K. Clark,TOT,,26,2,487,57,108,0.528,4,11,0.364,53,97,0.546,0.546,20,36,0.556,38,73,111,20,16,13,25,75,138,2010
K. Clark,LOS,,21,0,388,45,85,0.529,3,8,0.375,42,77,0.545,0.547,11,23,0.478,34,58,92,16,11,12,19,63,104,2010
K. Clark,TUL,,5,2,99,12,23,0.522,1,3,0.333,11,20,0.55,0.543,9,13,0.692,4,15,19,4,5,1,6,12,34,2010
L. Clinch,AUS,,49,14,924,158,412,0.383,78,218,0.358,80,194,0.412,0.478,50,63,0.794,13,61,74,41,23,3,57,63,444,2010
C. Clinkscales,ERI,,39,14,816,87,205,0.424,1,9,0.111,86,196,0.439,0.427,25,37,0.676,10,51,61,199,21,4,47,42,200,2010
D. Coleman,MAI,,5,0,98,8,23,0.348,2,10,0.2,6,13,0.462,0.391,0,0,0.0,6,4,10,11,5,1,3,6,18,2010
D. Coleman,AUS,,14,4,185,18,48,0.375,5,16,0.313,13,32,0.406,0.427,9,15,0.6,5,19,24,13,13,2,16,19,50,2010
D. Coleman,TOT,,19,4,283,26,71,0.366,7,26,0.269,19,45,0.422,0.415,9,15,0.6,11,23,34,24,18,3,19,25,68,2010
K. Collins,ABQ,,12,0,209,30,83,0.361,0,7,0.0,30,76,0.395,0.361,23,35,0.657,7,21,28,21,8,0,19,19,83,2010
W. Conroy,RIO,27.0,29,27,1101,164,317,0.517,22,63,0.349,142,254,0.559,0.552,127,162,0.784,33,145,178,290,42,2,105,79,477,2010
D. Cooper,DAK,,49,10,1128,106,263,0.403,43,114,0.377,63,149,0.423,0.485,86,105,0.819,7,70,77,102,48,0,76,75,341,2010
J. Cornley,FOR,,9,0,121,19,44,0.432,1,2,0.5,18,42,0.429,0.443,4,11,0.364,6,3,9,6,3,0,5,9,43,2010
B. Cotton,FOR,,2,0,40,8,24,0.333,0,1,0.0,8,23,0.348,0.333,6,6,1.0,1,1,2,2,3,0,0,3,22,2010
J. Crawford,LOS,23.0,32,16,1163,202,468,0.432,43,145,0.297,159,323,0.492,0.478,122,168,0.726,23,76,99,98,29,11,63,61,569,2010
J. Cripe,SPR,,4,0,63,5,15,0.333,0,0,0.0,5,15,0.333,0.333,6,6,1.0,2,9,11,1,1,3,8,10,16,2010
S. Cuic,ABQ,,20,4,393,51,152,0.336,5,28,0.179,46,124,0.371,0.352,32,41,0.78,34,62,96,6,9,7,25,61,139,2010
S. Cuic,TOT,,32,4,565,76,231,0.329,11,51,0.216,65,180,0.361,0.353,45,59,0.763,41,79,120,10,16,8,36,99,208,2010
S. Cuic,LOS,,12,0,172,25,79,0.316,6,23,0.261,19,56,0.339,0.354,13,18,0.722,7,17,24,4,7,1,11,38,69,2010
L. Cummard,UTA,,22,7,366,42,87,0.483,16,34,0.471,26,53,0.491,0.575,10,11,0.909,8,34,42,26,13,2,21,49,110,2010
T. Cummings,MAI,28.0,18,4,311,59,126,0.468,0,0,0.0,59,126,0.468,0.468,18,24,0.75,19,55,74,11,4,2,14,52,136,2010
T. Cummings,TOT,28.0,39,23,1051,195,420,0.464,0,0,0.0,195,420,0.464,0.464,63,89,0.708,68,191,259,38,14,12,67,121,453,2010
T. Cummings,SPR,28.0,21,19,740,136,294,0.463,0,0,0.0,136,294,0.463,0.463,45,65,0.692,49,136,185,27,10,10,53,69,317,2010
J. Curry,SPR,24.0,27,27,1087,169,344,0.491,44,101,0.436,125,243,0.514,0.555,54,71,0.761,24,87,111,192,42,11,93,67,436,2010
J. Dabbert,IDA,28.0,25,23,622,117,250,0.468,2,3,0.667,115,247,0.466,0.472,114,157,0.726,108,114,222,13,14,30,68,107,350,2010
A. Danridge,ABQ,,41,1,672,119,207,0.575,0,4,0.0,119,203,0.586,0.575,55,66,0.833,34,45,79,37,14,7,40,42,293,2010
W. Daniels,BAK,,31,13,802,163,296,0.551,23,64,0.359,140,232,0.603,0.59,68,105,0.648,50,95,145,45,28,45,56,90,417,2010
J. Darger,UTA,,3,0,11,0,2,0.0,0,1,0.0,0,1,0.0,0.0,0,0,0.0,0,0,0,0,0,0,0,2,0,2010
B. Davis,UTA,,50,17,1406,235,483,0.487,4,30,0.133,231,453,0.51,0.491,165,226,0.73,118,219,337,86,39,37,83,141,639,2010
C. Davis,REN,,39,0,420,57,138,0.413,12,40,0.3,45,98,0.459,0.457,20,29,0.69,11,33,44,43,21,2,28,32,146,2010
P. Davis,MAI,25.0,16,14,456,92,198,0.465,0,2,0.0,92,196,0.469,0.465,56,62,0.903,53,88,141,31,19,26,32,61,240,2010
K. Dawkins,RIO,,8,0,85,7,30,0.233,0,2,0.0,7,28,0.25,0.233,9,10,0.9,2,13,15,8,3,0,14,4,23,2010
E. Dawson,AUS,25.0,2,1,30,7,11,0.636,0,0,0.0,7,11,0.636,0.636,4,7,0.571,4,5,9,1,1,1,3,3,18,2010
E. Devendorf,REN,,3,0,39,5,10,0.5,0,1,0.0,5,9,0.556,0.5,4,6,0.667,0,2,2,2,0,0,3,5,14,2010
D. Dickau,FOR,31.0,13,12,440,76,171,0.444,17,51,0.333,59,120,0.492,0.494,25,30,0.833,6,29,35,92,14,3,40,39,194,2010
J. Dorsey,RIO,26.0,16,16,503,97,150,0.647,0,0,0.0,97,150,0.647,0.647,44,88,0.5,75,137,212,27,18,22,60,62,238,2010
M. Dorsey,REN,28.0,21,3,394,59,126,0.468,0,12,0.0,59,114,0.518,0.468,23,30,0.767,7,22,29,49,12,0,36,42,141,2010
M. Dove,DAK,,41,33,1182,144,283,0.509,0,1,0.0,144,282,0.511,0.509,76,124,0.613,101,141,242,39,55,38,49,123,364,2010
Z. Dowdell,TUL,25.0,10,2,270,52,98,0.531,3,15,0.2,49,83,0.59,0.546,22,32,0.688,8,22,30,37,9,0,19,19,129,2010
B. Eaton,TUL,,2,0,18,1,7,0.143,0,1,0.0,1,6,0.167,0.143,0,0,0.0,0,4,4,1,0,0,5,4,2,2010
C. Edwards,DAK,30.0,9,7,221,41,91,0.451,0,0,0.0,41,91,0.451,0.451,30,35,0.857,17,35,52,6,4,9,20,34,112,2010
J. Edwards,BAK,28.0,25,14,504,96,186,0.516,0,0,0.0,96,186,0.516,0.516,39,56,0.696,31,101,132,18,8,15,40,96,231,2010
S. Edwards,ABQ,,39,25,1012,188,301,0.625,0,1,0.0,188,300,0.627,0.625,118,164,0.72,81,125,206,30,29,32,75,123,494,2010
M. Ehambe,TUL,,50,18,1389,244,551,0.443,117,255,0.459,127,296,0.429,0.549,45,53,0.849,19,113,132,53,24,10,52,78,650,2010
S. Ely,IOW,,49,1,577,62,167,0.371,18,54,0.333,44,113,0.389,0.425,45,55,0.818,7,69,76,38,24,6,34,45,187,2010
C. English,FOR,,9,0,181,20,59,0.339,5,23,0.217,15,36,0.417,0.381,15,20,0.75,3,12,15,33,10,0,9,12,60,2010
G. Ervin,MAI,,2,0,10,0,3,0.0,0,0,0.0,0,3,0.0,0.0,0,2,0.0,1,0,1,1,0,0,2,2,0,2010
B. Evans,IOW,,2,0,15,0,2,0.0,0,0,0.0,0,2,0.0,0.0,0,0,0.0,1,1,2,1,0,0,0,0,0,2010
D. Farmer,REN,28.0,49,49,1861,365,829,0.44,138,357,0.387,227,472,0.481,0.524,295,340,0.868,38,159,197,231,52,4,158,128,1163,2010
N. Felix,TOT,28.0,45,27,1055,166,377,0.44,3,7,0.429,163,370,0.441,0.444,105,123,0.854,84,161,245,53,20,35,95,154,440,2010
N. Felix,SPR,28.0,15,12,400,58,142,0.408,3,7,0.429,55,135,0.407,0.419,44,53,0.83,22,48,70,23,10,9,39,50,163,2010
N. Felix,MAI,28.0,30,15,655,108,235,0.46,0,0,0.0,108,235,0.46,0.46,61,70,0.871,62,113,175,30,10,26,56,104,277,2010
M. Fey,LOS,,50,47,1285,263,463,0.568,1,2,0.5,262,461,0.568,0.569,113,138,0.819,117,202,319,67,25,35,86,143,640,2010
R. Forehan-Kelly,LOS,,50,47,1599,277,528,0.525,82,173,0.474,195,355,0.549,0.602,103,128,0.805,48,190,238,154,65,18,54,123,739,2010
R. Frahm,REN,32.0,16,0,462,75,144,0.521,50,106,0.472,25,38,0.658,0.694,9,11,0.818,4,37,41,35,15,1,19,32,209,2010
C. Gadson,DAK,29.0,18,0,370,67,145,0.462,7,19,0.368,60,126,0.476,0.486,30,37,0.811,2,38,40,70,14,0,47,33,171,2010
R. Gaines,BAK,29.0,47,35,1566,234,485,0.482,62,149,0.416,172,336,0.512,0.546,143,177,0.808,13,117,130,187,35,7,112,129,673,2010
S. Gaines,IDA,23.0,14,8,511,118,226,0.522,23,71,0.324,95,155,0.613,0.573,76,121,0.628,19,47,66,96,32,4,38,33,335,2010
T. Gamble,TOT,,10,2,175,15,27,0.556,0,0,0.0,15,27,0.556,0.556,2,7,0.286,11,35,46,6,4,12,7,33,32,2010
T. Gamble,SFL,,3,0,16,4,6,0.667,0,0,0.0,4,6,0.667,0.667,0,0,0.0,3,3,6,1,0,1,2,3,8,2010
T. Gamble,BAK,,7,2,159,11,21,0.524,0,0,0.0,11,21,0.524,0.524,2,7,0.286,8,32,40,5,4,11,5,30,24,2010
M. Gansey,ERI,,27,26,1167,191,421,0.454,59,181,0.326,132,240,0.55,0.524,56,68,0.824,68,153,221,76,35,6,55,47,497,2010
M. Gansey,TOT,,38,27,1399,228,495,0.461,73,220,0.332,155,275,0.564,0.534,74,89,0.831,87,181,268,100,52,8,69,63,603,2010
M. Gansey,IDA,,11,1,232,37,74,0.5,14,39,0.359,23,35,0.657,0.595,18,21,0.857,19,28,47,24,17,2,14,16,106,2010
A. Gee,AUS,22.0,36,35,1376,272,530,0.513,25,62,0.403,247,468,0.528,0.537,196,279,0.703,81,159,240,46,53,20,117,105,765,2010
J. Giddens,MAI,24.0,4,4,127,29,45,0.644,6,10,0.6,23,35,0.657,0.711,8,10,0.8,1,17,18,12,4,2,8,7,72,2010
T. Gilder,ABQ,25.0,10,4,307,54,102,0.529,1,2,0.5,53,100,0.53,0.534,31,40,0.775,15,44,59,22,9,8,30,23,140,2010
T. Gilder,TOT,25.0,45,23,1376,240,441,0.544,8,20,0.4,232,421,0.551,0.553,152,200,0.76,63,189,252,107,43,50,96,97,640,2010
T. Gilder,MAI,25.0,35,19,1069,186,339,0.549,7,18,0.389,179,321,0.558,0.559,121,160,0.756,48,145,193,85,34,42,66,74,500,2010
B. Gillespie,MAI,27.0,5,0,38,2,6,0.333,1,3,0.333,1,3,0.333,0.417,2,4,0.5,0,0,0,9,0,0,5,2,7,2010
M. Gladness,RIO,23.0,41,6,525,67,118,0.568,0,2,0.0,67,116,0.578,0.568,34,53,0.642,44,83,127,10,11,52,22,69,168,2010
K. Goldcamp,ERI,,32,10,428,42,83,0.506,0,1,0.0,42,82,0.512,0.506,20,26,0.769,33,62,95,13,12,16,18,65,104,2010
L. Goldwire,SFL,,48,2,1220,211,498,0.424,71,204,0.348,140,294,0.476,0.495,124,147,0.844,35,97,132,151,56,4,113,94,617,2010
A. Goods,BAK,,9,0,150,10,46,0.217,3,19,0.158,7,27,0.259,0.25,4,5,0.8,0,19,19,14,5,0,9,13,27,2010
L. Graham,RIO,,4,0,16,0,3,0.0,0,0,0.0,0,3,0.0,0.0,3,4,0.75,0,4,4,1,0,2,1,9,3,2010
K. Gransberry,SPR,24.0,43,8,639,78,133,0.586,0,5,0.0,78,128,0.609,0.586,40,100,0.4,83,110,193,38,13,18,38,93,196,2010
G. Grant,UTA,,2,2,65,13,25,0.52,0,1,0.0,13,24,0.542,0.52,8,9,0.889,1,5,6,3,3,0,7,6,34,2010
J. Graves,IDA,28.0,2,2,45,9,17,0.529,0,0,0.0,9,17,0.529,0.529,1,2,0.5,3,8,11,0,1,3,3,9,19,2010
D. Green,ERI,22.0,2,1,71,17,41,0.415,7,14,0.5,10,27,0.37,0.5,10,13,0.769,6,5,11,5,8,2,8,5,51,2010
O. Greene,UTA,27.0,50,36,1646,295,616,0.479,64,172,0.372,231,444,0.52,0.531,184,277,0.664,77,179,256,178,131,15,198,209,838,2010
T. Griffin,IOW,23.0,12,11,345,40,92,0.435,4,17,0.235,36,75,0.48,0.457,31,44,0.705,15,59,74,26,16,5,25,27,115,2010
J. Gunter,ERI,,44,4,600,52,85,0.612,0,0,0.0,52,85,0.612,0.612,21,32,0.656,60,104,164,14,4,15,20,61,125,2010
M. Hairston,AUS,22.0,15,15,612,148,313,0.473,24,58,0.414,124,255,0.486,0.511,116,140,0.829,27,43,70,45,8,12,26,53,436,2010
B. Hamilton,UTA,,36,4,829,103,218,0.472,9,30,0.3,94,188,0.5,0.493,84,144,0.583,60,88,148,57,45,14,58,98,299,2010
E. Hansen,ABQ,,6,0,78,4,18,0.222,0,0,0.0,4,18,0.222,0.222,0,3,0.0,6,15,21,2,2,15,10,14,8,2010
D. Hardin,TUL,,36,29,736,85,172,0.494,0,1,0.0,85,171,0.497,0.494,49,77,0.636,50,115,165,20,13,37,45,95,219,2010
A. Harrington,SPR,29.0,7,7,213,22,70,0.314,6,21,0.286,16,49,0.327,0.357,11,14,0.786,6,22,28,13,1,0,13,24,61,2010
I. Harris,ERI,,49,29,1579,242,577,0.419,66,183,0.361,176,394,0.447,0.477,55,64,0.859,58,130,188,32,32,12,28,98,605,2010
M. Harris,RIO,26.0,34,31,1212,362,622,0.582,19,67,0.284,343,555,0.618,0.597,177,224,0.79,125,231,356,65,40,20,79,129,920,2010
T. Harris,MAI,22.0,22,0,350,46,107,0.43,14,44,0.318,32,63,0.508,0.495,26,33,0.788,10,45,55,29,26,0,30,64,132,2010
T. Harris,TOT,22.0,24,0,367,48,113,0.425,14,46,0.304,34,67,0.507,0.487,26,33,0.788,11,48,59,30,26,0,31,66,136,2010
T. Harris,RIO,22.0,2,0,17,2,6,0.333,0,2,0.0,2,4,0.5,0.333,0,0,0.0,1,3,4,1,0,0,1,2,4,2010
K. Hasbrouck,RIO,,10,9,325,64,127,0.504,16,42,0.381,48,85,0.565,0.567,25,31,0.806,4,20,24,29,16,0,19,29,169,2010
J. Hawkins,BAK,24.0,15,7,360,58,142,0.408,12,42,0.286,46,100,0.46,0.451,36,42,0.857,14,45,59,12,13,3,19,34,164,2010
J. Hawkins,TOT,24.0,39,26,1256,221,508,0.435,34,110,0.309,187,398,0.47,0.469,168,203,0.828,38,132,170,86,40,7,90,104,644,2010
J. Hawkins,SPR,24.0,24,19,896,163,366,0.445,22,68,0.324,141,298,0.473,0.475,132,161,0.82,24,87,111,74,27,4,71,70,480,2010
C. Hayes,LOS,,3,0,53,8,16,0.5,0,1,0.0,8,15,0.533,0.5,4,6,0.667,1,6,7,6,1,1,8,3,20,2010
R. Hicks,IOW,,4,0,21,0,3,0.0,0,0,0.0,0,3,0.0,0.0,0,0,0.0,1,2,3,0,1,1,1,4,0,2010
S. Hill,TUL,24.0,11,1,88,4,8,0.5,0,0,0.0,4,8,0.5,0.5,3,8,0.375,9,13,22,3,1,8,7,14,11,2010
T. Holmes,RIO,,4,0,23,1,4,0.25,0,1,0.0,1,3,0.333,0.25,0,0,0.0,0,2,2,1,3,0,1,1,2,2010
J. Horton,ABQ,,50,19,1070,66,203,0.325,15,52,0.288,51,151,0.338,0.362,43,62,0.694,22,86,108,215,42,2,87,122,190,2010
R. Howard,FOR,,29,29,1044,194,418,0.464,42,109,0.385,152,309,0.492,0.514,168,211,0.796,21,97,118,85,36,2,76,82,598,2010
M. Hubbard,REN,,17,15,409,62,161,0.385,11,32,0.344,51,129,0.395,0.419,33,47,0.702,39,69,108,20,12,8,22,42,168,2010
M. Hubbard,ABQ,,21,8,394,59,160,0.369,10,27,0.37,49,133,0.368,0.4,23,33,0.697,27,86,113,16,12,12,29,51,151,2010
M. Hubbard,TOT,,38,23,803,121,321,0.377,21,59,0.356,100,262,0.382,0.41,56,80,0.7,66,155,221,36,24,20,51,93,319,2010
L. Hudson,TOT,25.0,20,4,542,108,248,0.435,40,96,0.417,68,152,0.447,0.516,64,75,0.853,23,96,119,84,25,6,53,52,320,2010
L. Hudson,MAI,25.0,5,3,140,25,63,0.397,11,32,0.344,14,31,0.452,0.484,12,14,0.857,4,20,24,21,5,2,12,13,73,2010
L. Hudson,DAK,25.0,15,1,402,83,185,0.449,29,64,0.453,54,121,0.446,0.527,52,61,0.852,19,76,95,63,20,4,41,39,247,2010
G. Hughes,LOS,,28,3,467,70,131,0.534,0,0,0.0,70,131,0.534,0.534,54,77,0.701,76,87,163,16,14,17,32,85,194,2010
Q. Humphrey,RIO,,7,1,87,8,22,0.364,4,7,0.571,4,15,0.267,0.455,1,2,0.5,3,7,10,5,3,1,4,12,21,2010
L. Hurdle,TOT,,40,6,836,96,233,0.412,58,128,0.453,38,105,0.362,0.536,64,78,0.821,4,61,65,90,37,3,42,85,314,2010
L. Hurdle,IDA,,28,1,633,74,176,0.42,48,103,0.466,26,73,0.356,0.557,50,59,0.847,2,50,52,70,25,2,29,64,246,2010
L. Hurdle,BAK,,12,5,203,22,57,0.386,10,25,0.4,12,32,0.375,0.474,14,19,0.737,2,11,13,20,12,1,13,21,68,2010
A. Ingram,UTA,24.0,49,49,1667,219,480,0.456,93,231,0.403,126,249,0.506,0.553,102,120,0.85,42,147,189,104,73,6,64,94,633,2010
B. Jackson,LOS,,8,0,185,39,69,0.565,0,0,0.0,39,69,0.565,0.565,17,36,0.472,19,18,37,6,4,2,11,17,95,2010
B. Jackson,DAK,,32,14,674,96,202,0.475,0,1,0.0,96,201,0.478,0.475,72,103,0.699,72,107,179,22,13,10,41,63,264,2010
B. Jackson,BAK,,10,5,284,41,93,0.441,0,0,0.0,41,93,0.441,0.441,28,42,0.667,26,41,67,9,6,2,7,33,110,2010
B. Jackson,TOT,,50,19,1143,176,364,0.484,0,1,0.0,176,363,0.485,0.484,117,181,0.646,117,166,283,37,23,14,59,113,469,2010
B. Jackson,UTA,29.0,5,0,46,2,9,0.222,0,0,0.0,2,9,0.222,0.222,3,5,0.6,6,4,10,2,2,2,2,12,7,2010
C. Jackson,ERI,23.0,34,24,1143,175,411,0.426,27,100,0.27,148,311,0.476,0.459,180,249,0.723,28,163,191,252,70,12,112,101,557,2010
D. Jackson,ERI,24.0,2,2,83,28,43,0.651,0,0,0.0,28,43,0.651,0.651,10,19,0.526,7,16,23,2,6,2,6,8,66,2010
A. Jalloh,MAI,,9,1,120,16,39,0.41,1,9,0.111,15,30,0.5,0.423,17,21,0.81,1,17,18,17,3,0,9,16,50,2010
A. Jalloh,TOT,,41,8,831,138,300,0.46,21,66,0.318,117,234,0.5,0.495,126,156,0.808,27,125,152,100,61,6,91,107,423,2010
A. Jalloh,SPR,,32,7,711,122,261,0.467,20,57,0.351,102,204,0.5,0.506,109,135,0.807,26,108,134,83,58,6,82,91,373,2010
N. Jawai,SFL,23.0,4,0,84,14,31,0.452,0,0,0.0,14,31,0.452,0.452,5,10,0.5,7,11,18,4,1,0,11,14,33,2010
D. Jefferson,UTA,26.0,34,33,1219,185,434,0.426,32,99,0.323,153,335,0.457,0.463,194,245,0.792,25,106,131,187,51,8,104,102,596,2010
O. Jeffers,IOW,24.0,22,16,643,124,243,0.51,3,10,0.3,121,233,0.519,0.516,63,95,0.663,48,101,149,42,39,7,40,48,314,2010
C. Jerrells,AUS,,50,50,2012,365,778,0.469,70,186,0.376,295,592,0.498,0.514,234,301,0.777,28,199,227,285,93,12,160,126,1034,2010
A. Johnson,SFL,26.0,22,10,715,153,268,0.571,0,1,0.0,153,267,0.573,0.571,200,264,0.758,62,182,244,32,14,29,89,81,506,2010
C. Johnson,AUS,27.0,50,2,938,119,268,0.444,48,104,0.462,71,164,0.433,0.534,37,47,0.787,12,67,79,148,41,2,45,76,323,2010
M. Johnson,TUL,,7,0,60,2,13,0.154,0,1,0.0,2,12,0.167,0.154,6,8,0.75,0,6,6,7,1,0,5,9,10,2010
P. Johnson,SPR,,4,2,105,11,24,0.458,1,6,0.167,10,18,0.556,0.479,5,7,0.714,13,12,25,7,1,2,11,19,28,2010
T. Johnson,BAK,25.0,13,13,516,100,213,0.469,5,30,0.167,95,183,0.519,0.481,72,83,0.867,3,41,44,92,13,2,42,32,277,2010
M. Joiner,TOT,,46,37,1290,151,391,0.386,69,183,0.377,82,208,0.394,0.474,38,52,0.731,49,128,177,75,42,25,58,164,409,2010
M. Joiner,SFL,,28,23,803,93,249,0.373,37,100,0.37,56,149,0.376,0.448,25,34,0.735,31,71,102,54,24,12,40,87,248,2010
M. Joiner,AUS,,18,14,487,58,142,0.408,32,83,0.386,26,59,0.441,0.521,13,18,0.722,18,57,75,21,18,13,18,77,161,2010
D. Jones,AUS,26.0,48,48,1925,277,464,0.597,0,0,0.0,277,464,0.597,0.597,293,439,0.667,298,474,772,76,43,85,137,173,847,2010
E. Jones,IDA,,26,0,419,51,140,0.364,4,29,0.138,47,111,0.423,0.379,36,48,0.75,30,61,91,22,13,11,20,31,142,2010
C. Karl,IDA,26.0,26,26,1008,159,367,0.433,44,141,0.312,115,226,0.509,0.493,141,181,0.779,37,120,157,127,35,9,70,83,503,2010
A. Kent,FOR,26.0,45,18,1001,111,237,0.468,0,0,0.0,111,237,0.468,0.468,34,65,0.523,78,140,218,26,24,43,58,123,256,2010
Y. Korolev,TOT,22.0,47,13,1061,163,378,0.431,39,106,0.368,124,272,0.456,0.483,126,177,0.712,74,184,258,55,48,28,68,110,491,2010
Y. Korolev,REN,22.0,27,0,567,85,215,0.395,29,83,0.349,56,132,0.424,0.463,66,98,0.673,41,102,143,30,27,11,34,56,265,2010
Y. Korolev,ABQ,22.0,20,13,494,78,163,0.479,10,23,0.435,68,140,0.486,0.509,60,79,0.759,33,82,115,25,21,17,34,54,226,2010
K. Koufos,UTA,20.0,5,4,157,44,74,0.595,0,1,0.0,44,73,0.603,0.595,9,16,0.563,16,33,49,7,3,8,14,16,97,2010
J. Krabbenhoft,SFL,,18,10,519,95,184,0.516,12,32,0.375,83,152,0.546,0.549,46,58,0.793,38,92,130,45,21,6,20,61,248,2010
K. Kruger,UTA,,19,16,678,78,160,0.488,45,101,0.446,33,59,0.559,0.628,85,93,0.914,4,51,55,89,21,1,44,32,286,2010
R. Kurz,FOR,24.0,39,35,1447,234,474,0.494,50,115,0.435,184,359,0.513,0.546,164,203,0.808,126,269,395,89,32,57,90,138,682,2010
O. Lafayette,FOR,25.0,48,42,1697,288,656,0.439,90,236,0.381,198,420,0.471,0.508,154,193,0.798,38,184,222,310,88,3,153,134,820,2010
B. Laing,REN,,2,0,35,7,11,0.636,0,0,0.0,7,11,0.636,0.636,4,6,0.667,3,5,8,3,1,1,1,3,18,2010
M. Landry,MAI,24.0,13,2,324,54,133,0.406,21,55,0.382,33,78,0.423,0.485,19,33,0.576,14,42,56,21,10,11,19,32,148,2010
D. Lazare,MAI,,50,34,1364,223,480,0.465,0,4,0.0,223,476,0.468,0.465,80,105,0.762,99,169,268,67,38,23,69,100,526,2010
M. Lewis,TUL,,42,3,659,73,135,0.541,0,0,0.0,73,135,0.541,0.541,22,41,0.537,66,70,136,38,22,8,40,80,168,2010
L. Longar,LOS,,7,3,144,20,48,0.417,0,0,0.0,20,48,0.417,0.417,7,11,0.636,12,28,40,3,1,9,9,17,47,2010
L. Longar,BAK,,4,1,84,6,16,0.375,0,0,0.0,6,16,0.375,0.375,7,16,0.438,8,13,21,4,3,3,8,14,19,2010
L. Longar,TOT,,11,4,228,26,64,0.406,0,0,0.0,26,64,0.406,0.406,14,27,0.519,20,41,61,7,4,12,17,31,66,2010
K. Looby,RIO,,11,1,179,12,25,0.48,0,0,0.0,12,25,0.48,0.48,12,21,0.571,25,34,59,4,7,29,10,23,36,2010
K. Looby,MAI,,13,3,282,32,48,0.667,0,0,0.0,32,48,0.667,0.667,4,13,0.308,34,67,101,9,8,52,13,41,68,2010
K. Looby,ABQ,,26,23,806,73,123,0.593,0,0,0.0,73,123,0.593,0.593,31,55,0.564,73,162,235,9,15,85,40,82,177,2010
K. Looby,TOT,,50,27,1267,117,196,0.597,0,0,0.0,117,196,0.597,0.597,47,89,0.528,132,263,395,22,30,166,63,146,281,2010
C. Lowe,TOT,,19,1,284,30,77,0.39,0,5,0.0,30,72,0.417,0.39,14,18,0.778,6,35,41,45,13,0,22,19,74,2010
C. Lowe,SPR,,10,0,174,20,48,0.417,0,4,0.0,20,44,0.455,0.417,10,11,0.909,3,23,26,24,10,0,14,9,50,2010
C. Lowe,MAI,,9,1,110,10,29,0.345,0,1,0.0,10,28,0.357,0.345,4,7,0.571,3,12,15,21,3,0,8,10,24,2010
R. Major,DAK,27.0,49,8,1360,200,385,0.519,8,25,0.32,192,360,0.533,0.53,197,237,0.831,73,146,219,111,48,50,50,112,605,2010
J. Manuel,ERI,26.0,44,43,1834,238,539,0.442,11,39,0.282,227,500,0.454,0.452,123,197,0.624,72,148,220,117,65,40,110,174,610,2010
C. Martin,IOW,25.0,31,27,920,186,392,0.474,61,134,0.455,125,258,0.484,0.552,103,133,0.774,45,96,141,54,30,12,59,102,536,2010
J. Mathis,IDA,,11,2,162,18,44,0.409,0,0,0.0,18,44,0.409,0.409,7,12,0.583,17,14,31,5,2,5,14,32,43,2010
M. Maxwell,SPR,,26,11,674,77,186,0.414,4,17,0.235,73,169,0.432,0.425,37,47,0.787,13,45,58,54,22,10,43,40,195,2010
K. McAlarney,FOR,,23,10,604,89,177,0.503,39,81,0.481,50,96,0.521,0.613,25,27,0.926,12,41,53,68,14,0,39,27,242,2010
K. McAlarney,TOT,,43,30,1359,176,375,0.469,67,159,0.421,109,216,0.505,0.559,47,51,0.922,21,92,113,174,40,0,94,72,466,2010
K. McAlarney,SPR,,20,20,755,87,198,0.439,28,78,0.359,59,120,0.492,0.51,22,24,0.917,9,51,60,106,26,0,55,45,224,2010
D. McClure,AUS,,40,9,552,41,99,0.414,4,8,0.5,37,91,0.407,0.434,7,14,0.5,34,77,111,20,12,15,19,51,93,2010
C. McCray,SFL,25.0,38,26,1070,110,274,0.401,25,88,0.284,85,186,0.457,0.447,79,88,0.898,21,113,134,138,59,7,53,114,324,2010
S. McDowell,BAK,,3,0,35,4,11,0.364,2,6,0.333,2,5,0.4,0.455,1,3,0.333,1,2,3,5,2,0,4,3,11,2010
B. McKenzie,IDA,26.0,50,9,678,99,178,0.556,0,0,0.0,99,178,0.556,0.556,32,60,0.533,90,126,216,10,20,69,60,151,230,2010
L. McKenzie,LOS,,10,0,172,16,42,0.381,7,17,0.412,9,25,0.36,0.464,4,4,1.0,4,13,17,16,4,2,18,11,43,2010
K. McLeod,ABQ,30.0,30,28,1092,198,495,0.4,67,173,0.387,131,322,0.407,0.468,190,257,0.739,21,91,112,167,56,10,90,69,653,2010
R. Melzer,RIO,30.0,2,0,25,5,9,0.556,1,4,0.25,4,5,0.8,0.611,0,0,0.0,0,1,1,1,1,0,2,8,11,2010
D. Milligan,SPR,,42,21,1073,140,289,0.484,1,7,0.143,139,282,0.493,0.486,48,94,0.511,114,179,293,50,46,49,96,131,329,2010
J. Mills,FOR,,2,0,4,0,1,0.0,0,1,0.0,0,0,0.0,0.0,0,0,0.0,0,0,0,0,0,0,0,0,0,2010
P. Mills,IDA,21.0,5,2,176,42,96,0.438,21,42,0.5,21,54,0.389,0.547,23,27,0.852,3,6,9,27,8,0,13,20,128,2010
C. Minnifield,SPR,,15,1,327,29,81,0.358,6,22,0.273,23,59,0.39,0.395,16,22,0.727,4,19,23,26,3,1,14,27,80,2010
B. Mullens,TUL,20.0,27,27,850,161,360,0.447,15,35,0.429,146,325,0.449,0.468,72,104,0.692,57,145,202,27,17,25,77,76,409,2010
P. Mutombo,BAK,,25,5,545,54,133,0.406,15,42,0.357,39,91,0.429,0.462,8,9,0.889,15,49,64,23,13,2,13,46,131,2010
M. Nelson,SFL,,34,2,655,79,167,0.473,40,94,0.426,39,73,0.534,0.593,12,18,0.667,15,45,60,36,15,1,28,47,210,2010
L. Nevill,UTA,,45,40,1112,224,410,0.546,0,1,0.0,224,409,0.548,0.546,87,119,0.731,78,168,246,61,12,54,68,131,535,2010
J. Newson,BAK,,20,8,506,81,170,0.476,11,30,0.367,70,140,0.5,0.509,39,58,0.672,21,63,84,23,21,7,28,38,212,2010
J. Newson,TOT,,45,21,1055,163,345,0.472,15,50,0.3,148,295,0.502,0.494,84,131,0.641,47,131,178,54,39,13,53,77,425,2010
J. Newson,SFL,,25,13,549,82,175,0.469,4,20,0.2,78,155,0.503,0.48,45,73,0.616,26,68,94,31,18,6,25,39,213,2010
D. Noel,REN,,27,1,399,47,106,0.443,13,39,0.333,34,67,0.507,0.505,37,47,0.787,19,40,59,25,9,3,25,41,144,2010
Y. Ogunoye,IDA,,39,3,954,79,199,0.397,21,55,0.382,58,144,0.403,0.45,45,65,0.692,67,70,137,52,35,15,22,53,224,2010
Y. Ogunoye,TUL,,10,0,148,2,15,0.133,1,5,0.2,1,10,0.1,0.167,2,2,1.0,5,4,9,8,3,1,3,10,7,2010
Y. Ogunoye,TOT,,49,3,1102,81,214,0.379,22,60,0.367,59,154,0.383,0.43,47,67,0.701,72,74,146,60,38,16,25,63,231,2010
A. Okosun,AUS,,14,0,79,6,13,0.462,0,0,0.0,6,13,0.462,0.462,2,3,0.667,8,14,22,1,1,7,7,22,14,2010
L. Owens,TUL,27.0,50,50,1818,299,611,0.489,52,137,0.38,247,474,0.521,0.532,139,180,0.772,82,194,276,172,75,29,131,160,789,2010
C. Parker,LOS,,3,0,42,4,9,0.444,0,1,0.0,4,8,0.5,0.444,0,0,0.0,1,3,4,2,1,0,1,3,8,2010
K. Penney,SFL,29.0,4,3,137,35,60,0.583,9,17,0.529,26,43,0.605,0.658,16,21,0.762,3,14,17,9,4,0,11,10,95,2010
J. Peters,LOS,,12,11,361,71,134,0.53,1,5,0.2,70,129,0.543,0.534,35,50,0.7,23,42,65,20,9,7,28,33,178,2010
M. Phillips,IOW,,49,3,849,118,250,0.472,8,35,0.229,110,215,0.512,0.488,45,68,0.662,86,158,244,30,53,34,42,112,289,2010
K. Pittsnogle,ABQ,,28,21,795,116,298,0.389,48,150,0.32,68,148,0.459,0.47,51,60,0.85,31,119,150,38,19,18,38,87,331,2010
C. Powell,ABQ,,33,32,1284,239,485,0.493,27,87,0.31,212,398,0.533,0.521,225,292,0.771,29,135,164,164,54,20,104,113,730,2010
G. Pruitt,UTA,23.0,28,4,681,112,244,0.459,20,61,0.328,92,183,0.503,0.5,60,111,0.541,19,46,65,69,35,2,51,66,304,2010
G. Pruitt,TOT,23.0,38,13,1042,149,335,0.445,23,87,0.264,126,248,0.508,0.479,97,163,0.595,30,81,111,108,52,6,85,87,418,2010
G. Pruitt,LOS,23.0,10,9,361,37,91,0.407,3,26,0.115,34,65,0.523,0.423,37,52,0.712,11,35,46,39,17,4,34,21,114,2010
R. Reese,LOS,,3,1,85,7,22,0.318,3,7,0.429,4,15,0.267,0.386,1,2,0.5,2,8,10,7,2,0,3,6,18,2010
J. Reiner,FOR,27.0,18,14,530,89,193,0.461,0,0,0.0,89,193,0.461,0.461,52,72,0.722,41,127,168,21,14,22,44,64,230,2010
C. Richard,TUL,25.0,12,12,350,46,81,0.568,0,0,0.0,46,81,0.568,0.568,15,26,0.577,33,64,97,12,14,11,29,54,107,2010
J. Richards,UTA,,18,0,312,18,55,0.327,3,17,0.176,15,38,0.395,0.355,14,17,0.824,8,14,22,41,16,0,26,25,53,2010
R. Riley,AUS,28.0,14,1,166,20,38,0.526,0,0,0.0,20,38,0.526,0.526,25,35,0.714,23,20,43,2,3,3,15,37,65,2010
F. Robinson,LOS,,38,25,1170,172,400,0.43,26,107,0.243,146,293,0.498,0.463,101,146,0.692,42,113,155,141,73,13,115,110,471,2010
R. Robinson,TOT,24.0,47,43,1731,260,584,0.445,76,203,0.374,184,381,0.483,0.51,172,211,0.815,34,116,150,220,93,9,152,117,768,2010
R. Robinson,REN,24.0,22,19,806,118,282,0.418,37,98,0.378,81,184,0.44,0.484,87,106,0.821,17,51,68,81,42,4,83,54,360,2010
R. Robinson,MAI,24.0,25,24,925,142,302,0.47,39,105,0.371,103,197,0.523,0.535,85,105,0.81,17,65,82,139,51,5,69,63,408,2010
K. Rogers,RIO,,8,5,126,25,52,0.481,0,0,0.0,25,52,0.481,0.481,6,8,0.75,5,17,22,4,0,1,8,24,56,2010
A. Sandoval,FOR,,2,1,34,3,13,0.231,0,3,0.0,3,10,0.3,0.231,4,9,0.444,0,4,4,2,3,0,1,1,10,2010
A. Santos,BAK,,20,0,311,30,68,0.441,0,0,0.0,30,68,0.441,0.441,30,37,0.811,22,53,75,4,8,13,30,52,90,2010
D. Scott,TOT,,33,3,548,66,145,0.455,36,75,0.48,30,70,0.429,0.579,8,10,0.8,18,42,60,16,12,0,9,59,176,2010
D. Scott,REN,,5,0,78,10,24,0.417,5,10,0.5,5,14,0.357,0.521,0,0,0.0,2,2,4,3,1,0,4,15,25,2010
D. Scott,FOR,,28,3,470,56,121,0.463,31,65,0.477,25,56,0.446,0.591,8,10,0.8,16,40,56,13,11,0,5,44,151,2010
E. Scott,RIO,,50,12,1160,172,397,0.433,133,321,0.414,39,76,0.513,0.601,18,22,0.818,41,153,194,66,40,33,36,154,495,2010
J. Sensley,RIO,,38,29,1044,158,352,0.449,42,118,0.356,116,234,0.496,0.509,55,79,0.696,52,151,203,80,25,33,62,104,413,2010
M. Shakur,TUL,25.0,47,47,1779,324,664,0.488,50,131,0.382,274,533,0.514,0.526,207,277,0.747,47,165,212,324,106,9,151,119,905,2010
C. Simmons,IDA,24.0,13,11,407,76,150,0.507,0,0,0.0,76,150,0.507,0.507,41,78,0.526,22,70,92,8,9,38,19,47,193,2010
D. Simpson,LOS,,30,30,957,175,394,0.444,0,1,0.0,175,393,0.445,0.444,116,163,0.712,113,176,289,65,54,42,45,89,466,2010
C. Sims,IOW,26.0,14,0,277,57,114,0.5,3,9,0.333,54,105,0.514,0.513,56,80,0.7,32,61,93,8,5,14,22,43,173,2010
J. Smith,TUL,,4,0,65,8,24,0.333,5,17,0.294,3,7,0.429,0.438,0,0,0.0,5,6,11,15,5,0,5,9,21,2010
L. Smith,IDA,,16,13,428,48,139,0.345,16,47,0.34,32,92,0.348,0.403,21,35,0.6,10,38,48,95,18,0,33,59,133,2010
T. Snow,ERI,,7,0,41,3,9,0.333,1,2,0.5,2,7,0.286,0.389,3,4,0.75,1,2,3,7,1,0,5,4,10,2010
S. Sonderleiter,FOR,,45,28,1123,189,386,0.49,0,0,0.0,189,386,0.49,0.49,115,159,0.723,107,175,282,57,37,24,80,156,493,2010
Z. Sowers,ERI,,2,0,8,0,2,0.0,0,1,0.0,0,1,0.0,0.0,0,0,0.0,0,0,0,0,0,0,0,1,0,2010
G. Stiemsma,SFL,24.0,45,44,1258,165,305,0.541,0,1,0.0,165,304,0.543,0.541,64,78,0.821,61,259,320,56,30,162,58,167,394,2010
C. Stinson,IOW,26.0,50,50,2115,308,663,0.465,9,51,0.176,299,612,0.489,0.471,136,168,0.81,55,225,280,546,108,12,209,144,761,2010
J. Straight,DAK,,13,1,255,46,101,0.455,13,32,0.406,33,69,0.478,0.52,39,50,0.78,8,25,33,31,6,1,34,28,144,2010
J. Straight,TOT,,27,1,491,85,188,0.452,24,60,0.4,61,128,0.477,0.516,55,69,0.797,13,35,48,62,15,2,51,46,249,2010
J. Straight,FOR,,14,0,236,39,87,0.448,11,28,0.393,28,59,0.475,0.511,16,19,0.842,5,10,15,31,9,1,17,18,105,2010
D. Strawberry,REN,24.0,26,0,727,128,281,0.456,26,74,0.351,102,207,0.493,0.502,59,88,0.67,20,53,73,145,39,7,49,65,341,2010
M. Sweetney,ERI,27.0,9,2,230,49,77,0.636,0,1,0.0,49,76,0.645,0.636,22,44,0.5,21,41,62,8,2,8,26,30,120,2010
R. Swift,BAK,24.0,2,2,50,1,7,0.143,0,0,0.0,1,7,0.143,0.143,3,4,0.75,2,10,12,1,0,3,6,7,5,2010
A. Sy,BAK,,16,15,553,90,170,0.529,11,26,0.423,79,144,0.549,0.562,49,64,0.766,44,72,116,56,15,10,53,56,240,2010
R. Sykes,SFL,,47,20,1121,194,333,0.583,0,0,0.0,194,333,0.583,0.583,104,146,0.712,108,112,220,35,26,51,61,143,492,2010
D. Taylor,IDA,27.0,35,31,1256,305,617,0.494,47,126,0.373,258,491,0.525,0.532,111,147,0.755,83,169,252,168,58,11,117,116,768,2010
D. Taylor,ERI,27.0,13,13,445,103,227,0.454,5,14,0.357,98,213,0.46,0.465,32,49,0.653,20,61,81,37,18,3,45,46,243,2010
D. Taylor,TOT,27.0,48,44,1701,408,844,0.483,52,140,0.371,356,704,0.506,0.514,143,196,0.73,103,230,333,205,76,14,162,162,1011,2010
J. Taylor,RIO,23.0,8,4,222,59,123,0.48,12,36,0.333,47,87,0.54,0.528,28,39,0.718,19,19,38,17,10,4,17,23,158,2010
G. Temple,RIO,23.0,30,30,1046,153,359,0.426,59,157,0.376,94,202,0.465,0.508,82,102,0.804,22,90,112,102,42,19,69,89,447,2010
A. Terrell,MAI,28.0,31,6,398,52,100,0.52,0,1,0.0,52,99,0.525,0.52,20,39,0.513,39,48,87,17,11,9,26,37,124,2010
H. Thabeet,DAK,22.0,6,4,188,27,54,0.5,0,0,0.0,27,54,0.5,0.5,29,42,0.69,25,42,67,4,4,19,16,21,83,2010
B. Thomas,MAI,34.0,39,23,1062,109,268,0.407,54,148,0.365,55,120,0.458,0.507,36,43,0.837,16,94,110,75,31,9,41,62,308,2010
D. Thomas,REN,,48,35,1295,182,349,0.521,0,0,0.0,182,349,0.521,0.521,84,131,0.641,110,234,344,43,43,23,63,128,448,2010
S. Thomas,MAI,,2,0,40,8,13,0.615,1,2,0.5,7,11,0.636,0.654,0,0,0.0,3,3,6,1,0,0,2,3,17,2010
F. Tolbert,ERI,,18,7,398,31,103,0.301,6,29,0.207,25,74,0.338,0.33,41,48,0.854,13,29,42,22,9,5,37,53,109,2010
A. Tolliver,IDA,24.0,14,14,525,100,213,0.469,37,106,0.349,63,107,0.589,0.556,62,79,0.785,49,111,160,35,18,17,44,48,299,2010
C. Toppert,ABQ,24.0,50,21,1410,184,402,0.458,111,231,0.481,73,171,0.427,0.596,77,90,0.856,31,151,182,67,35,4,43,106,556,2010
D. Townes,TOT,,14,0,104,6,19,0.316,0,0,0.0,6,19,0.316,0.316,9,12,0.75,9,9,18,2,2,14,7,21,21,2010
D. Townes,IOW,,8,0,65,4,12,0.333,0,0,0.0,4,12,0.333,0.333,7,10,0.7,6,7,13,0,0,9,4,13,15,2010
D. Townes,UTA,,6,0,39,2,7,0.286,0,0,0.0,2,7,0.286,0.286,2,2,1.0,3,2,5,2,2,5,3,8,6,2010
J. Trepagnier,IOW,30.0,48,36,1291,199,516,0.386,89,265,0.336,110,251,0.438,0.472,119,145,0.821,27,101,128,52,109,25,43,92,606,2010
C. Trybanski,REN,30.0,47,1,768,119,180,0.661,0,0,0.0,119,180,0.661,0.661,106,153,0.693,64,117,181,27,18,84,49,95,344,2010
D. Tucker,LOS,21.0,46,12,982,203,480,0.423,23,111,0.207,180,369,0.488,0.447,100,150,0.667,62,119,181,78,42,11,70,79,529,2010
M. Tyndale,IOW,24.0,50,3,1163,203,380,0.534,11,41,0.268,192,339,0.566,0.549,197,283,0.696,69,110,179,105,69,14,92,82,614,2010
C. Underwood,TOT,,21,3,418,69,143,0.483,0,3,0.0,69,140,0.493,0.483,27,42,0.643,24,55,79,18,11,6,17,60,165,2010
C. Underwood,IDA,,4,2,69,9,18,0.5,0,0,0.0,9,18,0.5,0.5,2,5,0.4,3,2,5,3,2,2,1,14,20,2010
C. Underwood,DAK,,10,0,194,35,79,0.443,0,3,0.0,35,76,0.461,0.443,17,24,0.708,12,31,43,8,4,2,10,25,87,2010
C. Underwood,ABQ,,7,1,155,25,46,0.543,0,0,0.0,25,46,0.543,0.543,8,13,0.615,9,22,31,7,5,2,6,21,58,2010
H. Walker,MAI,22.0,9,9,275,54,114,0.474,10,26,0.385,44,88,0.5,0.518,39,42,0.929,7,51,58,16,4,5,20,32,157,2010
J. Wallace,RIO,,50,28,1382,158,358,0.441,84,201,0.418,74,157,0.471,0.559,86,97,0.887,34,72,106,156,47,0,71,124,486,2010
D. Washington,TUL,,41,20,1077,147,360,0.408,30,98,0.306,117,262,0.447,0.45,144,202,0.713,41,141,182,77,38,27,76,136,468,2010
D. Washington,TOT,,49,24,1280,175,432,0.405,32,107,0.299,143,325,0.44,0.442,163,225,0.724,48,172,220,88,39,32,98,166,545,2010
D. Washington,LOS,,8,4,203,28,72,0.389,2,9,0.222,26,63,0.413,0.403,19,23,0.826,7,31,38,11,1,5,22,30,77,2010
K. Weaver,TUL,23.0,5,5,214,26,63,0.413,5,15,0.333,21,48,0.438,0.452,5,5,1.0,5,22,27,36,7,7,22,17,62,2010
R. Webb,TUL,,3,0,31,4,9,0.444,0,0,0.0,4,9,0.444,0.444,0,0,0.0,4,5,9,2,0,0,2,3,8,2010
R. Webb,TOT,,46,14,977,137,290,0.472,1,3,0.333,136,287,0.474,0.474,55,81,0.679,76,144,220,40,31,37,50,110,330,2010
R. Webb,LOS,,18,0,329,49,90,0.544,0,1,0.0,49,89,0.551,0.544,23,34,0.676,27,55,82,12,12,12,19,36,121,2010
R. Webb,BAK,,25,14,617,84,191,0.44,1,2,0.5,83,189,0.439,0.442,32,47,0.681,45,84,129,26,19,25,29,71,201,2010
M. West,MAI,25.0,11,6,327,50,102,0.49,6,24,0.25,44,78,0.564,0.52,45,67,0.672,5,27,32,45,14,5,34,32,151,2010
C. Wheeler,UTA,,43,33,1272,209,410,0.51,5,25,0.2,204,385,0.53,0.516,120,173,0.694,71,244,315,92,41,29,115,124,543,2010
D. White,TUL,23.0,10,10,394,84,138,0.609,0,1,0.0,84,137,0.613,0.609,34,39,0.872,30,81,111,12,7,14,26,31,202,2010
T. Whitted,SPR,,47,24,1283,155,386,0.402,40,118,0.339,115,268,0.429,0.453,70,86,0.814,34,78,112,90,30,4,65,96,420,2010
J. Williams,BAK,,37,9,767,103,243,0.424,58,136,0.426,45,107,0.421,0.543,54,67,0.806,10,34,44,113,28,1,51,62,318,2010
L. Williams,TUL,,47,9,969,152,288,0.528,1,12,0.083,151,276,0.547,0.53,61,100,0.61,123,238,361,32,32,35,55,111,366,2010
M. Williams,AUS,23.0,8,8,330,71,126,0.563,8,24,0.333,63,102,0.618,0.595,44,53,0.83,6,37,43,38,6,2,33,28,194,2010
M. Williams,MAI,,8,0,79,6,10,0.6,1,1,1.0,5,9,0.556,0.65,3,7,0.429,4,13,17,2,0,7,8,11,16,2010
R. Williams,SFL,23.0,31,31,1240,298,517,0.576,57,139,0.41,241,378,0.638,0.632,164,199,0.824,38,134,172,98,48,7,83,67,817,2010
R. Wilmont,FOR,,48,19,1333,161,450,0.358,59,186,0.317,102,264,0.386,0.423,83,117,0.709,35,143,178,63,47,1,59,75,464,2010
C. Winder,RIO,,29,0,652,145,288,0.503,26,70,0.371,119,218,0.546,0.549,99,127,0.78,35,70,105,64,36,11,58,73,415,2010
M. Wingate,SPR,,18,5,468,49,109,0.45,0,0,0.0,49,109,0.45,0.45,38,57,0.667,19,79,98,30,6,21,44,56,136,2010
J. Wise,BAK,,45,38,1453,259,499,0.519,33,88,0.375,226,411,0.55,0.552,198,234,0.846,27,117,144,228,59,23,119,137,749,2010
C. Withers,DAK,,50,29,1224,201,405,0.496,1,4,0.25,200,401,0.499,0.498,160,232,0.69,119,218,337,45,59,40,124,154,563,2010
H. Wormely,LOS,,43,19,1232,97,233,0.416,27,77,0.351,70,156,0.449,0.474,75,92,0.815,13,108,121,165,44,1,79,104,296,2010
A. Wright,BAK,,2,0,28,2,11,0.182,0,1,0.0,2,10,0.2,0.182,4,7,0.571,1,4,5,0,0,0,3,1,8,2010
J. Wright,LOS,,30,23,812,168,331,0.508,17,44,0.386,151,287,0.526,0.533,48,64,0.75,8,36,44,90,16,3,45,27,401,2010
M. Zeno,ERI,,12,0,232,25,69,0.362,0,7,0.0,25,62,0.403,0.362,9,22,0.409,7,21,28,20,10,1,9,18,59,2010
M. Abukar,TOT,,31,2,614,113,252,0.448,37,91,0.407,76,161,0.472,0.522,60,74,0.811,19,82,101,12,8,8,33,46,323,2009
M. Abukar,IDA,,15,2,323,62,137,0.453,18,49,0.367,44,88,0.5,0.518,36,42,0.857,5,51,56,5,6,6,19,22,178,2009
M. Abukar,AUS,,16,0,291,51,115,0.443,19,42,0.452,32,73,0.438,0.526,24,32,0.75,14,31,45,7,2,2,14,24,145,2009
A. Acker,FOR,26.0,4,4,146,28,63,0.444,5,17,0.294,23,46,0.5,0.484,11,12,0.917,5,16,21,11,5,1,11,15,72,2009
A. Agudio,ABQ,24.0,26,10,839,134,276,0.486,51,119,0.429,83,157,0.529,0.578,67,82,0.817,16,65,81,36,46,2,43,42,386,2009
B. Ahearn,TOT,24.0,47,47,1791,313,703,0.445,143,332,0.431,170,371,0.458,0.547,276,290,0.952,15,98,113,243,35,2,151,119,1045,2009
B. Ahearn,DAK,24.0,41,41,1585,281,631,0.445,126,300,0.42,155,331,0.468,0.545,244,255,0.957,13,86,99,207,30,2,134,97,932,2009
B. Ahearn,AUS,24.0,6,6,206,32,72,0.444,17,32,0.531,15,40,0.375,0.563,32,35,0.914,2,12,14,36,5,0,17,22,113,2009
A. Ajinca,SFL,20.0,11,0,251,48,101,0.475,0,3,0.0,48,98,0.49,0.475,35,44,0.795,26,49,75,4,9,20,28,41,131,2009
C. Alexander,SFL,,11,11,351,27,75,0.36,0,1,0.0,27,74,0.365,0.36,22,40,0.55,44,50,94,12,7,22,18,47,76,2009
R. Allen,ANA,,49,24,996,130,326,0.399,5,29,0.172,125,297,0.421,0.406,68,83,0.819,40,119,159,21,20,6,53,148,333,2009
S. Allen,ABQ,,44,4,335,32,86,0.372,0,0,0.0,32,86,0.372,0.372,9,28,0.321,29,52,81,8,10,11,21,63,73,2009
L. Allred,IDA,27.0,45,45,1343,294,588,0.5,0,2,0.0,294,586,0.502,0.5,110,155,0.71,103,310,413,60,23,28,74,98,698,2009
M. Almond,UTA,23.0,14,13,442,112,215,0.521,22,54,0.407,90,161,0.559,0.572,88,108,0.815,14,40,54,14,7,3,31,38,334,2009
M. Ambres,IDA,,45,4,721,118,287,0.411,5,20,0.25,113,267,0.423,0.42,53,72,0.736,70,122,192,31,16,17,35,103,294,2009
T. Anderson,ERI,,21,0,131,11,20,0.55,1,3,0.333,10,17,0.588,0.575,10,18,0.556,15,13,28,4,4,0,3,14,33,2009
S. Angounou,AUS,,37,3,356,28,83,0.337,1,16,0.063,27,67,0.403,0.343,30,35,0.857,29,77,106,15,10,8,11,65,87,2009
E. Ard,UTA,,25,4,338,41,91,0.451,0,3,0.0,41,88,0.466,0.451,24,37,0.649,18,39,57,14,5,3,23,29,106,2009
S. Asumnu,RIO,,47,20,1147,232,422,0.55,0,2,0.0,232,420,0.552,0.55,32,81,0.395,125,90,215,84,40,10,45,92,496,2009
J. Axon,FOR,,14,0,171,19,55,0.345,8,26,0.308,11,29,0.379,0.418,5,8,0.625,4,16,20,14,5,0,8,17,51,2009
L. Ayuso,IOW,,14,14,490,62,162,0.383,27,84,0.321,35,78,0.449,0.466,34,38,0.895,4,35,39,27,9,2,34,36,185,2009
M. Badiane,ANA,,19,8,376,39,96,0.406,0,1,0.0,39,95,0.411,0.406,16,24,0.667,30,72,102,9,7,7,21,54,94,2009
D. Bailey,TOT,,37,24,1170,182,412,0.442,51,135,0.378,131,277,0.473,0.504,110,148,0.743,43,94,137,171,52,3,107,100,525,2009
D. Bailey,SFL,,29,24,1046,170,379,0.449,47,125,0.376,123,254,0.484,0.511,94,127,0.74,40,78,118,140,47,3,93,86,481,2009
D. Bailey,FOR,,8,0,124,12,33,0.364,4,10,0.4,8,23,0.348,0.424,16,21,0.762,3,16,19,31,5,0,14,14,44,2009
M. Baker,DAK,29.0,49,49,1929,303,696,0.435,50,160,0.313,253,536,0.472,0.471,129,157,0.822,92,243,335,282,83,2,153,150,785,2009
S. Bang,REN,25.0,4,0,109,15,42,0.357,9,31,0.29,6,11,0.545,0.464,10,11,0.909,1,7,8,2,4,1,13,6,49,2009
A. Bangura,TOT,,35,16,974,201,458,0.439,10,46,0.217,191,412,0.464,0.45,162,205,0.79,54,101,155,51,47,8,85,84,574,2009
A. Bangura,RIO,,26,16,778,169,379,0.446,9,40,0.225,160,339,0.472,0.458,145,180,0.806,44,82,126,38,40,3,74,64,492,2009
A. Bangura,BAK,,9,0,196,32,79,0.405,1,6,0.167,31,73,0.425,0.411,17,25,0.68,10,19,29,13,7,5,11,20,82,2009
J. Barber,UTA,,5,0,24,0,1,0.0,0,0,0.0,0,1,0.0,0.0,0,0,0.0,0,2,2,0,0,0,0,2,0,2009
E. Barron,LOS,27.0,13,6,368,54,130,0.415,0,1,0.0,54,129,0.419,0.415,21,33,0.636,38,55,93,31,7,9,30,45,129,2009
R. Beck,DAK,,16,5,449,85,167,0.509,29,59,0.492,56,108,0.519,0.596,55,61,0.902,11,22,33,46,11,3,36,27,254,2009
D. Bell,DAK,,49,1,1186,174,425,0.409,96,236,0.407,78,189,0.413,0.522,113,128,0.883,17,99,116,107,32,1,62,63,557,2009
C. Bennerman,ANA,,12,8,431,64,137,0.467,16,40,0.4,48,97,0.495,0.526,16,22,0.727,6,27,33,22,14,2,18,32,160,2009
R. Benson,DAK,24.0,22,1,449,61,111,0.55,0,1,0.0,61,110,0.555,0.55,38,56,0.679,46,85,131,18,8,24,27,45,160,2009
R. Benson,TOT,24.0,39,13,982,170,297,0.572,0,1,0.0,170,296,0.574,0.572,96,146,0.658,103,172,275,51,25,68,67,90,436,2009
R. Benson,REN,24.0,17,12,533,109,186,0.586,0,0,0.0,109,186,0.586,0.586,58,90,0.644,57,87,144,33,17,44,40,45,276,2009
R. Bergersen,IDA,,25,4,537,74,192,0.385,44,112,0.393,30,80,0.375,0.5,21,27,0.778,9,35,44,32,24,5,34,48,213,2009
D. Berghoefer,BAK,,23,1,331,45,64,0.703,0,0,0.0,45,64,0.703,0.703,22,31,0.71,37,56,93,5,5,8,14,57,112,2009
T. Bethel,ERI,,20,14,510,70,159,0.44,17,59,0.288,53,100,0.53,0.494,24,29,0.828,9,47,56,28,17,3,29,50,181,2009
C. Bozeman,ANA,25.0,48,48,2030,312,648,0.481,59,170,0.347,253,478,0.529,0.527,243,287,0.847,54,266,320,204,72,5,131,151,926,2009
R. Bright,AUS,,21,3,281,42,76,0.553,11,24,0.458,31,52,0.596,0.625,6,17,0.353,19,40,59,28,13,16,16,26,101,2009
A. Brown,AUS,27.0,17,14,598,114,230,0.496,0,1,0.0,114,229,0.498,0.496,25,69,0.362,63,103,166,16,6,11,42,63,253,2009
D. Brown,REN,29.0,30,28,972,178,372,0.478,24,71,0.338,154,301,0.512,0.511,97,149,0.651,83,137,220,57,33,37,76,98,477,2009
D. Brown,TOT,26.0,22,13,637,119,260,0.458,3,14,0.214,116,246,0.472,0.463,50,59,0.847,22,70,92,43,27,4,39,47,291,2009
D. Brown,IOW,26.0,14,5,391,73,162,0.451,2,8,0.25,71,154,0.461,0.457,40,46,0.87,19,43,62,21,15,3,21,34,188,2009
D. Brown,DAK,26.0,8,8,246,46,98,0.469,1,6,0.167,45,92,0.489,0.474,10,13,0.769,3,27,30,22,12,1,18,13,103,2009
J. Brown,LOS,,14,7,395,49,105,0.467,0,1,0.0,49,104,0.471,0.467,24,35,0.686,29,45,74,21,5,5,18,42,122,2009
J. Brown,BAK,,8,0,110,20,30,0.667,0,0,0.0,20,30,0.667,0.667,3,10,0.3,9,8,17,4,3,2,4,16,43,2009
J. Brown,TOT,,22,7,505,69,135,0.511,0,1,0.0,69,134,0.515,0.511,27,45,0.6,38,53,91,25,8,7,22,58,165,2009
J. Brown,COL,,46,4,763,122,242,0.504,1,3,0.333,121,239,0.506,0.506,44,75,0.587,94,103,197,24,19,28,51,144,289,2009
K. Brown,ANA,27.0,42,38,1693,271,588,0.461,42,134,0.313,229,454,0.504,0.497,156,194,0.804,83,197,280,111,56,24,94,125,740,2009
M. Brown,AUS,,1,0,25,5,9,0.556,0,0,0.0,5,9,0.556,0.556,1,2,0.5,1,4,5,0,1,2,3,3,11,2009
N. Brown,AUS,,13,4,316,36,88,0.409,11,40,0.275,25,48,0.521,0.472,14,19,0.737,7,30,37,62,10,0,31,22,97,2009
T. Brown,ANA,29.0,18,14,576,112,210,0.533,2,10,0.2,110,200,0.55,0.538,58,74,0.784,7,50,57,93,20,3,67,44,284,2009
K. Brumbaugh,SFL,,49,7,927,161,330,0.488,36,96,0.375,125,234,0.534,0.542,48,65,0.738,53,118,171,36,43,20,75,148,406,2009
K. Burleson,IDA,29.0,23,19,632,84,197,0.426,38,106,0.358,46,91,0.505,0.523,46,59,0.78,14,39,53,126,21,2,48,64,252,2009
S. Burrell,AUS,,22,4,469,56,109,0.514,4,11,0.364,52,98,0.531,0.532,21,28,0.75,11,24,35,45,11,2,30,38,137,2009
L. Butler,TOT,,42,0,596,97,207,0.469,57,116,0.491,40,91,0.44,0.606,19,24,0.792,11,39,50,68,19,1,56,39,270,2009
L. Butler,REN,,15,0,220,43,83,0.518,25,47,0.532,18,36,0.5,0.669,11,14,0.786,4,16,20,20,4,0,20,13,122,2009
L. Butler,COL,,27,0,376,54,124,0.435,32,69,0.464,22,55,0.4,0.565,8,10,0.8,7,23,30,48,15,1,36,26,148,2009
D. Byars,BAK,24.0,49,40,1874,332,699,0.475,85,222,0.383,247,477,0.518,0.536,128,170,0.753,50,188,238,137,49,7,111,119,877,2009
R. Byrd,LOS,,19,0,297,41,100,0.41,0,0,0.0,41,100,0.41,0.41,11,32,0.344,32,38,70,6,5,20,28,55,93,2009
R. Byrd,TOT,,22,0,330,45,107,0.421,0,0,0.0,45,107,0.421,0.421,13,35,0.371,35,45,80,6,5,25,30,62,103,2009
R. Byrd,RIO,,3,0,33,4,7,0.571,0,0,0.0,4,7,0.571,0.571,2,3,0.667,3,7,10,0,0,5,2,7,10,2009
M. Campbell,ANA,26.0,38,36,1031,183,348,0.526,0,1,0.0,183,347,0.527,0.526,52,90,0.578,115,223,338,62,18,52,114,149,418,2009
G. Carlisle,ANA,32.0,18,2,350,59,126,0.468,12,32,0.375,47,94,0.5,0.516,37,48,0.771,6,26,32,17,13,0,24,21,167,2009
M. Carter,RIO,32.0,14,0,198,17,63,0.27,5,21,0.238,12,42,0.286,0.31,11,19,0.579,5,17,22,28,7,0,14,13,50,2009
C. Childress,SFL,,10,0,45,0,6,0.0,0,0,0.0,0,6,0.0,0.0,3,4,0.75,4,6,10,1,0,0,1,8,3,2009
K. Clack,ABQ,31.0,9,2,187,19,40,0.475,0,5,0.0,19,35,0.543,0.475,28,38,0.737,12,16,28,10,12,3,10,38,66,2009
K. Clark,TUL,,49,29,1350,233,466,0.5,20,87,0.23,213,379,0.562,0.521,104,167,0.623,84,249,333,71,40,42,87,167,590,2009
M. Clark,SFL,25.0,19,0,349,39,92,0.424,1,4,0.25,38,88,0.432,0.429,9,13,0.692,20,41,61,18,14,2,24,28,88,2009
G. Claxton,ERI,,14,0,216,20,48,0.417,0,2,0.0,20,46,0.435,0.417,3,13,0.231,15,31,46,14,9,7,12,33,43,2009
M. Cleaves,BAK,31.0,36,33,1226,173,370,0.468,15,55,0.273,158,315,0.502,0.488,93,119,0.782,23,97,120,294,39,2,97,100,454,2009
C. Clinkscales,RIO,,6,0,115,18,37,0.486,0,0,0.0,18,37,0.486,0.486,0,0,0.0,2,8,10,29,4,1,10,5,36,2009
C. Clinkscales,ERI,,43,9,1226,132,293,0.451,3,14,0.214,129,279,0.462,0.456,46,76,0.605,24,80,104,229,41,10,57,59,313,2009
C. Clinkscales,TOT,,49,9,1341,150,330,0.455,3,14,0.214,147,316,0.465,0.459,46,76,0.605,26,88,114,258,45,11,67,64,349,2009
A. Coleman,LOS,26.0,9,9,283,25,63,0.397,0,6,0.0,25,57,0.439,0.397,16,26,0.615,13,36,49,16,4,14,26,33,66,2009
D. Coleman,COL,,50,47,1682,296,593,0.499,79,192,0.411,217,401,0.541,0.566,97,139,0.698,126,264,390,242,144,18,119,125,768,2009
C. Collins,FOR,,46,16,1142,186,384,0.484,0,3,0.0,186,381,0.488,0.484,145,193,0.751,83,164,247,56,33,37,75,81,517,2009
K. Collins,AUS,,2,0,27,2,7,0.286,0,0,0.0,2,7,0.286,0.286,3,4,0.75,0,1,1,1,0,0,0,0,7,2009
W. Conroy,ABQ,26.0,49,49,2199,440,915,0.481,97,281,0.345,343,634,0.541,0.534,323,460,0.702,41,192,233,391,93,2,206,143,1300,2009
A. Cook,BAK,,17,4,294,24,66,0.364,12,27,0.444,12,39,0.308,0.455,4,5,0.8,6,19,25,31,7,0,9,33,64,2009
M. Cook,ERI,,10,0,130,25,63,0.397,3,12,0.25,22,51,0.431,0.421,33,46,0.717,3,12,15,8,1,1,9,7,86,2009
D. Cooper,LOS,,43,14,1019,103,257,0.401,49,118,0.415,54,139,0.388,0.496,57,69,0.826,12,69,81,102,39,5,48,50,312,2009
J. Crawford,LOS,22.0,43,42,1641,325,684,0.475,87,231,0.377,238,453,0.525,0.539,159,192,0.828,65,131,196,117,45,7,109,99,896,2009
T. Cummings,ANA,27.0,3,3,73,10,24,0.417,0,0,0.0,10,24,0.417,0.417,10,10,1.0,3,7,10,0,4,0,5,8,30,2009
J. Curry,IOW,23.0,16,13,552,77,178,0.433,17,48,0.354,60,130,0.462,0.48,26,29,0.897,9,37,46,44,18,3,30,46,197,2009
J. Dabbert,COL,27.0,50,44,1057,212,401,0.529,0,4,0.0,212,397,0.534,0.529,139,198,0.702,135,155,290,43,32,66,89,216,563,2009
E. Daniels,ERI,26.0,50,48,2020,432,929,0.465,58,186,0.312,374,743,0.503,0.496,135,195,0.692,134,365,499,226,66,38,151,190,1057,2009
K. Dartez,RIO,28.0,14,11,391,64,139,0.46,3,5,0.6,61,134,0.455,0.471,30,48,0.625,40,47,87,21,12,12,33,54,161,2009
J. Davidson,IDA,24.0,15,15,506,96,185,0.519,0,0,0.0,96,185,0.519,0.519,50,64,0.781,36,126,162,29,10,23,33,43,242,2009
B. Davis,UTA,,48,21,873,100,247,0.405,6,19,0.316,94,228,0.412,0.417,107,130,0.823,57,109,166,55,20,48,48,97,313,2009
J. Davis,COL,28.0,45,42,1435,306,638,0.48,104,278,0.374,202,360,0.561,0.561,130,149,0.872,116,209,325,84,80,24,86,145,846,2009
K. Davis,REN,26.0,5,0,81,7,22,0.318,0,1,0.0,7,21,0.333,0.318,4,6,0.667,6,11,17,3,0,8,6,16,18,2009
E. Dawson,AUS,24.0,31,23,758,144,246,0.585,0,0,0.0,144,246,0.585,0.585,33,52,0.635,79,125,204,47,35,32,36,99,321,2009
D. Dial,TUL,33.0,47,13,1392,237,516,0.459,64,185,0.346,173,331,0.523,0.521,87,131,0.664,55,187,242,173,33,30,70,118,625,2009
R. Diggs,UTA,,41,0,429,56,128,0.438,7,31,0.226,49,97,0.505,0.465,43,49,0.878,12,30,42,57,15,0,33,43,162,2009
J. Dorsey,RIO,25.0,7,5,206,27,43,0.628,0,0,0.0,27,43,0.628,0.628,14,36,0.389,22,41,63,7,7,11,21,26,68,2009
M. Dorsey,TOT,27.0,51,24,1021,180,423,0.426,3,23,0.13,177,400,0.443,0.429,84,99,0.848,23,67,90,166,38,4,92,75,447,2009
M. Dorsey,REN,27.0,46,24,940,155,374,0.414,1,17,0.059,154,357,0.431,0.416,72,86,0.837,20,65,85,162,34,3,88,69,383,2009
M. Dorsey,ABQ,27.0,5,0,81,25,49,0.51,2,6,0.333,23,43,0.535,0.531,12,13,0.923,3,2,5,4,4,1,4,6,64,2009
Q. Douby,ERI,24.0,5,3,143,31,67,0.463,8,27,0.296,23,40,0.575,0.522,20,23,0.87,2,16,18,9,6,4,5,18,90,2009
J. Dukes,LOS,,2,2,26,2,11,0.182,0,0,0.0,2,11,0.182,0.182,0,2,0.0,2,2,4,3,1,0,2,7,4,2009
R. Dupree,UTA,28.0,31,29,1054,186,383,0.486,18,61,0.295,168,322,0.522,0.509,112,141,0.794,36,168,204,122,29,21,69,93,502,2009
R. Dupree,TUL,28.0,18,16,660,126,268,0.47,15,48,0.313,111,220,0.505,0.498,92,133,0.692,24,95,119,67,28,9,59,53,359,2009
R. Dupree,TOT,28.0,49,45,1714,312,651,0.479,33,109,0.303,279,542,0.515,0.505,204,274,0.745,60,263,323,189,57,30,128,146,861,2009
J. Edwards,IOW,27.0,7,6,180,28,52,0.538,0,0,0.0,28,52,0.538,0.538,10,12,0.833,13,24,37,6,4,7,13,22,66,2009
J. Edwards,TOT,27.0,23,20,511,91,173,0.526,0,0,0.0,91,173,0.526,0.526,28,35,0.8,47,99,146,15,10,25,39,80,210,2009
J. Edwards,SFL,27.0,16,14,331,63,121,0.521,0,0,0.0,63,121,0.521,0.521,18,23,0.783,34,75,109,9,6,18,26,58,144,2009
M. Efevberha,ANA,24.0,8,0,178,25,80,0.313,3,17,0.176,22,63,0.349,0.331,30,31,0.968,4,24,28,6,4,4,12,24,83,2009
M. Ehambe,TUL,,50,4,947,177,431,0.411,103,248,0.415,74,183,0.404,0.53,47,56,0.839,12,73,85,39,21,2,40,54,504,2009
C. Elliott,FOR,,27,22,963,136,318,0.428,28,84,0.333,108,234,0.462,0.472,53,70,0.757,40,125,165,113,71,7,70,65,353,2009
C. Elliott,TOT,,46,41,1629,257,588,0.437,45,137,0.328,212,451,0.47,0.475,97,134,0.724,53,177,230,195,121,8,128,127,656,2009
C. Elliott,SFL,,19,19,666,121,270,0.448,17,53,0.321,104,217,0.479,0.48,44,64,0.688,13,52,65,82,50,1,58,62,303,2009
C. Ellis,TOT,24.0,48,23,1070,110,270,0.407,0,2,0.0,110,268,0.41,0.407,121,156,0.776,142,188,330,35,24,32,77,173,341,2009
C. Ellis,SFL,24.0,28,17,686,67,156,0.429,0,1,0.0,67,155,0.432,0.429,73,97,0.753,95,132,227,14,12,24,41,112,207,2009
C. Ellis,TUL,24.0,20,6,384,43,114,0.377,0,1,0.0,43,113,0.381,0.377,48,59,0.814,47,56,103,21,12,8,36,61,134,2009
J. Ellis,IDA,,48,15,1157,125,262,0.477,0,2,0.0,125,260,0.481,0.477,82,102,0.804,194,223,417,41,43,34,55,131,332,2009
C. English,DAK,,33,1,231,18,68,0.265,5,23,0.217,13,45,0.289,0.301,9,14,0.643,0,13,13,45,14,0,23,15,50,2009
G. Ervin,TOT,,43,1,785,134,275,0.487,7,38,0.184,127,237,0.536,0.5,77,104,0.74,41,60,101,113,42,2,49,67,352,2009
G. Ervin,SFL,,18,1,330,63,124,0.508,3,19,0.158,60,105,0.571,0.52,23,34,0.676,22,18,40,38,19,0,20,26,152,2009
G. Ervin,TUL,,25,0,455,71,151,0.47,4,19,0.211,67,132,0.508,0.483,54,70,0.771,19,42,61,75,23,2,29,41,200,2009
D. Erwin,LOS,26.0,14,8,334,41,93,0.441,0,3,0.0,41,90,0.456,0.441,17,28,0.607,23,42,65,36,10,19,18,55,99,2009
B. Evans,IOW,,33,4,700,101,206,0.49,1,9,0.111,100,197,0.508,0.493,85,102,0.833,18,48,66,57,28,1,43,34,288,2009
T. Everett,TOT,,27,5,499,71,180,0.394,14,38,0.368,57,142,0.401,0.433,31,43,0.721,13,45,58,62,29,4,30,38,187,2009
T. Everett,BAK,,25,4,460,68,164,0.415,14,38,0.368,54,126,0.429,0.457,28,40,0.7,13,42,55,58,28,3,25,32,178,2009
T. Everett,TUL,,2,1,39,3,16,0.188,0,0,0.0,3,16,0.188,0.188,3,3,1.0,0,3,3,4,1,1,5,6,9,2009
P. Ewing,REN,24.0,30,9,1057,172,370,0.465,12,51,0.235,160,319,0.502,0.481,147,191,0.77,72,195,267,92,44,38,78,110,503,2009
N. Felix,ANA,27.0,17,16,569,88,187,0.471,5,10,0.5,83,177,0.469,0.484,51,63,0.81,38,72,110,20,15,32,51,75,232,2009
K. Fesenko,UTA,22.0,14,10,358,62,122,0.508,0,0,0.0,62,122,0.508,0.508,47,73,0.644,44,75,119,34,4,22,30,47,171,2009
G. Forbes,TUL,23.0,30,26,956,202,395,0.511,22,65,0.338,180,330,0.545,0.539,115,156,0.737,47,123,170,121,34,13,94,85,541,2009
G. Forbes,TOT,23.0,52,33,1587,328,670,0.49,65,168,0.387,263,502,0.524,0.538,183,244,0.75,74,201,275,165,50,23,155,138,904,2009
G. Forbes,SFL,23.0,22,7,631,126,275,0.458,43,103,0.417,83,172,0.483,0.536,68,88,0.773,27,78,105,44,16,10,61,53,363,2009
A. Ford,RIO,27.0,21,19,599,72,162,0.444,2,14,0.143,70,148,0.473,0.451,61,77,0.792,38,113,151,21,9,8,51,90,207,2009
A. Ford,REN,27.0,15,13,401,45,101,0.446,0,2,0.0,45,99,0.455,0.446,48,67,0.716,20,79,99,22,9,8,24,54,138,2009
A. Ford,TOT,27.0,36,32,1000,117,263,0.445,2,16,0.125,115,247,0.466,0.449,109,144,0.757,58,192,250,43,18,16,75,144,345,2009
R. Forehan-Kelly,LOS,,31,8,903,154,302,0.51,46,96,0.479,108,206,0.524,0.586,46,54,0.852,29,111,140,100,53,18,32,91,400,2009
R. Frahm,REN,31.0,21,21,832,138,292,0.473,83,177,0.469,55,115,0.478,0.615,40,50,0.8,12,78,90,64,27,10,24,37,399,2009
W. Frisby,DAK,27.0,41,39,1296,251,471,0.533,2,4,0.5,249,467,0.533,0.535,121,169,0.716,112,202,314,92,26,28,109,158,625,2009
C. Gadson,ABQ,28.0,5,5,182,27,72,0.375,5,15,0.333,22,57,0.386,0.41,21,25,0.84,1,11,12,15,6,0,27,13,80,2009
C. Gaines,AUS,,23,21,838,138,261,0.529,0,0,0.0,138,261,0.529,0.529,71,102,0.696,75,165,240,17,24,15,50,76,347,2009
T. Gamble,BAK,,17,7,139,15,23,0.652,0,0,0.0,15,23,0.652,0.652,9,14,0.643,9,24,33,6,3,11,10,24,39,2009
T. Gardner,ANA,23.0,1,0,31,9,16,0.563,1,6,0.167,8,10,0.8,0.594,7,9,0.778,1,6,7,1,0,0,1,2,26,2009
M. Gelabale,LOS,25.0,6,0,188,39,78,0.5,8,19,0.421,31,59,0.525,0.551,10,12,0.833,9,17,26,10,6,1,6,20,96,2009
F. Gibson,TOT,,32,1,405,60,116,0.517,7,21,0.333,53,95,0.558,0.547,24,35,0.686,25,33,58,23,22,7,25,51,151,2009
F. Gibson,AUS,,2,0,23,0,7,0.0,0,2,0.0,0,5,0.0,0.0,0,0,0.0,0,2,2,4,1,0,2,3,0,2009
F. Gibson,ABQ,,30,1,382,60,109,0.55,7,19,0.368,53,90,0.589,0.583,24,35,0.686,25,31,56,19,21,7,23,48,151,2009
J. Giddens,UTA,23.0,26,23,947,188,325,0.578,8,29,0.276,180,296,0.608,0.591,62,91,0.681,44,119,163,77,28,35,59,56,446,2009
T. Gilder,COL,24.0,50,11,1192,251,492,0.51,32,99,0.323,219,393,0.557,0.543,151,198,0.763,82,195,277,71,60,34,93,111,685,2009
C. Giles,TOT,23.0,25,9,564,104,189,0.55,0,4,0.0,104,185,0.562,0.55,50,69,0.725,56,111,167,12,16,36,33,88,258,2009
C. Giles,SFL,23.0,14,0,267,46,83,0.554,0,2,0.0,46,81,0.568,0.554,28,34,0.824,27,49,76,3,9,13,15,38,120,2009
C. Giles,LOS,23.0,11,9,297,58,106,0.547,0,2,0.0,58,104,0.558,0.547,22,35,0.629,29,62,91,9,7,23,18,50,138,2009
E. Gill,COL,30.0,40,38,1387,156,389,0.401,48,146,0.329,108,243,0.444,0.463,230,290,0.793,20,136,156,336,66,20,125,126,590,2009
K. Gransberry,COL,23.0,26,0,377,55,109,0.505,0,1,0.0,55,108,0.509,0.505,25,55,0.455,51,69,120,27,18,11,34,74,135,2009
G. Grant,UTA,,43,4,798,113,265,0.426,3,18,0.167,110,247,0.445,0.432,134,176,0.761,37,82,119,54,17,10,64,61,363,2009
D. Greene,REN,20.0,5,0,160,37,83,0.446,8,29,0.276,29,54,0.537,0.494,20,29,0.69,2,18,20,10,6,6,8,17,102,2009
Q. Greer,DAK,27.0,12,3,274,52,119,0.437,6,14,0.429,46,105,0.438,0.462,22,33,0.667,22,43,65,15,8,3,27,32,132,2009
J. Gunter,ERI,,38,2,476,50,86,0.581,0,0,0.0,50,86,0.581,0.581,15,28,0.536,55,74,129,9,5,29,14,64,115,2009
H. Haddadi,DAK,23.0,18,9,315,40,91,0.44,0,3,0.0,40,88,0.455,0.44,26,41,0.634,50,70,120,16,8,30,36,41,106,2009
M. Hairston,AUS,21.0,30,30,1239,242,455,0.532,26,59,0.441,216,396,0.545,0.56,176,211,0.834,61,103,164,112,41,32,86,111,686,2009
V. Hamilton,FOR,,4,0,46,4,17,0.235,0,3,0.0,4,14,0.286,0.235,2,4,0.5,2,6,8,5,7,0,6,4,10,2009
V. Hamilton,COL,,19,5,276,37,87,0.425,8,23,0.348,29,64,0.453,0.471,3,9,0.333,6,17,23,42,16,2,20,32,85,2009
V. Hamilton,TOT,,23,5,322,41,104,0.394,8,26,0.308,33,78,0.423,0.433,5,13,0.385,8,23,31,47,23,2,26,36,95,2009
B. Harper,TOT,,13,0,97,16,38,0.421,1,5,0.2,15,33,0.455,0.434,1,4,0.25,7,10,17,3,2,3,8,19,34,2009
B. Harper,SFL,,8,0,70,13,26,0.5,1,4,0.25,12,22,0.545,0.519,1,4,0.25,6,7,13,1,2,2,5,14,28,2009
B. Harper,REN,,5,0,27,3,12,0.25,0,1,0.0,3,11,0.273,0.25,0,0,0.0,1,3,4,2,0,1,3,5,6,2009
I. Harris,ERI,,50,49,1872,334,694,0.481,39,91,0.429,295,603,0.489,0.509,78,90,0.867,83,174,257,38,39,26,41,159,785,2009
J. Harris,BAK,,26,5,436,39,99,0.394,17,34,0.5,22,65,0.338,0.48,6,7,0.857,5,27,32,51,5,2,24,46,101,2009
O. Harrington,LOS,35.0,3,0,42,2,7,0.286,0,0,0.0,2,7,0.286,0.286,2,3,0.667,4,6,10,3,1,2,8,9,6,2009
S. Hawkins,IOW,,6,0,95,12,22,0.545,3,8,0.375,9,14,0.643,0.614,7,11,0.636,3,16,19,4,0,1,4,8,34,2009
S. Hawkins,FOR,,20,5,465,53,129,0.411,24,51,0.471,29,78,0.372,0.504,21,28,0.75,29,65,94,21,8,5,21,49,151,2009
S. Hawkins,TOT,,26,5,560,65,151,0.43,27,59,0.458,38,92,0.413,0.52,28,39,0.718,32,81,113,25,8,6,25,57,185,2009
B. Heath,LOS,,50,41,1644,299,674,0.444,86,255,0.337,213,419,0.508,0.507,84,112,0.75,44,155,199,209,70,5,120,82,768,2009
R. Hendrix,TOT,,46,46,1425,269,477,0.564,7,14,0.5,262,463,0.566,0.571,122,198,0.616,140,385,525,67,47,71,96,186,667,2009
R. Hendrix,DAK,,37,37,1166,222,386,0.575,3,8,0.375,219,378,0.579,0.579,95,158,0.601,113,314,427,52,37,60,74,146,542,2009
R. Hendrix,BAK,,9,9,259,47,91,0.516,4,6,0.667,43,85,0.506,0.538,27,40,0.675,27,71,98,15,10,11,22,40,125,2009
H. Hill,TUL,,5,4,177,43,75,0.573,0,0,0.0,43,75,0.573,0.573,2,6,0.333,14,34,48,7,2,17,15,15,88,2009
H. Hill,TOT,,16,6,349,70,127,0.551,0,0,0.0,70,127,0.551,0.551,8,19,0.421,28,65,93,11,6,27,33,35,148,2009
H. Hill,BAK,,11,2,172,27,52,0.519,0,0,0.0,27,52,0.519,0.519,6,13,0.462,14,31,45,4,4,10,18,20,60,2009
M. Hill,TUL,30.0,5,0,37,8,14,0.571,2,4,0.5,6,10,0.6,0.643,0,0,0.0,2,2,4,1,1,1,3,6,18,2009
S. Hill,TUL,23.0,7,5,146,20,36,0.556,0,0,0.0,20,36,0.556,0.556,13,25,0.52,14,26,40,2,2,16,10,22,53,2009
G. Hill-Thomas,REN,,43,2,746,104,188,0.553,0,0,0.0,104,188,0.553,0.553,69,103,0.67,51,68,119,56,31,4,35,60,277,2009
D. Holland,RIO,,2,0,38,8,25,0.32,1,5,0.2,7,20,0.35,0.34,2,2,1.0,1,2,3,1,0,0,2,2,19,2009
L. Houston,IOW,,8,0,58,2,13,0.154,2,10,0.2,0,3,0.0,0.231,3,4,0.75,1,7,8,2,1,0,2,4,9,2009
R. Howard,FOR,,48,43,1732,339,682,0.497,0,10,0.0,339,672,0.504,0.497,218,287,0.76,44,177,221,115,56,8,102,145,896,2009
M. Hubbard,TOT,,41,10,798,132,284,0.465,11,43,0.256,121,241,0.502,0.484,60,87,0.69,37,133,170,36,31,30,41,110,335,2009
M. Hubbard,RIO,,27,8,594,97,210,0.462,8,34,0.235,89,176,0.506,0.481,41,60,0.683,24,104,128,31,21,25,26,76,243,2009
M. Hubbard,DAK,,14,2,204,35,74,0.473,3,9,0.333,32,65,0.492,0.493,19,27,0.704,13,29,42,5,10,5,15,34,92,2009
G. Hughes,LOS,,35,27,733,112,202,0.554,0,0,0.0,112,202,0.554,0.554,86,122,0.705,98,155,253,34,10,29,64,133,310,2009
Q. Humphrey,RIO,,43,17,903,125,303,0.413,32,97,0.33,93,206,0.451,0.465,39,59,0.661,55,92,147,50,33,4,38,60,321,2009
R. Humphrey,TUL,29.0,36,25,1006,216,427,0.506,0,2,0.0,216,425,0.508,0.506,132,205,0.644,90,175,265,49,29,35,119,95,564,2009
C. Hunter,FOR,24.0,47,46,1536,353,641,0.551,3,15,0.2,350,626,0.559,0.553,197,243,0.811,179,262,441,39,37,56,105,175,906,2009
O. Hunter,ANA,22.0,3,2,98,12,37,0.324,0,0,0.0,12,37,0.324,0.324,1,6,0.167,14,16,30,2,4,4,5,10,25,2009
A. Ingram,UTA,23.0,49,20,1352,164,363,0.452,87,185,0.47,77,178,0.433,0.572,94,108,0.87,41,129,170,79,45,7,65,73,509,2009
B. Jackson,UTA,28.0,39,27,842,75,185,0.405,0,0,0.0,75,185,0.405,0.405,83,104,0.798,50,111,161,60,25,29,54,126,233,2009
D. Jackson,ERI,23.0,2,0,51,15,23,0.652,0,0,0.0,15,23,0.652,0.652,9,12,0.75,6,6,12,1,2,0,4,8,39,2009
L. Jackson,IDA,27.0,36,35,1246,199,441,0.451,56,128,0.438,143,313,0.457,0.515,171,201,0.851,40,154,194,159,30,6,130,68,625,2009
N. Jawai,IDA,22.0,14,9,337,50,95,0.526,0,0,0.0,50,95,0.526,0.526,56,72,0.778,29,60,89,22,4,15,31,48,156,2009
D. Jefferson,UTA,25.0,33,33,1201,212,475,0.446,36,121,0.298,176,354,0.497,0.484,139,169,0.822,28,135,163,178,51,10,111,93,599,2009
O. Jeffers,IOW,23.0,48,32,1783,364,681,0.535,8,28,0.286,356,653,0.545,0.54,254,344,0.738,137,287,424,131,97,17,127,105,990,2009
C. Johnson,AUS,26.0,46,36,1475,150,358,0.419,57,154,0.37,93,204,0.456,0.499,51,64,0.797,32,109,141,237,79,3,91,105,408,2009
D. Johnson,AUS,28.0,8,0,170,21,63,0.333,9,33,0.273,12,30,0.4,0.405,11,17,0.647,5,20,25,5,4,2,16,11,62,2009
J. Johnson,ABQ,,45,33,1471,302,608,0.497,32,69,0.464,270,539,0.501,0.523,161,179,0.899,104,274,378,123,70,33,115,104,797,2009
J. Johnson,TOT,,49,37,1594,320,659,0.486,34,77,0.442,286,582,0.491,0.511,168,188,0.894,112,290,402,136,79,36,125,120,842,2009
J. Johnson,LOS,,4,4,123,18,51,0.353,2,8,0.25,16,43,0.372,0.373,7,9,0.778,8,16,24,13,9,3,10,16,45,2009
J. Johnson,SFL,25.0,6,0,54,4,14,0.286,1,6,0.167,3,8,0.375,0.321,2,2,1.0,2,6,8,4,3,0,0,3,11,2009
T. Johnson,BAK,24.0,39,39,1563,286,617,0.464,45,110,0.409,241,507,0.475,0.5,190,239,0.795,30,119,149,175,29,1,100,105,807,2009
M. Joiner,SFL,,34,26,1064,115,290,0.397,38,118,0.322,77,172,0.448,0.462,22,26,0.846,45,120,165,50,30,17,24,103,290,2009
B. Jones,SFL,25.0,49,46,1686,261,548,0.476,42,138,0.304,219,410,0.534,0.515,227,288,0.788,133,241,374,118,67,25,134,210,791,2009
D. Jones,IOW,25.0,1,0,5,0,0,0.0,0,0,0.0,0,0,0.0,0.0,1,2,0.5,1,0,1,0,0,0,0,4,1,2009
D. Jones,IDA,25.0,13,13,385,63,111,0.568,0,0,0.0,63,111,0.568,0.568,51,74,0.689,58,74,132,11,4,18,33,34,177,2009
D. Jones,AUS,25.0,20,19,725,124,204,0.608,0,0,0.0,124,204,0.608,0.608,91,138,0.659,104,169,273,25,12,24,46,55,339,2009
D. Jones,TOT,25.0,34,32,1115,187,315,0.594,0,0,0.0,187,315,0.594,0.594,143,214,0.668,163,243,406,36,16,42,79,93,517,2009
M. Jones,IOW,,2,0,20,2,9,0.222,0,4,0.0,2,5,0.4,0.222,0,2,0.0,3,0,3,0,1,1,1,5,4,2009
A. Jordan,TUL,25.0,2,0,36,4,8,0.5,1,2,0.5,3,6,0.5,0.563,0,0,0.0,0,1,1,4,0,0,2,4,9,2009
J. Jordan,RIO,,37,30,1150,166,366,0.454,14,50,0.28,152,316,0.481,0.473,45,64,0.703,33,104,137,326,71,4,99,64,391,2009
D. Kabov,ANA,,10,0,61,4,22,0.182,1,6,0.167,3,16,0.188,0.205,2,5,0.4,0,5,5,1,0,0,4,1,11,2009
C. Karl,IDA,25.0,22,22,819,133,260,0.512,43,109,0.394,90,151,0.596,0.594,101,123,0.821,20,77,97,122,33,9,74,76,410,2009
J. Kelly,TUL,26.0,47,36,1321,154,376,0.41,45,126,0.357,109,250,0.436,0.469,92,124,0.742,18,113,131,184,51,9,126,152,445,2009
A. Kent,FOR,25.0,41,13,711,72,153,0.471,0,0,0.0,72,153,0.471,0.471,30,56,0.536,75,110,185,14,18,27,38,100,174,2009
K. Koufos,UTA,19.0,10,10,296,73,129,0.566,0,0,0.0,73,129,0.566,0.566,21,35,0.6,35,49,84,20,10,26,19,22,167,2009
K. Kruger,UTA,,21,16,636,71,150,0.473,44,84,0.524,27,66,0.409,0.62,53,63,0.841,4,52,56,92,29,0,42,15,239,2009
A. Kyle,FOR,,4,0,71,2,13,0.154,0,0,0.0,2,13,0.154,0.154,2,2,1.0,2,4,6,11,3,0,8,7,6,2009
O. Lafayette,ERI,24.0,36,22,1127,169,426,0.397,57,174,0.328,112,252,0.444,0.464,96,126,0.762,26,123,149,140,58,6,63,100,491,2009
J. Lang,UTA,25.0,33,16,525,93,160,0.581,0,0,0.0,93,160,0.581,0.581,46,68,0.676,50,93,143,22,4,21,49,90,232,2009
N. Lewis,BAK,25.0,50,50,1582,266,544,0.489,49,130,0.377,217,414,0.524,0.534,188,226,0.832,85,281,366,59,15,35,70,148,769,2009
A. Liberty,TUL,,16,0,188,16,51,0.314,0,4,0.0,16,47,0.34,0.314,9,19,0.474,3,16,19,29,8,1,18,29,41,2009
S. Livingston,TUL,23.0,11,10,323,44,109,0.404,0,5,0.0,44,104,0.423,0.404,14,17,0.824,6,33,39,66,7,6,32,26,102,2009
D. Lolar,COL,,9,0,117,12,38,0.316,3,12,0.25,9,26,0.346,0.355,12,22,0.545,5,11,16,9,7,1,15,15,39,2009
L. Longar,LOS,,14,2,312,39,81,0.481,0,0,0.0,39,81,0.481,0.481,31,49,0.633,25,62,87,14,5,19,19,44,109,2009
K. Looby,RIO,,50,31,1271,128,226,0.566,0,1,0.0,128,225,0.569,0.566,62,108,0.574,158,246,404,19,42,127,45,132,318,2009
J. Lucas,COL,26.0,21,3,628,129,266,0.485,43,97,0.443,86,169,0.509,0.566,16,17,0.941,20,30,50,93,12,1,30,40,317,2009
I. Mahinmi,AUS,22.0,1,1,21,1,5,0.2,0,0,0.0,1,5,0.2,0.2,2,2,1.0,0,1,1,2,0,1,4,4,4,2009
R. Major,DAK,26.0,42,42,1602,252,485,0.52,13,53,0.245,239,432,0.553,0.533,192,227,0.846,83,140,223,146,81,34,68,115,709,2009
J. Manuel,ERI,25.0,47,46,1779,168,351,0.479,6,22,0.273,162,329,0.492,0.487,87,147,0.592,84,251,335,86,63,53,66,172,429,2009
C. Martin,IOW,24.0,21,21,791,154,323,0.477,46,118,0.39,108,205,0.527,0.548,78,96,0.813,24,89,113,29,13,10,52,74,432,2009
C. Mason,ANA,27.0,18,8,525,72,152,0.474,4,7,0.571,68,145,0.469,0.487,53,70,0.757,44,58,102,44,21,0,41,53,201,2009
J. Mays,COL,,12,12,403,77,167,0.461,14,46,0.304,63,121,0.521,0.503,58,91,0.637,39,64,103,24,21,12,43,32,226,2009
J. McClellan,DAK,,28,3,465,53,120,0.442,2,16,0.125,51,104,0.49,0.45,18,27,0.667,26,39,65,22,17,5,20,47,126,2009
T. McCullough,FOR,,36,34,1162,242,544,0.445,68,197,0.345,174,347,0.501,0.507,82,114,0.719,33,140,173,54,49,16,52,103,634,2009
T. McCullough,ERI,,8,0,100,19,40,0.475,4,9,0.444,15,31,0.484,0.525,10,17,0.588,6,9,15,3,3,0,5,17,52,2009
T. McCullough,TOT,,44,34,1262,261,584,0.447,72,206,0.35,189,378,0.5,0.509,92,131,0.702,39,149,188,57,52,16,57,120,686,2009
G. McGowan,SFL,,23,19,808,132,264,0.5,15,48,0.313,117,216,0.542,0.528,103,146,0.705,51,130,181,33,14,12,55,86,382,2009
B. McKenzie,ANA,25.0,9,1,105,10,23,0.435,0,0,0.0,10,23,0.435,0.435,6,11,0.545,16,25,41,2,3,5,9,23,26,2009
L. McKenzie,LOS,,10,1,135,14,38,0.368,4,13,0.308,10,25,0.4,0.421,3,6,0.5,2,7,9,21,2,0,11,13,35,2009
R. McKiver,AUS,,12,0,62,4,22,0.182,2,13,0.154,2,9,0.222,0.227,1,6,0.167,0,7,7,3,2,0,8,6,11,2009
K. McLeod,ABQ,29.0,36,34,1377,153,378,0.405,38,114,0.333,115,264,0.436,0.455,165,206,0.801,19,92,111,157,59,4,82,112,509,2009
G. McNamara,REN,25.0,17,0,345,39,99,0.394,21,59,0.356,18,40,0.45,0.5,22,25,0.88,1,19,20,61,11,1,26,30,121,2009
A. Meeking,REN,27.0,33,33,1169,201,471,0.427,22,79,0.278,179,392,0.457,0.45,150,218,0.688,84,177,261,72,23,7,87,102,574,2009
A. Meeking,ABQ,27.0,15,7,501,65,166,0.392,4,22,0.182,61,144,0.424,0.404,70,98,0.714,28,58,86,26,12,3,39,47,204,2009
A. Meeking,TOT,27.0,48,40,1670,266,637,0.418,26,101,0.257,240,536,0.448,0.438,220,316,0.696,112,235,347,98,35,10,126,149,778,2009
P. Mensah-Bonsu,AUS,25.0,8,8,318,76,125,0.608,0,2,0.0,76,123,0.618,0.608,61,87,0.701,35,69,104,19,12,20,32,37,213,2009
T. Minor,AUS,,7,0,53,12,21,0.571,2,6,0.333,10,15,0.667,0.619,3,4,0.75,1,2,3,7,2,0,11,5,29,2009
D. Mitchell,LOS,26.0,49,49,1929,321,624,0.514,15,63,0.238,306,561,0.545,0.526,252,369,0.683,86,252,338,210,93,16,135,130,909,2009
D. Monds,ABQ,,31,28,1040,174,306,0.569,0,3,0.0,174,303,0.574,0.569,67,101,0.663,96,198,294,28,28,36,67,105,415,2009
D. Monds,TOT,,38,34,1237,203,369,0.55,0,3,0.0,203,366,0.555,0.55,73,108,0.676,115,230,345,39,31,39,79,125,479,2009
D. Monds,DAK,,7,6,197,29,63,0.46,0,0,0.0,29,63,0.46,0.46,6,7,0.857,19,32,51,11,3,3,12,20,64,2009
J. Moore,IOW,25.0,8,0,80,10,21,0.476,0,0,0.0,10,21,0.476,0.476,2,9,0.222,5,5,10,5,0,0,3,11,22,2009
B. Morrison,AUS,,12,0,96,15,35,0.429,7,18,0.389,8,17,0.471,0.529,7,8,0.875,1,9,10,15,1,0,8,16,44,2009
B. Morrison,TOT,,17,0,147,22,60,0.367,8,25,0.32,14,35,0.4,0.433,7,8,0.875,1,14,15,19,3,0,17,26,59,2009
B. Morrison,FOR,,5,0,51,7,25,0.28,1,7,0.143,6,18,0.333,0.3,0,0,0.0,0,5,5,4,2,0,9,10,15,2009
T. Morris,TOT,,23,1,321,33,71,0.465,0,0,0.0,33,71,0.465,0.465,34,47,0.723,28,54,82,4,4,14,31,64,100,2009
T. Morris,FOR,,14,0,192,25,50,0.5,0,0,0.0,25,50,0.5,0.5,20,29,0.69,18,34,52,4,3,6,20,33,70,2009
T. Morris,ABQ,,9,1,129,8,21,0.381,0,0,0.0,8,21,0.381,0.381,14,18,0.778,10,20,30,0,1,8,11,31,30,2009
D. Nelson,TOT,23.0,20,19,754,154,285,0.54,21,50,0.42,133,235,0.566,0.577,69,95,0.726,26,81,107,82,33,7,57,43,398,2009
D. Nelson,BAK,23.0,9,9,299,61,112,0.545,3,10,0.3,58,102,0.569,0.558,20,34,0.588,10,32,42,36,20,2,26,17,145,2009
D. Nelson,AUS,23.0,11,10,455,93,173,0.538,18,40,0.45,75,133,0.564,0.59,49,61,0.803,16,49,65,46,13,5,31,26,253,2009
S. Newman,IOW,,7,2,94,6,23,0.261,2,9,0.222,4,14,0.286,0.304,1,2,0.5,4,14,18,4,3,6,5,14,15,2009
S. Newman,UTA,,28,8,410,32,84,0.381,5,20,0.25,27,64,0.422,0.411,4,8,0.5,24,43,67,21,9,12,16,52,73,2009
S. Newman,TOT,,35,10,504,38,107,0.355,7,29,0.241,31,78,0.397,0.388,5,10,0.5,28,57,85,25,12,18,21,66,88,2009
D. Nichols,IOW,24.0,18,15,679,141,297,0.475,40,88,0.455,101,209,0.483,0.542,68,89,0.764,17,79,96,54,22,21,54,55,390,2009
D. Noel,REN,24.0,17,17,717,132,239,0.552,33,72,0.458,99,167,0.593,0.621,55,83,0.663,17,92,109,126,22,12,48,42,352,2009
D. Noel,ABQ,24.0,32,31,1312,222,443,0.501,46,114,0.404,176,329,0.535,0.553,90,115,0.783,44,144,188,137,80,18,104,116,580,2009
D. Noel,TOT,24.0,49,48,2029,354,682,0.519,79,186,0.425,275,496,0.554,0.577,145,198,0.732,61,236,297,263,102,30,152,158,932,2009
D. Noel,REN,,33,24,755,113,245,0.461,26,73,0.356,87,172,0.506,0.514,78,92,0.848,34,58,92,69,29,4,30,82,330,2009
Y. Ogunoye,TUL,,49,48,1868,127,308,0.412,15,41,0.366,112,267,0.419,0.437,48,80,0.6,69,140,209,85,74,28,62,111,317,2009
E. Osmundson,COL,25.0,1,0,14,0,3,0.0,0,0,0.0,0,3,0.0,0.0,2,2,1.0,2,2,4,1,1,0,2,2,2,2009
C. Parker,LOS,,32,12,596,83,172,0.483,9,25,0.36,74,147,0.503,0.509,41,69,0.594,30,40,70,55,32,7,28,34,216,2009
J. Parker,AUS,,4,0,57,6,16,0.375,4,9,0.444,2,7,0.286,0.5,2,2,1.0,2,4,6,3,3,0,1,4,18,2009
S. Parker,RIO,27.0,18,16,651,104,239,0.435,30,73,0.411,74,166,0.446,0.498,72,107,0.673,8,73,81,135,41,5,91,62,310,2009
M. Parmer,COL,,17,4,309,44,104,0.423,0,7,0.0,44,97,0.454,0.423,48,60,0.8,8,20,28,62,13,2,44,24,136,2009
A. Patterson,ANA,25.0,26,2,458,40,87,0.46,1,5,0.2,39,82,0.476,0.466,24,31,0.774,24,47,71,16,14,17,22,52,105,2009
A. Patterson,TOT,25.0,37,2,610,61,127,0.48,1,5,0.2,60,122,0.492,0.484,35,44,0.795,34,67,101,30,17,23,32,76,158,2009
A. Patterson,REN,25.0,11,0,152,21,40,0.525,0,0,0.0,21,40,0.525,0.525,11,13,0.846,10,20,30,14,3,6,10,24,53,2009
B. Petway,IDA,,48,48,1422,193,384,0.503,39,123,0.317,154,261,0.59,0.553,64,101,0.634,55,142,197,62,24,103,54,156,489,2009
M. Phillips,IOW,,36,7,555,75,138,0.543,4,9,0.444,71,129,0.55,0.558,27,43,0.628,66,75,141,14,24,33,20,83,181,2009
K. Powell,SFL,27.0,20,15,655,146,300,0.487,27,82,0.329,119,218,0.546,0.532,52,76,0.684,17,63,80,82,30,9,34,48,371,2009
J. Reed,BAK,27.0,28,21,873,145,343,0.423,4,14,0.286,141,329,0.429,0.429,58,79,0.734,45,153,198,55,17,10,48,91,352,2009
R. Reed,ANA,,15,2,363,33,81,0.407,0,2,0.0,33,79,0.418,0.407,24,49,0.49,7,29,36,60,18,7,31,30,90,2009
M. Rice,ERI,,50,48,1841,372,789,0.471,50,132,0.379,322,657,0.49,0.503,142,167,0.85,58,165,223,198,65,2,101,69,936,2009
C. Richard,TUL,24.0,20,20,613,103,194,0.531,0,0,0.0,103,194,0.531,0.531,33,52,0.635,50,114,164,33,13,10,45,65,239,2009
R. Robinson,REN,23.0,50,35,1448,219,489,0.448,66,180,0.367,153,309,0.495,0.515,113,141,0.801,33,108,141,219,105,5,101,115,617,2009
W. Russell,FOR,26.0,47,46,1845,255,604,0.422,30,100,0.3,225,504,0.446,0.447,216,267,0.809,35,166,201,508,110,8,199,118,756,2009
C. Samb,COL,24.0,10,4,255,49,95,0.516,3,9,0.333,46,86,0.535,0.532,23,32,0.719,28,43,71,8,9,38,16,37,124,2009
P. Sanders,IOW,,41,36,1257,194,474,0.409,60,144,0.417,134,330,0.406,0.473,121,157,0.771,38,111,149,56,28,31,75,101,569,2009
T. Sanders,RIO,,2,0,23,4,8,0.5,0,0,0.0,4,8,0.5,0.5,1,2,0.5,2,5,7,1,1,0,0,4,9,2009
A. Sawadogo,IOW,,23,0,157,14,35,0.4,0,0,0.0,14,35,0.4,0.4,4,10,0.4,26,19,45,1,1,10,6,30,32,2009
D. Scales,LOS,,3,0,20,0,6,0.0,0,0,0.0,0,6,0.0,0.0,2,4,0.5,1,2,3,0,0,1,1,6,2,2009
D. Scott,FOR,,49,12,1365,139,377,0.369,85,225,0.378,54,152,0.355,0.481,25,30,0.833,27,90,117,28,24,1,18,119,388,2009
E. Scott,IDA,,19,2,346,45,119,0.378,30,76,0.395,15,43,0.349,0.504,4,7,0.571,10,32,42,12,11,5,15,32,124,2009
E. Scott,TOT,,46,2,906,132,330,0.4,88,221,0.398,44,109,0.404,0.533,18,29,0.621,34,80,114,47,23,17,35,81,370,2009
E. Scott,RIO,,27,0,560,87,211,0.412,58,145,0.4,29,66,0.439,0.55,14,22,0.636,24,48,72,35,12,12,20,49,246,2009
M. Sene,ABQ,22.0,10,9,303,43,85,0.506,0,0,0.0,43,85,0.506,0.506,14,26,0.538,40,64,104,6,9,37,12,23,100,2009
J. Sensley,RIO,,10,3,249,47,92,0.511,5,14,0.357,42,78,0.538,0.538,15,22,0.682,17,29,46,14,14,5,10,18,114,2009
J. Sensley,COL,,7,0,121,25,49,0.51,6,16,0.375,19,33,0.576,0.571,3,6,0.5,6,15,21,10,6,2,7,13,59,2009
J. Sensley,TOT,,17,3,370,72,141,0.511,11,30,0.367,61,111,0.55,0.55,18,28,0.643,23,44,67,24,20,7,17,31,173,2009
W. Sharpe,FOR,22.0,4,3,87,16,37,0.432,1,2,0.5,15,35,0.429,0.446,10,12,0.833,6,8,14,2,2,2,5,13,43,2009
B. Sheldon,ANA,,6,0,58,3,14,0.214,0,4,0.0,3,10,0.3,0.214,2,2,1.0,0,2,2,3,1,0,1,5,8,2009
K. Shiloh,REN,,5,0,36,2,11,0.182,1,5,0.2,1,6,0.167,0.227,0,0,0.0,1,3,4,6,3,0,2,6,5,2009
C. Sims,IOW,25.0,32,31,1240,277,458,0.605,1,2,0.5,276,456,0.605,0.606,173,230,0.752,110,242,352,49,18,65,83,106,728,2009
S. Singletary,SFL,23.0,3,1,89,16,32,0.5,3,5,0.6,13,27,0.481,0.547,12,15,0.8,4,7,11,11,3,0,10,6,47,2009
E. Smith,FOR,,3,0,29,5,9,0.556,0,0,0.0,5,9,0.556,0.556,0,0,0.0,2,2,4,1,0,0,3,3,10,2009
J. Smith,REN,,33,30,816,127,277,0.458,0,2,0.0,127,275,0.462,0.458,62,92,0.674,73,150,223,21,16,15,57,82,316,2009
J. Smith,DAK,,14,1,257,42,86,0.488,0,0,0.0,42,86,0.488,0.488,16,19,0.842,21,49,70,12,6,5,13,26,100,2009
J. Smith,TOT,,47,31,1073,169,363,0.466,0,2,0.0,169,361,0.468,0.466,78,111,0.703,94,199,293,33,22,20,70,108,416,2009
L. Smith,IDA,,48,12,1027,91,225,0.404,25,80,0.313,66,145,0.455,0.46,83,116,0.716,13,97,110,143,31,2,92,103,290,2009
S. Sonderleiter,FOR,,33,1,362,46,111,0.414,0,0,0.0,46,111,0.414,0.414,39,60,0.65,41,61,102,13,18,9,35,64,131,2009
G. Stiemsma,SFL,23.0,1,0,14,1,3,0.333,0,0,0.0,1,3,0.333,0.333,4,4,1.0,2,4,6,0,0,1,0,2,6,2009
C. Stinson,IOW,25.0,50,50,2233,322,732,0.44,17,79,0.215,305,653,0.467,0.452,142,192,0.74,83,268,351,422,108,14,181,145,803,2009
B. Stricker,TOT,,44,11,565,44,77,0.571,0,1,0.0,44,76,0.579,0.571,30,59,0.508,38,70,108,18,10,14,26,96,118,2009
B. Stricker,DAK,,24,2,274,23,38,0.605,0,0,0.0,23,38,0.605,0.605,17,29,0.586,19,35,54,13,5,5,17,51,63,2009
B. Stricker,ABQ,,20,9,291,21,39,0.538,0,1,0.0,21,38,0.553,0.538,13,30,0.433,19,35,54,5,5,9,9,45,55,2009
T. Strickland,RIO,24.0,50,50,1579,315,706,0.446,37,121,0.306,278,585,0.475,0.472,208,281,0.74,99,207,306,70,51,11,98,149,875,2009
J. Tatum,IDA,,49,5,1299,204,519,0.393,41,126,0.325,163,393,0.415,0.433,127,160,0.794,28,90,118,194,51,2,86,105,576,2009
M. Taylor,ANA,27.0,3,0,72,11,31,0.355,0,4,0.0,11,27,0.407,0.355,6,7,0.857,2,5,7,6,0,0,7,3,28,2009
C. Terry,LOS,,16,0,212,19,59,0.322,8,30,0.267,11,29,0.379,0.39,3,5,0.6,4,20,24,11,1,0,13,20,49,2009
B. Thomas,COL,33.0,25,22,879,146,336,0.435,62,163,0.38,84,173,0.486,0.527,48,60,0.8,13,72,85,93,44,8,45,60,402,2009
J. Thomas,AUS,28.0,6,0,71,12,29,0.414,3,14,0.214,9,15,0.6,0.466,4,4,1.0,4,7,11,6,2,1,5,3,31,2009
J. Thomas,TOT,28.0,27,0,359,58,126,0.46,11,45,0.244,47,81,0.58,0.504,26,46,0.565,20,29,49,27,16,8,16,29,153,2009
J. Thomas,REN,28.0,21,0,288,46,97,0.474,8,31,0.258,38,66,0.576,0.515,22,42,0.524,16,22,38,21,14,7,11,26,122,2009
T. Thomas,BAK,28.0,49,19,1386,192,388,0.495,30,91,0.33,162,297,0.545,0.534,78,89,0.876,84,275,359,104,54,13,90,105,492,2009
J. Thorpe,AUS,,2,0,11,2,4,0.5,1,3,0.333,1,1,1.0,0.625,2,2,1.0,1,0,1,1,1,0,2,3,7,2009
A. Tolliver,TOT,23.0,17,14,617,85,178,0.478,37,92,0.402,48,86,0.558,0.581,39,49,0.796,38,98,136,33,22,18,34,56,246,2009
A. Tolliver,IOW,23.0,11,8,387,49,106,0.462,16,49,0.327,33,57,0.579,0.538,25,31,0.806,24,65,89,16,15,16,22,31,139,2009
A. Tolliver,AUS,23.0,6,6,230,36,72,0.5,21,43,0.488,15,29,0.517,0.646,14,18,0.778,14,33,47,17,7,2,12,25,107,2009
D. Townes,ERI,,31,4,428,85,176,0.483,0,1,0.0,85,175,0.486,0.483,36,57,0.632,56,71,127,10,7,39,21,61,206,2009
J. Trepagnier,BAK,29.0,36,7,850,139,325,0.428,49,139,0.353,90,186,0.484,0.503,67,79,0.848,19,82,101,40,41,21,46,66,394,2009
J. Trepagnier,TOT,29.0,45,7,982,166,394,0.421,60,172,0.349,106,222,0.477,0.497,77,95,0.811,21,92,113,50,44,23,52,80,469,2009
J. Trepagnier,RIO,29.0,9,0,132,27,69,0.391,11,33,0.333,16,36,0.444,0.471,10,16,0.625,2,10,12,10,3,2,6,14,75,2009
C. Trybanski,REN,29.0,12,2,196,24,40,0.6,0,0,0.0,24,40,0.6,0.6,14,18,0.778,14,38,52,1,1,29,12,23,62,2009
A. Tucker,IOW,24.0,2,2,62,6,17,0.353,1,3,0.333,5,14,0.357,0.382,3,3,1.0,1,8,9,6,1,0,2,3,16,2009
M. Tyndale,IOW,23.0,16,4,441,61,124,0.492,4,12,0.333,57,112,0.509,0.508,51,75,0.68,25,49,74,24,20,10,22,41,177,2009
A. Ubaka,ANA,,12,0,169,14,29,0.483,1,5,0.2,13,24,0.542,0.5,9,11,0.818,1,12,13,10,4,0,7,7,38,2009
C. Underwood,ABQ,,20,16,502,89,179,0.497,0,0,0.0,89,179,0.497,0.497,43,70,0.614,36,60,96,20,13,7,23,53,221,2009
H. Walker,UTA,21.0,15,15,457,103,185,0.557,12,30,0.4,91,155,0.587,0.589,65,81,0.802,23,56,79,23,20,10,50,58,283,2009
K. Walters,ANA,,45,6,460,35,70,0.5,1,1,1.0,34,69,0.493,0.507,14,26,0.538,15,51,66,13,9,12,17,66,85,2009
M. Walters,ABQ,,43,10,628,79,170,0.465,11,39,0.282,68,131,0.519,0.497,39,62,0.629,45,66,111,40,39,6,22,71,208,2009
K. Watson,RIO,,8,0,76,5,19,0.263,0,3,0.0,5,16,0.313,0.263,5,8,0.625,2,6,8,11,4,0,12,9,15,2009
K. Weaver,TUL,22.0,2,2,89,14,27,0.519,1,6,0.167,13,21,0.619,0.537,5,6,0.833,5,10,15,18,6,4,7,5,34,2009
S. Weems,COL,22.0,22,8,622,190,389,0.488,18,70,0.257,172,319,0.539,0.512,53,75,0.707,27,72,99,65,22,14,61,76,451,2009
C. Wheeler,UTA,,50,1,1093,161,318,0.506,4,24,0.167,157,294,0.534,0.513,96,140,0.686,72,195,267,52,34,22,94,127,422,2009
D. White,TUL,22.0,6,5,188,46,82,0.561,0,0,0.0,46,82,0.561,0.561,18,21,0.857,15,28,43,7,4,9,10,17,110,2009
J. White,ANA,26.0,34,33,1397,291,530,0.549,49,133,0.368,242,397,0.61,0.595,249,291,0.856,37,134,171,86,40,17,99,112,880,2009
M. White,LOS,,9,3,180,22,50,0.44,0,0,0.0,22,50,0.44,0.44,13,17,0.765,23,34,57,6,10,3,8,26,57,2009
E. Wilborn,SFL,,8,0,98,8,16,0.5,0,0,0.0,8,16,0.5,0.5,3,9,0.333,7,9,16,1,0,6,7,19,19,2009
E. Williams,AUS,28.0,42,18,1105,165,378,0.437,60,141,0.426,105,237,0.443,0.516,59,69,0.855,49,113,162,69,51,19,66,102,449,2009
F. Williams,SFL,28.0,47,43,1732,244,690,0.354,117,360,0.325,127,330,0.385,0.438,209,245,0.853,25,115,140,168,67,22,109,94,814,2009
J. Williams,RIO,25.0,19,18,691,179,395,0.453,51,122,0.418,128,273,0.469,0.518,79,101,0.782,21,58,79,44,17,8,45,47,488,2009
M. Williams,AUS,22.0,45,44,1924,382,852,0.448,46,143,0.322,336,709,0.474,0.475,227,271,0.838,44,269,313,240,77,27,182,118,1037,2009
S. Williams,COL,22.0,8,6,207,31,62,0.5,0,1,0.0,31,61,0.508,0.5,16,23,0.696,16,44,60,11,4,31,20,36,78,2009
C. Winder,RIO,,46,6,741,149,338,0.441,23,78,0.295,126,260,0.485,0.475,88,111,0.793,37,76,113,82,44,11,64,104,409,2009
J. Wright,ABQ,,19,1,316,48,92,0.522,3,15,0.2,45,77,0.584,0.538,8,14,0.571,5,17,22,19,6,1,19,26,107,2009
S. Yue,LOS,23.0,6,6,200,23,58,0.397,8,21,0.381,15,37,0.405,0.466,5,7,0.714,2,18,20,22,8,14,12,18,59,2009
M. Ager,TUL,23.0,8,5,269,47,117,0.402,16,37,0.432,31,80,0.388,0.47,29,48,0.604,1,14,15,15,6,0,15,19,139,2008
B. Ahearn,DAK,23.0,41,15,1206,239,492,0.486,108,246,0.439,131,246,0.533,0.596,191,199,0.96,10,73,83,142,30,1,99,87,777,2008
D. Akindele,IOW,24.0,12,5,251,36,59,0.61,0,0,0.0,36,59,0.61,0.61,31,41,0.756,30,45,75,6,4,19,27,37,103,2008
C. Alexander,SFL,,40,26,1289,163,321,0.508,0,0,0.0,163,321,0.508,0.508,136,191,0.712,219,230,449,37,18,80,92,159,462,2008
R. Allen,SFL,,16,0,126,15,38,0.395,0,2,0.0,15,36,0.417,0.395,10,14,0.714,3,18,21,1,3,6,10,24,40,2008
L. Allred,IDA,26.0,38,33,1121,234,457,0.512,2,2,1.0,232,455,0.51,0.514,146,185,0.789,116,265,381,53,16,16,66,86,616,2008
M. Almond,UTA,22.0,34,31,1262,297,666,0.446,57,161,0.354,240,505,0.475,0.489,219,263,0.833,34,88,122,55,31,17,110,79,870,2008
M. Al-Sayyad,TUL,25.0,6,0,42,8,12,0.667,1,2,0.5,7,10,0.7,0.708,8,12,0.667,3,2,5,4,0,0,7,2,25,2008
M. Al-Sayyad,TOT,25.0,8,2,98,14,22,0.636,1,2,0.5,13,20,0.65,0.659,10,17,0.588,6,11,17,6,0,1,10,6,39,2008
M. Al-Sayyad,BAK,25.0,2,2,56,6,10,0.6,0,0,0.0,6,10,0.6,0.6,2,5,0.4,3,9,12,2,0,1,3,4,14,2008
L. Anderson,TOT,,16,0,158,16,57,0.281,11,34,0.324,5,23,0.217,0.377,6,7,0.857,2,8,10,5,2,0,7,12,49,2008
L. Anderson,RIO,,6,0,49,3,17,0.176,1,9,0.111,2,8,0.25,0.206,2,3,0.667,0,0,0,2,0,0,5,1,9,2008
L. Anderson,COL,,10,0,109,13,40,0.325,10,25,0.4,3,15,0.2,0.45,4,4,1.0,2,8,10,3,2,0,2,11,40,2008
R. Andrews,BAK,,34,2,290,21,46,0.457,1,7,0.143,20,39,0.513,0.467,21,34,0.618,8,36,44,11,12,2,13,58,64,2008
S. Angounou,ABQ,,21,0,348,38,100,0.38,1,4,0.25,37,96,0.385,0.385,24,35,0.686,35,50,85,12,11,7,22,59,101,2008
S. Angounou,TOT,,41,12,743,83,193,0.43,3,12,0.25,80,181,0.442,0.438,58,74,0.784,68,96,164,27,22,9,43,115,227,2008
S. Angounou,AUS,,20,12,395,45,93,0.484,2,8,0.25,43,85,0.506,0.495,34,39,0.872,33,46,79,15,11,2,21,56,126,2008
J. Anthony,IOW,25.0,3,3,73,9,20,0.45,0,0,0.0,9,20,0.45,0.45,6,12,0.5,8,12,20,0,1,12,3,12,24,2008
S. Asumnu,RIO,,38,3,857,145,262,0.553,1,8,0.125,144,254,0.567,0.555,31,73,0.425,70,97,167,19,35,12,29,94,322,2008
D. Bailey,SFL,,47,44,1604,242,559,0.433,76,184,0.413,166,375,0.443,0.501,162,199,0.814,35,129,164,262,78,4,114,145,722,2008
M. Baker,DAK,28.0,24,19,974,156,338,0.462,12,36,0.333,144,302,0.477,0.479,112,130,0.862,57,101,158,111,50,0,70,81,436,2008
S. Banks,LOS,23.0,49,48,1707,358,782,0.458,70,209,0.335,288,573,0.503,0.503,277,373,0.743,76,189,265,148,35,33,144,115,1063,2008
A. Barrett,BAK,25.0,30,29,1145,214,430,0.498,37,81,0.457,177,349,0.507,0.541,102,116,0.879,15,86,101,264,46,2,84,51,567,2008
A. Barrett,AUS,25.0,13,13,480,82,180,0.456,17,42,0.405,65,138,0.471,0.503,42,45,0.933,4,34,38,108,18,0,43,21,223,2008
A. Barrett,TOT,25.0,43,42,1625,296,610,0.485,54,123,0.439,242,487,0.497,0.53,144,161,0.894,19,120,139,372,64,2,127,72,790,2008
D. Bell,DAK,,9,5,301,38,97,0.392,21,49,0.429,17,48,0.354,0.5,22,27,0.815,2,33,35,33,9,0,18,22,119,2008
R. Benson,DAK,23.0,49,44,1646,248,478,0.519,0,0,0.0,248,478,0.519,0.519,170,252,0.675,198,393,591,59,63,66,99,162,666,2008
A. Berdiel,ABQ,,24,11,676,84,202,0.416,16,47,0.34,68,155,0.439,0.455,54,71,0.761,20,69,89,116,37,7,63,62,238,2008
R. Bergersen,IDA,,47,40,1458,239,502,0.476,95,245,0.388,144,257,0.56,0.571,43,55,0.782,21,115,136,130,57,12,78,103,616,2008
W. Blalock,ANA,24.0,41,38,1383,191,412,0.464,47,122,0.385,144,290,0.497,0.521,82,114,0.719,25,90,115,219,58,8,93,63,511,2008
J. Bluntt,TOT,,33,0,356,55,147,0.374,27,72,0.375,28,75,0.373,0.466,25,32,0.781,15,36,51,11,12,4,22,39,162,2008
J. Bluntt,SFL,,29,0,342,53,142,0.373,25,68,0.368,28,74,0.378,0.461,25,32,0.781,15,34,49,11,12,4,21,36,156,2008
J. Bluntt,IOW,,4,0,14,2,5,0.4,2,4,0.5,0,1,0.0,0.6,0,0,0.0,0,2,2,0,0,0,1,3,6,2008
T. Bobbitt,COL,28.0,3,0,53,7,19,0.368,2,11,0.182,5,8,0.625,0.421,4,4,1.0,1,7,8,3,5,4,4,6,20,2008
M. Boggan,ANA,,6,0,35,3,7,0.429,0,0,0.0,3,7,0.429,0.429,1,2,0.5,2,5,7,1,0,0,3,10,7,2008
K. Bookout,RIO,,9,5,166,17,30,0.567,0,1,0.0,17,29,0.586,0.567,7,12,0.583,17,25,42,4,1,1,5,13,41,2008
J. Bowen,AUS,24.0,46,15,1297,260,490,0.531,7,34,0.206,253,456,0.555,0.538,75,107,0.701,100,193,293,76,55,30,73,122,602,2008
B. Bowman,BAK,23.0,18,17,665,136,265,0.513,12,33,0.364,124,232,0.534,0.536,62,90,0.689,51,90,141,51,25,20,59,57,346,2008
J. Brewer,BAK,27.0,4,3,111,4,17,0.235,0,6,0.0,4,11,0.364,0.235,5,8,0.625,2,6,8,18,9,0,5,15,13,2008
D. Brewington,TUL,,21,0,326,61,120,0.508,6,17,0.353,55,103,0.534,0.533,26,35,0.743,29,37,66,22,6,6,26,32,154,2008
D. Brewington,TOT,,29,0,465,87,174,0.5,7,22,0.318,80,152,0.526,0.52,48,65,0.738,36,47,83,33,9,8,39,46,229,2008
D. Brewington,ABQ,,8,0,139,26,54,0.481,1,5,0.2,25,49,0.51,0.491,22,30,0.733,7,10,17,11,3,2,13,14,75,2008
A. Brooks,RIO,23.0,2,2,85,18,38,0.474,5,9,0.556,13,29,0.448,0.539,5,8,0.625,2,8,10,10,0,0,8,10,46,2008
C. Brown,LOS,,43,15,1125,193,409,0.472,44,103,0.427,149,306,0.487,0.526,104,128,0.813,15,101,116,81,35,6,58,62,534,2008
D. Brown,SFL,28.0,8,8,334,50,123,0.407,12,34,0.353,38,89,0.427,0.455,33,42,0.786,13,54,67,23,17,14,29,35,145,2008
E. Brown,COL,24.0,36,34,1321,268,527,0.509,1,3,0.333,267,524,0.51,0.509,199,294,0.677,137,290,427,74,21,33,117,112,736,2008
K. Brown,ANA,26.0,49,46,1714,277,620,0.447,53,183,0.29,224,437,0.513,0.49,139,188,0.739,81,207,288,87,69,20,81,127,746,2008
S. Brown,TOT,22.0,11,7,406,91,215,0.423,24,69,0.348,67,146,0.459,0.479,51,59,0.864,13,48,61,33,15,8,42,38,257,2008
S. Brown,RIO,22.0,5,1,196,40,98,0.408,7,27,0.259,33,71,0.465,0.444,16,21,0.762,8,14,22,13,3,4,18,19,103,2008
S. Brown,IOW,22.0,6,6,210,51,117,0.436,17,42,0.405,34,75,0.453,0.509,35,38,0.921,5,34,39,20,12,4,24,19,154,2008
E. Burns,SFL,,1,0,4,1,2,0.5,0,1,0.0,1,1,1.0,0.5,1,2,0.5,2,2,4,0,0,0,1,3,3,2008
T. Bush,AUS,,3,0,14,0,0,0.0,0,0,0.0,0,0,0.0,0.0,0,0,0.0,0,3,3,0,0,0,1,3,0,2008
P. Butorac,COL,,3,0,17,1,3,0.333,0,0,0.0,1,3,0.333,0.333,0,0,0.0,0,0,0,2,0,0,2,5,2,2008
J. Cage,COL,,43,24,1317,178,295,0.603,12,24,0.5,166,271,0.613,0.624,149,187,0.797,135,119,254,79,36,39,55,103,517,2008
E. Calloway,FOR,,50,46,1783,331,667,0.496,50,123,0.407,281,544,0.517,0.534,234,264,0.886,53,202,255,289,101,11,133,110,946,2008
M. Campbell,ANA,25.0,38,31,1051,223,418,0.533,1,1,1.0,222,417,0.532,0.535,80,137,0.584,138,224,362,28,18,48,75,129,527,2008
M. Campbell,TOT,25.0,43,31,1103,231,436,0.53,1,1,1.0,230,435,0.529,0.531,90,149,0.604,140,241,381,28,19,52,86,137,553,2008
M. Campbell,IDA,25.0,5,0,52,8,18,0.444,0,0,0.0,8,18,0.444,0.444,10,12,0.833,2,17,19,0,1,4,11,8,26,2008
N. Caner-Medley,SFL,,6,6,253,49,115,0.426,6,19,0.316,43,96,0.448,0.452,28,38,0.737,24,45,69,19,18,6,18,16,132,2008
R. Carter,TUL,,6,5,160,25,55,0.455,2,9,0.222,23,46,0.5,0.473,10,12,0.833,16,17,33,15,5,0,6,18,62,2008
M. Charlo,TOT,24.0,40,21,1162,184,437,0.421,39,144,0.271,145,293,0.495,0.466,150,193,0.777,73,109,182,62,44,35,67,85,557,2008
M. Charlo,COL,24.0,12,1,240,38,86,0.442,4,21,0.19,34,65,0.523,0.465,31,39,0.795,18,35,53,14,11,12,13,30,111,2008
M. Charlo,ANA,24.0,28,20,922,146,351,0.416,35,123,0.285,111,228,0.487,0.466,119,154,0.773,55,74,129,48,33,23,54,55,446,2008
B. Chase,LOS,26.0,36,25,1184,201,491,0.409,81,218,0.372,120,273,0.44,0.492,112,124,0.903,12,124,136,131,33,0,59,44,595,2008
E. Chenowith,IDA,28.0,9,0,60,10,22,0.455,0,1,0.0,10,21,0.476,0.455,3,7,0.429,8,12,20,1,1,6,3,16,23,2008
M. Clark,TOT,24.0,5,0,35,6,11,0.545,1,2,0.5,5,9,0.556,0.591,2,2,1.0,1,6,7,2,0,0,6,11,15,2008
M. Clark,SFL,24.0,1,0,3,1,1,1.0,0,0,0.0,1,1,1.0,1.0,0,0,0.0,0,1,1,0,0,0,0,3,2,2008
M. Clark,COL,24.0,4,0,32,5,10,0.5,1,2,0.5,4,8,0.5,0.55,2,2,1.0,1,5,6,2,0,0,6,8,13,2008
M. Cleaves,BAK,30.0,15,15,612,106,198,0.535,12,35,0.343,94,163,0.577,0.566,61,79,0.772,20,59,79,155,34,0,65,59,285,2008
K. Closs,TUL,31.0,49,11,914,120,200,0.6,1,3,0.333,119,197,0.604,0.603,61,89,0.685,65,150,215,32,17,133,50,77,302,2008
K. Collins,RIO,,32,7,848,166,352,0.472,5,23,0.217,161,329,0.489,0.479,126,170,0.741,26,68,94,114,38,1,63,75,463,2008
W. Conroy,ABQ,25.0,14,11,541,87,174,0.5,29,71,0.408,58,103,0.563,0.583,40,54,0.741,20,47,67,115,20,0,50,36,243,2008
D. Cook,IOW,20.0,3,3,118,21,57,0.368,9,22,0.409,12,35,0.343,0.447,7,10,0.7,6,15,21,11,4,1,7,11,58,2008
D. Cooper,LOS,,15,0,302,35,78,0.449,12,26,0.462,23,52,0.442,0.526,22,30,0.733,5,38,43,22,7,2,18,25,104,2008
E. Craven,LOS,,40,17,773,133,261,0.51,3,12,0.25,130,249,0.522,0.515,49,66,0.742,30,94,124,101,63,6,81,103,318,2008
T. Crawford,TOT,25.0,37,23,1022,99,218,0.454,3,16,0.188,96,202,0.475,0.461,148,209,0.708,103,129,232,70,41,8,72,114,349,2008
T. Crawford,COL,25.0,13,7,285,25,55,0.455,0,6,0.0,25,49,0.51,0.455,35,51,0.686,27,35,62,22,10,6,27,30,85,2008
T. Crawford,ANA,25.0,24,16,737,74,163,0.454,3,10,0.3,71,153,0.464,0.463,113,158,0.715,76,94,170,48,31,2,45,84,264,2008
M. Cuffee,BAK,,29,26,989,118,267,0.442,11,35,0.314,107,232,0.461,0.463,82,105,0.781,53,123,176,65,25,2,58,101,329,2008
M. Cuffee,UTA,,17,1,396,65,137,0.474,9,26,0.346,56,111,0.505,0.507,30,39,0.769,23,26,49,21,7,1,22,53,169,2008
M. Cuffee,TOT,,46,27,1385,183,404,0.453,20,61,0.328,163,343,0.475,0.478,112,144,0.778,76,149,225,86,32,3,80,154,498,2008
J. Curry,IOW,22.0,13,8,509,101,218,0.463,20,53,0.377,81,165,0.491,0.509,41,57,0.719,5,36,41,71,14,6,41,38,263,2008
J. Davidson,SFL,23.0,6,4,187,43,90,0.478,0,2,0.0,43,88,0.489,0.478,22,30,0.733,14,45,59,5,8,6,11,20,108,2008
C. Davis,COL,,3,0,21,2,9,0.222,1,2,0.5,1,7,0.143,0.278,0,0,0.0,1,1,2,0,1,0,1,3,5,2008
K. Davis,RIO,25.0,9,0,148,18,33,0.545,0,4,0.0,18,29,0.621,0.545,9,18,0.5,15,33,48,3,7,13,8,32,45,2008
E. Dawson,AUS,23.0,5,0,30,4,6,0.667,0,0,0.0,4,6,0.667,0.667,0,2,0.0,3,5,8,3,1,3,2,4,8,2008
B. Dean,COL,28.0,10,0,175,18,45,0.4,14,26,0.538,4,19,0.211,0.556,6,9,0.667,6,11,17,5,6,2,13,12,56,2008
D. Dial,ANA,32.0,4,2,77,5,21,0.238,1,7,0.143,4,14,0.286,0.262,1,1,1.0,2,7,9,5,2,0,6,2,12,2008
D. Dial,TUL,32.0,4,2,108,21,45,0.467,7,17,0.412,14,28,0.5,0.544,8,10,0.8,6,15,21,6,5,1,6,11,57,2008
D. Dial,TOT,32.0,8,4,185,26,66,0.394,8,24,0.333,18,42,0.429,0.455,9,11,0.818,8,22,30,11,7,1,12,13,69,2008
G. Diaz,ANA,22.0,22,13,761,131,292,0.449,22,68,0.324,109,224,0.487,0.486,114,135,0.844,20,68,88,69,20,4,44,41,398,2008
K. Dickens,COL,29.0,38,36,1188,249,551,0.452,110,273,0.403,139,278,0.5,0.552,123,153,0.804,44,155,199,54,30,28,96,131,731,2008
M. Dorsey,TOT,26.0,18,9,393,51,120,0.425,2,13,0.154,49,107,0.458,0.433,25,36,0.694,14,21,35,48,8,1,34,35,129,2008
M. Dorsey,AUS,26.0,2,0,17,0,2,0.0,0,0,0.0,0,2,0.0,0.0,1,2,0.5,1,0,1,1,0,0,0,0,1,2008
M. Dorsey,ABQ,26.0,16,9,376,51,118,0.432,2,13,0.154,49,105,0.467,0.441,24,34,0.706,13,21,34,47,8,1,34,35,128,2008
R. Dupree,TUL,27.0,9,2,282,67,115,0.583,5,11,0.455,62,104,0.596,0.604,16,27,0.593,12,41,53,21,9,2,27,28,155,2008
R. Dyer,ABQ,,50,17,1028,134,313,0.428,23,85,0.271,111,228,0.487,0.465,30,56,0.536,84,156,240,25,40,41,31,115,321,2008
M. Efevberha,TOT,23.0,49,11,1280,259,608,0.426,47,153,0.307,212,455,0.466,0.465,165,205,0.805,47,147,194,102,65,22,92,146,730,2008
M. Efevberha,IOW,23.0,37,11,1005,201,462,0.435,40,125,0.32,161,337,0.478,0.478,118,150,0.787,37,119,156,76,46,14,74,116,560,2008
M. Efevberha,ANA,23.0,12,0,275,58,146,0.397,7,28,0.25,51,118,0.432,0.421,47,55,0.855,10,28,38,26,19,8,18,30,170,2008
C. Elliott,SFL,,50,23,1547,285,642,0.444,38,141,0.27,247,501,0.493,0.474,100,130,0.769,86,141,227,140,98,7,126,120,708,2008
C. Ellis,TUL,23.0,48,19,816,98,202,0.485,1,5,0.2,97,197,0.492,0.488,72,107,0.673,78,132,210,33,19,36,59,147,269,2008
J. Ellis,IDA,,37,10,588,80,153,0.523,0,1,0.0,80,152,0.526,0.523,39,47,0.83,102,87,189,23,20,11,23,80,199,2008
D. Farmer,RIO,26.0,33,27,1254,260,552,0.471,89,212,0.42,171,340,0.503,0.552,205,244,0.84,21,114,135,135,38,4,103,113,814,2008
N. Fazekas,TUL,22.0,28,20,857,224,405,0.553,3,17,0.176,221,388,0.57,0.557,85,110,0.773,80,197,277,48,26,23,66,62,536,2008
N. Felix,ANA,26.0,11,7,265,33,69,0.478,0,2,0.0,33,67,0.493,0.478,17,22,0.773,15,28,43,13,8,13,34,39,83,2008
K. Fesenko,UTA,21.0,37,23,949,146,291,0.502,0,4,0.0,146,287,0.509,0.502,80,131,0.611,100,184,284,69,16,71,97,140,372,2008
P. Fields,AUS,,1,0,7,0,1,0.0,0,0,0.0,0,1,0.0,0.0,0,2,0.0,0,0,0,0,2,0,0,1,0,2008
J. Fontenet,TUL,25.0,44,19,1100,147,314,0.468,33,75,0.44,114,239,0.477,0.521,74,89,0.831,10,91,101,191,37,0,80,73,401,2008
W. Frisby,DAK,26.0,50,3,883,155,295,0.525,0,1,0.0,155,294,0.527,0.525,90,122,0.738,88,152,240,42,22,26,72,145,400,2008
A. Fuqua,AUS,24.0,39,4,523,46,75,0.613,0,1,0.0,46,74,0.622,0.613,30,44,0.682,57,61,118,17,7,23,34,86,122,2008
C. Gadson,TOT,27.0,42,19,1237,189,386,0.49,21,58,0.362,168,328,0.512,0.517,96,113,0.85,18,93,111,221,36,2,98,96,495,2008
C. Gadson,AUS,27.0,34,19,1016,139,297,0.468,15,43,0.349,124,254,0.488,0.493,75,87,0.862,15,74,89,192,25,2,83,83,368,2008
C. Gadson,ABQ,27.0,8,0,221,50,89,0.562,6,15,0.4,44,74,0.595,0.596,21,26,0.808,3,19,22,29,11,0,15,13,127,2008
M. Gansey,ANA,,19,0,187,20,54,0.37,5,27,0.185,15,27,0.556,0.417,9,13,0.692,2,17,19,9,5,1,4,14,54,2008
K. Gayden,IOW,,3,0,12,1,4,0.25,0,0,0.0,1,4,0.25,0.25,0,0,0.0,0,0,0,1,0,0,1,0,2,2008
M. Gelabale,IDA,24.0,6,1,193,43,72,0.597,7,20,0.35,36,52,0.692,0.646,14,18,0.778,8,18,26,14,6,4,6,11,107,2008
N. Gerwig,FOR,,40,15,698,58,119,0.487,0,2,0.0,58,117,0.496,0.487,27,55,0.491,88,147,235,24,13,7,43,114,143,2008
E. Gill,COL,29.0,37,36,1418,184,447,0.412,58,157,0.369,126,290,0.434,0.477,239,278,0.86,26,163,189,313,82,14,130,106,665,2008
T. Gipson,DAK,,21,15,681,102,220,0.464,10,42,0.238,92,178,0.517,0.486,56,66,0.848,23,35,58,88,27,3,74,50,270,2008
H. Good,FOR,,2,0,3,0,0,0.0,0,0,0.0,0,0,0.0,0.0,0,0,0.0,0,0,0,0,0,0,0,1,0,2008
M. Gortat,ANA,23.0,5,4,139,21,43,0.488,0,0,0.0,21,43,0.488,0.488,7,10,0.7,6,28,34,6,3,3,7,24,49,2008
B. Greene,COL,,23,7,606,94,213,0.441,33,99,0.333,61,114,0.535,0.519,40,48,0.833,26,88,114,27,20,11,43,69,261,2008
D. Green,LOS,25.0,24,24,837,153,313,0.489,20,60,0.333,133,253,0.526,0.521,68,86,0.791,38,115,153,101,28,14,69,60,394,2008
T. Green,TOT,21.0,8,5,266,42,99,0.424,18,37,0.486,24,62,0.387,0.515,36,41,0.878,3,34,37,55,14,3,26,12,138,2008
T. Green,IDA,21.0,4,4,150,22,56,0.393,9,18,0.5,13,38,0.342,0.473,24,28,0.857,3,18,21,39,8,2,16,9,77,2008
T. Green,COL,21.0,4,1,116,20,43,0.465,9,19,0.474,11,24,0.458,0.57,12,13,0.923,0,16,16,16,6,1,10,3,61,2008
R. Griffin,FOR,,9,1,129,29,59,0.492,14,27,0.519,15,32,0.469,0.61,1,2,0.5,8,5,13,7,8,0,3,16,73,2008
J. Gross,ABQ,24.0,33,22,1077,190,398,0.477,37,94,0.394,153,304,0.503,0.524,125,152,0.822,53,123,176,44,25,11,70,75,542,2008
J. Gross,TOT,24.0,45,25,1369,238,497,0.479,46,128,0.359,192,369,0.52,0.525,139,171,0.813,65,156,221,54,32,17,85,104,661,2008
J. Gross,IOW,24.0,4,1,87,12,31,0.387,1,11,0.091,11,20,0.55,0.403,4,6,0.667,3,12,15,3,4,1,3,11,29,2008
J. Gross,AUS,24.0,8,2,205,36,68,0.529,8,23,0.348,28,45,0.622,0.588,10,13,0.769,9,21,30,7,3,5,12,18,90,2008
J. Hagen,IOW,25.0,15,4,250,29,64,0.453,0,0,0.0,29,64,0.453,0.453,23,27,0.852,33,38,71,17,9,19,23,45,81,2008
M. Hall,TUL,23.0,48,40,1792,266,633,0.42,73,210,0.348,193,423,0.456,0.478,172,202,0.851,130,225,355,140,53,17,78,95,777,2008
A. Haluska,IOW,,11,11,424,69,165,0.418,17,56,0.304,52,109,0.477,0.47,51,58,0.879,17,35,52,32,9,0,22,23,206,2008
D. Ham,TOT,34.0,47,33,1472,197,369,0.534,0,1,0.0,197,368,0.535,0.534,82,160,0.513,74,184,258,77,41,33,90,183,476,2008
D. Ham,AUS,34.0,4,4,122,18,32,0.563,0,0,0.0,18,32,0.563,0.563,5,6,0.833,2,15,17,7,1,1,4,18,41,2008
D. Ham,ABQ,34.0,43,29,1350,179,337,0.531,0,1,0.0,179,336,0.533,0.531,77,154,0.5,72,169,241,70,40,32,86,165,435,2008
B. Hamilton,UTA,,49,31,1525,198,372,0.532,0,3,0.0,198,369,0.537,0.532,132,208,0.635,98,178,276,114,115,32,114,174,528,2008
A. Harrington,TUL,27.0,41,32,1305,234,527,0.444,80,186,0.43,154,341,0.452,0.52,108,134,0.806,19,94,113,132,42,8,72,99,656,2008
J. Harris,TOT,,46,0,790,113,249,0.454,21,59,0.356,92,190,0.484,0.496,51,57,0.895,10,59,69,78,16,8,50,55,298,2008
J. Harris,IOW,,21,0,329,44,109,0.404,8,28,0.286,36,81,0.444,0.44,21,24,0.875,5,22,27,30,5,3,20,20,117,2008
J. Harris,BAK,,25,0,461,69,140,0.493,13,31,0.419,56,109,0.514,0.539,30,33,0.909,5,37,42,48,11,5,30,35,181,2008
G. Hill-Thomas,UTA,,18,1,196,22,38,0.579,0,0,0.0,22,38,0.579,0.579,23,37,0.622,11,16,27,13,10,1,11,20,67,2008
J. Hodge,ABQ,24.0,16,15,607,152,253,0.601,0,2,0.0,152,251,0.606,0.601,77,111,0.694,66,66,132,95,17,6,50,51,381,2008
J. Horner,IOW,,50,39,1969,196,503,0.39,90,266,0.338,106,237,0.447,0.479,94,118,0.797,38,185,223,315,99,15,112,92,576,2008
D. Horton,ABQ,23.0,26,16,827,141,293,0.481,50,106,0.472,91,187,0.487,0.567,71,90,0.789,14,66,80,116,33,9,52,64,403,2008
R. Howard,FOR,,47,37,1346,199,382,0.521,1,7,0.143,198,375,0.528,0.522,126,158,0.797,30,108,138,84,61,4,85,137,525,2008
Q. Humphrey,RIO,,49,31,1395,140,333,0.42,40,118,0.339,100,215,0.465,0.48,51,60,0.85,74,164,238,95,33,5,66,86,371,2008
A. Ingram,UTA,22.0,50,2,754,117,237,0.494,47,105,0.448,70,132,0.53,0.593,23,29,0.793,23,63,86,53,23,2,33,57,304,2008
E. Ingram,ABQ,,14,3,275,31,72,0.431,9,16,0.563,22,56,0.393,0.493,15,22,0.682,4,27,31,41,8,1,30,15,86,2008
B. Jackson,UTA,27.0,47,43,1385,149,337,0.442,0,1,0.0,149,336,0.443,0.442,152,183,0.831,89,214,303,142,33,50,110,192,450,2008
L. Jackson,IDA,26.0,19,11,505,81,198,0.409,25,66,0.379,56,132,0.424,0.472,66,79,0.835,17,53,70,61,21,3,37,25,253,2008
D. Jefferson,DAK,24.0,33,29,1284,177,414,0.428,37,114,0.325,140,300,0.467,0.472,170,218,0.78,23,132,155,166,66,10,94,102,561,2008
B. Johnsen,UTA,28.0,8,7,230,30,81,0.37,1,14,0.071,29,67,0.433,0.377,17,20,0.85,12,34,46,14,5,5,14,28,78,2008
C. Johnson,AUS,25.0,49,11,893,74,158,0.468,29,67,0.433,45,91,0.495,0.56,26,39,0.667,13,95,108,174,43,0,79,93,203,2008
D. Johnson,AUS,27.0,44,32,1564,256,576,0.444,109,278,0.392,147,298,0.493,0.539,134,161,0.832,25,177,202,80,60,27,123,121,755,2008
I. Johnson,TOT,23.0,45,20,1301,242,504,0.48,10,33,0.303,232,471,0.493,0.49,131,210,0.624,82,220,302,44,56,46,103,174,625,2008
I. Johnson,RIO,23.0,10,0,301,61,113,0.54,6,15,0.4,55,98,0.561,0.566,30,47,0.638,19,51,70,11,12,15,24,39,158,2008
I. Johnson,ANA,23.0,35,20,1000,181,391,0.463,4,18,0.222,177,373,0.475,0.468,101,163,0.62,63,169,232,33,44,31,79,135,467,2008
P. Johnson,DAK,,43,0,576,61,139,0.439,5,21,0.238,56,118,0.475,0.457,16,30,0.533,22,48,70,31,9,21,43,90,143,2008
T. Johnson,BAK,23.0,24,1,625,105,230,0.457,17,45,0.378,88,185,0.476,0.493,57,72,0.792,21,59,80,95,14,0,55,52,284,2008
M. Joiner,SFL,,50,30,1465,211,486,0.434,53,160,0.331,158,326,0.485,0.489,40,54,0.741,63,156,219,50,31,27,51,161,515,2008
B. Jones,SFL,24.0,5,2,140,24,53,0.453,2,9,0.222,22,44,0.5,0.472,12,15,0.8,10,18,28,12,3,5,14,22,62,2008
D. Jones,FOR,27.0,10,10,372,86,164,0.524,3,9,0.333,83,155,0.535,0.534,69,93,0.742,9,37,46,24,8,11,28,38,244,2008
D. Jones,TUL,,10,1,98,18,30,0.6,0,1,0.0,18,29,0.621,0.6,6,9,0.667,6,4,10,10,3,0,3,9,42,2008
C. Karl,LOS,24.0,17,17,638,94,209,0.45,44,107,0.411,50,102,0.49,0.555,65,78,0.833,13,80,93,72,18,6,48,48,297,2008
J. Kelly,TUL,25.0,47,20,1278,132,315,0.419,17,72,0.236,115,243,0.473,0.446,62,92,0.674,34,105,139,175,58,13,94,175,343,2008
J. Klotz,SFL,,33,22,580,76,157,0.484,0,2,0.0,76,155,0.49,0.484,33,45,0.733,58,79,137,13,11,28,39,132,185,2008
K. Kruger,UTA,,49,45,1870,196,451,0.435,93,240,0.388,103,211,0.488,0.538,169,192,0.88,12,121,133,348,60,7,139,89,654,2008
A. Kyle,FOR,,26,0,335,36,79,0.456,7,20,0.35,29,59,0.492,0.5,12,19,0.632,10,33,43,82,20,0,32,28,91,2008
K. Langford,AUS,24.0,25,19,1025,222,425,0.522,45,113,0.398,177,312,0.567,0.575,125,176,0.71,28,115,143,94,40,7,52,62,614,2008
J. Lang,UTA,24.0,48,23,1073,248,439,0.565,0,0,0.0,248,439,0.565,0.565,100,140,0.714,103,231,334,56,16,47,95,186,596,2008
K. Lang,AUS,28.0,9,4,270,46,84,0.548,0,0,0.0,46,84,0.548,0.548,24,38,0.632,15,42,57,14,3,9,26,32,116,2008
S. Lasme,LOS,25.0,37,14,1070,139,268,0.519,0,0,0.0,139,268,0.519,0.519,113,149,0.758,118,158,276,48,38,97,64,106,391,2008
N. Lewis,TOT,24.0,49,27,1282,214,448,0.478,25,84,0.298,189,364,0.519,0.506,118,149,0.792,98,203,301,56,17,30,90,113,571,2008
N. Lewis,IOW,24.0,24,6,449,87,178,0.489,8,28,0.286,79,150,0.527,0.511,40,50,0.8,43,48,91,15,4,8,32,36,222,2008
N. Lewis,BAK,24.0,25,21,833,127,270,0.47,17,56,0.304,110,214,0.514,0.502,78,99,0.788,55,155,210,41,13,22,58,77,349,2008
R. Livingston,IDA,32.0,43,39,1743,232,528,0.439,80,229,0.349,152,299,0.508,0.515,165,185,0.892,25,155,180,451,57,10,180,126,709,2008
D. Lolar,COL,,41,0,582,85,202,0.421,17,64,0.266,68,138,0.493,0.463,54,86,0.628,30,67,97,56,24,3,56,45,241,2008
K. Lyde,DAK,27.0,44,39,1380,232,455,0.51,1,1,1.0,231,454,0.509,0.511,77,137,0.562,114,228,342,87,28,83,74,167,542,2008
I. Mahinmi,AUS,21.0,46,40,1360,276,449,0.615,0,0,0.0,276,449,0.615,0.615,219,286,0.766,118,249,367,62,66,78,123,192,771,2008
J. Manuel,IOW,24.0,30,12,768,128,271,0.472,4,21,0.19,124,250,0.496,0.48,60,91,0.659,23,80,103,53,36,10,53,90,320,2008
J. Mathis,SFL,,46,7,647,70,160,0.438,0,0,0.0,70,160,0.438,0.438,34,51,0.667,65,76,141,16,9,11,42,99,174,2008
J. McCoy,LOS,30.0,36,25,1090,174,253,0.688,0,1,0.0,174,252,0.69,0.688,55,108,0.509,75,208,283,118,27,74,92,105,403,2008
S. McFadgon,BAK,25.0,48,31,1621,299,651,0.459,9,43,0.209,290,608,0.477,0.466,162,187,0.866,58,119,177,98,28,4,87,84,769,2008
G. McGowan,TOT,,23,8,517,101,185,0.546,6,8,0.75,95,177,0.537,0.562,80,98,0.816,42,70,112,23,12,1,40,59,288,2008
G. McGowan,SFL,,5,0,118,29,44,0.659,5,5,1.0,24,39,0.615,0.716,15,20,0.75,11,15,26,4,4,0,11,19,78,2008
G. McGowan,TUL,,18,8,399,72,141,0.511,1,3,0.333,71,138,0.514,0.514,65,78,0.833,31,55,86,19,8,1,29,40,210,2008
B. McKenzie,ANA,24.0,8,0,38,9,13,0.692,0,0,0.0,9,13,0.692,0.692,2,2,1.0,5,4,9,0,1,1,6,7,20,2008
J. McRoberts,IDA,20.0,15,2,399,46,111,0.414,2,13,0.154,44,98,0.449,0.423,21,30,0.7,25,71,96,38,9,14,31,24,115,2008
S. Mejia,FOR,,12,12,481,98,206,0.476,6,24,0.25,92,182,0.505,0.49,51,76,0.671,44,64,108,32,16,6,38,25,253,2008
J. Merrill,RIO,,10,0,196,32,65,0.492,9,24,0.375,23,41,0.561,0.562,22,30,0.733,10,27,37,7,4,3,20,26,95,2008
S. Merritt,TUL,26.0,46,15,782,125,252,0.496,0,4,0.0,125,248,0.504,0.496,60,82,0.732,62,96,158,20,16,21,51,114,310,2008
A. Mills,ABQ,,39,15,994,111,272,0.408,28,90,0.311,83,182,0.456,0.46,48,72,0.667,24,68,92,143,48,1,62,81,298,2008
J. Millsap,UTA,,42,0,428,67,147,0.456,0,1,0.0,67,146,0.459,0.456,36,53,0.679,39,59,98,21,12,6,40,58,170,2008
O. Mims,BAK,,12,0,181,14,32,0.438,1,1,1.0,13,31,0.419,0.453,4,9,0.444,18,30,48,11,3,11,15,26,33,2008
C. Minnifield,FOR,,43,28,1421,264,574,0.46,11,30,0.367,253,544,0.465,0.47,167,225,0.742,58,187,245,55,31,35,110,143,706,2008
D. Mitchell,IOW,25.0,32,23,1144,211,451,0.468,15,44,0.341,196,407,0.482,0.484,192,296,0.649,55,145,200,98,49,11,137,98,629,2008
B. Morrison,LOS,,23,2,287,45,117,0.385,16,50,0.32,29,67,0.433,0.453,10,15,0.667,3,24,27,37,7,0,20,32,116,2008
G. Muoneke,RIO,29.0,12,9,478,103,217,0.475,15,36,0.417,88,181,0.486,0.509,91,121,0.752,30,36,66,34,8,8,38,37,312,2008
A. N'Diaye,LOS,,44,0,651,88,146,0.603,0,0,0.0,88,146,0.603,0.603,18,30,0.6,67,107,174,20,12,41,49,124,194,2008
E. Nesbitt,SFL,27.0,49,30,1594,259,665,0.389,118,310,0.381,141,355,0.397,0.478,120,155,0.774,37,119,156,177,84,5,110,135,756,2008
D. Nichols,IOW,23.0,14,13,523,103,246,0.419,22,66,0.333,81,180,0.45,0.463,42,54,0.778,13,46,59,40,16,14,42,44,270,2008
Y. Nicholson,AUS,,7,1,62,6,16,0.375,0,0,0.0,6,16,0.375,0.375,4,6,0.667,3,4,7,3,0,2,2,8,16,2008
D. Noel,TUL,23.0,17,13,674,138,263,0.525,46,94,0.489,92,169,0.544,0.612,32,60,0.533,20,82,102,66,25,14,43,50,354,2008
S. Novak,RIO,24.0,9,7,354,59,126,0.468,27,60,0.45,32,66,0.485,0.575,20,22,0.909,13,53,66,16,3,4,18,30,165,2008
P. O'Bryant,BAK,21.0,8,8,289,58,102,0.569,0,0,0.0,58,102,0.569,0.569,19,23,0.826,14,66,80,17,7,28,18,25,135,2008
L. Obrzut,TOT,,38,12,452,47,109,0.431,0,0,0.0,47,109,0.431,0.431,24,38,0.632,33,58,91,7,3,19,19,76,118,2008
L. Obrzut,FOR,,20,6,254,34,70,0.486,0,0,0.0,34,70,0.486,0.486,13,22,0.591,18,32,50,2,0,8,10,42,81,2008
L. Obrzut,BAK,,18,6,198,13,39,0.333,0,0,0.0,13,39,0.333,0.333,11,16,0.688,15,26,41,5,3,11,9,34,37,2008
E. Osmundson,COL,24.0,50,24,1234,151,350,0.431,64,173,0.37,87,177,0.492,0.523,67,95,0.705,15,81,96,114,21,7,66,138,433,2008
D. Palmer,DAK,26.0,38,13,850,106,260,0.408,41,117,0.35,65,143,0.455,0.487,38,42,0.905,18,102,120,55,14,11,42,82,291,2008
A. Patterson,DAK,24.0,2,0,23,4,9,0.444,0,0,0.0,4,9,0.444,0.444,4,4,1.0,6,4,10,1,1,1,2,3,12,2008
K. Paulino,AUS,,34,3,494,60,141,0.426,31,84,0.369,29,57,0.509,0.535,38,46,0.826,7,32,39,34,21,1,22,39,189,2008
M. Peeples,DAK,,2,0,16,2,5,0.4,0,0,0.0,2,5,0.4,0.4,0,0,0.0,1,3,4,0,1,0,2,3,4,2008
K. Perovic,BAK,22.0,21,11,490,75,150,0.5,0,2,0.0,75,148,0.507,0.5,47,63,0.746,42,107,149,8,7,33,46,71,197,2008
J. Peters,TOT,,51,35,1446,287,576,0.498,0,4,0.0,287,572,0.502,0.498,120,194,0.619,83,169,252,46,54,55,121,174,694,2008
J. Peters,FOR,,18,4,438,82,168,0.488,0,2,0.0,82,166,0.494,0.488,27,51,0.529,26,41,67,17,22,18,32,59,191,2008
J. Peters,BAK,,33,31,1008,205,408,0.502,0,2,0.0,205,406,0.505,0.502,93,143,0.65,57,128,185,29,32,37,89,115,503,2008
B. Petway,IDA,,45,24,1084,138,252,0.548,11,37,0.297,127,215,0.591,0.569,42,72,0.583,56,120,176,59,35,68,55,103,329,2008
K. Pittsnogle,TOT,,49,32,1313,221,517,0.427,112,293,0.382,109,224,0.487,0.536,77,89,0.865,35,213,248,70,26,16,96,180,631,2008
K. Pittsnogle,AUS,,16,9,305,38,103,0.369,24,70,0.343,14,33,0.424,0.485,14,18,0.778,8,35,43,13,6,2,28,46,114,2008
K. Pittsnogle,ABQ,,33,23,1008,183,414,0.442,88,223,0.395,95,191,0.497,0.548,63,71,0.887,27,178,205,57,20,14,68,134,517,2008
C. Powell,DAK,,48,43,1903,374,770,0.486,45,112,0.402,329,658,0.5,0.515,289,374,0.773,65,243,308,229,66,10,178,165,1082,2008
K. Powell,SFL,26.0,40,38,1541,345,679,0.508,54,131,0.412,291,548,0.531,0.548,144,207,0.696,53,187,240,119,55,26,93,131,888,2008
G. Pruitt,UTA,21.0,18,15,638,123,284,0.433,39,108,0.361,84,176,0.477,0.502,49,65,0.754,20,30,50,70,39,4,57,41,334,2008
J. Reed,BAK,26.0,15,15,599,113,266,0.425,6,21,0.286,107,245,0.437,0.436,72,92,0.783,37,70,107,56,13,7,39,44,304,2008
J. Reed,AUS,26.0,15,7,462,85,191,0.445,0,0,0.0,85,191,0.445,0.445,48,69,0.696,31,69,100,16,13,6,24,40,218,2008
J. Reed,TOT,26.0,30,22,1061,198,457,0.433,6,21,0.286,192,436,0.44,0.44,120,161,0.745,68,139,207,72,26,13,63,84,522,2008
D. Rice,IDA,,2,0,3,0,1,0.0,0,0,0.0,0,1,0.0,0.0,0,0,0.0,0,0,0,0,0,0,0,0,0,2008
L. Rice,UTA,,49,2,751,110,227,0.485,1,5,0.2,109,222,0.491,0.487,35,45,0.778,60,111,171,31,12,10,36,113,256,2008
C. Richard,SFL,23.0,6,2,170,26,57,0.456,0,0,0.0,26,57,0.456,0.456,9,23,0.391,25,44,69,4,4,5,12,25,61,2008
J. Richardson,FOR,23.0,12,10,467,113,253,0.447,20,52,0.385,93,201,0.463,0.486,58,68,0.853,16,57,73,19,14,5,38,32,304,2008
R. Riley,TOT,26.0,50,26,1272,172,362,0.475,2,5,0.4,170,357,0.476,0.478,148,201,0.736,125,208,333,30,16,30,105,162,494,2008
R. Riley,COL,26.0,32,16,816,122,251,0.486,2,4,0.5,120,247,0.486,0.49,87,120,0.725,80,141,221,18,10,23,61,97,333,2008
R. Riley,BAK,26.0,18,10,456,50,111,0.45,0,1,0.0,50,110,0.455,0.45,61,81,0.753,45,67,112,12,6,7,44,65,161,2008
A. Robinson,SFL,23.0,3,3,106,19,38,0.5,6,14,0.429,13,24,0.542,0.579,11,12,0.917,6,13,19,4,4,3,6,6,55,2008
F. Robinson,TUL,,6,0,28,2,9,0.222,0,1,0.0,2,8,0.25,0.222,3,3,1.0,1,7,8,0,1,0,1,3,7,2008
W. Russell,FOR,25.0,17,3,464,76,182,0.418,10,28,0.357,66,154,0.429,0.445,85,94,0.904,10,38,48,81,19,2,47,29,247,2008
C. Samb,FOR,23.0,20,19,508,89,179,0.497,0,0,0.0,89,179,0.497,0.497,29,39,0.744,36,100,136,13,12,75,30,65,207,2008
R. Sanchez,IDA,20.0,25,1,482,67,151,0.444,41,92,0.446,26,59,0.441,0.579,7,14,0.5,2,58,60,24,19,10,28,64,182,2008
S. Sanchez,RIO,,16,1,181,19,47,0.404,8,25,0.32,11,22,0.5,0.489,4,6,0.667,2,4,6,17,2,1,10,20,50,2008
A. Sawadogo,UTA,,8,0,40,4,6,0.667,0,0,0.0,4,6,0.667,0.667,2,3,0.667,3,7,10,0,0,2,2,8,10,2008
A. Sawadogo,TOT,,19,0,86,8,11,0.727,0,0,0.0,8,11,0.727,0.727,3,6,0.5,7,17,24,0,1,6,2,16,19,2008
A. Sawadogo,IOW,,11,0,46,4,5,0.8,0,0,0.0,4,5,0.8,0.8,1,3,0.333,4,10,14,0,1,4,0,8,9,2008
E. Scott,IDA,,40,10,902,113,274,0.412,56,162,0.346,57,112,0.509,0.515,36,49,0.735,34,104,138,45,25,14,58,76,318,2008
M. Sene,IDA,21.0,27,4,761,131,244,0.537,0,0,0.0,131,244,0.537,0.537,73,126,0.579,81,162,243,11,19,47,45,76,335,2008
J. Sensley,COL,,7,7,223,48,98,0.49,11,19,0.579,37,79,0.468,0.546,10,15,0.667,22,40,62,19,4,4,16,19,117,2008
R. Sessions,TUL,21.0,24,13,869,165,356,0.463,4,12,0.333,161,344,0.468,0.469,168,220,0.764,52,106,158,182,38,2,83,44,502,2008
C. Simmons,RIO,22.0,3,2,86,9,20,0.45,0,0,0.0,9,20,0.45,0.45,10,18,0.556,8,8,16,1,2,13,9,13,28,2008
C. Simmons,IOW,22.0,6,6,177,39,71,0.549,0,0,0.0,39,71,0.549,0.549,14,26,0.538,16,25,41,4,5,13,14,21,92,2008
C. Simmons,TOT,22.0,9,8,263,48,91,0.527,0,0,0.0,48,91,0.527,0.527,24,44,0.545,24,33,57,5,7,26,23,34,120,2008
C. Sims,IOW,24.0,15,2,333,94,146,0.644,0,1,0.0,94,145,0.648,0.644,45,64,0.703,44,54,98,13,6,13,31,42,233,2008
E. Smith,FOR,,47,7,859,133,260,0.512,4,15,0.267,129,245,0.527,0.519,55,91,0.604,63,79,142,26,15,25,51,102,325,2008
J. Smith,BAK,,3,0,25,2,6,0.333,1,3,0.333,1,3,0.333,0.417,2,2,1.0,1,4,5,0,0,0,1,3,7,2008
J. Smith,ABQ,,11,1,184,13,52,0.25,1,18,0.056,12,34,0.353,0.26,14,18,0.778,8,24,32,4,4,6,11,47,41,2008
J. Smith,TOT,,14,1,209,15,58,0.259,2,21,0.095,13,37,0.351,0.276,16,20,0.8,9,28,37,4,4,6,12,50,48,2008
J. Smith,RIO,,50,33,1296,190,407,0.467,1,2,0.5,189,405,0.467,0.468,75,109,0.688,128,227,355,21,15,32,83,163,456,2008
S. Smith,ANA,24.0,23,14,860,159,337,0.472,28,78,0.359,131,259,0.506,0.513,91,111,0.82,33,107,140,50,38,13,84,79,437,2008
D. Stevens,COL,,2,0,28,1,5,0.2,1,2,0.5,0,3,0.0,0.3,0,0,0.0,0,2,2,5,1,0,3,4,3,2008
L. Stewart,ANA,,8,0,33,4,11,0.364,0,0,0.0,4,11,0.364,0.364,5,7,0.714,0,2,2,0,0,0,1,3,13,2008
C. Stinson,UTA,24.0,8,2,244,36,82,0.439,3,8,0.375,33,74,0.446,0.457,9,11,0.818,10,25,35,38,6,2,26,21,84,2008
C. Stinson,TOT,24.0,22,7,612,82,206,0.398,9,32,0.281,73,174,0.42,0.42,41,48,0.854,16,56,72,81,18,3,41,47,214,2008
C. Stinson,IOW,24.0,7,5,244,36,92,0.391,4,17,0.235,32,75,0.427,0.413,17,19,0.895,4,18,22,24,9,0,11,11,93,2008
C. Stinson,AUS,24.0,7,0,124,10,32,0.313,2,7,0.286,8,25,0.32,0.344,15,18,0.833,2,13,15,19,3,1,4,15,37,2008
D. Strawberry,ABQ,22.0,5,4,206,56,106,0.528,13,30,0.433,43,76,0.566,0.59,33,45,0.733,7,12,19,16,10,3,24,20,158,2008
T. Strickland,RIO,23.0,47,29,1228,221,513,0.431,27,109,0.248,194,404,0.48,0.457,135,177,0.763,97,169,266,33,33,10,72,120,604,2008
K. Sweetwyne,UTA,,12,0,48,5,20,0.25,1,6,0.167,4,14,0.286,0.275,3,5,0.6,3,4,7,6,3,0,1,8,14,2008
Y. Tabuse,ANA,27.0,40,0,513,64,171,0.374,14,41,0.341,50,130,0.385,0.415,34,42,0.81,10,33,43,78,26,0,32,48,176,2008
C. Taft,RIO,22.0,8,0,107,13,25,0.52,0,0,0.0,13,25,0.52,0.52,6,10,0.6,7,13,20,3,2,2,4,10,32,2008
K. Taylor,RIO,,15,8,490,74,170,0.435,45,99,0.455,29,71,0.408,0.568,27,33,0.818,20,43,63,44,9,1,24,20,220,2008
M. Taylor,IDA,22.0,39,6,1085,204,423,0.482,47,139,0.338,157,284,0.553,0.538,111,157,0.707,37,99,136,168,49,9,134,93,566,2008
B. Thomas,COL,32.0,37,37,1386,208,466,0.446,95,239,0.397,113,227,0.498,0.548,87,105,0.829,27,100,127,142,82,8,61,86,598,2008
D. Thomas,IOW,,50,34,1346,218,431,0.506,0,2,0.0,218,429,0.508,0.506,88,130,0.677,120,191,311,52,39,36,77,127,524,2008
J. Thomas,TOT,27.0,46,12,1057,162,352,0.46,33,121,0.273,129,231,0.558,0.507,86,124,0.694,47,108,155,76,54,20,61,65,443,2008
J. Thomas,ANA,27.0,22,0,424,63,145,0.434,18,64,0.281,45,81,0.556,0.497,40,57,0.702,18,29,47,31,28,6,23,26,184,2008
J. Thomas,ABQ,27.0,24,12,633,99,207,0.478,15,57,0.263,84,150,0.56,0.514,46,67,0.687,29,79,108,45,26,14,38,39,259,2008
J. Thomas,COL,32.0,16,14,508,84,144,0.583,0,1,0.0,84,143,0.587,0.583,37,60,0.617,49,80,129,20,16,10,32,58,205,2008
A. Tolliver,IOW,22.0,25,11,685,112,220,0.509,18,50,0.36,94,170,0.553,0.55,49,73,0.671,58,101,159,23,22,27,35,98,291,2008
K. Trim,DAK,,36,0,277,37,73,0.507,0,0,0.0,37,73,0.507,0.507,20,36,0.556,18,34,52,6,5,6,16,46,94,2008
A. Tucker,ABQ,23.0,21,18,808,223,420,0.531,35,88,0.398,188,332,0.566,0.573,101,120,0.842,61,64,125,34,30,1,38,30,582,2008
L. Turner,FOR,,47,28,1058,149,303,0.492,0,0,0.0,149,303,0.492,0.492,68,124,0.548,117,188,305,16,17,53,84,206,366,2008
E. Ugboaja,ABQ,,14,4,156,21,47,0.447,0,1,0.0,21,46,0.457,0.447,2,6,0.333,14,25,39,3,4,3,9,32,44,2008
E. Ugboaja,TOT,,45,5,657,97,201,0.483,0,1,0.0,97,200,0.485,0.483,25,46,0.543,86,138,224,12,21,10,39,108,219,2008
E. Ugboaja,ANA,,31,1,501,76,154,0.494,0,0,0.0,76,154,0.494,0.494,23,40,0.575,72,113,185,9,17,7,30,76,175,2008
A. Ugrinoski,UTA,,18,0,150,16,48,0.333,1,5,0.2,15,43,0.349,0.344,6,7,0.857,3,4,7,29,5,0,21,13,39,2008
C. Underwood,ABQ,,36,10,571,87,207,0.42,1,3,0.333,86,204,0.422,0.423,41,62,0.661,28,76,104,20,17,22,28,91,216,2008
F. Vay,IOW,,42,2,480,54,123,0.439,24,54,0.444,30,69,0.435,0.537,21,23,0.913,21,39,60,31,14,7,28,42,153,2008
C. Violette,IDA,,50,40,1443,259,508,0.51,3,12,0.25,256,496,0.516,0.513,150,208,0.721,129,224,353,92,51,36,104,135,671,2008
B. Wallace,TOT,,31,14,934,109,244,0.447,4,24,0.167,105,220,0.477,0.455,37,59,0.627,70,135,205,83,35,66,46,77,259,2008
B. Wallace,LOS,,22,10,648,72,161,0.447,3,16,0.188,69,145,0.476,0.457,27,44,0.614,46,95,141,65,19,54,30,58,174,2008
B. Wallace,IOW,,3,0,50,5,13,0.385,0,0,0.0,5,13,0.385,0.385,0,0,0.0,4,5,9,2,3,5,3,7,10,2008
B. Wallace,UTA,,6,4,236,32,70,0.457,1,8,0.125,31,62,0.5,0.464,10,15,0.667,20,35,55,16,13,7,13,12,75,2008
A. Washington,IDA,,2,0,21,3,7,0.429,0,0,0.0,3,7,0.429,0.429,0,0,0.0,1,1,2,1,0,2,1,3,6,2008
D. Washington,AUS,22.0,6,5,226,52,110,0.473,9,23,0.391,43,87,0.494,0.514,37,49,0.755,16,32,48,31,10,1,34,20,150,2008
D. Watkins,LOS,23.0,18,16,356,35,72,0.486,0,0,0.0,35,72,0.486,0.486,19,27,0.704,37,66,103,13,12,22,19,51,89,2008
D. Watkins,IOW,23.0,22,10,447,77,142,0.542,0,0,0.0,77,142,0.542,0.542,34,54,0.63,48,81,129,17,15,16,37,68,188,2008
D. Watkins,TOT,23.0,40,26,803,112,214,0.523,0,0,0.0,112,214,0.523,0.523,53,81,0.654,85,147,232,30,27,38,56,119,277,2008
C. Watson,RIO,23.0,16,12,607,127,252,0.504,18,45,0.4,109,207,0.527,0.54,148,166,0.892,19,68,87,92,29,3,56,53,420,2008
M. Webb,ANA,,26,11,472,28,73,0.384,13,37,0.351,15,36,0.417,0.473,14,19,0.737,11,18,29,20,15,0,13,39,83,2008
B. Wethers,BAK,,2,0,43,7,19,0.368,3,8,0.375,4,11,0.364,0.447,2,2,1.0,1,5,6,1,1,0,3,4,19,2008
R. Whaley,LOS,25.0,21,9,271,43,93,0.462,0,0,0.0,43,93,0.462,0.462,3,7,0.429,18,42,60,14,7,7,20,59,89,2008
D. White,TOT,26.0,35,12,922,114,244,0.467,12,37,0.324,102,207,0.493,0.492,137,171,0.801,19,82,101,120,47,7,70,76,377,2008
D. White,COL,26.0,10,0,234,25,57,0.439,2,7,0.286,23,50,0.46,0.456,35,49,0.714,8,22,30,30,14,3,18,21,87,2008
D. White,ANA,26.0,25,12,688,89,187,0.476,10,30,0.333,79,157,0.503,0.503,102,122,0.836,11,60,71,90,33,4,52,55,290,2008
L. White,COL,,18,1,316,45,82,0.549,9,16,0.563,36,66,0.545,0.604,47,54,0.87,11,30,41,49,11,10,29,48,146,2008
L. Whitehead,IOW,26.0,10,0,132,13,44,0.295,0,0,0.0,13,44,0.295,0.295,22,32,0.688,8,21,29,9,3,1,6,19,48,2008
M. White,LOS,,1,0,14,0,2,0.0,0,0,0.0,0,2,0.0,0.0,0,0,0.0,0,3,3,0,1,0,1,2,0,2008
Q. White,RIO,27.0,43,26,1116,87,202,0.431,9,33,0.273,78,169,0.462,0.453,35,56,0.625,43,84,127,170,37,5,73,128,218,2008
W. White,LOS,,40,28,1122,209,403,0.519,2,12,0.167,207,391,0.529,0.521,52,80,0.65,83,130,213,62,46,9,65,110,472,2008
A. Wilkins,BAK,27.0,41,7,876,99,242,0.409,35,98,0.357,64,144,0.444,0.481,46,63,0.73,18,88,106,36,16,1,41,47,279,2008
D. Williams,BAK,,18,0,78,14,31,0.452,1,7,0.143,13,24,0.542,0.468,9,16,0.563,11,10,21,3,3,0,4,9,38,2008
G. Williams,BAK,27.0,27,5,374,20,47,0.426,0,0,0.0,20,47,0.426,0.426,15,18,0.833,6,43,49,7,7,6,15,55,55,2008
M. Williams,AUS,21.0,36,20,1259,272,522,0.521,30,86,0.349,242,436,0.555,0.55,118,145,0.814,61,190,251,112,53,26,100,91,692,2008
R. Wilmont,FOR,,50,9,1409,207,563,0.368,73,248,0.294,134,315,0.425,0.433,99,135,0.733,30,116,146,39,49,7,51,82,586,2008
C. Winder,RIO,,42,1,762,122,316,0.386,50,141,0.355,72,175,0.411,0.465,43,64,0.672,30,72,102,56,27,9,41,110,337,2008
M. Ager,FTW,22.0,9,4,273,42,103,0.408,10,31,0.323,32,72,0.444,0.456,32,44,0.727,2,23,25,27,4,1,31,24,126,2007
D. Akindele,FTW,23.0,48,15,1012,140,274,0.511,0,1,0.0,140,273,0.513,0.511,116,173,0.671,119,206,325,28,20,62,69,161,396,2007
A. Akingbala,LOS,23.0,14,7,311,42,84,0.5,0,0,0.0,42,84,0.5,0.5,23,36,0.639,27,68,95,16,8,20,31,36,107,2007
M. Allen,ARK,27.0,28,3,709,99,217,0.456,21,64,0.328,78,153,0.51,0.505,84,108,0.778,18,34,52,97,39,4,99,75,303,2007
L. Allred,IDA,25.0,43,16,899,155,296,0.524,0,1,0.0,155,295,0.525,0.524,123,154,0.799,79,164,243,24,16,9,48,100,433,2007
M. Al-Sayyad,TUL,24.0,13,5,253,40,70,0.571,0,0,0.0,40,70,0.571,0.571,27,50,0.54,24,34,58,4,6,10,25,45,107,2007
L. Amundson,COL,24.0,25,25,631,117,208,0.563,0,2,0.0,117,206,0.568,0.563,43,88,0.489,82,107,189,18,19,62,39,79,277,2007
A. Anagonye,LOS,25.0,24,23,670,92,217,0.424,0,3,0.0,92,214,0.43,0.424,60,83,0.723,61,75,136,33,28,13,43,81,244,2007
A. Anderson,TUL,24.0,26,8,748,152,279,0.545,19,42,0.452,133,237,0.561,0.579,87,100,0.87,47,53,100,69,26,0,80,77,410,2007
M. Andriuskevicius,DAK,20.0,3,0,56,7,17,0.412,0,0,0.0,7,17,0.412,0.412,1,1,1.0,3,4,7,2,0,3,4,5,15,2007
B. Armstrong,TOT,26.0,24,0,443,73,175,0.417,14,43,0.326,59,132,0.447,0.457,19,25,0.76,8,28,36,27,9,3,22,42,179,2007
B. Armstrong,DAK,26.0,14,0,289,52,119,0.437,11,31,0.355,41,88,0.466,0.483,8,11,0.727,6,18,24,20,4,1,13,29,123,2007
B. Armstrong,BAK,26.0,7,0,127,18,44,0.409,1,8,0.125,17,36,0.472,0.42,10,12,0.833,0,10,10,7,5,2,8,11,47,2007
B. Armstrong,ANA,26.0,3,0,27,3,12,0.25,2,4,0.5,1,8,0.125,0.333,1,2,0.5,2,0,2,0,0,0,1,2,9,2007
J. Augustine,ANA,22.0,8,4,218,36,53,0.679,0,0,0.0,36,53,0.679,0.679,9,11,0.818,25,46,71,7,8,6,11,24,81,2007
K. Azubuike,FTW,23.0,12,12,503,113,220,0.514,32,66,0.485,81,154,0.526,0.586,54,68,0.794,9,51,60,38,14,7,32,26,312,2007
M. Baker,DAK,27.0,49,46,1379,139,354,0.393,42,125,0.336,97,229,0.424,0.452,66,77,0.857,48,158,206,222,46,3,96,127,386,2007
S. Banks,LOS,22.0,33,29,992,193,440,0.439,41,132,0.311,152,308,0.494,0.485,183,220,0.832,46,94,140,100,22,16,113,77,610,2007
S. Banks,ANA,22.0,4,0,59,9,22,0.409,0,5,0.0,9,17,0.529,0.409,14,18,0.778,5,8,13,5,1,1,9,5,32,2007
S. Banks,TOT,22.0,37,29,1051,202,462,0.437,41,137,0.299,161,325,0.495,0.482,197,238,0.828,51,102,153,105,23,17,122,82,642,2007
S. Barber,ABQ,27.0,28,0,331,53,136,0.39,14,38,0.368,39,98,0.398,0.441,36,41,0.878,4,21,25,30,8,0,28,36,156,2007
J. Barea,FTW,22.0,8,6,293,79,151,0.523,21,48,0.438,58,103,0.563,0.593,39,50,0.78,10,30,40,62,10,0,25,15,218,2007
T. Barnes,IDA,,42,2,721,51,142,0.359,20,53,0.377,31,89,0.348,0.43,23,24,0.958,12,51,63,94,36,2,38,60,145,2007
T. Barnes,BAK,,6,5,127,11,22,0.5,4,6,0.667,7,16,0.438,0.591,2,2,1.0,1,13,14,15,3,0,9,8,28,2007
T. Barnes,TOT,,48,7,848,62,164,0.378,24,59,0.407,38,105,0.362,0.451,25,26,0.962,13,64,77,109,39,2,47,68,173,2007
J. Beasley,DAK,26.0,18,7,384,63,142,0.444,0,3,0.0,63,139,0.453,0.444,36,63,0.571,15,65,80,13,9,4,33,48,162,2007
C. Bell,IDA,24.0,11,1,155,9,23,0.391,0,0,0.0,9,23,0.391,0.391,8,15,0.533,7,19,26,3,2,5,6,18,26,2007
C. Bell,COL,24.0,1,0,12,0,1,0.0,0,0,0.0,0,1,0.0,0.0,1,2,0.5,1,1,2,0,1,0,0,4,1,2007
C. Bell,ARK,24.0,12,0,63,7,13,0.538,0,0,0.0,7,13,0.538,0.538,5,7,0.714,5,7,12,2,1,1,8,21,19,2007
C. Bell,TOT,24.0,36,1,300,21,50,0.42,0,0,0.0,21,50,0.42,0.42,18,33,0.545,19,36,55,5,4,9,21,59,60,2007
C. Bell,SFL,24.0,12,0,70,5,13,0.385,0,0,0.0,5,13,0.385,0.385,4,9,0.444,6,9,15,0,0,3,7,16,14,2007
T. Bell,AUS,26.0,32,16,1054,175,391,0.448,42,107,0.393,133,284,0.468,0.501,121,141,0.858,43,105,148,110,49,17,80,67,513,2007
T. Bell,ABQ,26.0,11,1,208,36,85,0.424,4,14,0.286,32,71,0.451,0.447,42,45,0.933,11,30,41,27,4,6,26,32,118,2007
T. Bell,TOT,26.0,43,17,1262,211,476,0.443,46,121,0.38,165,355,0.465,0.492,163,186,0.876,54,135,189,137,53,23,106,99,631,2007
R. Benson,TOT,22.0,49,1,1002,165,328,0.503,0,0,0.0,165,328,0.503,0.503,75,114,0.658,133,180,313,33,28,40,47,135,405,2007
R. Benson,DAK,22.0,36,1,872,152,297,0.512,0,0,0.0,152,297,0.512,0.512,70,99,0.707,124,170,294,31,23,35,39,114,374,2007
R. Benson,AUS,22.0,13,0,130,13,31,0.419,0,0,0.0,13,31,0.419,0.419,5,15,0.333,9,10,19,2,5,5,8,21,31,2007
J. Blackburn,IDA,,36,20,829,114,216,0.528,12,46,0.261,102,170,0.6,0.556,35,51,0.686,24,82,106,64,34,10,55,69,275,2007
W. Blalock,SFL,23.0,12,1,316,39,105,0.371,5,17,0.294,34,88,0.386,0.395,24,30,0.8,11,40,51,76,6,1,26,17,107,2007
T. Bland,ABQ,27.0,42,40,1524,208,461,0.451,24,67,0.358,184,394,0.467,0.477,130,155,0.839,39,120,159,222,28,9,83,98,570,2007
T. Bobbitt,COL,27.0,18,2,415,86,215,0.4,29,92,0.315,57,123,0.463,0.467,12,19,0.632,7,26,33,46,29,6,20,40,213,2007
T. Bobbitt,BAK,27.0,18,5,488,105,226,0.465,25,62,0.403,80,164,0.488,0.52,38,46,0.826,4,44,48,40,33,8,30,59,273,2007
T. Bobbitt,TOT,27.0,36,7,903,191,441,0.433,54,154,0.351,137,287,0.477,0.494,50,65,0.769,11,70,81,86,62,14,50,99,486,2007
D. Bowden,ARK,26.0,3,0,37,2,7,0.286,0,1,0.0,2,6,0.333,0.286,2,5,0.4,1,2,3,17,4,0,7,8,6,2007
J. Bowen,AUS,23.0,44,14,869,170,321,0.53,13,37,0.351,157,284,0.553,0.55,52,78,0.667,81,105,186,32,34,18,51,78,405,2007
B. Bowman,BAK,22.0,43,29,1242,196,398,0.492,18,45,0.4,178,353,0.504,0.515,80,138,0.58,86,158,244,85,44,19,90,94,490,2007
C. Bozeman,ABQ,23.0,14,13,570,74,178,0.416,16,46,0.348,58,132,0.439,0.461,50,61,0.82,18,77,95,141,36,1,54,46,214,2007
A. Brown,SFL,25.0,16,16,635,147,232,0.634,0,3,0.0,147,229,0.642,0.634,70,119,0.588,70,103,173,20,15,11,53,61,364,2007
D. Brown,SFL,27.0,25,25,829,136,293,0.464,13,48,0.271,123,245,0.502,0.486,92,124,0.742,56,118,174,50,22,30,68,68,377,2007
D. Brown,TUL,24.0,42,24,1351,309,667,0.463,33,76,0.434,276,591,0.467,0.488,131,168,0.78,78,150,228,76,44,8,94,76,782,2007
E. Brown,COL,23.0,50,50,1613,347,671,0.517,0,0,0.0,347,671,0.517,0.517,226,353,0.64,155,327,482,106,25,15,127,136,920,2007
S. Brown,ABQ,21.0,1,1,27,6,15,0.4,2,6,0.333,4,9,0.444,0.467,0,0,0.0,1,3,4,6,0,0,3,1,14,2007
B. Buckman,AUS,23.0,42,2,723,97,255,0.38,11,40,0.275,86,215,0.4,0.402,74,104,0.712,72,108,180,21,17,32,46,103,279,2007
K. Burleson,FTW,27.0,50,49,1461,186,473,0.393,109,262,0.416,77,211,0.365,0.508,127,154,0.825,30,146,176,207,51,8,98,169,608,2007
B. Camara,LOS,25.0,6,3,64,5,21,0.238,0,0,0.0,5,21,0.238,0.238,0,1,0.0,5,6,11,8,0,0,2,17,10,2007
M. Campbell,ARK,24.0,35,15,496,119,254,0.469,0,0,0.0,119,254,0.469,0.469,41,70,0.586,59,114,173,26,11,41,50,101,279,2007
M. Campbell,TOT,24.0,51,17,720,171,342,0.5,0,0,0.0,171,342,0.5,0.5,48,95,0.505,82,154,236,34,17,56,82,150,390,2007
M. Campbell,AUS,24.0,16,2,224,52,88,0.591,0,0,0.0,52,88,0.591,0.591,7,25,0.28,23,40,63,8,6,15,32,49,111,2007
M. Charlo,TOT,23.0,10,1,168,26,54,0.481,5,15,0.333,21,39,0.538,0.528,7,9,0.778,11,15,26,11,8,3,10,24,64,2007
M. Charlo,COL,23.0,4,0,57,8,20,0.4,1,6,0.167,7,14,0.5,0.425,2,3,0.667,5,6,11,6,3,1,5,7,19,2007
M. Charlo,ABQ,23.0,6,1,111,18,34,0.529,4,9,0.444,14,25,0.56,0.588,5,6,0.833,6,9,15,5,5,2,5,17,45,2007
B. Chase,LOS,25.0,46,45,1613,276,624,0.442,118,270,0.437,158,354,0.446,0.537,76,82,0.927,26,157,183,173,64,3,77,93,746,2007
K. Clack,AUS,29.0,43,23,1185,136,305,0.446,20,55,0.364,116,250,0.464,0.479,74,115,0.643,53,157,210,85,57,19,84,139,366,2007
M. Clark,ANA,23.0,48,8,634,75,161,0.466,2,10,0.2,73,151,0.483,0.472,40,49,0.816,28,53,81,18,8,5,51,40,192,2007
G. Clausen,ABQ,27.0,29,4,411,34,100,0.34,0,2,0.0,34,98,0.347,0.34,17,24,0.708,33,52,85,16,6,4,16,52,85,2007
G. Clausen,TOT,27.0,46,4,637,57,150,0.38,0,4,0.0,57,146,0.39,0.38,25,40,0.625,51,76,127,23,7,9,26,87,139,2007
G. Clausen,ANA,27.0,17,0,226,23,50,0.46,0,2,0.0,23,48,0.479,0.46,8,16,0.5,18,24,42,7,1,5,10,35,54,2007
M. Cleaves,BAK,29.0,22,15,691,129,251,0.514,20,47,0.426,109,204,0.534,0.554,86,110,0.782,6,50,56,197,23,2,61,56,364,2007
A. Coleman,BAK,24.0,49,9,1099,119,298,0.399,21,61,0.344,98,237,0.414,0.435,62,76,0.816,58,177,235,52,29,24,50,112,321,2007
B. Collins,BAK,22.0,7,0,123,9,27,0.333,0,5,0.0,9,22,0.409,0.333,18,28,0.643,5,9,14,17,2,1,9,11,36,2007
W. Conroy,TUL,24.0,42,41,1648,212,488,0.434,46,131,0.351,166,357,0.465,0.482,161,224,0.719,49,166,215,447,54,1,172,91,631,2007
C. Copeland,FTW,22.0,19,0,368,61,141,0.433,42,91,0.462,19,50,0.38,0.582,27,34,0.794,21,70,91,16,14,13,24,48,191,2007
T. Crawford,COL,24.0,47,19,936,100,203,0.493,1,14,0.071,99,189,0.524,0.495,82,105,0.781,76,128,204,74,36,17,55,114,283,2007
T. Cummings,ABQ,25.0,7,5,160,39,74,0.527,0,0,0.0,39,74,0.527,0.527,19,23,0.826,7,18,25,6,5,1,13,29,97,2007
T. Cummings,TOT,25.0,23,12,569,128,258,0.496,0,1,0.0,128,257,0.498,0.496,41,50,0.82,35,69,104,27,12,4,39,87,297,2007
T. Cummings,LOS,25.0,16,7,409,89,184,0.484,0,1,0.0,89,183,0.486,0.484,22,27,0.815,28,51,79,21,7,3,26,58,200,2007
J. Dabbert,SFL,25.0,16,0,209,35,72,0.486,0,0,0.0,35,72,0.486,0.486,25,32,0.781,14,31,45,3,9,17,13,42,95,2007
S. Daniels,BAK,27.0,29,11,567,64,109,0.587,0,0,0.0,64,109,0.587,0.587,17,24,0.708,46,66,112,36,18,11,17,54,145,2007
B. Dean,ARK,27.0,46,37,1558,175,403,0.434,44,134,0.328,131,269,0.487,0.489,77,107,0.72,32,120,152,216,80,20,89,157,471,2007
M. Dean,BAK,24.0,7,7,199,35,91,0.385,3,7,0.429,32,84,0.381,0.401,24,32,0.75,4,5,9,14,1,0,19,13,97,2007
N. Dixon,SFL,26.0,4,3,66,7,17,0.412,0,0,0.0,7,17,0.412,0.412,10,19,0.526,7,17,24,0,1,1,9,15,24,2007
S. Dockery,FTW,24.0,15,0,131,17,37,0.459,0,3,0.0,17,34,0.5,0.459,11,17,0.647,2,7,9,15,11,0,13,21,45,2007
M. Dorsey,ANA,25.0,50,35,1369,214,494,0.433,10,49,0.204,204,445,0.458,0.443,146,169,0.864,27,92,119,208,39,1,106,117,584,2007
M. Dos Santos,TUL,22.0,7,4,136,15,35,0.429,0,0,0.0,15,35,0.429,0.429,4,4,1.0,6,20,26,6,5,6,8,22,34,2007
M. Dos Santos,TOT,22.0,13,4,167,15,40,0.375,0,0,0.0,15,40,0.375,0.375,4,4,1.0,7,22,29,8,5,10,9,26,34,2007
M. Dos Santos,DAK,22.0,6,0,31,0,5,0.0,0,0,0.0,0,5,0.0,0.0,0,0,0.0,1,2,3,2,0,4,1,4,0,2007
M. Douthit,ABQ,26.0,11,11,413,70,147,0.476,0,0,0.0,70,147,0.476,0.476,41,61,0.672,27,66,93,26,15,17,44,41,181,2007
R. Dryden,BAK,28.0,4,0,61,7,15,0.467,0,0,0.0,7,15,0.467,0.467,1,2,0.5,4,7,11,4,0,6,5,12,15,2007
R. Dryden,TOT,28.0,6,0,92,11,24,0.458,0,0,0.0,11,24,0.458,0.458,1,2,0.5,5,16,21,6,2,7,8,16,23,2007
R. Dryden,LOS,28.0,2,0,31,4,9,0.444,0,0,0.0,4,9,0.444,0.444,0,0,0.0,1,9,10,2,2,1,3,4,8,2007
J. Dupree,ANA,25.0,11,0,162,23,46,0.5,0,0,0.0,23,46,0.5,0.5,1,6,0.167,14,22,36,3,4,6,8,22,47,2007
N. Ebi,FTW,22.0,20,15,475,114,253,0.451,1,8,0.125,113,245,0.461,0.453,28,38,0.737,51,65,116,15,19,28,36,64,257,2007
C. Edwards,BAK,,3,0,62,10,23,0.435,2,6,0.333,8,17,0.471,0.478,1,3,0.333,7,3,10,7,3,2,1,6,23,2007
C. Edwards,ANA,27.0,31,16,898,155,353,0.439,0,2,0.0,155,351,0.442,0.439,129,157,0.822,70,163,233,13,28,25,66,105,439,2007
J. Edwards,TUL,25.0,5,2,113,26,43,0.605,0,0,0.0,26,43,0.605,0.605,13,16,0.813,3,10,13,3,2,2,17,20,65,2007
J. Edwards,TOT,25.0,20,9,374,77,147,0.524,0,1,0.0,77,146,0.527,0.524,44,60,0.733,20,59,79,9,4,10,47,77,198,2007
J. Edwards,ABQ,25.0,15,7,261,51,104,0.49,0,1,0.0,51,103,0.495,0.49,31,44,0.705,17,49,66,6,2,8,30,57,133,2007
M. Efevberha,IDA,22.0,5,0,31,4,18,0.222,0,5,0.0,4,13,0.308,0.222,3,3,1.0,3,2,5,2,0,0,2,4,11,2007
B. Elder,AUS,24.0,45,45,1640,356,729,0.488,67,180,0.372,289,549,0.526,0.534,117,161,0.727,54,113,167,86,30,11,111,126,896,2007
C. Ellis,TUL,22.0,7,7,151,15,33,0.455,0,0,0.0,15,33,0.455,0.455,11,12,0.917,10,24,34,3,2,7,13,31,41,2007
A. Emmett,LOS,24.0,29,1,844,171,354,0.483,17,61,0.279,154,293,0.526,0.507,92,136,0.676,64,87,151,59,36,3,69,47,451,2007
D. Erwin,ABQ,24.0,37,30,1099,157,310,0.506,3,16,0.188,154,294,0.524,0.511,48,58,0.828,78,204,282,56,32,48,75,133,365,2007
D. Erwin,TOT,24.0,46,33,1237,165,339,0.487,5,23,0.217,160,316,0.506,0.494,57,71,0.803,86,230,316,62,38,61,90,154,392,2007
D. Erwin,LOS,24.0,9,3,138,8,29,0.276,2,7,0.286,6,22,0.273,0.31,9,13,0.692,8,26,34,6,6,13,15,21,27,2007
O. Famutimi,ARK,22.0,45,27,1148,197,418,0.471,4,18,0.222,193,400,0.483,0.476,124,149,0.832,70,172,242,78,52,32,80,121,522,2007
J. Farmar,LOS,20.0,3,2,95,14,36,0.389,2,12,0.167,12,24,0.5,0.417,14,14,1.0,1,7,8,17,5,1,5,4,44,2007
D. Farmer,TUL,25.0,32,20,1048,219,477,0.459,72,207,0.348,147,270,0.544,0.535,124,181,0.685,33,92,125,86,33,6,63,66,634,2007
J. Moupegnou,TUL,24.0,50,28,1150,128,327,0.391,62,170,0.365,66,157,0.42,0.486,64,83,0.771,60,163,223,67,59,10,54,124,382,2007
E. Fobbs,TOT,26.0,44,27,979,101,157,0.643,0,1,0.0,101,156,0.647,0.643,61,100,0.61,80,144,224,13,16,60,49,154,263,2007
E. Fobbs,SFL,26.0,24,20,660,72,109,0.661,0,1,0.0,72,108,0.667,0.661,41,66,0.621,56,95,151,9,15,42,32,96,185,2007
E. Fobbs,ABQ,26.0,20,7,319,29,48,0.604,0,0,0.0,29,48,0.604,0.604,20,34,0.588,24,49,73,4,1,18,17,58,78,2007
J. Fontenet,TUL,24.0,2,0,73,5,14,0.357,1,2,0.5,4,12,0.333,0.393,4,4,1.0,3,6,9,4,2,0,6,6,15,2007
T. Fowlkes,DAK,30.0,9,2,138,17,47,0.362,0,4,0.0,17,43,0.395,0.362,14,23,0.609,14,11,25,1,9,0,12,21,48,2007
A. Fuqua,AUS,23.0,50,44,1072,64,144,0.444,0,0,0.0,64,144,0.444,0.444,73,109,0.67,124,148,272,22,26,52,68,160,201,2007
C. Gadson,AUS,26.0,26,23,919,152,338,0.45,20,67,0.299,132,271,0.487,0.479,70,88,0.795,21,82,103,137,32,1,79,61,394,2007
C. Gadson,TUL,26.0,22,16,764,138,300,0.46,19,51,0.373,119,249,0.478,0.492,63,82,0.768,10,64,74,91,13,1,58,56,358,2007
C. Gadson,TOT,26.0,48,39,1683,290,638,0.455,39,118,0.331,251,520,0.483,0.485,133,170,0.782,31,146,177,228,45,2,137,117,752,2007
B. Gaye,IDA,25.0,12,1,138,22,44,0.5,0,1,0.0,22,43,0.512,0.5,8,18,0.444,18,33,51,5,2,7,16,28,52,2007
J. Gilchrist,LOS,22.0,10,0,152,14,42,0.333,2,10,0.2,12,32,0.375,0.357,6,8,0.75,3,12,15,12,9,0,12,6,36,2007
J. Gilchrist,IDA,22.0,3,0,44,6,11,0.545,1,5,0.2,5,6,0.833,0.591,3,5,0.6,0,4,4,7,5,0,8,4,16,2007
J. Gilchrist,TOT,22.0,13,0,196,20,53,0.377,3,15,0.2,17,38,0.447,0.406,9,13,0.692,3,16,19,19,14,0,20,10,52,2007
B. Gillespie,AUS,24.0,41,13,827,119,269,0.442,43,106,0.406,76,163,0.466,0.522,23,39,0.59,19,50,69,69,30,2,84,60,304,2007
A. Glyniadakis,ABQ,25.0,24,21,703,130,250,0.52,0,0,0.0,130,250,0.52,0.52,91,119,0.765,50,93,143,20,9,33,66,82,351,2007
S. Graham,SFL,24.0,32,31,1124,205,440,0.466,13,48,0.271,192,392,0.49,0.481,152,176,0.864,47,109,156,92,23,8,81,104,575,2007
J. Graves,IDA,25.0,31,28,770,159,276,0.576,0,0,0.0,159,276,0.576,0.576,95,130,0.731,79,171,250,33,19,26,77,112,413,2007
D. Green,LOS,24.0,13,13,509,78,184,0.424,16,39,0.41,62,145,0.428,0.467,82,98,0.837,13,49,62,54,21,12,52,37,254,2007
Q. Greer,DAK,25.0,49,42,1479,323,685,0.472,18,61,0.295,305,624,0.489,0.485,157,211,0.744,96,208,304,96,44,12,108,117,821,2007
V. Grier,SFL,23.0,17,16,638,120,234,0.513,4,10,0.4,116,224,0.518,0.521,88,126,0.698,31,69,100,64,22,3,42,50,332,2007
J. Gross,LOS,23.0,14,3,201,30,68,0.441,4,10,0.4,26,58,0.448,0.471,17,26,0.654,6,13,19,6,6,4,15,16,81,2007
D. Hadley,TOT,29.0,27,8,616,51,148,0.345,12,55,0.218,39,93,0.419,0.385,45,59,0.763,16,52,68,58,25,2,40,64,159,2007
D. Hadley,SFL,29.0,16,8,386,22,87,0.253,0,27,0.0,22,60,0.367,0.253,29,37,0.784,9,30,39,39,14,1,24,33,73,2007
D. Hadley,IDA,29.0,11,0,230,29,61,0.475,12,28,0.429,17,33,0.515,0.574,16,22,0.727,7,22,29,19,11,1,16,31,86,2007
M. Hall,TUL,22.0,32,28,1189,196,396,0.495,55,149,0.369,141,247,0.571,0.564,55,64,0.859,110,162,272,60,38,4,38,76,502,2007
G. Hamilton,LOS,22.0,9,8,217,17,44,0.386,0,0,0.0,17,44,0.386,0.386,8,12,0.667,19,28,47,18,14,5,18,39,42,2007
M. Harris,COL,23.0,48,16,1116,237,385,0.616,14,44,0.318,223,341,0.654,0.634,79,98,0.806,133,196,329,65,38,74,84,132,567,2007
M. Haryasz,ARK,22.0,30,27,865,121,239,0.506,0,0,0.0,121,239,0.506,0.506,77,99,0.778,60,154,214,23,9,41,64,103,319,2007
B. Hendrix,COL,29.0,37,3,580,99,253,0.391,25,95,0.263,74,158,0.468,0.441,34,45,0.756,28,87,115,21,14,13,31,75,257,2007
R. Hite,SFL,23.0,19,0,464,97,207,0.469,31,71,0.437,66,136,0.485,0.543,50,66,0.758,21,52,73,34,20,3,23,28,275,2007
J. Hodge,TOT,23.0,22,10,658,130,263,0.494,2,6,0.333,128,257,0.498,0.498,81,116,0.698,35,102,137,161,17,12,91,52,343,2007
J. Hodge,IDA,23.0,2,0,30,10,15,0.667,0,1,0.0,10,14,0.714,0.667,5,7,0.714,1,7,8,3,1,0,5,4,25,2007
J. Hodge,COL,23.0,9,0,207,46,98,0.469,1,2,0.5,45,96,0.469,0.474,16,29,0.552,12,26,38,59,8,5,31,20,109,2007
J. Hodge,ABQ,23.0,11,10,421,74,150,0.493,1,3,0.333,73,147,0.497,0.497,60,80,0.75,22,69,91,99,8,7,55,28,209,2007
R. Hollins,FTW,22.0,5,5,164,23,48,0.479,0,0,0.0,23,48,0.479,0.479,15,22,0.682,21,31,52,3,2,10,16,19,61,2007
A. Hood,COL,23.0,50,6,1087,134,316,0.424,40,120,0.333,94,196,0.48,0.487,91,122,0.746,30,85,115,125,36,3,81,110,399,2007
D. Horton,LOS,22.0,14,4,305,30,85,0.353,7,30,0.233,23,55,0.418,0.394,13,17,0.765,3,23,26,40,14,3,20,25,80,2007
G. Husted,DAK,23.0,8,0,116,15,41,0.366,0,1,0.0,15,40,0.375,0.366,3,6,0.5,12,15,27,3,5,1,5,21,33,2007
M. Ilic,COL,22.0,9,6,152,19,37,0.514,0,0,0.0,19,37,0.514,0.514,9,11,0.818,9,27,36,6,1,15,22,21,47,2007
B. Jackson,ARK,26.0,42,38,1182,178,408,0.436,0,2,0.0,178,406,0.438,0.436,126,165,0.764,64,157,221,90,49,26,99,159,482,2007
D. Jackson,IDA,,9,9,293,48,107,0.449,10,23,0.435,38,84,0.452,0.495,31,34,0.912,4,22,26,28,6,2,31,29,137,2007
L. Jackson,IDA,25.0,23,16,681,121,252,0.48,34,70,0.486,87,182,0.478,0.548,60,76,0.789,23,81,104,89,29,6,51,48,336,2007
D. Jefferson,DAK,23.0,49,3,1148,145,334,0.434,10,30,0.333,135,304,0.444,0.449,154,193,0.798,43,123,166,183,68,11,105,132,454,2007
P. Jeter,COL,23.0,50,50,1655,259,533,0.486,10,38,0.263,249,495,0.503,0.495,193,218,0.885,37,115,152,355,67,1,137,112,721,2007
A. Johnson,ARK,23.0,5,4,132,25,46,0.543,0,0,0.0,25,46,0.543,0.543,16,30,0.533,7,36,43,5,3,3,15,15,66,2007
A. Johnson,SFL,19.0,22,22,775,157,252,0.623,1,3,0.333,156,249,0.627,0.625,100,134,0.746,76,136,212,46,26,69,70,97,415,2007
D. Johnson,IDA,25.0,2,0,29,6,12,0.5,0,1,0.0,6,11,0.545,0.5,1,1,1.0,5,3,8,0,0,1,0,4,13,2007
J. Johnson,ANA,23.0,4,4,90,9,28,0.321,3,11,0.273,6,17,0.353,0.375,11,13,0.846,1,5,6,12,3,0,8,14,32,2007
K. Johnson,LOS,26.0,16,3,291,44,85,0.518,3,11,0.273,41,74,0.554,0.535,43,58,0.741,17,21,38,27,8,2,29,39,134,2007
B. Jones,FTW,23.0,3,0,73,15,34,0.441,2,7,0.286,13,27,0.481,0.471,9,13,0.692,9,15,24,3,3,0,4,10,41,2007
D. Jones,ABQ,23.0,2,1,81,5,12,0.417,0,0,0.0,5,12,0.417,0.417,13,23,0.565,10,13,23,1,4,12,4,7,23,2007
M. Jones,COL,31.0,6,3,112,13,41,0.317,0,2,0.0,13,39,0.333,0.317,8,14,0.571,7,12,19,7,1,2,4,12,34,2007
A. Jordan,FTW,23.0,6,0,39,2,12,0.167,0,1,0.0,2,11,0.182,0.167,3,8,0.375,1,2,3,1,2,0,3,8,7,2007
A. Joseph,LOS,25.0,2,2,55,4,12,0.333,0,0,0.0,4,12,0.333,0.333,0,0,0.0,0,1,1,5,2,0,7,5,8,2007
J. Kelly,TUL,24.0,22,3,322,32,78,0.41,10,36,0.278,22,42,0.524,0.474,7,11,0.636,5,27,32,64,16,2,18,50,81,2007
J. Lang,ARK,23.0,7,1,127,22,46,0.478,0,0,0.0,22,46,0.478,0.478,9,15,0.6,12,20,32,4,5,10,12,17,53,2007
N. Lewis,LOS,23.0,19,2,462,52,128,0.406,5,19,0.263,47,109,0.431,0.426,35,48,0.729,34,61,95,16,5,12,29,51,144,2007
R. Livingston,IDA,31.0,46,46,1806,175,472,0.371,61,195,0.313,114,277,0.412,0.435,154,182,0.846,37,178,215,488,75,7,160,124,565,2007
D. Logan,FTW,24.0,7,1,63,10,26,0.385,3,14,0.214,7,12,0.583,0.442,2,3,0.667,2,3,5,5,1,1,9,2,25,2007
K. Lyde,DAK,26.0,45,37,994,190,305,0.623,0,1,0.0,190,304,0.625,0.623,41,80,0.513,115,173,288,58,12,61,67,176,421,2007
R. Major,DAK,24.0,45,45,1525,272,542,0.502,26,93,0.28,246,449,0.548,0.526,250,308,0.812,92,152,244,118,68,30,77,120,820,2007
J. Manuel,LOS,23.0,46,44,1324,178,427,0.417,6,25,0.24,172,402,0.428,0.424,76,126,0.603,45,131,176,84,49,18,113,127,438,2007
D. Markota,TUL,21.0,10,6,282,39,85,0.459,12,31,0.387,27,54,0.5,0.529,14,18,0.778,7,41,48,18,7,6,25,18,104,2007
C. Mason,LOS,25.0,45,1,931,128,270,0.474,2,12,0.167,126,258,0.488,0.478,82,117,0.701,77,86,163,72,35,12,66,83,340,2007
J. Maye,DAK,26.0,33,33,1046,187,407,0.459,27,78,0.346,160,329,0.486,0.493,119,127,0.937,24,118,142,75,18,7,76,89,520,2007
A. McCollum,BAK,31.0,27,15,716,83,206,0.403,14,43,0.326,69,163,0.423,0.437,51,64,0.797,15,44,59,61,12,0,46,55,231,2007
C. McCray,DAK,22.0,23,2,598,96,218,0.44,26,55,0.473,70,163,0.429,0.5,54,59,0.915,23,46,69,67,33,3,39,51,272,2007
S. McFadgon,BAK,24.0,22,17,673,154,328,0.47,4,15,0.267,150,313,0.479,0.476,98,109,0.899,15,50,65,54,18,1,40,32,410,2007
J. McGuire,LOS,25.0,6,0,49,4,9,0.444,0,0,0.0,4,9,0.444,0.444,2,4,0.5,4,10,14,3,1,3,6,9,10,2007
A. McHenry,FTW,23.0,19,8,243,19,55,0.345,5,12,0.417,14,43,0.326,0.391,6,15,0.4,13,26,39,24,11,12,21,36,49,2007
B. McKenzie,ANA,23.0,23,18,394,44,78,0.564,0,0,0.0,44,78,0.564,0.564,15,35,0.429,41,70,111,6,7,21,27,62,103,2007
J. McKrieth,TOT,,16,0,208,19,50,0.38,2,4,0.5,17,46,0.37,0.4,10,15,0.667,3,22,25,20,11,3,15,25,50,2007
J. McKrieth,LOS,,7,0,94,8,23,0.348,1,2,0.5,7,21,0.333,0.37,5,5,1.0,3,12,15,10,4,2,7,7,22,2007
J. McKrieth,COL,,9,0,114,11,27,0.407,1,2,0.5,10,25,0.4,0.426,5,10,0.5,0,10,10,10,7,1,8,18,28,2007
G. McNamara,BAK,23.0,41,34,1123,155,389,0.398,44,145,0.303,111,244,0.455,0.455,95,103,0.922,10,78,88,215,37,1,103,112,449,2007
J. McNeil,FTW,26.0,9,0,74,5,9,0.556,0,0,0.0,5,9,0.556,0.556,3,8,0.375,5,8,13,1,1,4,3,20,13,2007
A. Meeking,SFL,25.0,10,2,230,37,92,0.402,1,6,0.167,36,86,0.419,0.408,11,27,0.407,21,41,62,9,2,0,14,26,86,2007
P. Mensah-Bonsu,FTW,23.0,26,23,797,154,275,0.56,0,0,0.0,154,275,0.56,0.56,104,173,0.601,120,151,271,15,20,33,72,100,412,2007
S. Merritt,TUL,25.0,1,0,14,0,2,0.0,0,0,0.0,0,2,0.0,0.0,0,0,0.0,0,1,1,0,1,2,1,1,0,2007
S. Merritt,TOT,25.0,22,17,566,72,170,0.424,1,3,0.333,71,167,0.425,0.426,58,70,0.829,46,98,144,9,12,13,42,62,203,2007
S. Merritt,AUS,25.0,21,17,552,72,168,0.429,1,3,0.333,71,165,0.43,0.432,58,70,0.829,46,97,143,9,11,11,41,61,203,2007
C. Miles,IDA,19.0,8,0,253,51,100,0.51,19,45,0.422,32,55,0.582,0.605,17,22,0.773,15,28,43,14,10,4,15,21,138,2007
J. Moore,ARK,24.0,26,0,569,80,166,0.482,1,6,0.167,79,160,0.494,0.485,38,56,0.679,32,89,121,30,32,13,35,57,199,2007
M. Narvaez,COL,25.0,4,0,26,1,5,0.2,0,0,0.0,1,5,0.2,0.2,0,0,0.0,4,1,5,2,0,0,5,4,2,2007
M. Narvaez,ABQ,25.0,13,7,261,25,47,0.532,0,1,0.0,25,46,0.543,0.532,17,21,0.81,27,56,83,5,6,2,14,36,67,2007
M. Narvaez,TOT,25.0,17,7,287,26,52,0.5,0,1,0.0,26,51,0.51,0.5,17,21,0.81,31,57,88,7,6,2,19,40,69,2007
A. Neale,DAK,25.0,17,0,267,32,85,0.376,16,44,0.364,16,41,0.39,0.471,19,28,0.679,8,40,48,7,7,0,9,18,99,2007
E. Nesbitt,SFL,26.0,38,6,620,101,239,0.423,42,109,0.385,59,130,0.454,0.51,51,62,0.823,11,56,67,90,25,3,55,64,295,2007
P. O'Bryant,BAK,20.0,25,23,746,122,237,0.515,0,1,0.0,122,236,0.517,0.515,57,72,0.792,56,185,241,35,15,72,50,90,301,2007
E. Osmundson,COL,23.0,25,3,424,48,121,0.397,3,29,0.103,45,92,0.489,0.409,22,31,0.71,8,40,48,26,14,1,18,55,121,2007
A. Owens,ANA,26.0,50,43,1927,284,633,0.449,46,146,0.315,238,487,0.489,0.485,214,277,0.773,56,227,283,158,53,5,112,157,828,2007
A. Patterson,LOS,23.0,50,36,1612,222,422,0.526,1,7,0.143,221,415,0.533,0.527,78,110,0.709,125,235,360,99,49,78,81,134,523,2007
K. Pinkney,BAK,23.0,47,47,1628,333,650,0.512,5,19,0.263,328,631,0.52,0.516,204,261,0.782,101,237,338,88,62,29,91,171,875,2007
J. Pinnock,ARK,23.0,21,15,653,96,200,0.48,6,32,0.188,90,168,0.536,0.495,34,44,0.773,38,105,143,96,30,12,65,51,232,2007
R. Powell,ARK,24.0,28,23,981,222,424,0.524,23,71,0.324,199,353,0.564,0.551,157,204,0.77,86,96,182,55,12,24,69,78,624,2007
J. Pugh,DAK,24.0,2,0,6,0,2,0.0,0,0,0.0,0,2,0.0,0.0,0,0,0.0,0,2,2,0,0,0,0,1,0,2007
P. Ramos,IDA,21.0,33,33,896,184,332,0.554,0,0,0.0,184,332,0.554,0.554,66,107,0.617,46,162,208,38,8,45,94,114,434,2007
A. Ray,AUS,22.0,2,0,35,10,18,0.556,2,6,0.333,8,12,0.667,0.611,7,7,1.0,2,3,5,4,0,0,2,10,29,2007
J. Reiner,SFL,24.0,28,28,892,155,326,0.475,0,1,0.0,155,325,0.477,0.475,78,112,0.696,72,174,246,42,15,26,51,110,388,2007
D. Rice,DAK,24.0,18,0,459,89,200,0.445,40,105,0.381,49,95,0.516,0.545,28,35,0.8,27,50,77,25,10,5,22,33,246,2007
J. Richardson,FTW,22.0,34,32,1051,231,511,0.452,42,114,0.368,189,397,0.476,0.493,89,109,0.817,23,80,103,59,28,10,60,104,593,2007
J. Rich,FTW,32.0,4,0,34,3,5,0.6,0,0,0.0,3,5,0.6,0.6,0,1,0.0,0,2,2,8,0,0,3,4,6,2007
R. Rickert,COL,23.0,50,13,1153,199,399,0.499,2,8,0.25,197,391,0.504,0.501,140,162,0.864,146,153,299,33,32,20,64,128,540,2007
R. Riley,BAK,25.0,50,14,909,104,209,0.498,0,2,0.0,104,207,0.502,0.498,83,134,0.619,87,159,246,31,21,17,87,155,291,2007
A. Roberson,ARK,23.0,18,4,470,109,241,0.452,47,114,0.412,62,127,0.488,0.55,35,44,0.795,15,24,39,35,21,0,24,44,300,2007
A. Robinson,SFL,22.0,49,0,830,133,315,0.422,31,98,0.316,102,217,0.47,0.471,16,27,0.593,37,80,117,40,14,25,26,63,313,2007
B. Robinson,ABQ,25.0,50,25,1368,233,419,0.556,2,17,0.118,231,402,0.575,0.558,84,125,0.672,166,144,310,69,70,43,59,182,552,2007
E. Robinson,IDA,30.0,27,21,917,184,356,0.517,1,8,0.125,183,348,0.526,0.518,51,62,0.823,30,66,96,62,38,16,28,63,420,2007
C. Rodgers,TOT,23.0,31,1,598,68,180,0.378,5,23,0.217,63,157,0.401,0.392,105,130,0.808,13,51,64,69,25,1,65,74,246,2007
C. Rodgers,SFL,23.0,4,0,73,6,18,0.333,1,4,0.25,5,14,0.357,0.361,2,4,0.5,1,9,10,10,3,0,10,11,15,2007
C. Rodgers,ABQ,23.0,27,1,525,62,162,0.383,4,19,0.211,58,143,0.406,0.395,103,126,0.817,12,42,54,59,22,1,55,63,231,2007
W. Russell,FTW,24.0,15,0,230,26,75,0.347,3,10,0.3,23,65,0.354,0.367,29,37,0.784,3,21,24,54,7,2,20,21,84,2007
T. Sally,ARK,25.0,38,14,868,147,279,0.527,6,14,0.429,141,265,0.532,0.538,53,67,0.791,72,74,146,52,39,11,61,88,353,2007
R. Sanchez,IDA,19.0,50,21,1402,194,480,0.404,98,268,0.366,96,212,0.453,0.506,93,125,0.744,35,177,212,85,32,36,80,170,579,2007
C. Santee,FTW,23.0,50,2,1270,222,553,0.401,108,296,0.365,114,257,0.444,0.499,38,61,0.623,15,60,75,87,36,2,44,64,590,2007
L. Schenscher,FTW,24.0,34,34,823,133,260,0.512,0,0,0.0,133,260,0.512,0.512,59,84,0.702,101,133,234,24,19,38,63,110,325,2007
M. Scott,AUS,24.0,6,1,125,7,25,0.28,5,9,0.556,2,16,0.125,0.38,8,15,0.533,0,7,7,10,2,0,13,17,27,2007
M. Sene,IDA,20.0,15,1,322,58,113,0.513,0,0,0.0,58,113,0.513,0.513,32,54,0.593,49,59,108,5,10,23,23,48,148,2007
H. Seung-Jin,ANA,21.0,26,16,326,29,70,0.414,0,0,0.0,29,70,0.414,0.414,13,22,0.591,22,50,72,6,5,10,20,51,71,2007
J. Shipp,ABQ,25.0,43,30,1321,255,584,0.437,45,154,0.292,210,430,0.488,0.475,142,184,0.772,49,122,171,96,30,13,75,95,697,2007
C. Shumate,ABQ,25.0,20,0,229,32,90,0.356,13,36,0.361,19,54,0.352,0.428,7,8,0.875,10,28,38,13,6,1,15,16,84,2007
T. Slay,BAK,26.0,26,16,670,122,247,0.494,7,21,0.333,115,226,0.509,0.508,47,59,0.797,23,74,97,51,30,10,60,79,298,2007
J. Smith,AUS,26.0,50,38,1691,276,638,0.433,8,26,0.308,268,612,0.438,0.439,142,200,0.71,81,292,373,97,37,35,153,116,702,2007
J. Smith,ARK,,14,0,202,36,87,0.414,2,6,0.333,34,81,0.42,0.425,10,14,0.714,12,15,27,10,12,0,10,15,84,2007
S. Smith,ANA,23.0,23,16,774,164,316,0.519,14,35,0.4,150,281,0.534,0.541,81,99,0.818,61,100,161,26,17,10,53,73,423,2007
T. Smith,ANA,27.0,49,30,1324,168,365,0.46,11,35,0.314,157,330,0.476,0.475,113,141,0.801,61,145,206,26,29,12,63,150,460,2007
A. Spanich,TUL,30.0,11,0,99,7,28,0.25,5,15,0.333,2,13,0.154,0.339,3,3,1.0,2,6,8,7,0,1,7,9,22,2007
F. Steyn,TUL,24.0,49,18,831,114,202,0.564,0,1,0.0,114,201,0.567,0.564,70,140,0.5,75,122,197,5,12,33,72,185,298,2007
C. Stinson,TOT,23.0,28,17,804,140,311,0.45,4,22,0.182,136,289,0.471,0.457,50,62,0.806,28,83,111,147,34,1,58,59,334,2007
C. Stinson,FTW,23.0,16,16,521,91,190,0.479,1,10,0.1,90,180,0.5,0.482,25,32,0.781,16,61,77,113,19,1,37,39,208,2007
C. Stinson,DAK,23.0,12,1,283,49,121,0.405,3,12,0.25,46,109,0.422,0.417,25,30,0.833,12,22,34,34,15,0,21,20,126,2007
A. Storey,DAK,29.0,3,0,73,13,26,0.5,2,5,0.4,11,21,0.524,0.538,0,2,0.0,7,11,18,2,5,0,3,10,28,2007
T. Strickland,AUS,22.0,2,0,33,6,12,0.5,0,0,0.0,6,12,0.5,0.5,0,2,0.0,2,2,4,2,0,0,2,0,12,2007
J. Sullinger,TUL,24.0,2,0,13,1,2,0.5,0,1,0.0,1,1,1.0,0.5,0,0,0.0,0,1,1,1,0,0,2,2,2,2007
Y. Tabuse,BAK,26.0,43,3,818,109,266,0.41,15,57,0.263,94,209,0.45,0.438,34,44,0.773,17,46,63,151,39,1,53,61,267,2007
M. Taylor,TUL,25.0,22,5,328,52,112,0.464,3,20,0.15,49,92,0.533,0.478,13,15,0.867,12,9,21,20,8,0,22,22,120,2007
R. Taylor,IDA,24.0,50,35,1603,283,573,0.494,15,45,0.333,268,528,0.508,0.507,125,163,0.767,80,217,297,178,70,35,104,142,706,2007
A. Terrell,FTW,25.0,49,9,883,120,261,0.46,0,1,0.0,120,260,0.462,0.46,55,90,0.611,80,111,191,31,23,25,45,60,295,2007
J. Terrell,ARK,22.0,20,0,277,35,60,0.583,0,0,0.0,35,60,0.583,0.583,19,34,0.559,14,43,57,15,6,6,22,48,89,2007
J. Thomas,ABQ,26.0,20,4,499,77,170,0.453,17,53,0.321,60,117,0.513,0.503,33,42,0.786,10,35,45,36,10,20,23,44,204,2007
J. Thomas,TOT,26.0,47,4,1104,165,378,0.437,38,137,0.277,127,241,0.527,0.487,71,93,0.763,50,91,141,68,35,37,50,85,439,2007
J. Thomas,ANA,26.0,27,0,605,88,208,0.423,21,84,0.25,67,124,0.54,0.474,38,51,0.745,40,56,96,32,25,17,27,41,235,2007
T. Thomas,FTW,26.0,45,17,1136,170,358,0.475,31,94,0.33,139,264,0.527,0.518,61,80,0.763,75,221,296,118,25,9,88,67,432,2007
D. Thompson,ABQ,23.0,32,31,1284,251,485,0.518,40,100,0.4,211,385,0.548,0.559,124,164,0.756,83,203,286,137,56,33,124,99,666,2007
C. Trybanski,TUL,27.0,48,28,1103,90,162,0.556,0,1,0.0,90,161,0.559,0.556,54,67,0.806,86,144,230,25,9,121,44,125,234,2007
C. Tucker,ARK,26.0,46,42,1838,329,779,0.422,94,255,0.369,235,524,0.448,0.483,154,182,0.846,21,165,186,252,96,10,147,134,906,2007
P. Tucker,COL,21.0,19,12,459,84,178,0.472,2,7,0.286,82,171,0.48,0.478,33,39,0.846,26,38,64,39,13,4,30,38,203,2007
N. Vander Laan,LOS,27.0,5,4,156,25,42,0.595,0,0,0.0,25,42,0.595,0.595,13,18,0.722,20,42,62,7,4,3,15,24,63,2007
J. Varem,SFL,23.0,37,21,1067,116,281,0.413,19,59,0.322,97,222,0.437,0.447,86,133,0.647,64,156,220,77,45,12,74,112,337,2007
J. Varem,TUL,23.0,6,1,179,30,63,0.476,7,17,0.412,23,46,0.5,0.532,11,18,0.611,20,28,48,18,10,4,13,10,78,2007
J. Varem,TOT,23.0,43,22,1246,146,344,0.424,26,76,0.342,120,268,0.448,0.462,97,151,0.642,84,184,268,95,55,16,87,122,415,2007
M. Vinicius,TUL,22.0,13,6,430,85,176,0.483,27,71,0.38,58,105,0.552,0.56,24,31,0.774,11,76,87,31,16,3,31,24,221,2007
V. Wafer,COL,21.0,42,42,1351,312,642,0.486,120,265,0.453,192,377,0.509,0.579,140,182,0.769,19,103,122,138,33,16,94,90,884,2007
D. White,ANA,25.0,45,11,1090,146,335,0.436,13,76,0.171,133,259,0.514,0.455,138,184,0.75,29,92,121,165,55,6,73,105,443,2007
J. White,AUS,24.0,15,11,518,84,176,0.477,13,39,0.333,71,137,0.518,0.514,64,85,0.753,20,40,60,47,25,8,45,41,245,2007
L. Whitehead,SFL,25.0,8,1,192,33,79,0.418,9,24,0.375,24,55,0.436,0.475,17,25,0.68,13,23,36,11,11,4,15,14,92,2007
C. Williams,SFL,,15,6,424,69,138,0.5,5,11,0.455,64,127,0.504,0.518,45,72,0.625,12,40,52,62,14,2,47,35,188,2007
C. Williams,DAK,,20,19,499,106,200,0.53,5,11,0.455,101,189,0.534,0.543,63,102,0.618,15,64,79,69,29,3,61,51,280,2007
C. Williams,TOT,,35,25,923,175,338,0.518,10,22,0.455,165,316,0.522,0.533,108,174,0.621,27,104,131,131,43,5,108,86,468,2007
E. Williams,IDA,28.0,6,0,76,17,29,0.586,0,0,0.0,17,29,0.586,0.586,1,3,0.333,6,11,17,3,1,1,11,13,35,2007
F. Williams,SFL,26.0,44,44,1525,214,550,0.389,122,327,0.373,92,223,0.413,0.5,144,171,0.842,25,148,173,206,78,16,104,82,694,2007
J. Williams,ANA,23.0,50,49,1961,347,793,0.438,83,244,0.34,264,549,0.481,0.49,181,227,0.797,58,170,228,85,40,24,103,103,958,2007
J. Williams,ANA,24.0,5,0,41,6,19,0.316,0,1,0.0,6,18,0.333,0.316,4,4,1.0,3,4,7,0,3,0,1,7,16,2007
J. Williams,AUS,25.0,3,1,84,6,23,0.261,3,9,0.333,3,14,0.214,0.326,3,4,0.75,1,7,8,16,2,0,15,8,18,2007
J. Williams,DAK,22.0,12,12,383,62,113,0.549,0,1,0.0,62,112,0.554,0.549,27,47,0.574,62,92,154,8,8,40,20,43,151,2007
L. Williams,FTW,20.0,3,2,108,27,38,0.711,5,8,0.625,22,30,0.733,0.776,19,27,0.704,1,13,14,24,5,2,11,9,78,2007
W. Wilson,ABQ,,5,0,99,15,33,0.455,0,0,0.0,15,33,0.455,0.455,4,10,0.4,7,20,27,4,1,5,10,20,34,2007
W. Wilson,TOT,,32,10,660,121,225,0.538,0,1,0.0,121,224,0.54,0.538,36,52,0.692,43,95,138,28,21,33,34,87,278,2007
W. Wilson,LOS,,27,10,561,106,192,0.552,0,1,0.0,106,191,0.555,0.552,32,42,0.762,36,75,111,24,20,28,24,67,244,2007
L. Woods,AUS,28.0,15,0,419,70,126,0.556,0,0,0.0,70,126,0.556,0.556,46,58,0.793,56,120,176,32,13,33,40,43,186,2007
Q. Woods,BAK,25.0,7,0,106,25,52,0.481,2,7,0.286,23,45,0.511,0.5,9,12,0.75,4,11,15,4,1,2,14,13,61,2007
J. Works,SFL,23.0,5,0,25,6,10,0.6,0,0,0.0,6,10,0.6,0.6,1,2,0.5,5,4,9,1,2,0,2,6,13,2007
A. Acker,FAY,23.0,17,9,603,111,254,0.437,21,57,0.368,90,197,0.457,0.478,63,77,0.818,21,61,82,81,32,9,47,42,306,2006
B. Adams,AUS,26.0,7,0,100,13,29,0.448,1,7,0.143,12,22,0.545,0.466,10,15,0.667,3,12,15,13,5,1,12,13,37,2006
D. Akindele,FTW,22.0,43,12,860,122,222,0.55,0,0,0.0,122,222,0.55,0.55,105,175,0.6,77,128,205,20,11,30,69,151,349,2006
M. Allen,ARK,26.0,48,14,1053,170,337,0.504,23,59,0.39,147,278,0.529,0.539,137,180,0.761,38,79,117,111,44,4,117,123,500,2006
M. Andriuskevicius,ARK,19.0,15,4,286,37,74,0.5,1,9,0.111,36,65,0.554,0.507,30,45,0.667,15,48,63,7,3,17,20,39,105,2006
K. Azubuike,FTW,22.0,41,17,1051,193,380,0.508,29,79,0.367,164,301,0.545,0.546,101,129,0.783,42,123,165,60,29,11,66,77,516,2006
S. Banks,TUL,21.0,12,5,269,54,117,0.462,10,32,0.313,44,85,0.518,0.504,34,46,0.739,15,24,39,12,5,2,32,20,152,2006
A. Barrett,FLO,23.0,33,33,1175,217,457,0.475,16,46,0.348,201,411,0.489,0.492,111,148,0.75,22,95,117,217,37,9,93,77,561,2006
E. Barron,FLO,24.0,6,3,175,43,84,0.512,0,1,0.0,43,83,0.518,0.512,16,21,0.762,17,41,58,13,4,1,20,26,102,2006
E. Basden,TUL,22.0,14,8,356,63,130,0.485,7,23,0.304,56,107,0.523,0.512,14,30,0.467,18,45,63,39,34,1,30,23,147,2006
B. Bass,TUL,20.0,1,0,26,7,13,0.538,0,0,0.0,7,13,0.538,0.538,2,4,0.5,4,1,5,0,0,2,1,1,16,2006
T. Battle,FTW,22.0,3,0,43,1,4,0.25,0,1,0.0,1,3,0.333,0.25,0,0,0.0,1,3,4,3,1,0,2,9,2,2006
N. Billings,FTW,24.0,12,0,92,11,24,0.458,0,0,0.0,11,24,0.458,0.458,3,6,0.5,11,8,19,0,2,8,6,26,25,2006
N. Billings,FAY,24.0,2,0,15,2,3,0.667,0,0,0.0,2,3,0.667,0.667,0,0,0.0,1,2,3,0,0,0,3,2,4,2006
N. Billings,ABQ,24.0,17,0,159,11,33,0.333,0,0,0.0,11,33,0.333,0.333,9,19,0.474,11,27,38,3,3,17,11,36,31,2006
N. Billings,TOT,24.0,31,0,266,24,60,0.4,0,0,0.0,24,60,0.4,0.4,12,25,0.48,23,37,60,3,5,25,20,64,60,2006
R. Blackshear,TUL,27.0,3,0,25,2,10,0.2,1,5,0.2,1,5,0.2,0.25,0,0,0.0,1,1,2,0,1,0,0,3,5,2006
T. Bland,ABQ,26.0,43,34,1231,124,344,0.36,24,94,0.255,100,250,0.4,0.395,107,142,0.754,22,118,140,147,21,5,78,93,379,2006
A. Blatche,ROA,19.0,6,2,148,25,49,0.51,1,5,0.2,24,44,0.545,0.52,16,19,0.842,6,35,41,8,8,9,19,16,67,2006
S. Boxley,TUL,23.0,38,15,475,48,108,0.444,0,6,0.0,48,102,0.471,0.444,19,30,0.633,21,42,63,21,13,5,20,29,115,2006
T. Braggs,TUL,29.0,14,8,400,47,106,0.443,0,1,0.0,47,105,0.448,0.443,64,85,0.753,29,64,93,35,14,3,55,58,158,2006
D. Brooks,ABQ,23.0,23,2,385,48,116,0.414,2,5,0.4,46,111,0.414,0.422,7,13,0.538,28,47,75,23,18,2,11,34,105,2006
A. Broussard,ABQ,23.0,7,1,80,10,23,0.435,2,5,0.4,8,18,0.444,0.478,10,16,0.625,6,10,16,5,6,0,7,20,32,2006
E. Brown,FLO,22.0,5,0,159,25,47,0.532,0,0,0.0,25,47,0.532,0.532,19,26,0.731,17,32,49,8,2,0,16,18,69,2006
R. Brown,FLO,25.0,9,0,54,3,5,0.6,0,0,0.0,3,5,0.6,0.6,1,4,0.25,0,5,5,1,1,1,1,16,7,2006
T. Brown,ABQ,26.0,32,26,1149,211,498,0.424,24,86,0.279,187,412,0.454,0.448,105,132,0.795,15,135,150,208,48,5,119,68,551,2006
W. Bynum,ROA,23.0,29,28,1094,206,440,0.468,25,83,0.301,181,357,0.507,0.497,260,305,0.852,19,64,83,193,48,2,165,101,697,2006
M. Campbell,ARK,23.0,13,8,251,59,92,0.641,0,0,0.0,59,92,0.641,0.641,8,12,0.667,17,45,62,5,7,11,24,39,126,2006
A. Carmona,FTW,22.0,7,0,84,8,26,0.308,0,0,0.0,8,26,0.308,0.308,1,2,0.5,6,5,11,3,2,0,5,11,17,2006
B. Chase,ROA,24.0,3,2,126,14,42,0.333,8,25,0.32,6,17,0.353,0.429,3,4,0.75,0,12,12,18,3,0,7,7,39,2006
J. Clark,ROA,23.0,32,2,425,44,77,0.571,0,0,0.0,44,77,0.571,0.571,25,46,0.543,43,79,122,11,14,2,29,76,113,2006
M. Cleaves,FAY,28.0,11,8,360,71,145,0.49,17,37,0.459,54,108,0.5,0.548,47,63,0.746,4,29,33,76,16,1,27,42,206,2006
A. Coleman,ABQ,23.0,4,0,33,3,8,0.375,0,1,0.0,3,7,0.429,0.375,0,0,0.0,3,4,7,2,0,1,0,6,6,2006
W. Conroy,TUL,23.0,47,26,1464,219,448,0.489,31,87,0.356,188,361,0.521,0.523,136,210,0.648,48,151,199,314,71,2,151,98,605,2006
T. Cummings,ABQ,24.0,48,24,1194,244,460,0.53,0,0,0.0,244,460,0.53,0.53,118,138,0.855,126,183,309,48,17,20,54,150,606,2006
V. Cummings,FTW,29.0,24,23,803,102,235,0.434,41,85,0.482,61,150,0.407,0.521,45,55,0.818,15,71,86,111,37,4,40,83,290,2006
R. Curry,AUS,25.0,44,43,1538,279,610,0.457,68,163,0.417,211,447,0.472,0.513,114,134,0.851,43,107,150,123,55,5,91,65,740,2006
E. Daniels,FAY,23.0,46,42,1575,334,684,0.488,35,125,0.28,299,559,0.535,0.514,108,155,0.697,97,275,372,133,34,18,125,163,811,2006
N. Daniels,ROA,22.0,16,0,181,20,64,0.313,11,40,0.275,9,24,0.375,0.398,7,9,0.778,5,14,19,12,3,2,8,30,58,2006
K. Dartez,FLO,25.0,14,3,257,29,66,0.439,0,0,0.0,29,66,0.439,0.439,28,38,0.737,25,36,61,5,5,11,16,41,86,2006
B. Dean,ARK,26.0,19,15,497,74,139,0.532,26,49,0.531,48,90,0.533,0.626,28,37,0.757,7,39,46,50,22,3,27,53,202,2006
K. Dickens,FAY,27.0,26,6,587,96,228,0.421,29,86,0.337,67,142,0.472,0.485,45,64,0.703,29,59,88,23,10,7,35,80,266,2006
N. Dixon,FAY,25.0,3,1,56,7,17,0.412,1,3,0.333,6,14,0.429,0.441,7,17,0.412,2,9,11,2,2,1,14,16,22,2006
S. Doliboa,ROA,25.0,47,37,1293,165,384,0.43,33,100,0.33,132,284,0.465,0.473,107,137,0.781,43,138,181,82,46,27,68,116,470,2006
M. Dorsey,FTW,24.0,7,1,100,15,39,0.385,1,6,0.167,14,33,0.424,0.397,10,13,0.769,7,6,13,7,4,1,7,10,41,2006
M. Douthit,ABQ,25.0,42,31,1206,175,333,0.526,0,1,0.0,175,332,0.527,0.526,100,141,0.709,92,211,303,48,54,45,107,137,450,2006
R. Dryden,FAY,27.0,8,5,101,11,28,0.393,0,0,0.0,11,28,0.393,0.393,5,8,0.625,7,9,16,5,0,3,8,22,27,2006
N. Ebi,FTW,21.0,16,11,397,74,143,0.517,1,5,0.2,73,138,0.529,0.521,33,48,0.688,42,68,110,11,8,37,18,61,182,2006
A. Emmett,AUS,23.0,47,18,1258,228,442,0.516,28,71,0.394,200,371,0.539,0.548,97,156,0.622,71,130,201,72,61,8,82,69,581,2006
D. Erwin,FLO,23.0,22,22,641,75,164,0.457,0,1,0.0,75,163,0.46,0.457,49,60,0.817,54,139,193,35,8,23,39,93,199,2006
D. Erwin,FAY,23.0,8,1,156,12,28,0.429,0,1,0.0,12,27,0.444,0.429,8,11,0.727,13,23,36,3,3,6,13,35,32,2006
D. Erwin,TOT,23.0,30,23,797,87,192,0.453,0,2,0.0,87,190,0.458,0.453,57,71,0.803,67,162,229,38,11,29,52,128,231,2006
O. Famutimi,ARK,21.0,47,13,775,122,238,0.513,2,11,0.182,120,227,0.529,0.517,75,100,0.75,44,84,128,36,36,8,54,80,321,2006
D. Farmer,TUL,24.0,48,30,1545,274,604,0.454,113,264,0.428,161,340,0.474,0.547,128,184,0.696,30,142,172,102,44,4,84,126,789,2006
D. Fischer,ROA,24.0,26,0,513,65,112,0.58,0,0,0.0,65,112,0.58,0.58,24,29,0.828,39,92,131,16,6,34,23,74,154,2006
G. Fitch,AUS,23.0,3,1,69,11,39,0.282,2,11,0.182,9,28,0.321,0.308,11,11,1.0,5,8,13,6,2,1,6,5,35,2006
M. Fizer,AUS,27.0,35,35,1210,286,557,0.513,17,53,0.321,269,504,0.534,0.529,207,279,0.742,70,202,272,116,29,17,93,121,796,2006
S. Ford,FAY,24.0,15,8,411,73,139,0.525,0,3,0.0,73,136,0.537,0.525,49,75,0.653,33,93,126,16,10,21,44,60,195,2006
B. Freeman,ARK,23.0,4,0,48,12,22,0.545,2,4,0.5,10,18,0.556,0.591,6,7,0.857,2,9,11,3,2,0,2,7,32,2006
K. Frey,ABQ,25.0,3,0,25,4,12,0.333,0,0,0.0,4,12,0.333,0.333,1,5,0.2,2,4,6,1,1,0,1,4,9,2006
H. Fuller,FLO,24.0,24,20,711,109,245,0.445,0,0,0.0,109,245,0.445,0.445,71,105,0.676,67,151,218,29,14,22,72,84,289,2006
A. Fuqua,AUS,22.0,24,0,162,7,18,0.389,0,0,0.0,7,18,0.389,0.389,21,34,0.618,16,19,35,2,2,5,12,24,35,2006
O. George,TUL,23.0,47,35,1187,182,355,0.513,0,0,0.0,182,355,0.513,0.513,121,177,0.684,115,177,292,35,36,17,70,177,485,2006
A. Glyniadakis,ROA,24.0,15,10,275,36,78,0.462,0,0,0.0,36,78,0.462,0.462,42,51,0.824,20,37,57,8,0,16,20,53,114,2006
A. Glyniadakis,ABQ,24.0,23,12,624,111,197,0.563,0,0,0.0,111,197,0.563,0.563,73,90,0.811,51,82,133,6,13,32,56,101,295,2006
A. Glyniadakis,TOT,24.0,38,22,899,147,275,0.535,0,0,0.0,147,275,0.535,0.535,115,141,0.816,71,119,190,14,13,48,76,154,409,2006
D. Gonner,FTW,,6,0,57,2,7,0.286,0,1,0.0,2,6,0.333,0.286,9,14,0.643,2,4,6,6,4,0,1,5,13,2006
G. Green,FLO,20.0,1,0,15,3,6,0.5,0,0,0.0,3,6,0.5,0.5,0,2,0.0,0,1,1,0,1,1,2,0,6,2006
G. Green,FAY,20.0,8,5,211,40,93,0.43,5,11,0.455,35,82,0.427,0.457,16,20,0.8,15,28,43,14,11,2,26,23,101,2006
G. Green,TOT,20.0,9,5,226,43,99,0.434,5,11,0.455,38,88,0.432,0.46,16,22,0.727,15,29,44,14,12,3,28,23,107,2006
Q. Greer,TUL,24.0,11,0,91,21,43,0.488,0,2,0.0,21,41,0.512,0.488,14,18,0.778,5,16,21,3,5,2,5,15,56,2006
J. Gross,FLO,22.0,6,0,87,15,28,0.536,3,5,0.6,12,23,0.522,0.589,10,14,0.714,1,8,9,2,4,2,5,9,43,2006
A. Grundy,ROA,26.0,44,43,1753,340,787,0.432,101,256,0.395,239,531,0.45,0.496,231,292,0.791,61,176,237,193,109,7,144,119,1012,2006
J. Hagen,AUS,23.0,44,3,637,52,121,0.43,0,0,0.0,52,121,0.43,0.43,37,50,0.74,66,82,148,32,16,27,42,115,141,2006
T. Hamilton,TUL,27.0,5,3,129,23,50,0.46,2,2,1.0,21,48,0.438,0.48,8,10,0.8,11,25,36,5,1,1,8,10,56,2006
C. Hawkins,FAY,24.0,14,9,387,51,119,0.429,5,21,0.238,46,98,0.469,0.45,26,42,0.619,14,16,30,85,28,1,44,58,133,2006
C. Hayes,ABQ,22.0,15,13,483,65,120,0.542,0,0,0.0,65,120,0.542,0.542,32,47,0.681,57,114,171,36,21,11,39,53,162,2006
M. Hill,TUL,27.0,15,0,179,18,55,0.327,3,15,0.2,15,40,0.375,0.355,6,7,0.857,7,20,27,14,4,3,7,23,45,2006
J. Hodge,AUS,22.0,11,4,331,66,134,0.493,5,11,0.455,61,123,0.496,0.511,58,78,0.744,17,44,61,30,9,4,38,34,195,2006
C. Hurt,FAY,22.0,11,10,346,27,102,0.265,17,53,0.321,10,49,0.204,0.348,19,21,0.905,7,39,46,48,6,1,17,25,90,2006
E. Ilyasova,TUL,18.0,46,19,1297,218,536,0.407,68,195,0.349,150,341,0.44,0.47,70,99,0.707,60,264,324,46,33,38,90,151,574,2006
B. Jackson,ARK,25.0,47,46,1402,224,445,0.503,1,5,0.2,223,440,0.507,0.504,142,180,0.789,73,204,277,61,43,41,88,198,591,2006
A. Johnson,FAY,18.0,18,12,508,119,178,0.669,1,1,1.0,118,177,0.667,0.671,70,97,0.722,54,74,128,21,16,27,42,67,309,2006
J. Johnson,FAY,22.0,6,1,98,6,25,0.24,1,8,0.125,5,17,0.294,0.26,2,2,1.0,0,4,4,13,3,0,9,14,15,2006
K. Johnson,ABQ,27.0,26,16,801,106,205,0.517,0,0,0.0,106,205,0.517,0.517,62,73,0.849,45,116,161,18,2,60,48,85,274,2006
K. Johnson,FAY,25.0,38,15,843,140,285,0.491,22,58,0.379,118,227,0.52,0.53,81,132,0.614,42,84,126,39,24,3,66,96,383,2006
S. Johnson,TOT,25.0,47,11,882,135,217,0.622,0,0,0.0,135,217,0.622,0.622,82,159,0.516,80,123,203,44,15,27,100,142,352,2006
S. Johnson,ARK,25.0,22,5,441,68,113,0.602,0,0,0.0,68,113,0.602,0.602,38,82,0.463,41,66,107,15,10,11,49,63,174,2006
S. Johnson,TUL,25.0,25,6,441,67,104,0.644,0,0,0.0,67,104,0.644,0.644,44,77,0.571,39,57,96,29,5,16,51,79,178,2006
D. Jones,FLO,22.0,26,25,808,76,163,0.466,0,1,0.0,76,162,0.469,0.466,80,124,0.645,118,186,304,32,8,52,52,84,232,2006
T. Jones,FLO,23.0,15,0,217,27,63,0.429,2,13,0.154,25,50,0.5,0.444,37,43,0.86,6,13,19,16,10,1,15,24,93,2006
M. Karcher,FAY,27.0,10,1,238,38,102,0.373,13,26,0.5,25,76,0.329,0.436,12,18,0.667,14,25,39,18,7,0,23,23,101,2006
B. King,TUL,24.0,34,22,1062,166,346,0.48,18,70,0.257,148,276,0.536,0.506,102,126,0.81,44,87,131,154,29,6,94,131,452,2006
M. King,FAY,27.0,21,17,606,105,222,0.473,22,54,0.407,83,168,0.494,0.523,70,80,0.875,24,59,83,40,22,6,50,62,302,2006
T. Kitchings,TUL,26.0,16,7,346,60,110,0.545,0,0,0.0,60,110,0.545,0.545,21,42,0.5,24,71,95,24,7,15,34,40,141,2006
K. Langford,FTW,22.0,46,8,1110,194,397,0.489,10,25,0.4,184,372,0.495,0.501,129,195,0.662,44,96,140,110,40,14,78,99,527,2006
J. Lang,ARK,22.0,32,10,530,101,177,0.571,0,2,0.0,101,175,0.577,0.571,64,103,0.621,59,101,160,14,11,26,65,108,266,2006
G. Leach,FLO,24.0,47,18,990,164,300,0.547,0,0,0.0,164,300,0.547,0.547,64,99,0.646,79,170,249,35,22,65,63,163,392,2006
J. Lucas,TUL,23.0,35,35,1226,232,456,0.509,61,141,0.433,171,315,0.543,0.576,65,81,0.802,30,82,112,135,55,2,48,77,590,2006
K. Lyde,FAY,25.0,13,8,295,39,78,0.5,0,0,0.0,39,78,0.5,0.5,30,49,0.612,13,51,64,18,2,17,22,55,108,2006
J. Marlow,ARK,24.0,1,0,1,0,0,0.0,0,0,0.0,0,0,0.0,0.0,0,0,0.0,0,0,0,0,0,1,0,1,0,2006
R. Marshall,FTW,23.0,21,17,637,116,251,0.462,10,26,0.385,106,225,0.471,0.482,123,166,0.741,29,60,89,29,29,22,41,48,365,2006
B. Mason,ABQ,24.0,24,4,412,52,154,0.338,18,61,0.295,34,93,0.366,0.396,25,33,0.758,15,24,39,20,13,2,17,41,147,2006
B. Matthews,TOT,24.0,45,19,1221,135,320,0.422,13,46,0.283,122,274,0.445,0.442,210,292,0.719,107,124,231,77,75,11,104,185,493,2006
B. Matthews,ROA,24.0,33,14,893,86,204,0.422,5,22,0.227,81,182,0.445,0.434,157,217,0.724,77,81,158,53,58,10,74,129,334,2006
B. Matthews,ABQ,24.0,12,5,328,49,116,0.422,8,24,0.333,41,92,0.446,0.457,53,75,0.707,30,43,73,24,17,1,30,56,159,2006
J. McNeil,FLO,25.0,2,0,13,4,4,1.0,0,0,0.0,4,4,1.0,1.0,0,0,0.0,1,0,1,1,1,0,0,5,8,2006
R. Melzer,ABQ,26.0,14,0,340,47,119,0.395,16,32,0.5,31,87,0.356,0.462,25,37,0.676,19,27,46,20,8,3,14,40,135,2006
S. Merritt,AUS,24.0,43,41,1228,187,379,0.493,1,4,0.25,186,375,0.496,0.495,83,115,0.722,88,160,248,32,17,41,58,126,458,2006
A. Miles,FTW,22.0,27,20,755,105,231,0.455,4,11,0.364,101,220,0.459,0.463,59,75,0.787,17,62,79,178,30,1,59,68,273,2006
C. Miles,ABQ,18.0,11,9,309,45,108,0.417,11,33,0.333,34,75,0.453,0.468,39,56,0.696,10,28,38,18,11,4,23,34,140,2006
D. Miller,FAY,23.0,45,18,889,87,206,0.422,1,6,0.167,86,200,0.43,0.425,83,118,0.703,47,81,128,118,29,4,81,119,258,2006
S. Monia,FTW,22.0,8,0,180,25,60,0.417,4,14,0.286,21,46,0.457,0.45,13,16,0.813,8,19,27,13,5,5,10,32,67,2006
J. Moon,FTW,25.0,3,1,52,3,13,0.231,0,2,0.0,3,11,0.273,0.231,4,4,1.0,1,6,7,2,6,1,1,5,10,2006
J. Moore,FLO,23.0,37,1,417,59,139,0.424,0,4,0.0,59,135,0.437,0.424,40,59,0.678,30,38,68,22,12,9,24,37,158,2006
M. Moore,ROA,29.0,47,4,682,61,176,0.347,5,28,0.179,56,148,0.378,0.361,58,93,0.624,20,54,74,69,19,3,60,50,185,2006
A. Nichols,FLO,23.0,47,32,1327,200,447,0.447,15,41,0.366,185,406,0.456,0.464,116,134,0.866,36,104,140,80,32,7,51,100,531,2006
R. Orr,ABQ,23.0,15,4,237,36,76,0.474,0,2,0.0,36,74,0.486,0.474,7,8,0.875,8,32,40,8,3,8,13,12,79,2006
K. Owens,ROA,25.0,44,9,689,87,189,0.46,0,0,0.0,87,189,0.46,0.46,59,121,0.488,68,137,205,22,17,27,48,146,233,2006
P. Podkolzin,FTW,21.0,11,9,207,28,55,0.509,0,0,0.0,28,55,0.509,0.509,17,26,0.654,28,36,64,6,4,8,17,41,73,2006
J. Powell,FTW,23.0,3,2,89,22,31,0.71,0,0,0.0,22,31,0.71,0.71,9,11,0.818,10,11,21,1,2,2,6,7,53,2006
P. Ramos,ROA,20.0,43,40,1322,266,452,0.588,0,1,0.0,266,451,0.59,0.588,109,182,0.599,93,240,333,42,15,78,142,169,641,2006
R. Randle,FAY,24.0,33,8,668,96,188,0.511,0,2,0.0,96,186,0.516,0.511,60,84,0.714,81,69,150,22,20,11,27,86,252,2006
R. Rawlings,FLO,27.0,10,0,194,28,67,0.418,9,25,0.36,19,42,0.452,0.485,12,17,0.706,3,14,17,10,7,6,10,21,77,2006
K. Reid,ARK,30.0,48,43,1765,222,503,0.441,10,46,0.217,212,457,0.464,0.451,172,213,0.808,41,101,142,391,76,1,130,116,626,2006
G. Richardson,ARK,,10,0,59,2,14,0.143,1,3,0.333,1,11,0.091,0.179,0,0,0.0,1,6,7,9,4,0,2,8,5,2006
N. Richardson,FAY,26.0,22,5,516,81,203,0.399,27,60,0.45,54,143,0.378,0.466,63,87,0.724,14,55,69,28,9,4,33,42,252,2006
R. Rickert,FAY,22.0,26,17,639,101,215,0.47,0,3,0.0,101,212,0.476,0.47,40,65,0.615,63,118,181,33,15,6,37,64,242,2006
R. Riley,FAY,24.0,29,13,713,80,166,0.482,0,2,0.0,80,164,0.488,0.482,113,157,0.72,69,108,177,15,10,16,57,114,273,2006
A. Roberson,ARK,22.0,10,0,271,64,141,0.454,22,50,0.44,42,91,0.462,0.532,29,35,0.829,8,22,30,15,12,4,14,23,179,2006
L. Roberts,ARK,23.0,10,6,369,80,154,0.519,0,1,0.0,80,153,0.523,0.519,38,58,0.655,36,66,102,8,15,10,20,27,198,2006
B. Robinson,FTW,24.0,18,7,372,51,103,0.495,0,2,0.0,51,101,0.505,0.495,29,41,0.707,29,53,82,16,32,17,25,55,131,2006
B. Robinson,ABQ,24.0,22,17,532,76,157,0.484,0,4,0.0,76,153,0.497,0.484,49,64,0.766,49,43,92,33,25,12,29,45,201,2006
B. Robinson,TOT,24.0,40,24,904,127,260,0.488,0,6,0.0,127,254,0.5,0.488,78,105,0.743,78,96,174,49,57,29,54,100,332,2006
E. Rowland,FLO,25.0,44,7,756,100,211,0.474,3,12,0.25,97,199,0.487,0.481,41,67,0.612,14,95,109,131,42,8,52,66,244,2006
T. Sally,ROA,24.0,47,0,510,59,121,0.488,0,3,0.0,59,118,0.5,0.488,51,68,0.75,36,38,74,16,10,9,28,60,169,2006
C. Sanders,FLO,26.0,6,0,133,8,22,0.364,0,0,0.0,8,22,0.364,0.364,3,6,0.5,11,22,33,5,4,4,8,18,19,2006
M. Sanders,FAY,25.0,19,15,601,111,238,0.466,3,23,0.13,108,215,0.502,0.473,49,65,0.754,34,41,75,41,26,5,33,70,274,2006
A. Scales,AUS,27.0,23,6,583,72,177,0.407,26,73,0.356,46,104,0.442,0.48,53,65,0.815,6,46,52,42,24,8,41,52,223,2006
L. Schenscher,FTW,23.0,36,33,887,122,230,0.53,0,0,0.0,122,230,0.53,0.53,51,84,0.607,80,140,220,45,28,51,57,139,295,2006
H. Seung-Jin,FTW,20.0,5,0,72,5,14,0.357,0,0,0.0,5,14,0.357,0.357,0,4,0.0,7,12,19,1,0,1,6,13,10,2006
N. Sheppard,FTW,29.0,26,0,291,21,56,0.375,0,0,0.0,21,56,0.375,0.375,11,26,0.423,22,45,67,18,3,6,21,57,53,2006
R. Shields,FLO,23.0,12,0,127,17,47,0.362,5,11,0.455,12,36,0.333,0.415,3,6,0.5,5,5,10,8,2,0,5,8,42,2006
J. Shipp,ABQ,24.0,24,22,825,163,343,0.475,11,54,0.204,152,289,0.526,0.491,83,125,0.664,34,73,107,58,24,9,47,46,420,2006
C. Shumate,ARK,24.0,46,0,524,63,169,0.373,22,59,0.373,41,110,0.373,0.438,36,44,0.818,24,54,78,32,13,4,21,31,184,2006
D. Smith,ARK,22.0,29,22,965,158,278,0.568,10,31,0.323,148,247,0.599,0.586,76,104,0.731,33,91,124,86,47,19,68,92,402,2006
J. Smith,AUS,25.0,48,17,1397,225,500,0.45,0,5,0.0,225,495,0.455,0.45,97,153,0.634,98,246,344,53,33,23,83,97,547,2006
T. Smith,FLO,25.0,33,30,1108,170,380,0.447,2,9,0.222,168,371,0.453,0.45,146,177,0.825,62,151,213,95,17,12,76,80,488,2006
T. Sorrentine,FLO,23.0,14,0,210,21,67,0.313,6,22,0.273,15,45,0.333,0.358,3,4,0.75,4,11,15,29,8,0,7,25,51,2006
P. Sow,ARK,24.0,18,14,607,117,224,0.522,0,0,0.0,117,224,0.522,0.522,120,151,0.795,65,143,208,12,25,21,63,83,354,2006
L. Stokes,FLO,,20,16,669,87,203,0.429,0,2,0.0,87,201,0.433,0.429,52,92,0.565,22,44,66,109,26,9,59,35,226,2006
C. Suitt,TUL,26.0,8,6,138,9,15,0.6,0,0,0.0,9,15,0.6,0.6,3,6,0.5,12,16,28,1,4,10,17,21,21,2006
Y. Tabuse,ABQ,25.0,34,4,766,89,219,0.406,10,32,0.313,79,187,0.422,0.429,32,41,0.78,25,48,73,137,42,1,41,72,220,2006
J. Taylor,ROA,23.0,3,0,35,6,13,0.462,1,2,0.5,5,11,0.455,0.5,4,4,1.0,0,2,2,0,2,1,1,6,17,2006
M. Taylor,TOT,24.0,14,6,190,34,68,0.5,0,7,0.0,34,61,0.557,0.5,13,15,0.867,10,8,18,18,2,1,16,17,81,2006
M. Taylor,ABQ,24.0,6,6,131,18,39,0.462,0,4,0.0,18,35,0.514,0.462,12,14,0.857,7,7,14,12,2,1,11,10,48,2006
M. Taylor,TUL,24.0,8,0,59,16,29,0.552,0,3,0.0,16,26,0.615,0.552,1,1,1.0,3,1,4,6,0,0,5,7,33,2006
A. Terrell,FTW,24.0,48,21,1306,171,357,0.479,0,7,0.0,171,350,0.489,0.479,52,101,0.515,78,125,203,65,31,22,59,101,394,2006
H. Thomas,TOT,23.0,15,0,144,12,35,0.343,0,2,0.0,12,33,0.364,0.343,17,28,0.607,7,14,21,7,6,6,13,30,41,2006
H. Thomas,FLO,23.0,6,0,51,4,13,0.308,0,2,0.0,4,11,0.364,0.308,4,6,0.667,5,7,12,2,1,2,5,12,12,2006
H. Thomas,ARK,23.0,9,0,93,8,22,0.364,0,0,0.0,8,22,0.364,0.364,13,22,0.591,2,7,9,5,5,4,8,18,29,2006
O. Thomas,AUS,23.0,10,0,183,30,64,0.469,2,6,0.333,28,58,0.483,0.484,25,32,0.781,16,13,29,4,4,4,10,20,87,2006
D. Thompson,ABQ,22.0,3,3,117,18,48,0.375,5,8,0.625,13,40,0.325,0.427,12,16,0.75,5,18,23,2,4,1,5,7,53,2006
C. Toppert,ABQ,23.0,16,2,228,22,65,0.338,12,34,0.353,10,31,0.323,0.431,3,4,0.75,5,13,18,21,9,0,8,32,59,2006
C. Trybanski,TUL,26.0,45,15,728,56,103,0.544,0,0,0.0,56,103,0.544,0.544,48,68,0.706,60,87,147,20,16,88,48,102,160,2006
C. Tucker,ARK,25.0,47,39,1478,236,586,0.403,98,252,0.389,138,334,0.413,0.486,92,129,0.713,20,122,142,113,66,12,64,123,662,2006
I. Udoka,FTW,28.0,45,44,1542,275,637,0.432,37,121,0.306,238,516,0.461,0.461,183,251,0.729,68,210,278,155,83,18,133,160,770,2006
I. Victor,ROA,27.0,45,44,1631,293,601,0.488,3,12,0.25,290,589,0.492,0.49,255,335,0.761,95,265,360,95,41,7,127,147,844,2006
V. Wafer,FTW,20.0,8,0,148,23,69,0.333,7,31,0.226,16,38,0.421,0.384,11,13,0.846,4,16,20,7,2,0,11,10,64,2006
M. Walsh,ARK,23.0,11,1,230,30,78,0.385,16,46,0.348,14,32,0.438,0.487,16,19,0.842,3,28,31,23,5,2,15,25,92,2006
M. Webster,FTW,19.0,8,0,203,32,85,0.376,7,22,0.318,25,63,0.397,0.418,15,19,0.789,3,24,27,5,3,2,17,14,86,2006
Q. White,AUS,25.0,10,0,124,13,29,0.448,2,10,0.2,11,19,0.579,0.483,1,2,0.5,4,9,13,15,9,0,9,20,29,2006
A. Wilkins,TUL,25.0,22,0,152,12,41,0.293,2,15,0.133,10,26,0.385,0.317,6,9,0.667,0,20,20,16,3,0,9,8,32,2006
A. Wilkins,TOT,25.0,36,9,459,49,132,0.371,8,40,0.2,41,92,0.446,0.402,15,23,0.652,13,48,61,35,11,0,17,32,121,2006
A. Wilkins,FTW,25.0,14,9,307,37,91,0.407,6,25,0.24,31,66,0.47,0.44,9,14,0.643,13,28,41,19,8,0,8,24,89,2006
E. Williams,AUS,25.0,42,29,1158,194,418,0.464,57,145,0.393,137,273,0.502,0.532,81,97,0.835,46,114,160,78,48,9,69,118,526,2006
J. Williams,FAY,22.0,4,1,123,21,54,0.389,3,15,0.2,18,39,0.462,0.417,11,15,0.733,9,11,20,7,2,0,5,13,56,2006
B. Wright,FLO,21.0,30,30,1127,218,473,0.461,47,110,0.427,171,363,0.471,0.511,176,220,0.8,22,95,117,124,28,10,83,73,659,2006
D. Wright,FLO,20.0,6,0,124,33,64,0.516,1,3,0.333,32,61,0.525,0.523,6,6,1.0,9,14,23,11,3,2,14,7,73,2006
D. Zimmerman,AUS,24.0,45,43,1642,156,330,0.473,1,21,0.048,155,309,0.502,0.474,69,128,0.539,63,151,214,290,87,25,132,148,382,2006
B. Adams,CLB,25.0,8,0,143,23,40,0.575,0,1,0.0,23,39,0.59,0.575,18,22,0.818,3,11,14,22,8,0,16,15,64,2005
C. Alexander,ROA,31.0,32,32,1107,174,405,0.43,23,60,0.383,151,345,0.438,0.458,154,186,0.828,18,96,114,267,69,5,125,84,525,2005
J. Aubry,FLO,27.0,16,6,456,39,76,0.513,0,0,0.0,39,76,0.513,0.513,18,41,0.439,30,52,82,19,7,23,18,44,96,2005
S. Bang,ROA,21.0,41,24,1113,196,460,0.426,38,97,0.392,158,363,0.435,0.467,84,104,0.808,18,63,81,50,36,2,55,109,514,2005
E. Barron,HUN,23.0,45,23,1159,209,419,0.499,0,0,0.0,209,419,0.499,0.499,133,164,0.811,107,149,256,36,20,28,62,141,551,2005
M. Bateer,HUN,29.0,24,24,636,100,186,0.538,1,1,1.0,99,185,0.535,0.54,86,120,0.717,56,71,127,40,5,10,63,93,287,2005
M. Benton,CLB,24.0,48,45,1259,159,305,0.521,0,0,0.0,159,305,0.521,0.521,74,125,0.592,100,218,318,26,22,98,55,141,392,2005
R. Bias,HUN,25.0,43,39,1338,140,228,0.614,0,0,0.0,140,228,0.614,0.614,44,87,0.506,221,335,556,31,25,36,68,142,324,2005
R. Blackshear,HUN,26.0,20,0,289,68,154,0.442,9,24,0.375,59,130,0.454,0.471,10,13,0.769,3,13,16,6,6,2,20,20,155,2005
R. Boumtje-Boumtje,FAY,26.0,38,18,972,100,228,0.439,0,0,0.0,100,228,0.439,0.439,63,87,0.724,79,205,284,34,13,61,76,129,263,2005
T. Bowers,ASH,23.0,48,16,1370,198,411,0.482,5,32,0.156,193,379,0.509,0.488,61,74,0.824,36,131,167,192,60,8,89,65,462,2005
K. Braswell,CLB,26.0,12,0,250,47,125,0.376,2,16,0.125,45,109,0.413,0.384,15,17,0.882,5,18,23,32,9,1,21,15,111,2005
K. Braswell,TOT,26.0,27,10,711,121,304,0.398,9,40,0.225,112,264,0.424,0.413,54,62,0.871,14,52,66,137,32,4,69,54,305,2005
K. Braswell,FLO,26.0,15,10,461,74,179,0.413,7,24,0.292,67,155,0.432,0.433,39,45,0.867,9,34,43,105,23,3,48,39,194,2005
C. Brooks,FAY,23.0,11,1,231,36,61,0.59,1,2,0.5,35,59,0.593,0.598,32,43,0.744,13,17,30,5,7,4,19,31,105,2005
B. Brown,FAY,25.0,2,2,58,8,17,0.471,0,0,0.0,8,17,0.471,0.471,1,1,1.0,0,11,11,0,1,5,5,4,17,2005
D. Brown,HUN,25.0,32,26,1091,196,465,0.422,6,24,0.25,190,441,0.431,0.428,112,151,0.742,43,140,183,71,32,18,90,106,510,2005
E. Brown,FAY,25.0,22,20,726,120,265,0.453,0,1,0.0,120,264,0.455,0.453,75,114,0.658,51,119,170,27,13,38,66,74,315,2005
N. Burton,ASH,,10,0,177,16,40,0.4,0,0,0.0,16,40,0.4,0.4,14,16,0.875,3,9,12,9,4,1,9,19,46,2005
M. Carroll,ROA,24.0,24,18,761,177,352,0.503,23,38,0.605,154,314,0.49,0.536,106,123,0.862,14,53,67,38,26,11,43,56,483,2005
O. Cisse,FAY,22.0,48,33,1238,136,286,0.476,0,0,0.0,136,286,0.476,0.476,90,143,0.629,141,203,344,18,25,85,65,165,362,2005
D. Collins,FLO,24.0,12,0,156,11,34,0.324,0,1,0.0,11,33,0.333,0.324,5,17,0.294,18,34,52,8,3,11,9,26,27,2005
O. Cook,FAY,23.0,44,40,1677,205,508,0.404,11,31,0.355,194,477,0.407,0.414,87,121,0.719,35,124,159,380,92,5,103,112,508,2005
R. Curry,CLB,24.0,25,21,750,167,336,0.497,4,10,0.4,163,326,0.5,0.503,37,47,0.787,29,62,91,71,17,4,62,39,375,2005
K. Dartez,FLO,24.0,26,8,578,69,141,0.489,0,1,0.0,69,140,0.493,0.489,31,45,0.689,40,60,100,16,10,36,37,65,169,2005
D. Davenport,ASH,,2,0,39,5,7,0.714,0,0,0.0,5,7,0.714,0.714,8,10,0.8,1,6,7,1,1,4,2,10,18,2005
G. Davis,FAY,22.0,42,6,619,68,153,0.444,7,14,0.5,61,139,0.439,0.467,14,19,0.737,10,37,47,108,25,0,34,60,157,2005
K. Davis,HUN,22.0,13,0,261,30,67,0.448,0,1,0.0,30,66,0.455,0.448,16,31,0.516,22,41,63,10,7,23,14,43,76,2005
M. Davis,ROA,23.0,46,14,955,85,255,0.333,5,18,0.278,80,237,0.338,0.343,74,100,0.74,10,107,117,160,36,3,71,101,249,2005
T. Dobbins,ASH,23.0,47,6,918,96,233,0.412,1,7,0.143,95,226,0.42,0.414,38,62,0.613,43,109,152,62,56,18,34,84,231,2005
S. Doliboa,CLB,24.0,23,2,464,53,138,0.384,2,6,0.333,51,132,0.386,0.391,37,49,0.755,23,56,79,24,11,11,23,40,145,2005
S. Doliboa,TOT,24.0,45,18,1156,153,368,0.416,8,25,0.32,145,343,0.423,0.427,105,126,0.833,52,109,161,61,29,19,54,95,419,2005
S. Doliboa,ROA,24.0,22,16,692,100,230,0.435,6,19,0.316,94,211,0.445,0.448,68,77,0.883,29,53,82,37,18,8,31,55,274,2005
O. Ekezie,CLB,29.0,11,0,278,47,105,0.448,0,1,0.0,47,104,0.452,0.448,45,67,0.672,22,52,74,19,7,4,29,38,139,2005
C. English,FLO,23.0,48,29,1412,272,589,0.462,21,46,0.457,251,543,0.462,0.48,134,175,0.766,46,158,204,150,59,10,99,122,699,2005
S. Finn,TOT,23.0,44,2,702,65,111,0.586,0,0,0.0,65,111,0.586,0.586,13,47,0.277,45,110,155,9,7,24,26,108,143,2005
S. Finn,ROA,23.0,14,0,210,14,24,0.583,0,0,0.0,14,24,0.583,0.583,0,4,0.0,12,35,47,3,2,8,4,37,28,2005
S. Finn,FLO,23.0,20,0,273,28,50,0.56,0,0,0.0,28,50,0.56,0.56,8,21,0.381,21,46,67,5,3,8,11,37,64,2005
S. Finn,FAY,23.0,10,2,219,23,37,0.622,0,0,0.0,23,37,0.622,0.622,5,22,0.227,12,29,41,1,2,8,11,34,51,2005
J. Flippen,FLO,25.0,3,0,17,0,1,0.0,0,0,0.0,0,1,0.0,0.0,0,0,0.0,3,1,4,0,1,2,4,4,0,2005
J. Forte,ASH,23.0,39,6,880,194,404,0.48,7,22,0.318,187,382,0.49,0.489,70,94,0.745,36,92,128,87,47,6,58,62,465,2005
T. Fowlkes,FLO,28.0,10,3,248,28,80,0.35,1,6,0.167,27,74,0.365,0.356,35,58,0.603,12,29,41,12,17,1,11,25,92,2005
H. Fuller,FLO,23.0,41,38,1234,202,416,0.486,0,0,0.0,202,416,0.486,0.486,167,232,0.72,122,225,347,41,27,68,105,178,571,2005
S. Gay,ROA,22.0,48,7,951,143,289,0.495,0,0,0.0,143,289,0.495,0.495,82,126,0.651,78,75,153,17,22,41,55,95,368,2005
T. Hamilton,FAY,26.0,42,38,1486,268,508,0.528,1,8,0.125,267,500,0.534,0.529,125,171,0.731,63,227,290,91,42,23,69,84,662,2005
A. Harrington,CLB,24.0,35,1,770,152,351,0.433,20,44,0.455,132,307,0.43,0.462,68,85,0.8,16,51,67,53,26,3,51,71,392,2005
K. Haston,FLO,25.0,46,46,1672,314,689,0.456,4,9,0.444,310,680,0.456,0.459,122,173,0.705,102,261,363,74,49,74,72,156,754,2005
B. Hawkins,HUN,24.0,5,0,55,2,8,0.25,0,0,0.0,2,8,0.25,0.25,3,4,0.75,2,5,7,5,4,0,7,8,7,2005
C. Henderson,HUN,29.0,29,16,864,135,328,0.412,7,24,0.292,128,304,0.421,0.422,69,98,0.704,25,71,96,56,25,17,77,77,346,2005
T. Hill,ROA,22.0,8,0,75,4,15,0.267,0,1,0.0,4,14,0.286,0.267,5,10,0.5,2,9,11,4,5,0,2,8,13,2005
G. Hill-Thomas,ROA,,14,0,355,65,137,0.474,1,1,1.0,64,136,0.471,0.478,60,96,0.625,17,19,36,35,14,2,37,32,191,2005
L. Hurd,CLB,24.0,26,0,559,94,217,0.433,12,32,0.375,82,185,0.443,0.461,60,82,0.732,28,69,97,36,7,3,46,70,260,2005
A. Jones,FAY,25.0,7,4,110,10,26,0.385,0,0,0.0,10,26,0.385,0.385,4,5,0.8,5,7,12,4,1,0,8,2,24,2005
B. King,HUN,23.0,25,24,890,162,332,0.488,21,49,0.429,141,283,0.498,0.52,115,137,0.839,24,69,93,119,36,11,60,82,460,2005
M. King,TOT,26.0,44,4,1108,239,518,0.461,8,26,0.308,231,492,0.47,0.469,136,178,0.764,28,73,101,75,56,2,66,81,622,2005
M. King,ROA,26.0,8,0,194,44,96,0.458,1,5,0.2,43,91,0.473,0.464,25,29,0.862,5,10,15,15,11,0,13,14,114,2005
M. King,FAY,26.0,36,4,914,195,422,0.462,7,21,0.333,188,401,0.469,0.47,111,149,0.745,23,63,86,60,45,2,53,67,508,2005
T. Kitchings,ASH,25.0,48,43,1136,170,304,0.559,0,1,0.0,170,303,0.561,0.559,60,110,0.545,106,191,297,32,31,61,83,179,400,2005
B. Knight,ASH,23.0,22,22,625,90,209,0.431,6,16,0.375,84,193,0.435,0.445,46,72,0.639,23,56,79,111,39,0,61,62,232,2005
A. Landry,ROA,,10,2,206,22,73,0.301,1,9,0.111,21,64,0.328,0.308,11,17,0.647,1,9,10,23,5,1,18,18,56,2005
J. Lawson,CLB,30.0,4,3,65,7,13,0.538,0,0,0.0,7,13,0.538,0.538,5,8,0.625,6,7,13,0,1,4,3,11,19,2005
B. Matthews,HUN,23.0,10,0,203,28,78,0.359,0,3,0.0,28,75,0.373,0.359,24,34,0.706,32,27,59,14,11,3,27,36,80,2005
M. Mazur,ASH,26.0,14,3,194,22,52,0.423,0,0,0.0,22,52,0.423,0.423,7,10,0.7,17,30,47,5,3,11,6,23,51,2005
A. Meeking,ASH,23.0,23,23,750,177,347,0.51,2,4,0.5,175,343,0.51,0.513,90,133,0.677,47,131,178,37,13,10,35,69,446,2005
S. Merritt,CLB,23.0,41,40,1232,205,395,0.519,0,0,0.0,205,395,0.519,0.519,125,166,0.753,103,161,264,44,26,29,63,107,535,2005
C. Millage,FAY,23.0,1,0,6,0,2,0.0,0,0,0.0,0,2,0.0,0.0,0,0,0.0,0,1,1,0,0,0,2,2,0,2005
R. Minard,CLB,22.0,17,17,514,108,270,0.4,3,6,0.5,105,264,0.398,0.406,63,91,0.692,13,60,73,53,19,9,37,32,282,2005
J. Miskiri,HUN,29.0,40,38,1216,176,407,0.432,17,42,0.405,159,365,0.436,0.453,103,129,0.798,15,96,111,223,59,1,73,117,472,2005
M. Moore,FLO,24.0,45,19,1048,120,313,0.383,17,57,0.298,103,256,0.402,0.411,39,53,0.736,31,87,118,211,45,8,100,87,296,2005
B. Mouton,FLO,26.0,46,23,1098,152,300,0.507,2,7,0.286,150,293,0.512,0.51,119,159,0.748,65,68,133,71,37,5,74,99,425,2005
J. Myers,CLB,30.0,40,8,889,90,225,0.4,7,22,0.318,83,203,0.409,0.416,68,87,0.782,29,101,130,130,50,5,70,59,255,2005
A. Nichols,HUN,22.0,48,19,1120,182,410,0.444,7,23,0.304,175,387,0.452,0.452,125,142,0.88,41,77,118,44,28,8,43,129,496,2005
R. Orr,TOT,22.0,43,6,757,99,248,0.399,1,4,0.25,98,244,0.402,0.401,31,35,0.886,55,130,185,18,16,36,37,64,230,2005
R. Orr,HUN,22.0,27,3,366,46,107,0.43,0,1,0.0,46,106,0.434,0.43,7,9,0.778,22,55,77,13,7,20,22,30,99,2005
R. Orr,CLB,22.0,16,3,391,53,141,0.376,1,3,0.333,52,138,0.377,0.379,24,26,0.923,33,75,108,5,9,16,15,34,131,2005
K. Owens,ROA,24.0,48,47,1082,143,292,0.49,0,0,0.0,143,292,0.49,0.49,91,151,0.603,127,209,336,27,23,51,81,172,377,2005
A. Parada,HUN,23.0,23,1,317,45,87,0.517,0,0,0.0,45,87,0.517,0.517,29,40,0.725,24,54,78,12,12,16,26,55,119,2005
S. Parker,FLO,23.0,23,19,833,166,348,0.477,14,32,0.438,152,316,0.481,0.497,94,129,0.729,27,82,109,209,70,10,100,65,440,2005
K. Penney,ASH,24.0,46,40,1288,212,445,0.476,11,31,0.355,201,414,0.486,0.489,119,137,0.869,28,121,149,66,27,3,67,86,554,2005
A. Pettway,HUN,22.0,47,1,951,122,267,0.457,4,21,0.19,118,246,0.48,0.464,83,103,0.806,19,63,82,146,41,2,40,75,331,2005
T. Pickett,FLO,23.0,23,1,551,82,193,0.425,14,27,0.519,68,166,0.41,0.461,36,48,0.75,20,62,82,57,32,13,42,50,214,2005
R. Rawlings,CLB,26.0,48,47,1430,253,499,0.507,18,47,0.383,235,452,0.52,0.525,118,142,0.831,31,116,147,79,61,16,47,103,642,2005
K. Rhymer,CLB,26.0,31,5,687,47,115,0.409,0,0,0.0,47,115,0.409,0.409,47,65,0.723,48,104,152,15,8,47,35,89,141,2005
D. Rice,FLO,22.0,42,38,1254,175,435,0.402,7,40,0.175,168,395,0.425,0.41,85,98,0.867,54,123,177,82,30,17,87,98,442,2005
R. Rickert,ASH,21.0,12,1,217,32,69,0.464,0,1,0.0,32,68,0.471,0.464,16,17,0.941,9,29,38,7,3,5,11,32,80,2005
S. Ross,FAY,24.0,8,0,134,16,60,0.267,5,10,0.5,11,50,0.22,0.308,6,8,0.75,5,13,18,4,7,0,13,23,43,2005
J. Rowe,FAY,25.0,4,1,65,3,9,0.333,0,0,0.0,3,9,0.333,0.333,0,0,0.0,8,10,18,1,0,0,0,8,6,2005
C. Sanders,ROA,25.0,31,1,543,44,120,0.367,0,0,0.0,44,120,0.367,0.367,30,51,0.588,53,100,153,10,10,53,31,76,118,2005
E. Scott,HUN,23.0,8,8,201,15,48,0.313,0,1,0.0,15,47,0.319,0.313,7,10,0.7,6,7,13,14,7,0,24,21,37,2005
T. Shannon,ASH,25.0,19,15,551,86,183,0.47,0,0,0.0,86,183,0.47,0.47,76,106,0.717,31,59,90,32,20,16,37,56,248,2005
T. Shannon,TOT,25.0,40,36,1219,218,448,0.487,2,7,0.286,216,441,0.49,0.489,154,224,0.688,62,133,195,68,39,23,79,128,592,2005
T. Shannon,ROA,25.0,21,21,668,132,265,0.498,2,7,0.286,130,258,0.504,0.502,78,118,0.661,31,74,105,36,19,7,42,72,344,2005
J. Shipp,HUN,23.0,17,17,592,117,239,0.49,3,11,0.273,114,228,0.5,0.496,39,53,0.736,22,51,73,30,20,7,39,41,276,2005
R. Slay,ASH,23.0,48,22,1451,305,587,0.52,9,25,0.36,296,562,0.527,0.527,200,258,0.775,85,215,300,118,40,16,146,173,819,2005
J. Smith,FAY,22.0,46,19,1110,136,320,0.425,1,5,0.2,135,315,0.429,0.427,93,138,0.674,93,112,205,23,21,26,47,118,366,2005
L. Stokes,ASH,,42,39,1366,217,428,0.507,2,9,0.222,215,419,0.513,0.509,147,233,0.631,39,125,164,176,78,12,103,73,583,2005
C. Suitt,ASH,25.0,32,4,616,43,97,0.443,0,0,0.0,43,97,0.443,0.443,35,54,0.648,30,85,115,3,5,69,30,128,121,2005
J. Tate,ASH,28.0,1,0,11,1,1,1.0,0,0,0.0,1,1,1.0,1.0,4,6,0.667,2,6,8,0,0,0,0,1,6,2005
J. Thomas,ROA,24.0,36,35,1276,165,312,0.529,0,1,0.0,165,311,0.531,0.529,118,172,0.686,178,302,480,24,17,13,66,108,448,2005
D. Thornton,HUN,27.0,8,0,121,13,26,0.5,0,0,0.0,13,26,0.5,0.5,7,9,0.778,17,23,40,2,5,10,11,21,33,2005
L. Truscott,ASH,26.0,8,0,106,6,14,0.429,0,0,0.0,6,14,0.429,0.429,4,7,0.571,6,13,19,1,3,1,7,11,16,2005
I. Victor,ROA,26.0,41,19,1302,306,596,0.513,2,12,0.167,304,584,0.521,0.515,187,252,0.742,90,202,292,77,41,30,117,122,801,2005
T. Washington,FLO,25.0,31,0,404,38,97,0.392,0,2,0.0,38,95,0.4,0.392,49,65,0.754,30,47,77,18,7,5,23,56,125,2005
G. Williams,FAY,24.0,36,7,714,75,159,0.472,1,2,0.5,74,157,0.471,0.475,26,30,0.867,20,55,75,34,27,15,43,63,177,2005
G. Williams,TOT,24.0,40,11,844,93,194,0.479,2,3,0.667,91,191,0.476,0.485,36,46,0.783,28,67,95,40,27,15,51,79,224,2005
G. Williams,ROA,24.0,4,4,130,18,35,0.514,1,1,1.0,17,34,0.5,0.529,10,16,0.625,8,12,20,6,0,0,8,16,47,2005
N. Yanke,CLB,26.0,33,0,547,53,122,0.434,0,0,0.0,53,122,0.434,0.434,26,46,0.565,37,101,138,12,6,11,21,84,132,2005
D. Young,FAY,23.0,45,45,1391,303,664,0.456,21,66,0.318,282,598,0.472,0.472,204,250,0.816,27,72,99,79,38,7,112,123,831,2005
D. Zimmerman,CLB,23.0,48,48,1442,164,350,0.469,3,8,0.375,161,342,0.471,0.473,70,126,0.556,50,157,207,271,89,20,100,102,401,2005
R. Apodaca,HUN,23.0,25,7,640,91,221,0.412,23,59,0.39,68,162,0.42,0.464,62,73,0.849,9,28,37,42,19,5,33,47,267,2004
J. Asselin,ROA,25.0,46,36,1329,238,452,0.527,1,8,0.125,237,444,0.534,0.528,187,242,0.773,78,196,274,37,30,45,91,180,664,2004
A. Bangura,CHS,,45,35,1259,265,532,0.498,8,24,0.333,257,508,0.506,0.506,138,183,0.754,67,87,154,67,53,6,73,96,676,2004
E. Barkley,HUN,25.0,42,20,1275,201,491,0.409,14,66,0.212,187,425,0.44,0.424,127,157,0.809,31,121,152,151,64,5,82,114,543,2004
E. Barron,HUN,22.0,10,9,227,32,59,0.542,0,0,0.0,32,59,0.542,0.542,16,21,0.762,27,34,61,6,10,7,16,39,80,2004
R. Bias,HUN,24.0,36,11,877,81,153,0.529,0,1,0.0,81,152,0.533,0.529,30,62,0.484,157,207,364,15,25,45,27,101,192,2004
D. Bird,CLB,23.0,33,8,426,41,125,0.328,11,42,0.262,30,83,0.361,0.372,27,34,0.794,6,25,31,22,14,6,19,44,120,2004
B. Bracey,HUN,25.0,6,2,76,7,27,0.259,1,6,0.167,6,21,0.286,0.278,6,9,0.667,2,8,10,2,2,1,3,7,21,2004
B. Brown,FAY,24.0,20,1,361,57,118,0.483,4,24,0.167,53,94,0.564,0.5,46,59,0.78,8,36,44,37,6,2,37,23,164,2004
D. Brown,CHS,24.0,18,1,470,66,170,0.388,15,40,0.375,51,130,0.392,0.432,52,61,0.852,17,71,88,25,19,10,36,46,199,2004
D. Brown,TOT,24.0,26,5,718,118,279,0.423,24,62,0.387,94,217,0.433,0.466,82,101,0.812,27,96,123,46,26,17,56,69,342,2004
D. Brown,HUN,24.0,8,4,248,52,109,0.477,9,22,0.409,43,87,0.494,0.518,30,40,0.75,10,25,35,21,7,7,20,23,143,2004
E. Brown,FAY,24.0,11,10,326,62,110,0.564,0,0,0.0,62,110,0.564,0.564,33,49,0.673,24,75,99,10,11,16,26,39,157,2004
T. Brown,CHS,24.0,41,39,1387,286,652,0.439,14,65,0.215,272,587,0.463,0.449,177,222,0.797,25,110,135,265,74,5,144,58,763,2004
J. Capel,FAY,24.0,31,24,1043,134,281,0.477,22,68,0.324,112,213,0.526,0.516,107,129,0.829,48,93,141,84,39,12,69,110,397,2004
T. Carberry,ASH,25.0,12,1,227,28,80,0.35,9,28,0.321,19,52,0.365,0.406,11,11,1.0,7,12,19,10,6,5,7,25,76,2004
M. Carroll,ROA,23.0,11,2,356,62,146,0.425,12,33,0.364,50,113,0.442,0.466,35,39,0.897,6,25,31,25,6,2,14,19,171,2004
C. Christoffersen,ROA,24.0,14,0,193,31,59,0.525,0,1,0.0,31,58,0.534,0.525,14,25,0.56,19,31,50,7,2,7,15,47,76,2004
C. Christoffersen,FAY,24.0,11,5,138,17,35,0.486,0,0,0.0,17,35,0.486,0.486,1,15,0.067,14,17,31,3,2,14,8,34,35,2004
C. Christoffersen,TOT,24.0,25,5,331,48,94,0.511,0,1,0.0,48,93,0.516,0.511,15,40,0.375,33,48,81,10,4,21,23,81,111,2004
K. Christianson,CHS,29.0,9,0,135,11,17,0.647,0,0,0.0,11,17,0.647,0.647,3,5,0.6,8,16,24,0,1,2,12,35,25,2004
S. Clancy,FAY,23.0,1,0,15,2,5,0.4,0,0,0.0,2,5,0.4,0.4,3,6,0.5,0,1,1,0,1,0,1,0,7,2004
M. Cleaves,HUN,26.0,42,27,1235,209,459,0.455,13,26,0.5,196,433,0.453,0.469,145,186,0.78,26,156,182,248,45,3,121,144,576,2004
J. Collier,FAY,26.0,30,21,845,159,348,0.457,2,13,0.154,157,335,0.469,0.46,142,175,0.811,76,140,216,24,15,24,80,95,462,2004
O. Cook,FAY,22.0,24,24,981,84,239,0.351,4,33,0.121,80,206,0.388,0.36,73,93,0.785,21,68,89,215,63,4,81,72,245,2004
T. Crutchfield,CLB,24.0,18,12,427,65,164,0.396,12,35,0.343,53,129,0.411,0.433,33,54,0.611,22,27,49,20,7,4,34,43,175,2004
P. Doctor,CLB,23.0,3,0,65,8,20,0.4,0,0,0.0,8,20,0.4,0.4,15,19,0.789,7,7,14,0,2,0,5,14,31,2004
K. Duany,FAY,23.0,3,0,38,4,10,0.4,0,1,0.0,4,9,0.444,0.4,2,6,0.333,1,3,4,0,0,1,3,4,10,2004
R. Dupree,HUN,23.0,15,15,483,104,187,0.556,1,6,0.167,103,181,0.569,0.559,45,59,0.763,25,44,69,22,23,5,42,46,254,2004
C. Eidson,CHS,23.0,32,7,707,84,193,0.435,12,32,0.375,72,161,0.447,0.466,56,73,0.767,44,67,111,55,47,9,33,53,236,2004
R. Elliott,ROA,30.0,8,0,146,19,41,0.463,3,10,0.3,16,31,0.516,0.5,13,15,0.867,5,17,22,14,9,1,24,22,54,2004
C. English,CHS,22.0,45,2,861,132,347,0.38,50,145,0.345,82,202,0.406,0.452,66,93,0.71,21,70,91,39,30,3,57,83,380,2004
M. Fleming,HUN,25.0,36,8,818,95,213,0.446,1,4,0.25,94,209,0.45,0.448,107,155,0.69,66,147,213,20,23,11,50,80,298,2004
I. Fontaine,HUN,28.0,8,8,228,30,82,0.366,5,24,0.208,25,58,0.431,0.396,19,24,0.792,5,23,28,16,4,2,15,24,84,2004
H. Fuller,CHS,22.0,40,9,945,114,252,0.452,0,2,0.0,114,250,0.456,0.452,85,143,0.594,93,186,279,28,21,76,79,160,313,2004
C. Gadson,HUN,23.0,34,0,523,84,194,0.433,3,12,0.25,81,182,0.445,0.441,45,60,0.75,16,47,63,51,13,3,52,44,216,2004
J. Gee,CHS,28.0,26,0,384,47,108,0.435,0,2,0.0,47,106,0.443,0.435,12,17,0.706,28,52,80,21,5,9,19,55,106,2004
W. Gibbs,CHS,,2,0,8,0,2,0.0,0,0,0.0,0,2,0.0,0.0,1,2,0.5,0,2,2,0,0,0,0,0,1,2004
C. Gray,FAY,,24,4,346,31,88,0.352,7,22,0.318,24,66,0.364,0.392,25,33,0.758,9,38,47,64,10,0,33,36,94,2004
R. Grizzard,HUN,23.0,44,38,1375,224,524,0.427,35,120,0.292,189,404,0.468,0.461,132,164,0.805,41,175,216,121,43,31,78,120,615,2004
J. Hamilton,ROA,,12,2,223,25,59,0.424,2,14,0.143,23,45,0.511,0.441,8,11,0.727,5,21,26,25,14,0,14,23,60,2004
D. Hand,ROA,24.0,13,0,176,13,53,0.245,2,19,0.105,11,34,0.324,0.264,13,20,0.65,3,12,15,35,17,1,26,30,41,2004
L. Harrell,CLB,31.0,11,8,272,42,113,0.372,10,25,0.4,32,88,0.364,0.416,27,34,0.794,8,16,24,23,8,5,28,23,121,2004
A. Harrington,CLB,23.0,17,9,448,66,162,0.407,19,45,0.422,47,117,0.402,0.466,39,48,0.813,6,23,29,29,16,3,29,43,190,2004
C. Henderson,FAY,28.0,13,10,400,68,152,0.447,4,15,0.267,64,137,0.467,0.461,38,50,0.76,17,37,54,17,27,9,29,33,178,2004
R. Hill,CHS,26.0,13,9,319,49,104,0.471,4,16,0.25,45,88,0.511,0.49,18,22,0.818,18,45,63,12,6,3,28,35,120,2004
C. James,CLB,27.0,46,46,1567,162,348,0.466,0,3,0.0,162,345,0.47,0.466,99,170,0.582,107,270,377,106,22,26,98,131,423,2004
L. Jerry,ASH,,5,0,31,4,12,0.333,1,4,0.25,3,8,0.375,0.375,0,0,0.0,0,4,4,1,1,0,2,1,9,2004
B. Johnsen,FAY,24.0,34,27,1057,176,372,0.473,18,49,0.367,158,323,0.489,0.497,125,170,0.735,52,150,202,62,27,12,73,116,495,2004
D. Johns,TOT,27.0,44,15,905,145,275,0.527,0,0,0.0,145,275,0.527,0.527,46,74,0.622,76,171,247,20,21,43,62,116,336,2004
D. Johns,ROA,27.0,12,0,233,36,71,0.507,0,0,0.0,36,71,0.507,0.507,19,35,0.543,19,48,67,6,6,6,16,33,91,2004
D. Johns,FAY,27.0,32,15,672,109,204,0.534,0,0,0.0,109,204,0.534,0.534,27,39,0.692,57,123,180,14,15,37,46,83,245,2004
K. Johnson,HUN,25.0,40,27,1020,129,268,0.481,0,1,0.0,129,267,0.483,0.481,81,110,0.736,49,146,195,34,9,97,75,120,339,2004
D. Jones,CLB,24.0,6,0,68,8,25,0.32,0,3,0.0,8,22,0.364,0.32,13,19,0.684,3,3,6,1,2,0,8,12,29,2004
M. King,ROA,25.0,46,25,1115,148,368,0.402,18,58,0.31,130,310,0.419,0.427,105,144,0.729,38,102,140,71,50,3,54,109,419,2004
B. Knight,ASH,22.0,38,37,907,128,273,0.469,5,25,0.2,123,248,0.496,0.478,41,61,0.672,17,72,89,186,68,7,63,98,302,2004
D. Knight,FAY,24.0,5,0,56,3,13,0.231,0,2,0.0,3,11,0.273,0.231,2,4,0.5,4,3,7,3,1,0,6,6,8,2004
B. Kurtz,ASH,25.0,33,1,832,165,344,0.48,1,4,0.25,164,340,0.482,0.481,115,165,0.697,76,156,232,30,23,34,50,125,446,2004
J. Lang,ASH,20.0,3,1,54,5,15,0.333,0,0,0.0,5,15,0.333,0.333,4,11,0.364,2,10,12,2,0,3,2,9,14,2004
K. Lang,ASH,24.0,44,44,1182,206,336,0.613,0,0,0.0,206,336,0.613,0.613,74,129,0.574,82,181,263,71,22,63,75,120,486,2004
R. LaRue,ASH,30.0,27,1,671,98,216,0.454,43,87,0.494,55,129,0.426,0.553,41,49,0.837,12,46,58,59,30,3,35,59,280,2004
M. Laur,CLB,23.0,9,0,73,11,18,0.611,0,0,0.0,11,18,0.611,0.611,2,2,1.0,5,12,17,4,2,1,4,11,24,2004
J. Locklier,CLB,,9,0,78,7,18,0.389,0,0,0.0,7,18,0.389,0.389,4,11,0.364,6,5,11,4,0,0,4,15,18,2004
B. Lucas,FAY,25.0,45,39,1461,231,460,0.502,16,43,0.372,215,417,0.516,0.52,128,167,0.766,103,264,367,39,33,14,79,155,606,2004
K. Lyde,CLB,23.0,46,46,1299,206,415,0.496,2,5,0.4,204,410,0.498,0.499,65,125,0.52,72,212,284,83,15,75,72,179,479,2004
E. Maxey,CLB,25.0,45,36,1331,199,466,0.427,29,88,0.33,170,378,0.45,0.458,129,179,0.721,69,128,197,67,34,5,83,112,556,2004
M. Mazur,ROA,25.0,4,0,39,4,7,0.571,0,0,0.0,4,7,0.571,0.571,3,4,0.75,3,3,6,0,1,0,2,6,11,2004
M. Mazur,FAY,25.0,10,0,190,20,36,0.556,0,0,0.0,20,36,0.556,0.556,7,11,0.636,10,26,36,8,2,4,2,18,47,2004
M. Mazur,CLB,25.0,10,0,147,13,34,0.382,0,0,0.0,13,34,0.382,0.382,8,13,0.615,7,24,31,1,1,3,6,19,34,2004
M. Mazur,ASH,25.0,6,0,82,5,13,0.385,0,0,0.0,5,13,0.385,0.385,3,6,0.5,5,11,16,4,0,2,4,10,13,2004
M. Mazur,TOT,25.0,30,0,458,42,90,0.467,0,0,0.0,42,90,0.467,0.467,21,34,0.618,25,64,89,13,4,9,14,53,105,2004
A. Meeking,ASH,22.0,46,14,1077,182,397,0.458,0,2,0.0,182,395,0.461,0.458,151,214,0.706,85,164,249,34,25,18,61,125,515,2004
J. Miskiri,CHS,28.0,41,7,833,104,251,0.414,36,108,0.333,68,143,0.476,0.486,72,90,0.8,21,65,86,153,58,1,72,111,316,2004
J. Moon,HUN,23.0,1,0,13,2,4,0.5,0,2,0.0,2,2,1.0,0.5,0,0,0.0,0,1,1,0,2,2,1,1,4,2004
M. Moore,ROA,28.0,17,17,687,122,226,0.54,2,10,0.2,120,216,0.556,0.544,101,132,0.765,40,112,152,48,16,29,45,60,347,2004
T. Morris,CLB,25.0,46,5,1220,220,482,0.456,26,80,0.325,194,402,0.483,0.483,60,83,0.723,88,252,340,87,32,72,84,120,526,2004
J. Myers,CLB,29.0,36,5,936,146,313,0.466,28,68,0.412,118,245,0.482,0.511,131,154,0.851,43,105,148,156,52,1,92,90,451,2004
M. N'Diaye,ASH,28.0,6,0,126,16,34,0.471,0,0,0.0,16,34,0.471,0.471,21,30,0.7,10,28,38,1,4,11,7,22,53,2004
N. Neumann,FAY,,1,0,1,1,1,1.0,0,0,0.0,1,1,1.0,1.0,0,0,0.0,0,0,0,0,0,0,0,0,2,2004
I. Nwankwo,HUN,,15,1,269,14,47,0.298,0,0,0.0,14,47,0.298,0.298,9,20,0.45,30,48,78,2,10,12,23,53,37,2004
G. Owens,ROA,25.0,45,39,1080,129,265,0.487,0,0,0.0,129,265,0.487,0.487,106,189,0.561,97,219,316,42,24,39,65,182,364,2004
K. Owens,ROA,23.0,44,1,538,65,129,0.504,0,1,0.0,65,128,0.508,0.504,50,99,0.505,41,122,163,16,11,26,31,126,180,2004
D. Penigar,ASH,22.0,38,33,1109,308,608,0.507,32,86,0.372,276,522,0.529,0.533,98,125,0.784,63,182,245,54,52,20,69,129,746,2004
M. Perry,ROA,23.0,44,44,1728,242,539,0.449,19,54,0.352,223,485,0.46,0.467,175,218,0.803,28,163,191,295,67,4,170,89,678,2004
S. Peterson,CLB,,9,3,187,20,46,0.435,4,10,0.4,16,36,0.444,0.478,4,8,0.5,2,12,14,18,4,1,14,12,48,2004
A. Pettway,FAY,24.0,1,0,5,1,1,1.0,0,0,0.0,1,1,1.0,1.0,0,0,0.0,0,0,0,0,0,1,0,1,2,2004
W. Pippen,HUN,23.0,10,0,111,11,36,0.306,4,14,0.286,7,22,0.318,0.361,2,4,0.5,2,5,7,7,5,1,6,7,28,2004
L. Postell,ASH,25.0,45,44,1445,202,475,0.425,33,98,0.337,169,377,0.448,0.46,149,182,0.819,49,149,198,132,37,14,80,115,586,2004
R. Rawlings,ASH,25.0,7,0,134,22,50,0.44,12,28,0.429,10,22,0.455,0.56,9,9,1.0,4,6,10,6,7,3,7,17,65,2004
R. Rawlings,TOT,25.0,11,0,228,40,86,0.465,18,45,0.4,22,41,0.537,0.57,13,13,1.0,7,13,20,11,12,4,12,23,111,2004
R. Rawlings,CLB,25.0,4,0,94,18,36,0.5,6,17,0.353,12,19,0.632,0.583,4,4,1.0,3,7,10,5,5,1,5,6,46,2004
D. Reid,ASH,25.0,3,0,69,14,28,0.5,1,1,1.0,13,27,0.481,0.518,2,4,0.5,1,3,4,16,1,0,3,5,31,2004
K. Reid,ASH,28.0,43,9,1238,188,409,0.46,15,53,0.283,173,356,0.486,0.478,126,158,0.797,24,81,105,290,47,2,90,88,517,2004
L. Reid,HUN,24.0,2,0,23,1,8,0.125,0,0,0.0,1,8,0.125,0.125,0,0,0.0,0,1,1,6,0,0,1,3,2,2004
P. Ricci,HUN,23.0,45,44,1243,247,470,0.526,1,7,0.143,246,463,0.531,0.527,137,190,0.721,92,151,243,59,28,29,90,119,632,2004
R. Roberts,CHS,25.0,46,37,1157,177,337,0.525,0,3,0.0,177,334,0.53,0.525,68,158,0.43,101,179,280,34,40,55,83,157,422,2004
T. Rutland,CHS,28.0,3,0,20,2,6,0.333,1,4,0.25,1,2,0.5,0.417,0,0,0.0,0,3,3,0,2,0,5,1,5,2004
J. Sanders,FAY,31.0,44,29,1445,277,616,0.45,19,69,0.275,258,547,0.472,0.465,170,211,0.806,77,101,178,120,52,3,117,125,743,2004
K. Satterfield,FAY,22.0,18,17,692,111,293,0.379,29,78,0.372,82,215,0.381,0.428,83,107,0.776,23,55,78,124,36,1,76,53,334,2004
A. Scales,HUN,25.0,12,9,365,76,158,0.481,3,25,0.12,73,133,0.549,0.491,26,34,0.765,8,21,29,23,24,3,23,23,181,2004
K. Shabazz,CHS,25.0,46,45,1331,113,206,0.549,0,0,0.0,113,206,0.549,0.549,75,114,0.658,111,237,348,43,46,96,68,160,301,2004
T. Shannon,ROA,24.0,34,5,936,161,355,0.454,4,25,0.16,157,330,0.476,0.459,139,187,0.743,49,113,162,45,20,20,89,121,465,2004
N. Sheppard,TOT,27.0,33,0,600,80,188,0.426,0,0,0.0,80,188,0.426,0.426,48,84,0.571,50,118,168,24,10,3,66,108,208,2004
N. Sheppard,HUN,27.0,8,0,141,18,46,0.391,0,0,0.0,18,46,0.391,0.391,7,13,0.538,17,30,47,3,1,1,17,31,43,2004
N. Sheppard,CLB,27.0,25,0,459,62,142,0.437,0,0,0.0,62,142,0.437,0.437,41,71,0.577,33,88,121,21,9,2,49,77,165,2004
A. Smith,ASH,,8,0,99,11,37,0.297,2,17,0.118,9,20,0.45,0.324,5,8,0.625,3,3,6,10,7,0,8,16,29,2004
C. Staples,ROA,27.0,44,14,958,128,325,0.394,55,151,0.364,73,174,0.42,0.478,78,92,0.848,7,48,55,33,24,0,33,78,389,2004
G. Stevenson,TOT,25.0,44,31,1246,189,332,0.569,8,21,0.381,181,311,0.582,0.581,91,124,0.734,66,143,209,85,63,11,49,85,477,2004
G. Stevenson,FAY,25.0,6,3,139,20,41,0.488,0,0,0.0,20,41,0.488,0.488,5,6,0.833,2,14,16,11,7,0,7,8,45,2004
G. Stevenson,ASH,25.0,38,28,1107,169,291,0.581,8,21,0.381,161,270,0.596,0.595,86,118,0.729,64,129,193,74,56,11,42,77,432,2004
L. Stokes,ASH,,16,0,276,29,57,0.509,0,1,0.0,29,56,0.518,0.509,18,27,0.667,20,25,45,23,20,10,14,22,76,2004
I. Udoka,CHS,26.0,41,39,1274,252,548,0.46,43,122,0.352,209,426,0.491,0.499,147,206,0.714,78,217,295,104,64,15,115,139,694,2004
S. Webber,CLB,27.0,17,9,599,112,259,0.432,13,45,0.289,99,214,0.463,0.458,81,96,0.844,33,53,86,33,27,5,47,58,318,2004
E. Williams,CLB,23.0,11,5,251,48,108,0.444,11,23,0.478,37,85,0.435,0.495,18,23,0.783,11,22,33,16,8,3,28,24,125,2004
G. Williams,ASH,,20,17,489,59,131,0.45,8,25,0.32,51,106,0.481,0.481,38,40,0.95,17,46,63,19,11,1,34,56,164,2004
G. Williams,ROA,23.0,45,45,1457,222,447,0.497,2,15,0.133,220,432,0.509,0.499,78,119,0.655,76,179,255,89,21,15,109,134,524,2004
K. Williams,FAY,22.0,46,1,661,80,190,0.421,45,100,0.45,35,90,0.389,0.539,56,72,0.778,8,34,42,59,24,3,31,47,261,2004
T. Williams,FAY,26.0,15,0,168,22,44,0.5,0,0,0.0,22,44,0.5,0.5,10,13,0.769,13,18,31,2,5,17,13,23,54,2004
V. Williams,ROA,24.0,2,0,21,3,13,0.231,0,3,0.0,3,10,0.3,0.231,3,6,0.5,1,0,1,3,2,0,3,3,9,2004
D. Zimmerman,CLB,22.0,45,38,1243,127,280,0.454,5,20,0.25,122,260,0.469,0.463,68,112,0.607,43,172,215,238,58,15,83,99,327,2004
L. Abney,ASH,25.0,50,48,1293,163,357,0.457,3,8,0.375,160,349,0.458,0.461,108,157,0.688,92,188,280,60,38,6,85,119,437,2003
C. Alexander,ROA,29.0,50,50,1794,288,693,0.416,65,208,0.313,223,485,0.46,0.462,186,230,0.809,36,170,206,306,99,10,198,144,827,2003
R. Alston,MOB,26.0,6,5,217,38,84,0.452,6,13,0.462,32,71,0.451,0.488,13,17,0.765,6,17,23,58,9,0,21,17,95,2003
C. Anderson,GRE,28.0,3,0,43,4,10,0.4,0,0,0.0,4,10,0.4,0.4,1,2,0.5,0,4,4,0,2,0,5,9,9,2003
J. Aubry,FAY,25.0,50,49,1219,129,258,0.5,0,0,0.0,129,258,0.5,0.5,75,125,0.6,82,194,276,39,24,70,62,161,333,2003
A. Bangura,NCH,,23,2,418,82,160,0.513,0,4,0.0,82,156,0.526,0.513,42,63,0.667,36,28,64,17,13,0,24,40,206,2003
M. Barnes,FAY,22.0,50,12,932,172,442,0.389,61,175,0.349,111,267,0.416,0.458,79,113,0.699,47,117,164,56,44,13,86,87,484,2003
C. Benjamin,NCH,24.0,38,29,1064,231,502,0.46,36,84,0.429,195,418,0.467,0.496,134,177,0.757,45,112,157,64,30,18,91,131,632,2003
R. Bias,HUN,23.0,49,9,863,118,206,0.573,0,1,0.0,118,205,0.576,0.573,36,80,0.45,153,209,362,40,15,50,53,135,272,2003
C. Bowman,GRE,25.0,4,0,13,0,5,0.0,0,0,0.0,0,5,0.0,0.0,4,4,1.0,2,1,3,0,0,1,0,3,4,2003
R. Brewer,NCH,,1,0,8,0,1,0.0,0,0,0.0,0,1,0.0,0.0,1,2,0.5,0,0,0,0,1,1,0,1,1,2003
D. Brown,NCH,23.0,42,26,1141,201,477,0.421,24,58,0.414,177,419,0.422,0.447,98,131,0.748,61,161,222,73,46,25,73,143,524,2003
D. Brown,FAY,24.0,44,40,1086,270,540,0.5,17,46,0.37,253,494,0.512,0.516,185,225,0.822,67,115,182,88,38,8,69,108,742,2003
E. Brown,MOB,23.0,50,42,1255,203,405,0.501,0,0,0.0,203,405,0.501,0.501,124,188,0.66,92,186,278,35,20,68,83,146,530,2003
S. Brown,ROA,23.0,48,19,628,38,103,0.369,0,1,0.0,38,102,0.373,0.369,59,94,0.628,40,60,100,7,15,7,37,89,135,2003
T. Brown,NCH,23.0,44,44,1240,250,510,0.49,15,42,0.357,235,468,0.502,0.505,177,200,0.885,38,129,167,216,58,7,130,76,692,2003
V. Brown,ROA,22.0,8,0,65,9,32,0.281,2,14,0.143,7,18,0.389,0.313,8,12,0.667,3,6,9,6,7,0,3,10,28,2003
C. Bunton,ROA,30.0,14,0,274,32,66,0.485,2,8,0.25,30,58,0.517,0.5,3,16,0.188,27,35,62,8,5,4,19,32,69,2003
J. Capel,FAY,23.0,42,42,1059,151,314,0.481,28,77,0.364,123,237,0.519,0.525,154,174,0.885,48,106,154,83,34,12,72,96,484,2003
T. Carberry,NCH,24.0,34,6,479,85,181,0.47,9,38,0.237,76,143,0.531,0.494,21,29,0.724,20,23,43,25,15,3,24,59,200,2003
G. Carlisle,MOB,26.0,2,2,53,5,12,0.417,0,1,0.0,5,11,0.455,0.417,2,2,1.0,0,5,5,7,1,0,3,3,12,2003
R. Carroll,ASH,23.0,25,0,380,40,95,0.421,20,48,0.417,20,47,0.426,0.526,32,41,0.78,13,37,50,15,13,5,24,46,132,2003
E. Chenowith,HUN,23.0,33,28,732,90,240,0.375,0,1,0.0,90,239,0.377,0.375,96,119,0.807,60,121,181,52,5,26,66,124,276,2003
S. Colson,MOB,27.0,9,7,253,44,101,0.436,7,16,0.438,37,85,0.435,0.47,31,35,0.886,14,17,31,44,4,1,30,18,126,2003
R. Conley,GRE,,2,0,32,4,11,0.364,1,4,0.25,3,7,0.429,0.409,5,8,0.625,0,3,3,1,0,0,3,4,14,2003
O. Cook,FAY,21.0,50,2,1099,124,342,0.363,34,107,0.318,90,235,0.383,0.412,87,123,0.707,20,97,117,268,78,3,106,116,369,2003
P. Cornell,NCH,26.0,35,26,877,123,207,0.594,0,0,0.0,123,207,0.594,0.594,61,122,0.5,74,135,209,25,21,44,98,132,307,2003
R. Dalmau,ROA,29.0,11,0,181,26,60,0.433,2,8,0.25,24,52,0.462,0.45,19,24,0.792,2,21,23,33,7,0,21,24,73,2003
R. Dalmau,FAY,29.0,3,0,20,1,4,0.25,0,0,0.0,1,4,0.25,0.25,0,2,0.0,0,2,2,2,2,0,2,5,2,2003
R. Dalmau,TOT,29.0,14,0,201,27,64,0.422,2,8,0.25,25,56,0.446,0.438,19,26,0.731,2,23,25,35,9,0,23,29,75,2003
S. Daugherty,CLB,27.0,50,34,983,131,338,0.388,18,68,0.265,113,270,0.419,0.414,26,57,0.456,84,139,223,34,15,13,56,123,306,2003
T. Delaney,NCH,29.0,30,13,544,43,99,0.434,0,0,0.0,43,99,0.434,0.434,12,29,0.414,46,106,152,14,9,10,34,52,98,2003
D. Dixon,NCH,24.0,8,0,70,3,11,0.273,0,0,0.0,3,11,0.273,0.273,9,11,0.818,8,7,15,2,2,2,3,12,15,2003
T. Dupay,MOB,23.0,6,2,84,14,37,0.378,6,16,0.375,8,21,0.381,0.459,7,10,0.7,3,7,10,7,5,0,10,6,41,2003
E. Edgerson,MOB,24.0,50,24,1212,108,203,0.532,0,0,0.0,108,203,0.532,0.532,131,164,0.799,129,193,322,47,28,8,76,136,347,2003
C. Eldridge,NCH,,16,5,196,8,31,0.258,0,9,0.0,8,22,0.364,0.258,0,0,0.0,2,13,15,26,6,1,15,18,16,2003
E. Elisma,ASH,27.0,50,27,1047,115,303,0.38,7,21,0.333,108,282,0.383,0.391,69,104,0.663,77,136,213,53,26,25,72,119,306,2003
D. Evans,ASH,,4,0,63,3,11,0.273,0,2,0.0,3,9,0.333,0.273,8,12,0.667,12,6,18,1,3,0,3,14,14,2003
M. Evans,CLB,,6,0,56,5,13,0.385,0,0,0.0,5,13,0.385,0.385,2,5,0.4,4,4,8,0,0,0,6,9,12,2003
L. Fernando,GRE,,11,3,149,20,49,0.408,0,0,0.0,20,49,0.408,0.408,11,19,0.579,10,20,30,5,3,3,14,27,51,2003
M. Fleming,HUN,24.0,3,0,44,4,10,0.4,0,1,0.0,4,9,0.444,0.4,9,10,0.9,6,8,14,5,0,1,4,6,17,2003
I. Fontaine,MOB,27.0,48,40,1205,190,452,0.42,61,138,0.442,129,314,0.411,0.488,116,138,0.841,35,76,111,103,41,2,92,124,557,2003
G. Giannoulis,HUN,26.0,2,0,7,0,1,0.0,0,0,0.0,0,1,0.0,0.0,0,0,0.0,1,0,1,0,0,0,1,1,0,2003
E. Gill,ASH,24.0,35,34,1085,147,333,0.441,28,85,0.329,119,248,0.48,0.483,117,133,0.88,23,101,124,182,42,15,86,94,439,2003
J. Goodman,ASH,,1,0,12,0,1,0.0,0,0,0.0,0,1,0.0,0.0,0,0,0.0,0,2,2,1,0,0,1,2,0,2003
P. Grant,ASH,29.0,24,16,562,98,217,0.452,0,5,0.0,98,212,0.462,0.452,53,75,0.707,33,80,113,19,7,14,40,65,249,2003
C. Gray,NCH,,1,0,22,4,6,0.667,1,1,1.0,3,5,0.6,0.75,2,2,1.0,1,0,1,2,3,0,1,3,11,2003
G. Gray,GRE,,48,38,981,126,287,0.439,2,28,0.071,124,259,0.479,0.443,65,100,0.65,49,87,136,45,63,8,69,64,319,2003
N. Green,CLB,25.0,37,35,1097,128,350,0.366,38,121,0.314,90,229,0.393,0.42,112,145,0.772,16,131,147,189,39,10,70,96,406,2003
L. Greer,GRE,23.0,13,0,243,44,92,0.478,8,25,0.32,36,67,0.537,0.522,25,34,0.735,8,13,21,27,4,1,21,18,121,2003
R. Grizzard,MOB,22.0,49,2,766,102,255,0.4,16,60,0.267,86,195,0.441,0.431,48,60,0.8,33,92,125,37,21,6,52,67,268,2003
A. Guyton,HUN,24.0,30,21,727,126,283,0.445,41,97,0.423,85,186,0.457,0.518,34,45,0.756,21,48,69,68,14,5,43,49,327,2003
T. Hamilton,CLB,24.0,50,50,1615,298,587,0.508,2,12,0.167,296,575,0.515,0.509,176,247,0.713,142,310,452,98,42,26,99,128,774,2003
T. Hamilton,GRE,27.0,6,0,71,10,18,0.556,0,1,0.0,10,17,0.588,0.556,5,11,0.455,4,15,19,2,2,0,11,15,25,2003
D. Hand,GRE,23.0,50,50,1375,154,419,0.368,52,162,0.321,102,257,0.397,0.43,208,249,0.835,44,136,180,247,68,1,144,141,568,2003
L. Harrell,HUN,30.0,50,44,1465,227,562,0.404,72,203,0.355,155,359,0.432,0.468,144,194,0.742,30,164,194,140,47,23,144,143,670,2003
C. Henderson,MOB,27.0,31,29,880,172,452,0.381,16,61,0.262,156,391,0.399,0.398,115,147,0.782,27,92,119,52,41,18,87,87,475,2003
B. Hendrix,HUN,25.0,50,41,1400,208,472,0.441,22,82,0.268,186,390,0.477,0.464,127,165,0.77,84,196,280,66,16,20,104,130,565,2003
D. Hood,MOB,26.0,48,43,1255,178,328,0.543,1,2,0.5,177,326,0.543,0.544,129,185,0.697,151,248,399,69,26,7,88,180,486,2003
S. Igo,GRE,28.0,14,1,211,23,48,0.479,1,1,1.0,22,47,0.468,0.49,24,37,0.649,30,36,66,2,2,13,22,31,71,2003
S. Igo,CLB,28.0,31,11,574,64,128,0.5,0,0,0.0,64,128,0.5,0.5,25,41,0.61,54,89,143,18,12,9,35,85,153,2003
S. Igo,TOT,28.0,45,12,785,87,176,0.494,1,1,1.0,86,175,0.491,0.497,49,78,0.628,84,125,209,20,14,22,57,116,224,2003
A. Jackson,ROA,22.0,13,0,87,7,23,0.304,2,4,0.5,5,19,0.263,0.348,3,4,0.75,2,10,12,2,2,0,3,16,19,2003
D. Johns,ROA,26.0,28,5,397,49,92,0.533,0,0,0.0,49,92,0.533,0.533,25,33,0.758,40,65,105,9,10,21,23,46,123,2003
N. Johnson,CLB,25.0,49,48,1529,354,759,0.466,22,71,0.31,332,688,0.483,0.481,225,303,0.743,62,181,243,141,64,28,136,141,955,2003
G. Jones,GRE,28.0,48,1,936,189,449,0.421,77,186,0.414,112,263,0.426,0.507,41,55,0.745,21,62,83,79,37,3,75,60,496,2003
L. Jones,CLB,23.0,8,8,123,7,26,0.269,0,0,0.0,7,26,0.269,0.269,2,4,0.5,11,19,30,2,0,6,5,13,16,2003
L. Jordan,HUN,23.0,25,0,203,12,58,0.207,2,11,0.182,10,47,0.213,0.224,3,3,1.0,2,16,18,16,4,2,8,16,29,2003
J. Kerner,GRE,28.0,15,3,356,41,105,0.39,0,0,0.0,41,105,0.39,0.39,17,20,0.85,24,46,70,9,13,2,18,55,99,2003
J. Kerner,CLB,28.0,2,0,27,3,9,0.333,0,0,0.0,3,9,0.333,0.333,2,2,1.0,1,5,6,0,3,1,0,3,8,2003
J. Kerner,TOT,28.0,17,3,383,44,114,0.386,0,0,0.0,44,114,0.386,0.386,19,22,0.864,25,51,76,9,16,3,18,58,107,2003
M. King,ROA,24.0,48,1,563,93,201,0.463,12,42,0.286,81,159,0.509,0.493,39,53,0.736,32,56,88,37,29,2,30,74,237,2003
B. Kurtz,TOT,24.0,47,41,1092,174,402,0.433,1,4,0.25,173,398,0.435,0.434,143,183,0.781,104,184,288,35,37,39,87,166,492,2003
B. Kurtz,GRE,24.0,24,22,552,80,187,0.428,1,3,0.333,79,184,0.429,0.43,63,79,0.797,56,87,143,15,21,15,42,91,224,2003
B. Kurtz,ASH,24.0,23,19,540,94,215,0.437,0,1,0.0,94,214,0.439,0.437,80,104,0.769,48,97,145,20,16,24,45,75,268,2003
J. Linehan,GRE,24.0,19,0,216,13,61,0.213,5,17,0.294,8,44,0.182,0.254,8,15,0.533,7,22,29,23,11,0,20,20,39,2003
A. Long,HUN,30.0,10,9,223,47,82,0.573,1,3,0.333,46,79,0.582,0.579,22,32,0.688,14,62,76,24,5,15,32,38,117,2003
B. Lucas,FAY,24.0,49,1,958,167,314,0.532,5,19,0.263,162,295,0.549,0.54,82,104,0.788,77,179,256,18,24,8,59,104,421,2003
K. Lyde,GRE,22.0,47,44,1131,185,370,0.5,0,0,0.0,185,370,0.5,0.5,79,128,0.617,99,202,301,45,19,53,59,194,449,2003
J. Marshall,MOB,23.0,19,1,138,13,37,0.351,1,5,0.2,12,32,0.375,0.365,11,14,0.786,2,3,5,9,0,0,17,10,38,2003
E. Mashack,ASH,,9,0,79,5,17,0.294,0,2,0.0,5,15,0.333,0.294,0,2,0.0,3,7,10,3,5,2,5,6,10,2003
M. Mazur,FAY,24.0,50,2,664,47,114,0.412,0,0,0.0,47,114,0.412,0.412,20,44,0.455,41,98,139,15,10,17,31,83,114,2003
T. McIntyre,FAY,25.0,50,49,1273,213,506,0.421,81,197,0.411,132,309,0.427,0.501,109,125,0.872,24,92,116,255,67,0,105,75,616,2003
T. McKenzie,NCH,23.0,29,12,310,25,56,0.446,0,0,0.0,25,56,0.446,0.446,22,34,0.647,30,36,66,12,2,7,21,76,72,2003
J. Moon,MOB,22.0,2,0,6,2,2,1.0,1,1,1.0,1,1,1.0,1.25,0,0,0.0,0,2,2,1,0,1,1,2,5,2003
M. Moore,ROA,27.0,42,41,1409,252,477,0.528,6,24,0.25,246,453,0.543,0.535,164,218,0.752,74,278,352,104,28,67,146,162,674,2003
K. Morris,ASH,,39,3,531,55,143,0.385,14,50,0.28,41,93,0.441,0.434,40,48,0.833,10,55,65,96,29,2,50,39,164,2003
G. Muoneke,ROA,24.0,8,7,259,49,104,0.471,5,19,0.263,44,85,0.518,0.495,68,98,0.694,18,52,70,15,3,4,17,25,171,2003
J. Myers,GRE,28.0,13,0,197,28,57,0.491,3,13,0.231,25,44,0.568,0.518,30,37,0.811,9,10,19,16,15,1,14,24,89,2003
I. Nwankwo,HUN,,11,11,297,29,62,0.468,0,1,0.0,29,61,0.475,0.468,18,35,0.514,32,63,95,11,3,15,15,56,76,2003
D. Oliver,TOT,24.0,16,8,293,39,99,0.394,11,33,0.333,28,66,0.424,0.449,25,31,0.806,3,23,26,47,18,0,16,39,114,2003
D. Oliver,GRE,24.0,6,0,64,6,20,0.3,1,6,0.167,5,14,0.357,0.325,6,9,0.667,0,5,5,12,1,0,3,8,19,2003
D. Oliver,ASH,24.0,10,8,229,33,79,0.418,10,27,0.37,23,52,0.442,0.481,19,22,0.864,3,18,21,35,17,0,13,31,95,2003
A. Owens,MOB,28.0,12,6,330,45,96,0.469,2,9,0.222,43,87,0.494,0.479,47,62,0.758,3,29,32,53,19,0,29,39,139,2003
G. Owens,ROA,24.0,44,28,795,89,162,0.549,0,0,0.0,89,162,0.549,0.549,64,115,0.557,81,117,198,18,17,32,47,160,242,2003
S. Penn,ASH,26.0,1,0,20,1,4,0.25,0,0,0.0,1,4,0.25,0.25,4,6,0.667,0,3,3,0,0,4,3,0,6,2003
S. Peterson,CLB,,43,2,509,76,164,0.463,11,33,0.333,65,131,0.496,0.497,33,43,0.767,11,28,39,90,24,0,39,40,196,2003
K. Poole,ROA,28.0,9,0,113,11,19,0.579,0,0,0.0,11,19,0.579,0.579,8,10,0.8,4,10,14,3,1,10,5,23,30,2003
L. Recker,ASH,24.0,34,4,635,98,219,0.447,43,112,0.384,55,107,0.514,0.546,62,75,0.827,12,47,59,30,18,4,47,48,301,2003
L. Reid,ROA,23.0,7,0,65,7,23,0.304,3,10,0.3,4,13,0.308,0.37,1,1,1.0,0,4,4,11,6,1,7,5,18,2003
L. Reid,NCH,23.0,24,0,441,66,158,0.418,9,18,0.5,57,140,0.407,0.446,22,29,0.759,9,47,56,58,20,0,27,48,163,2003
L. Reid,MOB,23.0,1,0,12,1,3,0.333,1,2,0.5,0,1,0.0,0.5,0,0,0.0,0,1,1,1,0,0,1,2,3,2003
L. Reid,TOT,23.0,32,0,518,74,184,0.402,13,30,0.433,61,154,0.396,0.438,23,30,0.767,9,52,61,70,26,1,35,55,184,2003
K. Rhymer,CLB,24.0,23,0,318,32,76,0.421,0,0,0.0,32,76,0.421,0.421,27,47,0.574,36,54,90,3,2,13,14,68,91,2003
N. Richardson,NCH,23.0,8,0,139,16,42,0.381,6,18,0.333,10,24,0.417,0.452,13,17,0.765,5,10,15,9,1,2,6,12,51,2003
R. Riley,HUN,29.0,21,3,276,39,98,0.398,2,14,0.143,37,84,0.44,0.408,15,23,0.652,14,20,34,23,16,5,33,34,95,2003
J. Robinson,ROA,29.0,50,49,1449,225,556,0.405,49,146,0.336,176,410,0.429,0.449,100,134,0.746,42,115,157,67,48,20,99,152,599,2003
R. Rollerson,ASH,22.0,33,6,329,55,113,0.487,0,0,0.0,55,113,0.487,0.487,12,17,0.706,35,63,98,8,5,14,25,65,122,2003
S. Samake,GRE,24.0,33,27,782,101,181,0.558,0,0,0.0,101,181,0.558,0.558,70,106,0.66,93,138,231,16,14,53,53,106,272,2003
C. Sanders,MOB,23.0,2,0,8,1,2,0.5,0,0,0.0,1,2,0.5,0.5,1,2,0.5,0,1,1,1,0,1,1,2,3,2003
J. Sanders,FAY,30.0,49,5,807,168,385,0.436,24,67,0.358,144,318,0.453,0.468,73,96,0.76,54,68,122,59,17,9,73,67,433,2003
L. Scruggs,ASH,23.0,47,14,993,182,391,0.465,22,66,0.333,160,325,0.492,0.494,73,95,0.768,60,178,238,28,18,56,63,127,459,2003
S. Seals,MOB,27.0,46,12,1002,165,452,0.365,54,126,0.429,111,326,0.34,0.425,135,181,0.746,44,85,129,57,39,7,76,87,519,2003
K. Shabazz,NCH,24.0,19,12,430,39,76,0.513,0,0,0.0,39,76,0.513,0.513,25,41,0.61,47,71,118,11,9,34,14,66,103,2003
T. Shannon,ROA,23.0,50,50,1491,256,533,0.48,2,12,0.167,254,521,0.488,0.482,220,321,0.685,106,174,280,55,38,40,119,164,734,2003
D. Shaw,HUN,24.0,50,9,815,119,274,0.434,10,31,0.323,109,243,0.449,0.453,86,114,0.754,75,108,183,78,39,4,41,83,334,2003
T. Shine,NCH,24.0,13,1,185,18,47,0.383,7,21,0.333,11,26,0.423,0.457,8,8,1.0,1,8,9,22,8,0,5,9,51,2003
B. Simmons,MOB,22.0,14,14,423,76,180,0.422,2,10,0.2,74,170,0.435,0.428,86,103,0.835,29,44,73,22,11,2,47,47,240,2003
B. Smith,ASH,,7,2,56,4,11,0.364,0,2,0.0,4,9,0.444,0.364,3,4,0.75,4,9,13,2,0,5,4,4,11,2003
S. Smith,CLB,23.0,49,11,712,64,205,0.312,17,68,0.25,47,137,0.343,0.354,37,45,0.822,9,61,70,101,31,3,43,65,182,2003
J. Sobral,HUN,22.0,5,0,35,0,7,0.0,0,2,0.0,0,5,0.0,0.0,3,4,0.75,1,8,9,1,0,0,3,5,3,2003
C. Staples,HUN,26.0,10,0,85,14,35,0.4,3,10,0.3,11,25,0.44,0.443,2,6,0.333,3,2,5,7,3,0,5,11,33,2003
G. Stempin,TOT,23.0,45,5,980,158,361,0.438,30,81,0.37,128,280,0.457,0.479,66,104,0.635,60,138,198,63,18,13,74,104,412,2003
G. Stempin,HUN,23.0,9,0,132,11,34,0.324,1,6,0.167,10,28,0.357,0.338,9,15,0.6,8,17,25,4,3,3,12,17,32,2003
G. Stempin,CLB,23.0,36,5,848,147,327,0.45,29,75,0.387,118,252,0.468,0.494,57,89,0.64,52,121,173,59,15,10,62,87,380,2003
D. Strong,CLB,34.0,18,15,482,57,129,0.442,0,1,0.0,57,128,0.445,0.442,50,64,0.781,30,77,107,11,11,3,37,39,164,2003
B. Thomas,GRE,27.0,49,49,1551,288,662,0.435,84,241,0.349,204,421,0.485,0.498,125,162,0.772,43,118,161,99,69,21,114,92,785,2003
J. Trepagnier,ASH,23.0,48,45,1491,290,664,0.437,79,209,0.378,211,455,0.464,0.496,191,240,0.796,53,141,194,116,111,40,106,124,850,2003
I. Udoka,NCH,25.0,50,24,1126,180,378,0.476,27,68,0.397,153,310,0.494,0.512,128,173,0.74,86,182,268,66,65,11,83,141,515,2003
J. Veal,CLB,26.0,14,4,342,55,128,0.43,0,6,0.0,55,122,0.451,0.43,25,29,0.862,5,30,35,53,14,2,24,27,135,2003
J. Veal,TOT,26.0,25,4,538,81,180,0.45,2,10,0.2,79,170,0.465,0.456,33,41,0.805,10,44,54,73,19,2,38,45,197,2003
J. Veal,MOB,26.0,11,0,196,26,52,0.5,2,4,0.5,24,48,0.5,0.519,8,12,0.667,5,14,19,20,5,0,14,18,62,2003
G. Walker,MOB,29.0,30,21,575,65,161,0.404,1,11,0.091,64,150,0.427,0.407,36,41,0.878,36,73,109,85,38,3,58,44,167,2003
J. Walker,CLB,25.0,13,0,255,41,105,0.39,10,24,0.417,31,81,0.383,0.438,25,32,0.781,15,25,40,21,7,1,16,20,117,2003
J. Walker,TOT,25.0,47,16,1129,180,454,0.396,28,81,0.346,152,373,0.408,0.427,111,143,0.776,51,100,151,87,23,8,65,71,499,2003
J. Walker,HUN,25.0,34,16,874,139,349,0.398,18,57,0.316,121,292,0.414,0.424,86,111,0.775,36,75,111,66,16,7,49,51,382,2003
T. Walker,GRE,23.0,23,5,358,58,124,0.468,13,29,0.448,45,95,0.474,0.52,9,12,0.75,31,34,65,16,9,3,17,48,138,2003
T. Washington,CLB,26.0,37,27,781,116,234,0.496,0,0,0.0,116,234,0.496,0.496,70,107,0.654,65,98,163,31,21,20,60,128,302,2003
J. Watkins,FAY,25.0,50,48,1058,174,334,0.521,0,0,0.0,174,334,0.521,0.521,71,129,0.55,114,206,320,28,33,58,82,196,419,2003
S. Webber,NCH,26.0,50,50,1610,277,661,0.419,37,125,0.296,240,536,0.448,0.447,192,244,0.787,110,168,278,124,87,28,109,147,783,2003
J. White,MOB,23.0,24,0,209,17,41,0.415,0,0,0.0,17,41,0.415,0.415,6,11,0.545,14,46,60,8,8,8,14,40,40,2003
M. Wilks,HUN,23.0,16,16,508,60,135,0.444,9,28,0.321,51,107,0.477,0.478,44,56,0.786,19,41,60,58,13,3,33,34,173,2003
B. Williams,HUN,27.0,41,41,1325,186,440,0.423,39,99,0.394,147,341,0.431,0.467,118,153,0.771,45,125,170,93,37,10,113,128,529,2003
E. Williams,TOT,24.0,24,2,240,32,81,0.395,0,2,0.0,32,79,0.405,0.395,21,24,0.875,32,46,78,17,2,3,14,44,85,2003
E. Williams,HUN,24.0,12,2,114,14,37,0.378,0,1,0.0,14,36,0.389,0.378,10,12,0.833,18,22,40,11,2,3,6,28,38,2003
E. Williams,GRE,24.0,7,0,102,17,37,0.459,0,1,0.0,17,36,0.472,0.459,7,8,0.875,9,21,30,6,0,0,5,10,41,2003
E. Williams,CLB,24.0,5,0,24,1,7,0.143,0,0,0.0,1,7,0.143,0.143,4,4,1.0,5,3,8,0,0,0,3,6,6,2003
F. Williams,GRE,28.0,40,7,787,148,322,0.46,11,34,0.324,137,288,0.476,0.477,71,98,0.724,42,144,186,30,25,9,76,66,378,2003
G. Williams,ASH,,25,20,603,81,170,0.476,9,31,0.29,72,139,0.518,0.503,34,47,0.723,21,51,72,41,13,8,48,72,205,2003
G. Williams,ROA,22.0,48,1,705,90,171,0.526,0,0,0.0,90,171,0.526,0.526,36,63,0.571,46,78,124,24,21,17,42,67,216,2003
J. Williams,MOB,23.0,12,0,71,8,13,0.615,1,2,0.5,7,11,0.636,0.654,5,5,1.0,8,8,16,1,1,2,4,18,22,2003
A. Woolridge,ASH,29.0,3,3,102,12,29,0.414,3,9,0.333,9,20,0.45,0.466,11,18,0.611,0,9,9,18,2,0,14,6,38,2003
C. Andersen,FAY,23.0,3,1,42,4,9,0.444,0,1,0.0,4,8,0.5,0.444,6,8,0.75,2,9,11,1,3,5,3,6,14,2002
H. Arceneaux,CLB,24.0,5,0,56,5,15,0.333,0,0,0.0,5,15,0.333,0.333,16,18,0.889,1,4,5,0,1,1,6,7,26,2002
T. Archie,MOB,24.0,7,4,102,13,28,0.464,1,4,0.25,12,24,0.5,0.482,3,4,0.75,2,5,7,12,3,0,12,8,30,2002
J. Aubry,FAY,24.0,55,32,1270,144,277,0.52,0,0,0.0,144,277,0.52,0.52,100,180,0.556,124,224,348,24,27,94,81,186,388,2002
V. Avila,NCH,,40,10,603,99,182,0.544,0,0,0.0,99,182,0.544,0.544,76,103,0.738,61,83,144,8,11,9,42,103,274,2002
C. Black,NCH,,30,17,466,64,158,0.405,0,3,0.0,64,155,0.413,0.405,63,83,0.759,49,68,117,9,15,16,33,68,191,2002
A. Blakes,ASH,,52,5,612,67,169,0.396,6,34,0.176,61,135,0.452,0.414,40,56,0.714,48,67,115,59,29,5,53,45,180,2002
J. Boese,ROA,,50,22,1019,104,265,0.392,26,90,0.289,78,175,0.446,0.442,65,87,0.747,53,102,155,57,36,11,68,125,299,2002
S. Boseman,ASH,26.0,14,1,203,26,76,0.342,9,37,0.243,17,39,0.436,0.401,29,36,0.806,2,23,25,18,8,0,12,17,90,2002
S. Boseman,TOT,26.0,32,7,555,75,219,0.342,26,86,0.302,49,133,0.368,0.402,75,98,0.765,10,55,65,40,24,0,42,52,251,2002
S. Boseman,CLB,26.0,18,6,352,49,143,0.343,17,49,0.347,32,94,0.34,0.402,46,62,0.742,8,32,40,22,16,0,30,35,161,2002
B. Bracey,FAY,23.0,1,0,1,0,0,0.0,0,0,0.0,0,0,0.0,0.0,0,0,0.0,0,0,0,0,0,0,0,0,0,2002
J. Brown,FAY,,2,0,20,2,4,0.5,0,1,0.0,2,3,0.667,0.5,1,2,0.5,2,4,6,0,1,0,2,1,5,2002
S. Brown,ASH,22.0,18,5,161,15,47,0.319,0,1,0.0,15,46,0.326,0.319,13,17,0.765,10,15,25,2,1,5,17,31,43,2002
S. Brown,TOT,22.0,43,7,536,44,116,0.379,0,1,0.0,44,115,0.383,0.379,37,59,0.627,42,57,99,6,13,15,33,76,125,2002
S. Brown,ROA,22.0,15,2,275,21,49,0.429,0,0,0.0,21,49,0.429,0.429,18,35,0.514,23,32,55,2,10,8,11,30,60,2002
S. Brown,CLB,22.0,10,0,100,8,20,0.4,0,0,0.0,8,20,0.4,0.4,6,7,0.857,9,10,19,2,2,2,5,15,22,2002
S. Burrell,FAY,31.0,6,5,141,12,45,0.267,3,16,0.188,9,29,0.31,0.3,6,7,0.857,10,12,22,6,2,2,8,12,33,2002
C. Carrawell,ASH,24.0,56,39,1283,157,390,0.403,9,35,0.257,148,355,0.417,0.414,85,119,0.714,68,136,204,103,21,16,70,81,408,2002
E. Chenowith,TOT,22.0,56,42,1144,195,410,0.476,1,3,0.333,194,407,0.477,0.477,157,196,0.801,116,226,342,30,17,50,87,192,548,2002
E. Chenowith,HUN,22.0,30,23,657,102,211,0.483,1,1,1.0,101,210,0.481,0.486,90,110,0.818,73,130,203,14,13,39,50,106,295,2002
E. Chenowith,GRE,22.0,26,19,487,93,199,0.467,0,2,0.0,93,197,0.472,0.467,67,86,0.779,43,96,139,16,4,11,37,86,253,2002
T. Christie,GRE,25.0,4,0,68,3,18,0.167,1,12,0.083,2,6,0.333,0.194,1,4,0.25,1,3,4,3,0,2,3,4,8,2002
S. Clark,HUN,29.0,28,26,825,112,270,0.415,0,2,0.0,112,268,0.418,0.415,84,116,0.724,75,172,247,59,19,18,81,110,308,2002
M. Code,GRE,27.0,23,1,224,30,62,0.484,14,31,0.452,16,31,0.516,0.597,16,18,0.889,2,17,19,24,9,0,23,29,90,2002
J. Coker,ASH,30.0,20,19,476,80,160,0.5,0,0,0.0,80,160,0.5,0.5,38,49,0.776,53,88,141,15,12,18,27,55,198,2002
L. Coleman,ROA,,46,32,704,126,208,0.606,0,0,0.0,126,208,0.606,0.606,57,95,0.6,61,146,207,24,4,67,82,153,309,2002
E. Coley,GRE,24.0,4,0,46,2,8,0.25,0,2,0.0,2,6,0.333,0.25,1,2,0.5,1,4,5,2,1,1,1,6,5,2002
O. Cook,FAY,20.0,35,23,1105,139,366,0.38,41,107,0.383,98,259,0.378,0.436,109,142,0.768,21,82,103,272,53,0,153,109,428,2002
W. Craft,HUN,,11,0,69,5,13,0.385,0,1,0.0,5,12,0.417,0.385,6,8,0.75,6,5,11,0,1,1,7,10,16,2002
C. Crosby,CLB,23.0,6,0,30,0,7,0.0,0,3,0.0,0,4,0.0,0.0,0,0,0.0,1,3,4,1,1,0,1,6,0,2002
D. Crouse,HUN,27.0,35,21,644,90,219,0.411,0,0,0.0,90,219,0.411,0.411,81,95,0.853,66,96,162,17,14,18,34,73,261,2002
D. Crouse,TOT,27.0,41,25,795,112,258,0.434,0,0,0.0,112,258,0.434,0.434,86,103,0.835,70,119,189,27,20,19,44,91,310,2002
D. Crouse,MOB,27.0,6,4,151,22,39,0.564,0,0,0.0,22,39,0.564,0.564,5,8,0.625,4,23,27,10,6,1,10,18,49,2002
T. Crutchfield,FAY,22.0,21,5,353,40,112,0.357,11,43,0.256,29,69,0.42,0.406,18,36,0.5,15,23,38,18,9,4,31,53,109,2002
E. Daniels,GRE,,5,1,80,8,32,0.25,3,14,0.214,5,18,0.278,0.297,15,17,0.882,1,5,6,12,10,0,13,8,34,2002
S. Daugherty,CLB,26.0,11,0,164,28,58,0.483,12,29,0.414,16,29,0.552,0.586,13,18,0.722,9,20,29,9,2,2,8,33,81,2002
T. Dehere,NCH,30.0,31,0,544,82,186,0.441,27,60,0.45,55,126,0.437,0.513,50,57,0.877,13,36,49,43,14,1,42,50,241,2002
K. Dickens,TOT,23.0,27,3,376,42,109,0.385,5,20,0.25,37,89,0.416,0.408,50,76,0.658,19,47,66,3,15,9,27,56,139,2002
K. Dickens,MOB,23.0,23,1,307,34,84,0.405,4,14,0.286,30,70,0.429,0.429,45,62,0.726,15,40,55,3,14,8,22,47,117,2002
K. Dickens,FAY,23.0,4,2,69,8,25,0.32,1,6,0.167,7,19,0.368,0.34,5,14,0.357,4,7,11,0,1,1,5,9,22,2002
J. Dixon,HUN,,7,0,91,7,24,0.292,0,0,0.0,7,24,0.292,0.292,7,10,0.7,14,21,35,4,4,1,6,13,21,2002
D. Earl,ROA,27.0,29,19,617,67,157,0.427,31,77,0.403,36,80,0.45,0.525,36,46,0.783,8,40,48,75,23,2,45,59,201,2002
E. Edgerson,MOB,23.0,56,9,1046,60,118,0.508,0,1,0.0,60,117,0.513,0.508,81,118,0.686,91,178,269,33,45,9,49,150,201,2002
D. Edwards,MOB,27.0,3,1,30,0,5,0.0,0,1,0.0,0,4,0.0,0.0,0,0,0.0,0,1,1,2,0,0,7,3,0,2002
N. Edwards,NCH,,55,25,1017,93,241,0.386,0,2,0.0,93,239,0.389,0.386,46,77,0.597,84,168,252,18,13,103,43,153,232,2002
T. Ellis,HUN,,56,10,871,110,278,0.396,18,67,0.269,92,211,0.436,0.428,52,78,0.667,45,52,97,54,35,11,68,114,290,2002
K. Ffriend,GRE,24.0,23,7,368,50,103,0.485,0,0,0.0,50,103,0.485,0.485,47,83,0.566,50,83,133,8,4,10,39,57,147,2002
I. Fontaine,MOB,26.0,52,50,1544,305,654,0.466,67,158,0.424,238,496,0.48,0.518,229,253,0.905,41,120,161,109,42,13,118,137,906,2002
T. Fowlkes,CLB,25.0,42,39,1338,212,513,0.413,8,39,0.205,204,474,0.43,0.421,269,364,0.739,112,130,242,63,35,11,84,131,701,2002
C. Garner,CLB,26.0,48,45,1166,121,374,0.324,25,96,0.26,96,278,0.345,0.357,53,68,0.779,32,96,128,195,62,7,111,112,320,2002
o. Givens,ROA,,23,8,263,26,80,0.325,0,0,0.0,26,80,0.325,0.325,18,22,0.818,15,34,49,4,7,4,14,53,70,2002
A. Grant,NCH,,45,7,565,77,187,0.412,18,50,0.36,59,137,0.431,0.46,23,45,0.511,41,59,100,25,27,5,28,49,195,2002
P. Grant,ASH,28.0,51,36,1208,237,518,0.458,2,10,0.2,235,508,0.463,0.459,83,116,0.716,99,189,288,28,15,47,83,142,559,2002
N. Green,NCH,24.0,35,31,820,77,197,0.391,16,47,0.34,61,150,0.407,0.431,45,81,0.556,10,104,114,143,44,12,63,59,215,2002
K. Gregory,GRE,23.0,24,1,298,48,115,0.417,0,6,0.0,48,109,0.44,0.417,16,31,0.516,23,27,50,19,7,4,17,24,112,2002
A. Griffin,ROA,,44,42,1504,201,541,0.372,103,270,0.381,98,271,0.362,0.467,125,150,0.833,41,120,161,123,48,9,96,97,630,2002
T. Hamilton,CLB,23.0,9,3,193,38,69,0.551,0,2,0.0,38,67,0.567,0.551,8,12,0.667,7,34,41,7,5,2,9,12,84,2002
T. Hamilton,ROA,26.0,18,16,572,91,156,0.583,0,0,0.0,91,156,0.583,0.583,34,67,0.507,45,142,187,36,8,32,75,52,216,2002
T. Hamilton,GRE,26.0,32,28,794,125,210,0.595,0,1,0.0,125,209,0.598,0.595,32,68,0.471,81,200,281,55,9,31,103,76,282,2002
T. Hamilton,TOT,26.0,50,44,1366,216,366,0.59,0,1,0.0,216,365,0.592,0.59,66,135,0.489,126,342,468,91,17,63,178,128,498,2002
D. Hand,GRE,22.0,15,0,125,8,29,0.276,3,15,0.2,5,14,0.357,0.328,9,14,0.643,4,11,15,19,9,0,17,24,28,2002
L. Harrell,HUN,29.0,56,55,1516,241,645,0.374,73,212,0.344,168,433,0.388,0.43,93,135,0.689,39,163,202,128,53,42,134,154,648,2002
E. Harris,GRE,25.0,41,6,695,68,168,0.405,17,47,0.362,51,121,0.421,0.455,54,63,0.857,9,45,54,78,42,3,39,51,207,2002
T. Harris,FAY,,12,0,213,21,62,0.339,14,32,0.438,7,30,0.233,0.452,17,24,0.708,2,7,9,20,7,0,9,29,73,2002
J. Hart,ASH,23.0,12,9,304,58,130,0.446,5,14,0.357,53,116,0.457,0.465,31,39,0.795,14,38,52,47,14,1,25,32,152,2002
S. Hart,FAY,,1,0,5,0,1,0.0,0,0,0.0,0,1,0.0,0.0,0,0,0.0,0,1,1,0,0,0,0,0,0,2002
C. Haywood,FAY,26.0,17,0,286,25,68,0.368,0,4,0.0,25,64,0.391,0.368,9,13,0.692,22,36,58,18,4,1,16,33,59,2002
J. Heide,HUN,,43,5,530,70,179,0.391,1,1,1.0,69,178,0.388,0.394,43,61,0.705,45,95,140,11,10,12,38,66,184,2002
J. Hemsley,ASH,24.0,46,31,1069,163,430,0.379,33,130,0.254,130,300,0.433,0.417,73,83,0.88,29,90,119,78,41,11,71,81,432,2002
D. Hines,ROA,,35,5,404,52,114,0.456,6,20,0.3,46,94,0.489,0.482,57,71,0.803,14,28,42,41,8,1,32,42,167,2002
D. Hood,MOB,25.0,54,52,1433,216,417,0.518,0,3,0.0,216,414,0.522,0.518,117,165,0.709,159,309,468,71,39,21,101,202,549,2002
F. House,NCH,,56,56,1443,268,585,0.458,32,118,0.271,236,467,0.505,0.485,183,246,0.744,118,133,251,100,139,11,108,150,751,2002
D. Hulett,GRE,21.0,34,27,869,155,316,0.491,4,20,0.2,151,296,0.51,0.497,65,88,0.739,65,66,131,32,22,20,51,66,379,2002
J. Hunter,HUN,24.0,56,28,1419,261,633,0.412,40,126,0.317,221,507,0.436,0.444,154,197,0.782,60,120,180,111,72,33,100,110,716,2002
K. Hunter,ROA,24.0,20,3,245,19,44,0.432,0,0,0.0,19,44,0.432,0.432,7,12,0.583,18,44,62,5,3,22,8,35,45,2002
J. Jackson,HUN,,13,0,136,11,27,0.407,0,0,0.0,11,27,0.407,0.407,12,17,0.706,11,22,33,4,1,6,9,29,34,2002
J. Jackson,CLB,,43,16,641,55,130,0.423,0,0,0.0,55,130,0.423,0.423,20,31,0.645,51,85,136,17,26,13,30,97,130,2002
J. Jackson,TOT,,56,16,777,66,157,0.42,0,0,0.0,66,157,0.42,0.42,32,48,0.667,62,107,169,21,27,19,39,126,164,2002
M. Jeffers,ASH,22.0,2,0,40,2,8,0.25,0,0,0.0,2,8,0.25,0.25,3,6,0.5,0,11,11,5,1,0,3,4,7,2002
V. Jennings,MOB,,18,8,301,32,92,0.348,0,3,0.0,32,89,0.36,0.348,17,20,0.85,11,37,48,41,18,0,31,38,81,2002
A. Johnson,MOB,27.0,15,13,394,72,156,0.462,3,12,0.25,69,144,0.479,0.471,32,43,0.744,10,36,46,44,31,1,32,40,179,2002
D. Johnson,FAY,25.0,26,14,681,117,288,0.406,8,32,0.25,109,256,0.426,0.42,44,61,0.721,15,42,57,47,30,2,36,65,286,2002
D. Johns,FAY,25.0,30,13,475,71,150,0.473,0,1,0.0,71,149,0.477,0.473,22,30,0.733,34,104,138,7,9,26,26,64,164,2002
N. Johnson,CLB,24.0,51,20,1265,251,567,0.443,21,55,0.382,230,512,0.449,0.461,176,231,0.762,74,164,238,95,62,30,117,134,699,2002
R. Kelley,FAY,,16,4,139,17,40,0.425,0,0,0.0,17,40,0.425,0.425,8,14,0.571,18,11,29,0,1,2,6,23,42,2002
J. Kendrick,NCH,26.0,10,7,189,31,68,0.456,0,4,0.0,31,64,0.484,0.456,15,19,0.789,14,21,35,6,7,0,8,21,77,2002
J. King,ASH,28.0,52,23,1194,168,397,0.423,20,69,0.29,148,328,0.451,0.448,131,178,0.736,46,117,163,134,59,14,95,110,487,2002
R. LaRue,ASH,28.0,26,17,728,107,242,0.442,52,121,0.43,55,121,0.455,0.55,47,52,0.904,10,58,68,73,30,3,54,38,313,2002
M. Lewis,TOT,26.0,32,8,713,120,276,0.435,8,29,0.276,112,247,0.453,0.449,93,124,0.75,53,55,108,16,38,7,50,75,341,2002
M. Lewis,ROA,26.0,28,8,672,112,261,0.429,8,28,0.286,104,233,0.446,0.444,89,120,0.742,53,55,108,16,38,7,47,74,321,2002
M. Lewis,MOB,26.0,4,0,41,8,15,0.533,0,1,0.0,8,14,0.571,0.533,4,4,1.0,0,0,0,0,0,0,3,1,20,2002
R. Lloyd,FAY,23.0,4,0,20,1,7,0.143,0,2,0.0,1,5,0.2,0.143,2,4,0.5,0,2,2,0,0,0,2,3,4,2002
R. Lockhart,GRE,24.0,56,29,1292,270,524,0.515,0,4,0.0,270,520,0.519,0.515,84,168,0.5,144,257,401,48,52,36,114,195,624,2002
T. Martin,HUN,,20,8,298,24,64,0.375,8,15,0.533,16,49,0.327,0.438,19,25,0.76,7,37,44,27,11,9,24,30,75,2002
S. McClain,ASH,23.0,20,0,231,22,53,0.415,0,2,0.0,22,51,0.431,0.415,15,25,0.6,14,20,34,14,9,5,24,40,59,2002
A. McCollum,ROA,26.0,43,32,1251,213,498,0.428,59,166,0.355,154,332,0.464,0.487,140,169,0.828,24,150,174,143,49,12,142,94,625,2002
J. McCutcheon,MOB,,56,47,1271,119,274,0.434,3,18,0.167,116,256,0.453,0.44,45,56,0.804,32,106,138,72,36,31,57,116,286,2002
T. McIntyre,FAY,24.0,39,38,1234,217,494,0.439,39,93,0.419,178,401,0.444,0.479,125,140,0.893,28,103,131,190,69,3,124,88,598,2002
B. McKie,NCH,24.0,56,0,1032,140,335,0.418,24,77,0.312,116,258,0.45,0.454,123,163,0.755,41,86,127,177,41,0,116,111,427,2002
J. Miskiri,GRE,26.0,7,1,139,19,52,0.365,9,20,0.45,10,32,0.313,0.452,8,10,0.8,4,10,14,10,3,0,12,13,55,2002
J. Moon,MOB,21.0,53,3,689,103,260,0.396,33,94,0.351,70,166,0.422,0.46,39,52,0.75,24,82,106,35,34,25,41,50,278,2002
R. Moore,ROA,25.0,26,0,316,25,78,0.321,5,24,0.208,20,54,0.37,0.353,5,10,0.5,6,26,32,22,16,0,18,22,60,2002
L. Moten,MOB,29.0,8,0,131,26,61,0.426,2,10,0.2,24,51,0.471,0.443,18,18,1.0,6,11,17,8,5,1,9,9,72,2002
T. Mott,FAY,28.0,4,0,37,7,18,0.389,0,2,0.0,7,16,0.438,0.389,8,10,0.8,3,12,15,3,2,0,8,4,22,2002
G. Muoneke,CLB,23.0,47,39,1407,283,601,0.471,14,54,0.259,269,547,0.492,0.483,224,315,0.711,83,196,279,77,39,20,112,145,804,2002
J. Myers,GRE,27.0,56,50,1534,196,424,0.462,30,92,0.326,166,332,0.5,0.498,138,180,0.767,63,186,249,200,118,12,137,145,560,2002
M. N'Diaye,NCH,28.0,48,43,1020,124,309,0.401,6,17,0.353,118,292,0.404,0.411,36,47,0.766,110,199,309,60,30,61,104,172,290,2002
T. Patterson,ASH,,6,3,110,10,42,0.238,1,4,0.25,9,38,0.237,0.25,6,7,0.857,9,7,16,11,9,0,9,4,27,2002
A. Pelle,ROA,29.0,29,24,731,68,156,0.436,0,1,0.0,68,155,0.439,0.436,46,73,0.63,58,123,181,20,12,49,58,89,182,2002
S. Penn,ASH,25.0,28,22,796,83,236,0.352,24,71,0.338,59,165,0.358,0.403,64,81,0.79,15,62,77,141,46,6,48,58,254,2002
J. Phillips,CLB,22.0,43,11,431,40,71,0.563,0,0,0.0,40,71,0.563,0.563,25,42,0.595,43,58,101,7,9,14,23,67,105,2002
M. Phillips,ROA,26.0,55,54,1716,223,583,0.383,27,84,0.321,196,499,0.393,0.406,240,329,0.729,90,227,317,120,70,25,167,186,713,2002
R. Phillips,MOB,23.0,53,27,1334,223,574,0.389,89,249,0.357,134,325,0.412,0.466,128,148,0.865,16,66,82,195,44,1,118,87,663,2002
K. Poole,CLB,27.0,55,44,1245,81,228,0.355,1,2,0.5,80,226,0.354,0.357,43,67,0.642,125,295,420,31,20,62,47,123,206,2002
D. Porter,HUN,23.0,20,0,192,25,59,0.424,5,16,0.313,20,43,0.465,0.466,19,29,0.655,7,23,30,46,15,0,18,28,74,2002
K. Price,HUN,,47,37,1270,132,325,0.406,1,2,0.5,131,323,0.406,0.408,133,215,0.619,125,211,336,43,43,32,85,168,398,2002
L. Pyfrom,CLB,23.0,17,3,153,6,19,0.316,0,0,0.0,6,19,0.316,0.316,7,10,0.7,14,28,42,0,2,13,4,24,19,2002
G. Reese,ASH,24.0,28,18,524,74,202,0.366,5,22,0.227,69,180,0.383,0.379,35,41,0.854,35,47,82,34,8,7,30,49,188,2002
G. Reese,TOT,24.0,50,21,780,118,293,0.403,5,22,0.227,113,271,0.417,0.411,45,58,0.776,49,74,123,48,14,9,42,90,286,2002
G. Reese,CLB,24.0,22,3,256,44,91,0.484,0,0,0.0,44,91,0.484,0.484,10,17,0.588,14,27,41,14,6,2,12,41,98,2002
O. Ricardo,FAY,24.0,22,14,249,19,47,0.404,0,0,0.0,19,47,0.404,0.404,9,18,0.5,14,36,50,8,9,7,28,49,47,2002
T. Roberson,HUN,25.0,14,14,394,68,154,0.442,6,24,0.25,62,130,0.477,0.461,46,62,0.742,17,36,53,23,16,5,36,41,188,2002
T. Roberson,GRE,25.0,12,0,194,28,71,0.394,7,21,0.333,21,50,0.42,0.444,9,15,0.6,9,9,18,11,2,0,17,17,72,2002
T. Roberson,TOT,25.0,26,14,588,96,225,0.427,13,45,0.289,83,180,0.461,0.456,55,77,0.714,26,45,71,34,18,5,53,58,260,2002
C. Robinson,TOT,27.0,54,27,1099,158,427,0.37,47,136,0.346,111,291,0.381,0.425,67,87,0.77,58,91,149,87,35,9,77,112,430,2002
C. Robinson,NCH,27.0,20,19,435,69,179,0.385,19,56,0.339,50,123,0.407,0.439,27,37,0.73,25,31,56,33,12,5,31,42,184,2002
C. Robinson,HUN,27.0,34,8,664,89,248,0.359,28,80,0.35,61,168,0.363,0.415,40,50,0.8,33,60,93,54,23,4,46,70,246,2002
T. Rolle,MOB,25.0,4,0,60,8,23,0.348,1,5,0.2,7,18,0.389,0.37,5,5,1.0,3,6,9,2,2,0,4,4,22,2002
J. Rush,ROA,22.0,14,0,106,6,28,0.214,0,12,0.0,6,16,0.375,0.214,13,18,0.722,6,15,21,3,2,4,16,16,25,2002
R. Salahuddin,FAY,27.0,9,2,203,27,72,0.375,6,18,0.333,21,54,0.389,0.417,32,41,0.78,6,26,32,9,10,4,19,18,92,2002
E. Saunders,ASH,,5,1,58,5,13,0.385,0,0,0.0,5,13,0.385,0.385,3,4,0.75,7,9,16,3,3,1,5,6,13,2002
D. Schintzius,MOB,33.0,35,21,539,55,162,0.34,0,0,0.0,55,162,0.34,0.34,13,29,0.448,26,105,131,28,7,34,23,51,123,2002
L. Scruggs,ASH,22.0,56,18,1158,224,509,0.44,35,117,0.299,189,392,0.482,0.474,129,156,0.827,94,251,345,31,34,118,70,161,612,2002
A. Sesay,GRE,25.0,45,41,1376,230,522,0.441,3,21,0.143,227,501,0.453,0.443,163,220,0.741,54,151,205,112,39,35,107,117,626,2002
N. Sheppard,MOB,25.0,55,23,935,130,319,0.408,0,1,0.0,130,318,0.409,0.408,44,88,0.5,47,147,194,51,23,9,84,164,304,2002
J. Skaer,MOB,,4,2,50,2,12,0.167,0,3,0.0,2,9,0.222,0.167,4,7,0.571,4,3,7,1,0,0,6,10,8,2002
A. Smith,FAY,26.0,36,23,1036,189,418,0.452,5,22,0.227,184,396,0.465,0.458,111,157,0.707,82,177,259,25,28,29,48,76,494,2002
M. Smith,FAY,25.0,14,8,253,38,101,0.376,8,29,0.276,30,72,0.417,0.416,16,22,0.727,14,29,43,9,8,5,15,24,100,2002
S. Smith,CLB,22.0,55,1,638,82,207,0.396,37,87,0.425,45,120,0.375,0.486,47,57,0.825,13,59,72,77,25,5,40,60,248,2002
G. Stempin,FAY,22.0,48,47,1611,266,619,0.43,38,137,0.277,228,482,0.473,0.46,182,271,0.672,89,210,299,82,48,23,117,143,752,2002
G. Stolt,HUN,,51,1,557,68,171,0.398,26,65,0.4,42,106,0.396,0.474,25,31,0.806,26,80,106,21,9,10,30,37,187,2002
J. Strickland,TOT,,41,29,1117,223,464,0.481,0,0,0.0,223,464,0.481,0.481,142,241,0.589,98,127,225,88,18,5,104,117,588,2002
J. Strickland,MOB,,12,11,312,65,139,0.468,0,0,0.0,65,139,0.468,0.468,42,70,0.6,22,31,53,21,7,2,33,29,172,2002
J. Strickland,FAY,,25,17,724,149,302,0.493,0,0,0.0,149,302,0.493,0.493,94,162,0.58,69,89,158,55,9,2,67,76,392,2002
J. Strickland,CLB,,4,1,81,9,23,0.391,0,0,0.0,9,23,0.391,0.391,6,9,0.667,7,7,14,12,2,1,4,12,24,2002
J. Tate,ASH,25.0,52,33,1170,124,307,0.404,1,8,0.125,123,299,0.411,0.406,62,111,0.559,99,183,282,45,31,43,74,138,311,2002
B. Taty,FAY,30.0,23,0,234,12,33,0.364,0,0,0.0,12,33,0.364,0.364,12,19,0.632,23,45,68,1,5,7,15,44,36,2002
J. Taylor,ROA,27.0,12,10,382,45,150,0.3,16,44,0.364,29,106,0.274,0.353,52,69,0.754,13,53,66,18,18,5,37,37,158,2002
C. Terry,FAY,27.0,12,1,61,6,20,0.3,1,1,1.0,5,19,0.263,0.325,6,10,0.6,5,8,13,3,3,2,4,11,19,2002
B. Thomas,GRE,26.0,45,42,1373,220,529,0.416,84,228,0.368,136,301,0.452,0.495,105,121,0.868,39,85,124,89,74,21,84,89,629,2002
R. Tutt,CLB,,47,38,1131,229,476,0.481,21,63,0.333,208,413,0.504,0.503,81,109,0.743,71,96,167,54,26,7,55,55,560,2002
J. Veal,TOT,25.0,50,17,967,134,317,0.423,8,33,0.242,126,284,0.444,0.435,82,94,0.872,31,81,112,118,43,5,84,87,358,2002
J. Veal,HUN,25.0,16,6,281,27,69,0.391,1,4,0.25,26,65,0.4,0.399,19,22,0.864,10,19,29,27,10,1,23,29,74,2002
J. Veal,CLB,25.0,34,11,686,107,248,0.431,7,29,0.241,100,219,0.457,0.446,63,72,0.875,21,62,83,91,33,4,61,58,284,2002
R. Vlijter,CLB,,3,0,5,0,1,0.0,0,0,0.0,0,1,0.0,0.0,0,0,0.0,0,0,0,0,0,0,0,3,0,2002
B. Wardle,FAY,22.0,45,19,535,49,139,0.353,3,15,0.2,46,124,0.371,0.363,16,23,0.696,25,49,74,38,11,4,37,80,117,2002
J. Watkins,FAY,24.0,16,12,403,58,114,0.509,1,1,1.0,57,113,0.504,0.513,35,57,0.614,35,85,120,5,11,25,21,58,152,2002
D. Watts,MOB,24.0,26,3,339,37,99,0.374,8,23,0.348,29,76,0.382,0.414,19,34,0.559,14,22,36,25,7,1,20,37,101,2002
S. Webber,NCH,25.0,55,39,1381,274,589,0.465,41,93,0.441,233,496,0.47,0.5,147,196,0.75,106,160,266,83,52,12,120,146,736,2002
T. Whitlock,TOT,,28,25,510,67,173,0.387,11,37,0.297,56,136,0.412,0.419,34,40,0.85,11,43,54,81,18,1,47,30,179,2002
T. Whitlock,NCH,,25,25,498,67,170,0.394,11,37,0.297,56,133,0.421,0.426,34,40,0.85,11,43,54,79,18,0,47,30,179,2002
T. Whitlock,CLB,,3,0,12,0,3,0.0,0,0,0.0,0,3,0.0,0.0,0,0,0.0,0,0,0,2,0,1,0,0,0,2002
T. Wideman,GRE,25.0,48,26,999,132,291,0.454,0,2,0.0,132,289,0.457,0.454,85,133,0.639,99,206,305,46,14,27,79,115,349,2002
M. Wilks,HUN,22.0,38,38,1136,121,292,0.414,23,60,0.383,98,232,0.422,0.454,122,155,0.787,49,94,143,172,62,6,67,102,387,2002
M. Wilks,TOT,22.0,44,38,1199,125,306,0.408,24,62,0.387,101,244,0.414,0.448,127,163,0.779,57,102,159,175,68,6,73,107,401,2002
M. Wilks,MOB,22.0,6,0,63,4,14,0.286,1,2,0.5,3,12,0.25,0.321,5,8,0.625,8,8,16,3,6,0,6,5,14,2002
A. Williams,MOB,24.0,29,0,278,33,69,0.478,0,2,0.0,33,67,0.493,0.478,34,47,0.723,14,34,48,4,2,13,18,35,100,2002
J. Williams,GRE,,8,0,44,5,12,0.417,0,2,0.0,5,10,0.5,0.417,4,6,0.667,4,8,12,3,1,0,1,3,14,2002
B. Wright,GRE,23.0,27,1,320,37,80,0.463,0,3,0.0,37,77,0.481,0.463,31,37,0.838,22,49,71,16,12,1,26,48,105,2002
G. Young,NCH,26.0,56,2,1337,229,609,0.376,35,103,0.34,194,506,0.383,0.405,154,227,0.678,84,224,308,139,63,16,141,211,647,2002
S. Youngblood,ROA,24.0,27,3,515,69,151,0.457,0,1,0.0,69,150,0.46,0.457,32,57,0.561,30,81,111,4,5,24,43,78,170,2002
K. Zepernick,ROA,,2,0,8,0,2,0.0,0,0,0.0,0,2,0.0,0.0,0,0,0.0,1,0,1,0,0,0,2,4,0,2002
