Player,Pos,Age,Tm,G,GS,MP,FG,FGA,FG%,3P,3PA,3P%,2P,2PA,2P%,eFG%,FT,FTA,FT%,ORB,DRB,TRB,AST,STL,BLK,TOV,PF,PTS,Yr
Alex Abrines,SG,23,OKC,68,6,1055,134,341,.393,94,247,.381,40,94,.426,.531,44,49,.898,18,68,86,40,37,8,33,114,406,2017
Quincy Acy,PF,26,TOT,38,1,558,70,170,.412,37,90,.411,33,80,.413,.521,45,60,.750,20,95,115,18,14,15,21,67,222,2017
Quincy Acy,PF,26,DAL,6,0,48,5,17,.294,1,7,.143,4,10,.400,.324,2,3,.667,2,6,8,0,0,0,2,9,13,2017
Quincy Acy,PF,26,BRK,32,1,510,65,153,.425,36,83,.434,29,70,.414,.542,43,57,.754,18,89,107,18,14,15,19,58,209,2017
Steven Adams,C,23,OKC,80,80,2389,374,655,.571,0,1,.000,374,654,.572,.571,157,257,.611,282,333,615,86,88,78,146,195,905,2017
Arron Afflalo,SG,31,SAC,61,45,1580,185,420,.440,62,151,.411,123,269,.457,.514,83,93,.892,9,116,125,78,21,7,42,104,515,2017
Alexis Ajinca,C,28,NOP,39,15,584,89,178,.500,0,4,.000,89,174,.511,.500,29,40,.725,46,131,177,12,20,22,31,77,207,2017
Cole Aldrich,C,28,MIN,62,0,531,45,86,.523,0,0,.000,45,86,.523,.523,15,22,.682,51,107,158,25,25,23,17,85,105,2017
LaMarcus Aldridge,PF,31,SAS,72,72,2335,500,1049,.477,23,56,.411,477,993,.480,.488,220,271,.812,174,350,524,139,46,89,98,158,1243,2017
Lavoy Allen,PF,27,IND,61,5,871,77,168,.458,0,1,.000,77,167,.461,.458,23,33,.697,105,115,220,57,18,24,29,78,177,2017
Tony Allen,SG,35,MEM,71,66,1914,274,595,.461,15,54,.278,259,541,.479,.473,80,130,.615,166,225,391,98,115,29,100,178,643,2017
Al-Farouq Aminu,SF,26,POR,61,25,1773,183,466,.393,70,212,.330,113,254,.445,.468,96,136,.706,77,374,451,99,60,44,94,102,532,2017
Chris Andersen,C,38,CLE,12,0,114,9,22,.409,0,3,.000,9,19,.474,.409,10,14,.714,9,22,31,5,5,7,5,20,28,2017
Alan Anderson,SF,34,LAC,30,0,308,30,80,.375,14,44,.318,16,36,.444,.463,12,16,.750,3,21,24,11,3,0,7,35,86,2017
Justin Anderson,SF,23,TOT,75,10,1228,186,439,.424,58,194,.299,128,245,.522,.490,102,129,.791,69,176,245,66,41,23,66,109,532,2017
Justin Anderson,SF,23,DAL,51,2,710,111,277,.401,37,122,.303,74,155,.477,.468,70,88,.795,39,110,149,32,28,16,40,64,329,2017
Justin Anderson,SF,23,PHI,24,8,518,75,162,.463,21,72,.292,54,90,.600,.528,32,41,.780,30,66,96,34,13,7,26,45,203,2017
Kyle Anderson,SG,23,SAS,72,14,1020,93,209,.445,15,40,.375,78,169,.462,.481,45,57,.789,33,175,208,91,51,26,39,63,246,2017
Ryan Anderson,PF,28,HOU,72,72,2116,323,773,.418,204,506,.403,119,267,.446,.550,129,150,.860,112,218,330,68,32,14,55,142,979,2017
Giannis Antetokounmpo,SF,22,MIL,80,80,2845,656,1259,.521,49,180,.272,607,1079,.563,.541,471,612,.770,142,558,700,434,131,151,234,246,1832,2017
Carmelo Anthony,SF,32,NYK,74,74,2538,602,1389,.433,151,421,.359,451,968,.466,.488,304,365,.833,62,374,436,213,60,34,153,198,1659,2017
Joel Anthony,C,34,SAS,19,0,122,10,16,.625,0,0,.000,10,16,.625,.625,5,8,.625,8,23,31,3,2,6,4,11,25,2017
Trevor Ariza,SF,31,HOU,80,80,2773,326,798,.409,191,555,.344,135,243,.556,.528,93,126,.738,54,405,459,175,147,20,74,133,936,2017
Darrell Arthur,PF,28,DEN,41,7,639,95,215,.442,53,117,.453,42,98,.429,.565,19,22,.864,25,87,112,42,19,21,36,76,262,2017
Omer Asik,C,30,NOP,31,19,482,31,65,.477,0,0,.000,31,65,.477,.477,23,39,.590,48,115,163,15,5,10,14,51,85,2017
D.J. Augustin,PG,29,ORL,78,20,1538,195,517,.377,95,274,.347,100,243,.412,.469,131,161,.814,15,102,117,209,31,1,90,101,616,2017
Luke Babbitt,SF,27,MIA,68,55,1065,113,281,.402,87,210,.414,26,71,.366,.557,11,15,.733,13,129,142,36,21,11,25,118,324,2017
Ron Baker,SG,23,NYK,52,13,857,82,217,.378,23,86,.267,59,131,.450,.431,28,43,.651,12,86,98,107,34,8,56,74,215,2017
Wade Baldwin,PG,20,MEM,33,1,405,36,115,.313,3,22,.136,33,93,.355,.326,31,37,.838,11,35,46,61,18,7,40,40,106,2017
Leandro Barbosa,SG,34,PHO,67,0,963,172,392,.439,35,98,.357,137,294,.466,.483,40,45,.889,15,89,104,81,31,8,48,82,419,2017
J.J. Barea,PG,32,DAL,35,6,771,142,343,.414,53,148,.358,89,195,.456,.491,44,51,.863,9,75,84,193,14,1,63,30,381,2017
Harrison Barnes,PF,24,DAL,79,79,2803,599,1280,.468,78,222,.351,521,1058,.492,.498,242,281,.861,94,303,397,117,66,15,102,128,1518,2017
Matt Barnes,SF,36,TOT,74,18,1777,185,473,.391,87,263,.331,98,210,.467,.483,70,89,.787,70,317,387,194,48,26,107,185,527,2017
Matt Barnes,SF,36,SAC,54,13,1367,147,383,.384,69,211,.327,78,172,.453,.474,50,66,.758,55,241,296,149,36,17,83,138,413,2017
Matt Barnes,SF,36,GSW,20,5,410,38,90,.422,18,52,.346,20,38,.526,.522,20,23,.870,15,76,91,45,12,9,24,47,114,2017
Will Barton,SG,26,DEN,60,19,1705,295,666,.443,87,235,.370,208,431,.483,.508,143,190,.753,58,200,258,206,48,28,97,110,820,2017
Brandon Bass,PF,31,LAC,52,0,577,107,186,.575,1,3,.333,106,183,.579,.578,77,88,.875,43,86,129,21,14,11,29,45,292,2017
Nicolas Batum,SG,28,CHO,77,77,2617,393,975,.403,135,405,.333,258,570,.453,.472,243,284,.856,46,435,481,455,86,29,194,109,1164,2017
Jerryd Bayless,PG,28,PHI,3,1,71,11,32,.344,2,5,.400,9,27,.333,.375,9,10,.900,3,9,12,13,0,0,9,4,33,2017
Aron Baynes,C,30,DET,75,2,1163,143,279,.513,0,0,.000,143,279,.513,.513,79,94,.840,111,222,333,32,17,39,50,166,365,2017
Kent Bazemore,SF,27,ATL,73,64,1963,295,721,.409,92,266,.346,203,455,.446,.473,119,168,.708,45,186,231,177,91,52,125,165,801,2017
Bradley Beal,SG,23,WAS,77,77,2684,637,1322,.482,223,552,.404,414,770,.538,.566,282,342,.825,53,186,239,267,83,21,157,169,1779,2017
Malik Beasley,SG,20,DEN,22,1,165,33,73,.452,9,28,.321,24,45,.533,.514,8,10,.800,5,12,17,11,7,0,8,10,83,2017
Michael Beasley,PF,28,MIL,56,6,935,216,406,.532,18,43,.419,198,363,.545,.554,78,105,.743,40,153,193,53,28,27,66,92,528,2017
Marco Belinelli,SG,30,CHO,74,0,1778,264,615,.429,102,283,.360,162,332,.488,.512,150,168,.893,14,164,178,147,44,9,70,90,780,2017
DeAndre' Bembry,SF,22,ATL,38,1,371,47,98,.480,1,18,.056,46,80,.575,.485,6,16,.375,14,45,59,28,8,5,16,21,101,2017
Dragan Bender,PF,19,PHO,43,0,574,57,161,.354,28,101,.277,29,60,.483,.441,4,11,.364,23,80,103,23,10,22,32,74,146,2017
Anthony Bennett,PF,23,BRK,23,1,264,38,92,.413,13,48,.271,25,44,.568,.484,26,36,.722,25,53,78,12,5,3,12,18,115,2017
Ben Bentil,PF,21,DAL,3,0,10,0,3,.000,0,1,.000,0,2,.000,.000,0,0,.000,0,2,2,0,0,0,1,1,0,2017
Davis Bertans,PF,24,SAS,67,6,808,103,234,.440,69,173,.399,34,61,.557,.588,28,34,.824,22,77,99,46,20,28,32,75,303,2017
Patrick Beverley,SG,28,HOU,67,67,2058,228,543,.420,110,288,.382,118,255,.463,.521,73,95,.768,95,299,394,281,99,25,100,222,639,2017
Bismack Biyombo,C,24,ORL,81,27,1793,179,339,.528,0,0,.000,179,339,.528,.528,125,234,.534,157,410,567,74,25,91,95,202,483,2017
Nemanja Bjelica,PF,28,MIN,65,1,1190,151,356,.424,56,177,.316,95,179,.531,.503,45,61,.738,57,187,244,79,40,20,59,154,403,2017
Tarik Black,C,25,LAL,67,16,1091,150,294,.510,1,2,.500,149,292,.510,.512,82,109,.752,143,199,342,39,30,44,58,173,383,2017
Eric Bledsoe,PG,27,PHO,66,66,2176,449,1034,.434,104,310,.335,345,724,.477,.485,388,458,.847,52,268,320,418,92,31,223,164,1390,2017
Bojan Bogdanovic,SF,27,TOT,81,54,2083,376,845,.445,144,392,.367,232,453,.512,.530,217,243,.893,37,240,277,111,34,7,130,146,1113,2017
Bojan Bogdanovic,SF,27,BRK,55,54,1482,269,611,.440,99,277,.357,170,334,.509,.521,146,167,.874,23,174,197,90,24,3,92,99,783,2017
Bojan Bogdanovic,SF,27,WAS,26,0,601,107,234,.457,45,115,.391,62,119,.521,.553,71,76,.934,14,66,80,21,10,4,38,47,330,2017
Andrew Bogut,C,32,TOT,27,21,583,38,81,.469,0,1,.000,38,80,.475,.469,3,11,.273,56,162,218,49,13,25,43,86,79,2017
Andrew Bogut,C,32,DAL,26,21,582,38,81,.469,0,1,.000,38,80,.475,.469,3,11,.273,56,162,218,49,13,25,43,84,79,2017
Andrew Bogut,C,32,CLE,1,0,1,0,0,.000,0,0,.000,0,0,.000,.000,0,0,.000,0,0,0,0,0,0,0,2,0,2017
Joel Bolomboy,PF,23,UTA,12,0,53,9,16,.563,1,4,.250,8,12,.667,.594,3,6,.500,4,13,17,2,1,2,2,1,22,2017
Devin Booker,SG,20,PHO,78,78,2730,606,1431,.423,147,405,.363,459,1026,.447,.475,367,441,.832,46,203,249,268,72,21,241,242,1726,2017
Trevor Booker,PF,29,BRK,71,43,1754,305,591,.516,25,78,.321,280,513,.546,.537,74,110,.673,142,428,570,138,76,28,127,152,709,2017
Avery Bradley,SG,26,BOS,55,55,1835,359,775,.463,108,277,.390,251,498,.504,.533,68,93,.731,65,269,334,121,68,11,88,141,894,2017
Corey Brewer,SF,30,TOT,82,11,1281,147,348,.422,27,118,.229,120,230,.522,.461,50,68,.735,32,134,166,97,61,19,55,133,371,2017
Corey Brewer,SF,30,HOU,58,8,923,94,227,.414,22,94,.234,72,133,.541,.463,32,44,.727,21,93,114,61,37,11,36,104,242,2017
Corey Brewer,SF,30,LAL,24,3,358,53,121,.438,5,24,.208,48,97,.495,.459,18,24,.750,11,41,52,36,24,8,19,29,129,2017
Malcolm Brogdon,SG,24,MIL,75,28,1982,290,635,.457,78,193,.404,212,442,.480,.518,109,126,.865,47,166,213,317,84,12,113,140,767,2017
Aaron Brooks,PG,32,IND,65,0,894,121,300,.403,48,128,.375,73,172,.424,.483,32,40,.800,18,51,69,125,25,9,66,93,322,2017
Anthony Brown,SF,24,TOT,11,0,159,18,50,.360,7,27,.259,11,23,.478,.430,0,0,.000,8,25,33,8,5,1,6,15,43,2017
Anthony Brown,SF,24,NOP,9,0,143,14,41,.341,6,24,.250,8,17,.471,.415,0,0,.000,6,20,26,6,5,1,5,13,34,2017
Anthony Brown,SF,24,ORL,2,0,16,4,9,.444,1,3,.333,3,6,.500,.500,0,0,.000,2,5,7,2,0,0,1,2,9,2017
Bobby Brown,PG,32,HOU,25,0,123,23,60,.383,14,35,.400,9,25,.360,.500,2,2,1.000,0,6,6,14,1,0,5,5,62,2017
Jaylen Brown,SF,20,BOS,78,20,1341,192,423,.454,46,135,.341,146,288,.507,.508,85,124,.685,45,175,220,64,35,18,68,142,515,2017
Nicolas Brussino,SF,23,DAL,54,2,521,52,141,.369,29,95,.305,23,46,.500,.472,17,22,.773,26,69,95,47,17,8,26,43,150,2017
Reggie Bullock,SF,25,DET,31,5,467,54,128,.422,28,73,.384,26,55,.473,.531,5,7,.714,13,51,64,29,18,3,10,22,141,2017
Trey Burke,PG,24,WAS,57,0,703,116,255,.455,31,70,.443,85,185,.459,.516,22,29,.759,7,40,47,100,11,5,48,54,285,2017
Alec Burks,SG,25,UTA,42,0,653,99,248,.399,25,76,.329,74,172,.430,.450,60,78,.769,17,103,120,30,18,5,35,50,283,2017
Jimmy Butler,SF,27,CHI,76,75,2809,570,1252,.455,91,248,.367,479,1004,.477,.492,585,676,.865,129,341,470,417,143,32,159,112,1816,2017
Bruno Caboclo,SF,21,TOR,9,0,40,6,16,.375,2,6,.333,4,10,.400,.438,0,0,.000,5,5,10,4,2,1,2,4,14,2017
Jose Calderon,PG,35,TOT,41,13,539,55,134,.410,20,64,.313,35,70,.500,.485,11,12,.917,15,59,74,88,11,1,41,36,141,2017
Jose Calderon,PG,35,LAL,24,11,292,32,77,.416,12,34,.353,20,43,.465,.494,4,4,1.000,8,34,42,51,7,1,26,22,80,2017
Jose Calderon,PG,35,ATL,17,2,247,23,57,.404,8,30,.267,15,27,.556,.474,7,8,.875,7,25,32,37,4,0,15,14,61,2017
Kentavious Caldwell-Pope,SG,23,DET,76,75,2529,370,928,.399,153,437,.350,217,491,.442,.481,154,185,.832,55,193,248,193,89,12,86,118,1047,2017
Isaiah Canaan,SG,25,CHI,39,0,592,63,173,.364,25,94,.266,38,79,.481,.436,30,33,.909,6,43,49,37,22,1,20,35,181,2017
Clint Capela,C,22,HOU,65,59,1551,362,563,.643,0,0,.000,362,563,.643,.643,94,177,.531,178,348,526,64,34,80,87,179,818,2017
DeMarre Carroll,SF,30,TOR,72,72,1882,220,549,.401,109,320,.341,111,229,.485,.500,89,117,.761,63,212,275,74,81,27,54,143,638,2017
Vince Carter,SF,40,MEM,73,15,1799,193,490,.394,112,296,.378,81,194,.418,.508,88,115,.765,36,191,227,133,60,36,50,163,586,2017
Michael Carter-Williams,PG,25,CHI,45,19,846,112,306,.366,15,64,.234,97,242,.401,.391,58,77,.753,24,128,152,113,38,23,66,102,297,2017
Omri Casspi,SF,28,TOT,36,2,643,77,165,.467,15,43,.349,62,122,.508,.512,17,29,.586,27,85,112,37,23,3,29,50,186,2017
Omri Casspi,SF,28,SAC,22,2,397,53,117,.453,11,29,.379,42,88,.477,.500,12,21,.571,20,70,90,26,10,1,17,23,129,2017
Omri Casspi,SF,28,NOP,1,0,24,5,9,.556,2,4,.500,3,5,.600,.667,0,0,.000,1,1,2,0,0,0,2,3,12,2017
Omri Casspi,SF,28,MIN,13,0,222,19,39,.487,2,10,.200,17,29,.586,.513,5,8,.625,6,14,20,11,13,2,10,24,45,2017
Willie Cauley-Stein,C,23,SAC,75,21,1421,255,481,.530,0,2,.000,255,479,.532,.530,101,151,.669,85,255,340,80,53,45,69,147,611,2017
Tyson Chandler,C,34,PHO,47,46,1298,153,228,.671,0,0,.000,153,228,.671,.671,91,124,.734,154,385,539,30,33,24,67,126,397,2017
Wilson Chandler,SF,29,DEN,71,33,2197,433,939,.461,110,326,.337,323,613,.527,.520,141,194,.727,103,356,459,141,52,30,114,172,1117,2017
Marquese Chriss,PF,19,PHO,82,75,1743,284,632,.449,72,224,.321,212,408,.520,.506,113,181,.624,96,252,348,60,67,70,108,263,753,2017
Rakeem Christmas,PF,25,IND,29,0,219,19,43,.442,0,0,.000,19,43,.442,.442,21,29,.724,26,30,56,4,3,6,8,37,59,2017
Semaj Christon,PG,24,OKC,64,1,973,77,223,.345,12,63,.190,65,160,.406,.372,17,31,.548,19,69,88,130,28,6,43,79,183,2017
Ian Clark,SG,25,GSW,77,0,1137,211,433,.487,61,163,.374,150,270,.556,.558,44,58,.759,22,100,122,90,39,8,55,77,527,2017
Jordan Clarkson,SG,24,LAL,82,19,2397,477,1071,.445,117,356,.329,360,715,.503,.500,134,168,.798,49,197,246,213,88,8,164,150,1205,2017
Norris Cole,PG,28,OKC,13,0,125,16,52,.308,3,13,.231,13,39,.333,.337,8,10,.800,0,11,11,14,8,0,7,18,43,2017
Darren Collison,PG,29,SAC,68,64,2063,340,714,.476,73,175,.417,267,539,.495,.527,147,171,.860,23,130,153,312,67,9,114,119,900,2017
Nick Collison,PF,36,OKC,20,0,128,14,23,.609,0,1,.000,14,22,.636,.609,5,8,.625,9,21,30,12,2,2,4,17,33,2017
Mike Conley,PG,29,MEM,69,68,2292,464,1009,.460,171,419,.408,293,590,.497,.545,316,368,.859,31,211,242,433,92,19,156,126,1415,2017
Pat Connaughton,SG,24,POR,39,1,316,37,72,.514,17,33,.515,20,39,.513,.632,7,9,.778,10,42,52,28,6,2,17,23,98,2017
Quinn Cook,PG,23,TOT,14,0,188,33,66,.500,11,26,.423,22,40,.550,.583,2,5,.400,1,6,7,26,4,0,13,13,79,2017
Quinn Cook,PG,23,DAL,5,0,77,11,25,.440,5,14,.357,6,11,.545,.540,0,2,.000,0,3,3,12,1,0,8,6,27,2017
Quinn Cook,PG,23,NOP,9,0,111,22,41,.537,6,12,.500,16,29,.552,.610,2,3,.667,1,3,4,14,3,0,5,7,52,2017
DeMarcus Cousins,C,26,TOT,72,72,2465,647,1433,.452,131,364,.360,516,1069,.483,.497,517,670,.772,153,644,797,332,100,92,269,278,1942,2017
DeMarcus Cousins,C,26,SAC,55,55,1891,505,1119,.451,95,268,.354,410,851,.482,.494,423,549,.770,115,470,585,266,75,73,207,203,1528,2017
DeMarcus Cousins,C,26,NOP,17,17,574,142,314,.452,36,96,.375,106,218,.486,.510,94,121,.777,38,174,212,66,25,19,62,75,414,2017
Robert Covington,SF,26,PHI,67,67,2119,292,732,.399,137,412,.333,155,320,.484,.492,143,174,.822,92,344,436,102,127,69,131,203,864,2017
Allen Crabbe,SG,24,POR,79,7,2254,303,647,.468,134,302,.444,169,345,.490,.572,105,124,.847,19,206,225,93,54,20,62,171,845,2017
Jamal Crawford,SG,36,LAC,82,1,2157,359,869,.413,116,322,.360,243,547,.444,.480,174,203,.857,17,112,129,213,59,14,134,115,1008,2017
Jordan Crawford,SG,28,NOP,19,0,442,105,218,.482,37,95,.389,68,123,.553,.567,20,26,.769,4,30,34,57,11,2,25,30,267,2017
Jae Crowder,SF,26,BOS,72,72,2335,333,720,.463,157,394,.398,176,326,.540,.572,176,217,.811,48,367,415,155,72,23,79,161,999,2017
Dante Cunningham,SF,29,NOP,66,35,1649,174,359,.485,71,181,.392,103,178,.579,.584,16,27,.593,56,221,277,36,39,28,28,100,435,2017
Seth Curry,PG,26,DAL,70,42,2029,338,703,.481,137,322,.425,201,381,.528,.578,85,100,.850,25,153,178,188,79,7,92,126,898,2017
Stephen Curry,PG,28,GSW,79,79,2638,675,1443,.468,324,789,.411,351,654,.537,.580,325,362,.898,61,292,353,523,143,17,239,183,1999,2017
Troy Daniels,SG,25,MEM,67,3,1183,185,495,.374,138,355,.389,47,140,.336,.513,43,54,.796,21,79,100,46,21,4,45,90,551,2017
Anthony Davis,C,23,NOP,75,75,2708,770,1527,.504,40,134,.299,730,1393,.524,.517,519,647,.802,174,712,886,157,94,167,181,168,2099,2017
Deyonta Davis,C,20,MEM,36,0,238,24,47,.511,0,0,.000,24,47,.511,.511,10,18,.556,20,40,60,2,3,17,8,40,58,2017
Ed Davis,PF,27,POR,46,12,789,75,142,.528,0,0,.000,75,142,.528,.528,50,81,.617,96,147,243,27,15,22,37,137,200,2017
Dewayne Dedmon,C,27,SAS,76,37,1330,161,259,.622,0,0,.000,161,259,.622,.622,65,93,.699,129,366,495,44,37,61,61,180,387,2017
Sam Dekker,SF,22,HOU,77,2,1419,203,429,.473,60,187,.321,143,242,.591,.543,38,68,.559,94,190,284,76,38,21,41,83,504,2017
Malcolm Delaney,PG,27,ATL,73,2,1248,145,388,.374,26,110,.236,119,278,.428,.407,75,93,.806,11,113,124,193,39,1,95,112,391,2017
Matthew Dellavedova,PG,26,MIL,76,54,1986,208,534,.390,79,215,.367,129,319,.404,.463,82,96,.854,24,123,147,357,53,0,133,153,577,2017
Luol Deng,SF,31,LAL,56,49,1486,164,424,.387,51,165,.309,113,259,.436,.447,46,63,.730,63,232,295,74,48,20,43,61,425,2017
DeMar DeRozan,SG,27,TOR,74,74,2620,721,1545,.467,33,124,.266,688,1421,.484,.477,545,647,.842,70,316,386,290,78,13,180,134,2020,2017
Cheick Diallo,PF,20,NOP,17,0,199,36,76,.474,0,0,.000,36,76,.474,.474,15,21,.714,23,50,73,4,4,7,7,17,87,2017
Boris Diaw,PF,34,UTA,73,33,1283,146,327,.446,20,81,.247,126,246,.512,.477,26,35,.743,46,112,158,170,18,9,87,83,338,2017
Gorgui Dieng,PF,27,MIN,82,82,2653,332,661,.502,16,43,.372,316,618,.511,.514,136,167,.814,188,459,647,158,88,95,107,254,816,2017
Spencer Dinwiddie,PG,23,BRK,59,18,1334,134,302,.444,38,101,.376,96,201,.478,.507,126,159,.792,27,137,164,185,44,23,66,119,432,2017
Toney Douglas,PG,30,MEM,24,0,394,43,117,.368,7,42,.167,36,75,.480,.397,24,29,.828,13,48,61,56,18,5,21,50,117,2017
Goran Dragic,PG,30,MIA,73,73,2459,534,1124,.475,117,289,.405,417,835,.499,.527,298,377,.790,61,217,278,423,89,13,212,199,1483,2017
Andre Drummond,C,23,DET,81,81,2409,483,911,.530,2,7,.286,481,904,.532,.531,137,355,.386,345,771,1116,89,124,89,152,237,1105,2017
Jared Dudley,PF,31,PHO,64,7,1362,157,346,.454,77,203,.379,80,143,.559,.565,43,65,.662,31,194,225,121,42,16,72,154,434,2017
Mike Dunleavy,SF,36,TOT,53,2,841,93,220,.423,53,134,.396,40,86,.465,.543,36,45,.800,18,97,115,50,15,7,28,67,275,2017
Mike Dunleavy,SF,36,CLE,23,2,366,36,90,.400,20,57,.351,16,33,.485,.511,14,19,.737,5,42,47,20,6,2,14,32,106,2017
Mike Dunleavy,SF,36,ATL,30,0,475,57,130,.438,33,77,.429,24,53,.453,.565,22,26,.846,13,55,68,30,9,5,14,35,169,2017
Kris Dunn,PG,22,MIN,78,7,1333,118,313,.377,21,73,.288,97,240,.404,.411,36,59,.610,24,142,166,188,78,36,89,178,293,2017
Kevin Durant,SF,28,GSW,62,62,2070,551,1026,.537,117,312,.375,434,714,.608,.594,336,384,.875,39,474,513,300,66,99,138,117,1555,2017
Jarell Eddie,SF,25,PHO,5,0,62,6,19,.316,4,16,.250,2,3,.667,.421,8,9,.889,1,6,7,0,1,0,1,1,24,2017
Henry Ellenson,PF,20,DET,19,2,146,23,64,.359,10,35,.286,13,29,.448,.438,4,8,.500,8,33,41,7,1,1,14,6,60,2017
Wayne Ellington,SG,29,MIA,62,13,1500,231,555,.416,149,394,.378,82,161,.509,.550,37,43,.860,18,115,133,70,35,4,30,70,648,2017
Monta Ellis,SG,31,IND,74,33,1998,247,557,.443,43,135,.319,204,422,.483,.482,93,128,.727,19,185,204,236,79,27,135,149,630,2017
Joel Embiid,C,22,PHI,31,31,786,200,429,.466,36,98,.367,164,331,.495,.508,191,244,.783,61,182,243,66,27,76,117,112,627,2017
James Ennis,SF,26,MEM,64,28,1501,146,321,.455,51,137,.372,95,184,.516,.534,86,110,.782,69,190,259,64,46,19,59,165,429,2017
Tyler Ennis,PG,22,TOT,53,2,588,90,208,.433,27,70,.386,63,138,.457,.498,21,25,.840,10,36,46,86,26,2,45,58,228,2017
Tyler Ennis,PG,22,HOU,31,0,196,25,64,.391,6,16,.375,19,48,.396,.438,2,3,.667,4,15,19,34,6,0,24,29,58,2017
Tyler Ennis,PG,22,LAL,22,2,392,65,144,.451,21,54,.389,44,90,.489,.524,19,22,.864,6,21,27,52,20,2,21,29,170,2017
Tyreke Evans,SF,27,TOT,40,6,788,150,370,.405,42,118,.356,108,252,.429,.462,69,92,.750,13,124,137,124,35,9,61,60,411,2017
Tyreke Evans,SF,27,NOP,26,0,474,91,227,.401,21,70,.300,70,157,.446,.447,45,58,.776,6,80,86,91,23,4,39,41,248,2017
Tyreke Evans,SF,27,SAC,14,6,314,59,143,.413,21,48,.438,38,95,.400,.486,24,34,.706,7,44,51,33,12,5,22,19,163,2017
Dante Exum,PG,21,UTA,66,26,1228,155,363,.427,44,149,.295,111,214,.519,.488,58,73,.795,30,102,132,112,21,12,80,146,412,2017
Kenneth Faried,PF,27,DEN,61,34,1296,228,416,.548,0,6,.000,228,410,.556,.548,131,189,.693,182,279,461,55,43,40,58,124,587,2017
Jordan Farmar,PG,30,SAC,2,0,35,4,12,.333,4,9,.444,0,3,.000,.500,0,0,.000,1,2,3,9,2,0,3,1,12,2017
Derrick Favors,PF,25,UTA,50,39,1186,203,417,.487,3,10,.300,200,407,.491,.490,67,109,.615,92,213,305,56,45,40,60,103,476,2017
Kay Felder,PG,21,CLE,42,0,386,62,158,.392,7,22,.318,55,136,.404,.415,35,49,.714,3,38,41,58,18,7,31,38,166,2017
Cristiano Felicio,C,24,CHI,66,0,1040,128,222,.577,0,0,.000,128,222,.577,.577,60,93,.645,124,187,311,40,25,16,33,110,316,2017
Raymond Felton,PG,32,LAC,80,11,1700,221,514,.430,46,144,.319,175,370,.473,.475,50,64,.781,33,184,217,191,67,22,83,125,538,2017
Yogi Ferrell,PG,23,TOT,46,29,1197,160,394,.406,68,176,.386,92,218,.422,.492,74,89,.831,20,91,111,172,42,9,70,90,462,2017
Yogi Ferrell,PG,23,BRK,10,0,151,18,49,.367,8,27,.296,10,22,.455,.449,10,16,.625,4,8,12,17,2,2,14,11,54,2017
Yogi Ferrell,PG,23,DAL,36,29,1046,142,345,.412,60,149,.403,82,196,.418,.499,64,73,.877,16,83,99,155,40,7,56,79,408,2017
Dorian Finney-Smith,PF,23,DAL,81,35,1642,124,333,.372,56,191,.293,68,142,.479,.456,46,61,.754,55,166,221,67,52,25,45,125,350,2017
Bryn Forbes,SG,23,SAS,36,0,285,36,99,.364,17,53,.321,19,46,.413,.449,5,6,.833,2,21,23,23,1,0,11,20,94,2017
Evan Fournier,SG,24,ORL,68,66,2234,408,930,.439,128,360,.356,280,570,.491,.508,223,277,.805,44,165,209,202,66,4,141,180,1167,2017
Randy Foye,SG,33,BRK,69,40,1284,118,325,.363,67,203,.330,51,122,.418,.466,54,63,.857,9,146,155,135,35,9,80,99,357,2017
Tim Frazier,PG,26,NOP,65,35,1525,163,404,.403,40,128,.313,123,276,.446,.453,98,129,.760,34,139,173,335,56,6,101,133,464,2017
Channing Frye,C,33,CLE,74,15,1398,238,520,.458,137,335,.409,101,185,.546,.589,63,74,.851,37,253,290,45,33,37,53,138,676,2017
Danilo Gallinari,SF,28,DEN,63,63,2134,335,750,.447,126,324,.389,209,426,.491,.531,349,387,.902,39,287,326,135,40,15,81,93,1145,2017
Langston Galloway,PG,25,TOT,74,2,1495,207,545,.380,120,308,.390,87,237,.367,.490,51,64,.797,27,129,156,93,46,6,46,96,585,2017
Langston Galloway,PG,25,NOP,55,0,1120,165,441,.374,101,268,.377,64,173,.370,.489,40,52,.769,20,101,121,65,40,5,28,76,471,2017
Langston Galloway,PG,25,SAC,19,2,375,42,104,.404,19,40,.475,23,64,.359,.495,11,12,.917,7,28,35,28,6,1,18,20,114,2017
Patricio Garino,SG,23,ORL,5,0,43,0,7,.000,0,5,.000,0,2,.000,.000,0,0,.000,1,6,7,0,0,0,3,4,0,2017
Marc Gasol,C,32,MEM,74,74,2531,532,1160,.459,104,268,.388,428,892,.480,.503,278,332,.837,60,402,462,338,67,99,166,171,1446,2017
Pau Gasol,C,36,SAS,64,39,1627,303,604,.502,56,104,.538,247,500,.494,.548,130,184,.707,107,394,501,150,24,70,81,110,792,2017
Rudy Gay,SF,30,SAC,30,30,1013,201,442,.455,42,113,.372,159,329,.483,.502,118,138,.855,35,155,190,82,44,26,74,79,562,2017
Michael Gbinije,SG,24,DET,9,0,32,1,10,.100,0,4,.000,1,6,.167,.100,2,2,1.000,2,1,3,2,0,0,0,2,4,2017
Alonzo Gee,SF,29,DEN,13,0,89,3,14,.214,0,3,.000,3,11,.273,.214,5,9,.556,4,11,15,6,5,1,4,14,11,2017
Paul George,SF,26,IND,75,75,2689,622,1349,.461,195,496,.393,427,853,.501,.533,336,374,.898,58,434,492,251,117,27,218,206,1775,2017
Marcus Georges-Hunt,SG,22,ORL,5,0,48,2,7,.286,1,2,.500,1,5,.200,.357,9,10,.900,1,8,9,3,1,0,2,5,14,2017
Jonathan Gibson,PG,29,DAL,17,0,231,35,95,.368,15,45,.333,20,50,.400,.447,21,29,.724,1,21,22,26,8,0,21,21,106,2017
Taj Gibson,PF,31,TOT,78,71,1989,365,709,.515,3,13,.231,362,696,.520,.517,113,158,.715,158,328,486,73,42,66,105,163,846,2017
Taj Gibson,PF,31,CHI,55,55,1502,276,530,.521,2,12,.167,274,518,.529,.523,85,119,.714,120,263,383,60,28,51,77,123,639,2017
Taj Gibson,PF,31,OKC,23,16,487,89,179,.497,1,1,1.000,88,178,.494,.500,28,39,.718,38,65,103,13,14,15,28,40,207,2017
Manu Ginobili,SG,39,SAS,69,0,1291,171,439,.390,89,227,.392,82,212,.387,.491,86,107,.804,28,129,157,183,82,16,96,119,517,2017
Rudy Gobert,C,24,UTA,81,81,2744,413,624,.662,0,1,.000,413,623,.663,.662,311,476,.653,314,721,1035,97,49,214,148,246,1137,2017
Archie Goodwin,SG,22,TOT,15,0,214,36,66,.545,5,15,.333,31,51,.608,.583,33,42,.786,7,21,28,24,4,5,14,8,110,2017
Archie Goodwin,SG,22,NOP,3,0,30,2,5,.400,1,2,.500,1,3,.333,.500,10,10,1.000,0,0,0,1,0,1,0,1,15,2017
Archie Goodwin,SG,22,BRK,12,0,184,34,61,.557,4,13,.308,30,48,.625,.590,23,32,.719,7,21,28,23,4,4,14,7,95,2017
Aaron Gordon,SF,21,ORL,80,72,2298,393,865,.454,77,267,.288,316,598,.528,.499,156,217,.719,116,289,405,150,64,40,89,172,1019,2017
Eric Gordon,SG,28,HOU,75,15,2323,412,1016,.406,246,661,.372,166,355,.468,.527,147,175,.840,29,172,201,188,48,40,121,150,1217,2017
Marcin Gortat,C,32,WAS,82,82,2556,390,674,.579,0,2,.000,390,672,.580,.579,103,159,.648,238,611,849,121,40,65,118,213,883,2017
Treveon Graham,SG,23,CHO,27,1,189,19,40,.475,9,15,.600,10,25,.400,.588,10,15,.667,5,17,22,6,6,1,3,18,57,2017
Jerami Grant,SF,22,TOT,80,4,1531,152,328,.463,43,116,.371,109,212,.514,.529,90,147,.612,38,168,206,46,33,79,44,149,437,2017
Jerami Grant,SF,22,PHI,2,0,41,6,17,.353,0,2,.000,6,15,.400,.353,4,8,.500,0,7,7,0,0,4,3,5,16,2017
Jerami Grant,SF,22,OKC,78,4,1490,146,311,.469,43,114,.377,103,197,.523,.539,86,139,.619,38,161,199,46,33,75,41,144,421,2017
Jerian Grant,PG,24,CHI,63,28,1028,128,301,.425,49,134,.366,79,167,.473,.507,65,73,.890,17,94,111,120,47,8,44,93,370,2017
Danny Green,SG,29,SAS,68,68,1807,176,449,.392,118,311,.379,58,138,.420,.523,27,32,.844,31,193,224,124,71,58,76,120,497,2017
Draymond Green,PF,26,GSW,76,76,2471,272,650,.418,81,263,.308,191,387,.494,.481,151,213,.709,98,501,599,533,154,106,184,217,776,2017
Gerald Green,SF,31,BOS,47,0,538,95,232,.409,39,111,.351,56,121,.463,.494,33,41,.805,17,68,85,33,9,7,25,48,262,2017
JaMychal Green,PF,26,MEM,77,75,2101,250,500,.500,55,145,.379,195,355,.549,.555,134,167,.802,167,377,544,84,46,34,94,248,689,2017
Jeff Green,PF,30,ORL,69,11,1534,220,558,.394,53,193,.275,167,365,.458,.442,145,168,.863,39,175,214,81,37,13,75,103,638,2017
Blake Griffin,PF,27,LAC,61,61,2076,479,971,.493,38,113,.336,441,858,.514,.513,320,421,.760,111,385,496,300,58,23,142,157,1316,2017
Justin Hamilton,C,26,BRK,64,7,1177,174,379,.459,55,181,.304,119,198,.601,.532,39,52,.750,71,191,262,55,29,43,43,91,442,2017
A.J. Hammons,C,24,DAL,22,0,163,17,42,.405,5,10,.500,12,32,.375,.464,9,20,.450,8,28,36,4,1,13,10,21,48,2017
Tim Hardaway,SG,24,ATL,79,30,2154,415,912,.455,149,417,.357,266,495,.537,.537,164,214,.766,35,189,224,182,55,15,106,103,1143,2017
James Harden,PG,27,HOU,81,81,2947,674,1533,.440,262,756,.347,412,777,.530,.525,746,881,.847,95,564,659,906,120,37,464,215,2356,2017
Maurice Harkless,SF,23,POR,77,69,2223,314,624,.503,68,194,.351,246,430,.572,.558,77,124,.621,125,216,341,89,85,70,85,214,773,2017
Justin Harper,PF,27,PHI,3,0,31,5,12,.417,2,7,.286,3,5,.600,.500,0,0,.000,2,3,5,2,0,0,4,2,12,2017
Montrezl Harrell,C,23,HOU,58,14,1064,225,345,.652,1,7,.143,224,338,.663,.654,76,121,.628,81,138,219,64,20,42,44,126,527,2017
Devin Harris,PG,33,DAL,65,0,1087,136,341,.399,58,177,.328,78,164,.476,.484,107,129,.829,11,116,127,136,43,7,57,101,437,2017
Gary Harris,SG,22,DEN,57,56,1782,320,637,.502,107,255,.420,213,382,.558,.586,104,134,.776,48,130,178,164,71,8,76,92,851,2017
Joe Harris,SG,25,BRK,52,11,1138,154,362,.425,85,221,.385,69,141,.489,.543,35,49,.714,16,131,147,54,30,8,55,121,428,2017
Manny Harris,SG,27,DAL,4,0,25,3,15,.200,0,2,.000,3,13,.231,.200,2,4,.500,3,6,9,2,0,0,2,1,8,2017
Tobias Harris,PF,24,DET,82,48,2567,511,1063,.481,109,314,.347,402,749,.537,.532,190,226,.841,63,353,416,142,60,39,95,133,1321,2017
Aaron Harrison,SG,22,CHO,5,0,17,0,4,.000,0,2,.000,0,2,.000,.000,1,2,.500,0,3,3,3,0,0,0,2,1,2017
Andrew Harrison,PG,22,MEM,72,18,1474,117,360,.325,43,156,.276,74,204,.363,.385,148,194,.763,23,113,136,198,54,20,85,194,425,2017
Udonis Haslem,C,36,MIA,17,0,130,11,23,.478,0,3,.000,11,20,.550,.478,9,15,.600,8,28,36,6,5,1,8,22,31,2017
Spencer Hawes,PF,28,TOT,54,1,797,134,277,.484,25,81,.309,109,196,.556,.529,44,52,.846,38,153,191,81,15,30,49,77,337,2017
Spencer Hawes,PF,28,CHO,35,1,626,104,218,.477,16,55,.291,88,163,.540,.514,30,34,.882,32,114,146,62,13,26,40,61,254,2017
Spencer Hawes,PF,28,MIL,19,0,171,30,59,.508,9,26,.346,21,33,.636,.585,14,18,.778,6,39,45,19,2,4,9,16,83,2017
Gordon Hayward,SF,26,UTA,73,73,2516,545,1156,.471,149,374,.398,396,782,.506,.536,362,429,.844,49,344,393,252,73,20,140,117,1601,2017
Gerald Henderson,SG,29,PHI,72,41,1667,234,553,.423,61,173,.353,173,380,.455,.478,133,165,.806,34,151,185,112,41,15,62,129,662,2017
John Henson,C,26,MIL,58,39,1123,159,309,.515,0,1,.000,159,308,.516,.515,74,107,.692,92,203,295,57,29,78,53,151,392,2017
Juan Hernangomez,PF,21,DEN,62,9,842,101,224,.451,46,113,.407,55,111,.495,.554,57,76,.750,43,144,187,29,29,12,31,62,305,2017
Willy Hernangomez,C,22,NYK,72,22,1324,246,465,.529,4,15,.267,242,450,.538,.533,91,125,.728,170,332,502,96,41,36,100,150,587,2017
Mario Hezonja,SF,21,ORL,65,2,960,117,330,.355,43,144,.299,74,186,.398,.420,40,50,.800,20,126,146,62,30,14,58,74,317,2017
Roy Hibbert,C,30,TOT,48,13,682,80,147,.544,0,0,.000,80,147,.544,.544,61,75,.813,54,100,154,21,8,46,32,100,221,2017
Roy Hibbert,C,30,CHO,42,13,671,78,144,.542,0,0,.000,78,144,.542,.542,61,75,.813,53,99,152,20,8,44,31,97,217,2017
Roy Hibbert,C,30,DEN,6,0,11,2,3,.667,0,0,.000,2,3,.667,.667,0,0,.000,1,1,2,1,0,2,1,3,4,2017
Buddy Hield,SG,23,TOT,82,55,1888,327,768,.426,148,379,.391,179,389,.460,.522,64,76,.842,35,234,269,121,38,9,101,115,866,2017
Buddy Hield,SG,23,NOP,57,37,1161,185,472,.392,89,241,.369,96,231,.416,.486,29,33,.879,19,147,166,77,18,7,48,81,488,2017
Buddy Hield,SG,23,SAC,25,18,727,142,296,.480,59,138,.428,83,158,.525,.579,35,43,.814,16,87,103,44,20,2,53,34,378,2017
Nene Hilario,C,34,HOU,67,8,1198,245,397,.617,3,9,.333,242,388,.624,.621,116,197,.589,95,186,281,65,56,40,73,163,609,2017
George Hill,PG,30,UTA,49,49,1544,289,606,.477,94,233,.403,195,373,.523,.554,157,196,.801,23,144,167,203,50,11,85,114,829,2017
Jordan Hill,C,29,MIN,7,0,47,5,13,.385,0,0,.000,5,13,.385,.385,2,2,1.000,8,6,14,0,1,0,4,9,12,2017
Solomon Hill,SF,25,NOP,80,71,2374,183,477,.384,94,270,.348,89,207,.430,.482,103,128,.805,51,256,307,141,71,32,82,182,563,2017
Darrun Hilliard,SG,23,DET,39,1,381,47,126,.373,12,46,.261,35,80,.438,.421,21,28,.750,2,31,33,33,11,2,28,39,127,2017
Jrue Holiday,PG,26,NOP,67,61,2190,405,894,.453,100,281,.356,305,613,.498,.509,119,168,.708,46,218,264,488,100,43,194,133,1029,2017
Justin Holiday,SG,27,NYK,82,4,1639,233,538,.433,97,273,.355,136,265,.513,.523,66,80,.825,27,198,225,102,65,31,66,109,629,2017
Rondae Hollis-Jefferson,SF,22,BRK,78,50,1761,235,542,.434,15,67,.224,220,475,.463,.447,190,253,.751,96,356,452,154,82,44,116,177,675,2017
Richaun Holmes,C,23,PHI,57,17,1193,230,412,.558,27,77,.351,203,335,.606,.591,72,103,.699,94,217,311,58,42,55,55,136,559,2017
Rodney Hood,SG,24,UTA,59,55,1593,272,666,.408,114,307,.371,158,359,.440,.494,90,115,.783,16,186,202,96,38,11,65,132,748,2017
Al Horford,C,30,BOS,68,68,2193,379,801,.473,86,242,.355,293,559,.524,.527,108,135,.800,95,369,464,337,52,87,116,138,952,2017
Danuel House,SG,23,WAS,1,0,1,0,0,.000,0,0,.000,0,0,.000,.000,0,0,.000,0,1,1,0,0,0,0,0,0,2017
Dwight Howard,C,31,ATL,74,74,2199,388,613,.633,0,2,.000,388,611,.635,.633,226,424,.533,296,644,940,104,64,92,170,203,1002,2017
Marcelo Huertas,PG,33,LAL,23,1,237,25,68,.368,4,19,.211,21,49,.429,.397,9,17,.529,2,22,24,52,10,2,19,16,63,2017
Josh Huestis,PF,25,OKC,2,0,31,6,11,.545,2,4,.500,4,7,.571,.636,0,1,.000,4,5,9,3,0,3,0,0,14,2017
Kris Humphries,PF,31,ATL,56,4,689,87,214,.407,19,54,.352,68,160,.425,.451,64,82,.780,60,146,206,29,15,21,28,69,257,2017
R.J. Hunter,SG,23,CHI,3,0,9,0,1,.000,0,1,.000,0,0,.000,.000,0,0,.000,0,1,1,0,0,0,0,0,0,2017
Serge Ibaka,PF,27,TOT,79,79,2422,471,982,.480,124,317,.391,347,665,.522,.543,107,125,.856,129,409,538,75,41,124,105,215,1173,2017
Serge Ibaka,PF,27,ORL,56,56,1710,343,703,.488,83,214,.388,260,489,.532,.547,77,91,.846,100,282,382,60,34,91,66,139,846,2017
Serge Ibaka,PF,27,TOR,23,23,712,128,279,.459,41,103,.398,87,176,.494,.532,30,34,.882,29,127,156,15,7,33,39,76,327,2017
Andre Iguodala,SF,33,GSW,76,0,1998,219,415,.528,64,177,.362,155,238,.651,.605,72,102,.706,51,253,304,262,76,39,58,97,574,2017
Ersan Ilyasova,PF,29,TOT,82,52,2142,384,890,.431,142,402,.353,242,488,.496,.511,161,207,.778,115,366,481,141,58,23,116,211,1071,2017
Ersan Ilyasova,PF,29,OKC,3,0,62,6,16,.375,3,12,.250,3,4,.750,.469,0,0,.000,2,14,16,1,3,1,4,5,15,2017
Ersan Ilyasova,PF,29,PHI,53,40,1447,285,648,.440,107,298,.359,178,350,.509,.522,109,142,.768,71,243,314,97,33,14,78,133,786,2017
Ersan Ilyasova,PF,29,ATL,26,12,633,93,226,.412,32,92,.348,61,134,.455,.482,52,65,.800,42,109,151,43,22,8,34,73,270,2017
Joe Ingles,SF,29,UTA,82,26,1972,204,451,.452,123,279,.441,81,172,.471,.589,50,68,.735,23,237,260,224,96,8,107,163,581,2017
Brandon Ingram,SF,19,LAL,79,40,2279,276,686,.402,55,187,.294,221,499,.443,.442,133,214,.621,60,257,317,166,50,36,116,158,740,2017
Kyrie Irving,PG,24,CLE,72,72,2525,671,1420,.473,177,441,.401,494,979,.505,.535,297,328,.905,52,178,230,418,83,25,180,157,1816,2017
Jarrett Jack,PG,33,NOP,2,0,33,2,3,.667,0,1,.000,2,2,1.000,.667,2,2,1.000,0,0,0,5,2,0,3,4,6,2017
Demetrius Jackson,PG,22,BOS,5,0,17,3,4,.750,1,1,1.000,2,3,.667,.875,3,6,.500,2,2,4,3,0,0,0,0,10,2017
Pierre Jackson,PG,25,DAL,8,1,84,13,39,.333,3,11,.273,10,28,.357,.372,6,7,.857,1,8,9,19,2,0,3,5,35,2017
Reggie Jackson,PG,26,DET,52,50,1424,284,677,.419,66,184,.359,218,493,.442,.468,118,136,.868,21,92,113,270,35,5,114,129,752,2017
LeBron James,SF,32,CLE,74,74,2794,736,1344,.548,124,342,.363,612,1002,.611,.594,358,531,.674,97,543,640,646,92,44,303,134,1954,2017
Al Jefferson,C,32,IND,66,1,931,235,471,.499,0,1,.000,235,470,.500,.499,65,85,.765,75,203,278,57,19,16,33,125,535,2017
Richard Jefferson,SF,36,CLE,79,13,1614,153,343,.446,62,186,.333,91,157,.580,.536,80,108,.741,28,174,202,78,26,10,52,153,448,2017
John Jenkins,SG,25,PHO,4,0,13,2,5,.400,1,2,.500,1,3,.333,.500,2,2,1.000,0,1,1,1,0,0,0,0,7,2017
Brandon Jennings,PG,27,TOT,81,13,1802,192,535,.359,79,252,.313,113,283,.399,.433,114,152,.750,29,167,196,395,70,5,128,116,577,2017
Brandon Jennings,PG,27,NYK,58,11,1428,163,429,.380,68,200,.340,95,229,.415,.459,102,135,.756,21,131,152,287,55,5,106,84,496,2017
Brandon Jennings,PG,27,WAS,23,2,374,29,106,.274,11,52,.212,18,54,.333,.325,12,17,.706,8,36,44,108,15,0,22,32,81,2017
Jonas Jerebko,PF,29,BOS,78,6,1232,114,262,.435,45,130,.346,69,132,.523,.521,26,37,.703,60,213,273,71,26,17,39,122,299,2017
Amir Johnson,PF,29,BOS,80,77,1608,213,370,.576,27,66,.409,186,304,.612,.612,67,100,.670,117,248,365,140,52,62,77,211,520,2017
Brice Johnson,PF,22,LAC,3,0,9,2,7,.286,0,0,.000,2,7,.286,.286,0,0,.000,1,2,3,1,2,1,1,0,4,2017
James Johnson,PF,29,MIA,76,5,2085,368,769,.479,87,256,.340,281,513,.548,.535,152,215,.707,66,309,375,276,76,86,171,197,975,2017
Joe Johnson,SF,35,UTA,78,14,1843,273,626,.436,106,258,.411,167,368,.454,.521,63,77,.818,33,209,242,144,36,18,69,93,715,2017
Stanley Johnson,SF,20,DET,77,1,1371,129,365,.353,45,154,.292,84,211,.398,.415,36,53,.679,36,153,189,105,56,24,71,121,339,2017
Tyler Johnson,PG,24,MIA,73,0,2178,357,824,.433,93,250,.372,264,574,.460,.490,195,254,.768,50,243,293,233,84,44,90,176,1002,2017
Wesley Johnson,SF,29,LAC,68,3,810,73,200,.365,29,118,.246,44,82,.537,.438,11,17,.647,26,155,181,23,29,30,18,83,186,2017
Nikola Jokic,C,21,DEN,73,59,2038,494,854,.578,45,139,.324,449,715,.628,.605,188,228,.825,212,506,718,359,61,56,171,214,1221,2017
Dahntay Jones,SF,36,CLE,1,0,12,3,8,.375,0,2,.000,3,6,.500,.375,3,4,.750,1,1,2,1,0,0,1,1,9,2017
Damian Jones,C,21,GSW,10,0,85,8,16,.500,0,0,.000,8,16,.500,.500,3,10,.300,9,14,23,0,1,4,6,15,19,2017
Derrick Jones,SF,19,PHO,32,8,545,68,121,.562,3,11,.273,65,110,.591,.574,29,41,.707,39,40,79,12,14,13,13,63,168,2017
James Jones,SF,36,CLE,48,2,381,44,92,.478,31,66,.470,13,26,.500,.647,13,20,.650,3,35,38,14,7,10,10,37,132,2017
Terrence Jones,PF,25,TOT,54,12,1270,231,491,.470,19,75,.253,212,416,.510,.490,103,170,.606,65,241,306,58,40,54,48,67,584,2017
Terrence Jones,PF,25,NOP,51,12,1264,231,488,.473,19,75,.253,212,413,.513,.493,103,170,.606,65,238,303,58,39,53,48,67,584,2017
Terrence Jones,PF,25,MIL,3,0,6,0,3,.000,0,0,.000,0,3,.000,.000,0,0,.000,0,3,3,0,1,1,0,0,0,2017
Tyus Jones,PG,20,MIN,60,0,774,75,181,.414,26,73,.356,49,108,.454,.486,33,43,.767,10,57,67,156,47,5,38,50,209,2017
DeAndre Jordan,C,28,LAC,81,81,2570,412,577,.714,0,2,.000,412,575,.717,.714,205,425,.482,297,817,1114,96,52,135,116,212,1029,2017
Cory Joseph,SG,25,TOR,80,22,2003,299,661,.452,48,135,.356,251,526,.477,.489,94,122,.770,51,184,235,265,66,13,108,140,740,2017
Frank Kaminsky,C,23,CHO,75,16,1954,320,802,.399,116,354,.328,204,448,.455,.471,118,156,.756,57,279,336,162,47,34,76,139,874,2017
Enes Kanter,C,24,OKC,72,0,1533,402,737,.545,5,38,.132,397,699,.568,.549,224,285,.786,195,287,482,67,32,38,123,154,1033,2017
Ryan Kelly,PF,25,ATL,16,0,110,8,28,.286,4,10,.400,4,18,.222,.357,5,6,.833,1,17,18,8,4,5,4,5,25,2017
Michael Kidd-Gilchrist,SF,23,CHO,81,81,2349,295,618,.477,1,9,.111,294,609,.483,.478,152,194,.784,156,409,565,114,81,77,56,187,743,2017
Sean Kilpatrick,SG,27,BRK,70,24,1754,305,735,.415,105,308,.341,200,427,.468,.486,204,242,.843,22,258,280,157,46,6,136,118,919,2017
Brandon Knight,SG,25,PHO,54,5,1140,209,525,.398,45,139,.324,164,386,.425,.441,132,154,.857,25,93,118,130,27,5,89,87,595,2017
Kyle Korver,SG,35,TOT,67,22,1753,239,515,.464,162,359,.451,77,156,.494,.621,38,42,.905,8,179,187,110,34,21,69,107,678,2017
Kyle Korver,SG,35,ATL,32,21,894,108,246,.439,65,159,.409,43,87,.494,.571,24,27,.889,1,89,90,75,23,13,40,47,305,2017
Kyle Korver,SG,35,CLE,35,1,859,131,269,.487,97,200,.485,34,69,.493,.667,14,15,.933,7,90,97,35,11,8,29,60,373,2017
Kosta Koufos,C,27,SAC,71,62,1419,216,392,.551,0,1,.000,216,391,.552,.551,38,62,.613,118,285,403,47,36,48,61,172,470,2017
Mindaugas Kuzminskas,SF,27,NYK,68,5,1016,158,369,.428,54,168,.321,104,201,.517,.501,55,68,.809,47,79,126,69,29,11,51,79,425,2017
Skal Labissiere,PF,20,SAC,33,12,612,117,218,.537,3,8,.375,114,210,.543,.544,52,74,.703,51,111,162,27,16,13,37,64,289,2017
Jeremy Lamb,SG,24,CHO,62,5,1143,226,491,.460,41,146,.281,185,345,.536,.502,110,129,.853,30,234,264,75,27,23,40,98,603,2017
Nicolas Laprovittola,PG,27,SAS,18,3,174,20,47,.426,10,27,.370,10,20,.500,.532,9,9,1.000,1,9,10,28,4,1,19,19,59,2017
Joffrey Lauvergne,PF-C,25,TOT,70,1,980,148,336,.440,33,98,.337,115,238,.483,.490,46,73,.630,72,179,251,70,25,6,56,83,375,2017
Joffrey Lauvergne,PF,25,OKC,50,0,739,111,244,.455,27,78,.346,84,166,.506,.510,37,58,.638,51,132,183,51,18,6,40,71,286,2017
Joffrey Lauvergne,C,25,CHI,20,1,241,37,92,.402,6,20,.300,31,72,.431,.435,9,15,.600,21,47,68,19,7,0,16,12,89,2017
Zach LaVine,SG,21,MIN,47,47,1749,326,710,.459,120,310,.387,206,400,.515,.544,117,140,.836,18,141,159,139,41,10,85,104,889,2017
Ty Lawson,PG,29,SAC,69,24,1732,237,522,.454,34,118,.288,203,404,.502,.487,173,217,.797,44,135,179,335,74,6,129,119,681,2017
Jake Layman,SF,22,POR,35,1,249,26,89,.292,13,51,.255,13,38,.342,.365,13,17,.765,6,18,24,11,9,3,11,22,78,2017
Courtney Lee,SG,31,NYK,77,74,2459,321,704,.456,108,269,.401,213,435,.490,.533,85,98,.867,53,207,260,179,81,23,69,141,835,2017
David Lee,PF,33,SAS,79,10,1477,248,420,.590,0,0,.000,248,420,.590,.590,80,113,.708,148,292,440,124,31,40,82,125,576,2017
Alex Len,C,23,PHO,77,34,1560,230,463,.497,3,12,.250,227,451,.503,.500,150,208,.721,156,354,510,44,37,98,102,242,613,2017
Kawhi Leonard,SF,25,SAS,74,74,2474,636,1311,.485,147,386,.381,489,925,.529,.541,469,533,.880,80,350,430,260,132,55,154,122,1888,2017
Meyers Leonard,PF,24,POR,74,12,1222,146,378,.386,74,213,.347,72,165,.436,.484,35,40,.875,27,209,236,71,13,28,35,172,401,2017
Jon Leuer,PF,27,DET,75,34,1944,310,646,.480,49,167,.293,261,479,.545,.518,98,113,.867,102,300,402,111,31,26,66,145,767,2017
Caris LeVert,SF,22,BRK,57,26,1237,171,380,.450,59,184,.321,112,196,.571,.528,67,93,.720,23,165,188,110,49,8,59,91,468,2017
DeAndre Liggins,SG,28,TOT,62,19,777,55,142,.387,17,46,.370,38,96,.396,.447,25,40,.625,20,88,108,54,47,14,42,81,152,2017
DeAndre Liggins,SG,28,CLE,61,19,752,52,136,.382,17,45,.378,35,91,.385,.445,23,37,.622,17,84,101,54,45,14,42,78,144,2017
DeAndre Liggins,SG,28,DAL,1,0,25,3,6,.500,0,1,.000,3,5,.600,.500,2,3,.667,3,4,7,0,2,0,0,3,8,2017
Damian Lillard,PG,26,POR,75,75,2694,661,1488,.444,214,578,.370,447,910,.491,.516,488,545,.895,46,322,368,439,68,20,197,152,2024,2017
Jeremy Lin,PG,28,BRK,36,33,883,175,400,.438,58,156,.372,117,244,.480,.510,115,141,.816,11,124,135,184,41,14,86,79,523,2017
Shaun Livingston,PG,31,GSW,76,3,1345,173,316,.547,1,3,.333,172,313,.550,.549,42,60,.700,28,123,151,139,38,20,61,120,389,2017
Shawn Long,C,24,PHI,18,0,234,61,109,.560,7,19,.368,54,90,.600,.592,19,35,.543,41,44,85,13,9,9,13,49,148,2017
Kevon Looney,C,20,GSW,53,4,447,56,107,.523,2,9,.222,54,98,.551,.533,21,34,.618,44,80,124,29,14,17,17,64,135,2017
Brook Lopez,C,28,BRK,75,75,2222,555,1172,.474,134,387,.346,421,785,.536,.531,295,364,.810,121,282,403,176,38,124,184,192,1539,2017
Robin Lopez,C,28,CHI,81,81,2271,382,775,.493,0,2,.000,382,773,.494,.493,75,104,.721,243,276,519,80,18,117,90,151,839,2017
Kevin Love,PF,28,CLE,60,60,1885,370,867,.427,145,389,.373,225,478,.471,.510,257,295,.871,148,518,666,116,53,22,122,125,1142,2017
Kyle Lowry,PG,30,TOR,60,60,2244,426,918,.464,193,468,.412,233,450,.518,.569,299,365,.819,48,240,288,417,88,19,173,170,1344,2017
John Lucas III,PG,34,MIN,5,0,11,1,4,.250,0,1,.000,1,3,.333,.250,0,0,.000,0,0,0,1,2,0,0,0,2,2017
Timothe Luwawu-Cabarrot,SF,21,PHI,69,19,1190,145,361,.402,50,161,.311,95,200,.475,.471,105,123,.854,25,124,149,75,32,10,73,154,445,2017
Trey Lyles,PF,21,UTA,71,4,1158,159,439,.362,65,204,.319,94,235,.400,.436,57,79,.722,48,187,235,70,26,20,64,97,440,2017
Shelvin Mack,PG,26,UTA,55,9,1205,170,381,.446,37,120,.308,133,261,.510,.495,53,77,.688,20,108,128,154,42,3,90,100,430,2017
Ian Mahinmi,C,30,WAS,31,0,555,65,111,.586,0,0,.000,65,111,.586,.586,43,75,.573,47,103,150,19,33,24,34,90,173,2017
Thon Maker,C,19,MIL,57,34,562,83,181,.459,28,74,.378,55,107,.514,.536,32,49,.653,40,74,114,23,10,26,17,84,226,2017
Boban Marjanovic,C,28,DET,35,0,293,72,132,.545,0,0,.000,72,132,.545,.545,47,58,.810,46,84,130,9,6,12,10,25,191,2017
Jarell Martin,PF,22,MEM,42,3,558,58,151,.384,9,25,.360,49,126,.389,.414,40,50,.800,42,120,162,8,17,9,28,91,165,2017
Wesley Matthews,SG,30,DAL,73,73,2495,333,847,.393,174,479,.363,159,368,.432,.496,146,179,.816,18,241,259,210,77,16,102,161,986,2017
Luc Mbah a Moute,SF,30,LAC,80,76,1787,191,378,.505,43,110,.391,148,268,.552,.562,59,87,.678,47,127,174,39,81,35,47,122,484,2017
James Michael McAdoo,PF,24,GSW,52,2,457,62,117,.530,2,8,.250,60,109,.550,.538,21,42,.500,34,56,90,17,18,29,19,47,147,2017
Patrick McCaw,SG,21,GSW,71,20,1074,106,245,.433,41,123,.333,65,122,.533,.516,29,37,.784,22,79,101,77,32,15,36,62,282,2017
Sheldon McClellan,SG,24,WAS,30,3,287,30,75,.400,7,30,.233,23,45,.511,.447,23,27,.852,4,30,34,15,8,2,5,17,90,2017
C.J. McCollum,SG,25,POR,80,80,2796,692,1441,.480,185,440,.420,507,1001,.506,.544,268,294,.912,60,231,291,285,72,42,172,202,1837,2017
T.J. McConnell,PG,24,PHI,81,51,2133,236,512,.461,11,55,.200,225,457,.492,.472,73,90,.811,39,212,251,534,134,10,159,139,556,2017
Chris McCullough,PF,21,TOT,16,0,80,16,32,.500,1,7,.143,15,25,.600,.516,3,5,.600,9,10,19,2,2,2,3,7,36,2017
Chris McCullough,PF,21,BRK,14,0,72,16,31,.516,1,6,.167,15,25,.600,.532,2,3,.667,9,8,17,2,1,2,2,7,35,2017
Chris McCullough,PF,21,WAS,2,0,8,0,1,.000,0,1,.000,0,0,.000,.000,1,2,.500,0,2,2,0,1,0,1,0,1,2017
K.J. McDaniels,SF,23,TOT,49,0,505,77,169,.456,20,66,.303,57,103,.553,.515,32,38,.842,15,67,82,13,19,18,29,49,206,2017
K.J. McDaniels,SF,23,HOU,29,0,212,31,68,.456,9,27,.333,22,41,.537,.522,9,10,.900,6,24,30,4,7,8,10,24,80,2017
K.J. McDaniels,SF,23,BRK,20,0,293,46,101,.455,11,39,.282,35,62,.565,.510,23,28,.821,9,43,52,9,12,10,19,25,126,2017
Doug McDermott,SF,25,TOT,66,5,1508,222,497,.447,77,207,.372,145,290,.500,.524,71,84,.845,20,159,179,58,13,5,38,79,592,2017
Doug McDermott,SF,25,CHI,44,4,1078,166,373,.445,56,149,.376,110,224,.491,.520,59,67,.881,14,116,130,45,11,4,32,57,447,2017
Doug McDermott,SF,25,OKC,22,1,430,56,124,.452,21,58,.362,35,66,.530,.536,12,17,.706,6,43,49,13,2,1,6,22,145,2017
JaVale McGee,C,29,GSW,77,10,739,208,319,.652,0,4,.000,208,315,.660,.652,56,111,.505,100,144,244,17,19,67,40,109,472,2017
Rodney McGruder,SG,25,MIA,78,65,1966,190,460,.413,73,220,.332,117,240,.488,.492,44,71,.620,95,162,257,124,45,18,56,140,497,2017
Ben McLemore,SG,23,SAC,61,26,1176,180,419,.430,65,170,.382,115,249,.462,.507,70,93,.753,19,111,130,51,29,6,62,108,495,2017
Jordan McRae,SG,25,CLE,37,4,384,58,150,.387,18,51,.353,40,99,.404,.447,27,34,.794,6,34,40,19,8,6,14,31,161,2017
Josh McRoberts,PF,29,MIA,22,14,381,44,118,.373,13,31,.419,31,87,.356,.428,6,9,.667,23,51,74,50,10,4,23,31,107,2017
Jodie Meeks,SG,29,ORL,36,10,738,103,256,.402,56,137,.409,47,119,.395,.512,65,74,.878,5,72,77,45,34,4,36,41,327,2017
Salah Mejri,C,30,DAL,73,11,905,88,137,.642,1,3,.333,87,134,.649,.646,36,61,.590,97,211,308,14,32,61,40,152,213,2017
Jordan Mickey,PF,22,BOS,25,1,141,15,34,.441,0,1,.000,15,33,.455,.441,8,14,.571,13,21,34,7,3,6,9,12,38,2017
Khris Middleton,SF,25,MIL,29,23,889,150,333,.450,45,104,.433,105,229,.459,.518,81,92,.880,11,112,123,99,41,7,65,79,426,2017
C.J. Miles,SF,29,IND,76,29,1776,281,647,.434,169,409,.413,112,238,.471,.565,84,93,.903,30,199,229,48,46,25,40,151,815,2017
Mike Miller,SF,36,DEN,20,0,151,9,23,.391,8,20,.400,1,3,.333,.565,2,2,1.000,3,36,39,22,2,0,13,9,28,2017
Patty Mills,PG,28,SAS,80,8,1754,273,622,.439,147,356,.413,126,266,.474,.557,66,80,.825,24,118,142,280,65,3,101,109,759,2017
Elijah Millsap,SG,29,PHO,2,0,23,1,7,.143,0,2,.000,1,5,.200,.143,1,2,.500,3,3,6,1,0,0,2,2,3,2017
Paul Millsap,PF,31,ATL,69,67,2343,430,972,.442,75,241,.311,355,731,.486,.481,311,405,.768,111,422,533,252,90,62,158,186,1246,2017
Nikola Mirotic,PF,25,CHI,70,15,1679,258,625,.413,129,377,.342,129,248,.520,.516,99,128,.773,61,323,384,75,53,56,79,128,744,2017
Greg Monroe,C,26,MIL,81,0,1823,387,726,.533,0,4,.000,387,722,.536,.533,177,239,.741,167,365,532,187,92,38,140,168,951,2017
E'Twaun Moore,SG,27,NOP,73,22,1820,283,619,.457,77,208,.370,206,411,.501,.519,57,74,.770,33,119,152,164,50,32,62,131,700,2017
Marcus Morris,SF,27,DET,79,79,2565,421,1007,.418,118,357,.331,303,650,.466,.477,145,185,.784,77,289,366,160,52,25,87,168,1105,2017
Markieff Morris,PF,27,WAS,76,76,2374,406,889,.457,71,196,.362,335,693,.483,.497,180,215,.837,107,385,492,126,82,42,129,254,1063,2017
Anthony Morrow,SG,31,TOT,49,7,714,98,252,.389,41,133,.308,57,119,.479,.470,34,37,.919,12,19,31,25,24,2,6,44,271,2017
Anthony Morrow,SG,31,OKC,40,7,627,86,223,.386,35,119,.294,51,104,.490,.464,23,26,.885,11,18,29,19,22,2,6,40,230,2017
Anthony Morrow,SG,31,CHI,9,0,87,12,29,.414,6,14,.429,6,15,.400,.517,11,11,1.000,1,1,2,6,2,0,0,4,41,2017
Donatas Motiejunas,PF,26,NOP,34,0,479,57,138,.413,11,47,.234,46,91,.505,.453,25,49,.510,26,75,101,34,18,11,31,55,150,2017
Timofey Mozgov,C,30,LAL,54,52,1104,169,328,.515,0,1,.000,169,327,.517,.515,63,78,.808,104,160,264,43,16,31,72,133,401,2017
Emmanuel Mudiay,PG,20,DEN,55,41,1406,208,551,.377,56,178,.315,152,373,.408,.428,131,167,.784,29,149,178,217,41,13,123,95,603,2017
Shabazz Muhammad,SF,24,MIN,78,1,1516,288,598,.482,49,146,.336,239,452,.529,.523,147,190,.774,84,136,220,35,22,6,56,86,772,2017
Dejounte Murray,PG,20,SAS,38,8,322,50,116,.431,9,23,.391,41,93,.441,.470,21,30,.700,6,36,42,48,8,6,38,29,130,2017
Jamal Murray,SG,19,DEN,82,10,1764,295,730,.404,115,344,.334,180,386,.466,.483,106,120,.883,41,173,214,170,52,24,113,124,811,2017
Mike Muscala,C,25,ATL,70,3,1237,170,337,.504,46,110,.418,124,227,.546,.573,49,64,.766,76,164,240,95,30,41,55,97,435,2017
Larry Nance Jr.,PF,24,LAL,63,7,1442,190,361,.526,10,36,.278,180,325,.554,.540,59,80,.738,120,249,369,96,82,40,56,149,449,2017
Shabazz Napier,PG,25,POR,53,2,512,73,183,.399,34,92,.370,39,91,.429,.492,38,49,.776,8,53,61,67,32,2,41,38,218,2017
Maurice Ndour,PF,24,NYK,32,4,331,39,86,.453,1,7,.143,38,79,.481,.459,19,26,.731,22,42,64,8,15,8,12,30,98,2017
Gary Neal,SG,32,ATL,2,0,18,0,7,.000,0,2,.000,0,5,.000,.000,4,4,1.000,0,1,1,1,0,0,0,1,4,2017
Jameer Nelson,PG,34,DEN,75,39,2045,268,604,.444,106,273,.388,162,331,.489,.531,45,63,.714,28,164,192,385,53,8,129,197,687,2017
Raul Neto,PG,24,UTA,40,0,346,41,91,.451,10,31,.323,31,60,.517,.505,8,9,.889,4,26,30,34,21,5,15,48,100,2017
Georges Niang,PF,23,IND,23,0,93,9,36,.250,1,12,.083,8,24,.333,.264,2,2,1.000,2,15,17,5,3,0,5,6,21,2017
Andrew Nicholson,PF,27,TOT,38,0,342,43,111,.387,5,27,.185,38,84,.452,.410,9,14,.643,15,46,61,10,16,6,17,55,100,2017
Andrew Nicholson,PF,27,WAS,28,0,231,30,77,.390,3,16,.188,27,61,.443,.409,7,12,.583,11,23,34,7,11,6,11,37,70,2017
Andrew Nicholson,PF,27,BRK,10,0,111,13,34,.382,2,11,.182,11,23,.478,.412,2,2,1.000,4,23,27,3,5,0,6,18,30,2017
Joakim Noah,C,31,NYK,46,46,1015,99,201,.493,0,1,.000,99,200,.495,.493,34,78,.436,161,241,402,103,30,37,58,127,232,2017
Nerlens Noel,C,22,TOT,51,19,1047,184,309,.595,0,1,.000,184,308,.597,.595,77,111,.694,93,201,294,50,65,51,51,126,445,2017
Nerlens Noel,C,22,PHI,29,7,564,107,175,.611,0,1,.000,107,174,.615,.611,43,63,.683,46,98,144,30,43,26,29,71,257,2017
Nerlens Noel,C,22,DAL,22,12,483,77,134,.575,0,0,.000,77,134,.575,.575,34,48,.708,47,103,150,20,22,25,22,55,188,2017
Lucas Nogueira,C,24,TOR,57,6,1088,103,156,.660,3,12,.250,100,144,.694,.670,44,67,.657,82,161,243,42,52,90,46,137,253,2017
Steve Novak,PF,33,MIL,8,0,22,2,7,.286,1,6,.167,1,1,1.000,.357,0,0,.000,0,3,3,0,0,0,0,1,5,2017
Dirk Nowitzki,PF,38,DAL,54,54,1424,296,678,.437,79,209,.378,217,469,.463,.495,98,112,.875,23,330,353,82,30,38,51,113,769,2017
Jusuf Nurkic,C,22,TOT,65,48,1391,271,534,.507,0,1,.000,271,533,.508,.507,120,210,.571,154,313,467,123,50,74,143,161,662,2017
Jusuf Nurkic,C,22,DEN,45,29,807,151,298,.507,0,0,.000,151,298,.507,.507,56,113,.496,89,171,260,60,25,36,81,88,358,2017
Jusuf Nurkic,C,22,POR,20,19,584,120,236,.508,0,1,.000,120,235,.511,.508,64,97,.660,65,142,207,63,25,38,62,73,304,2017
David Nwaba,SG,24,LAL,20,2,397,47,81,.580,1,5,.200,46,76,.605,.586,25,39,.641,16,46,62,14,13,7,11,36,120,2017
Johnny O'Bryant,PF,23,TOT,11,0,80,15,30,.500,3,6,.500,12,24,.500,.550,5,6,.833,9,10,19,6,0,1,6,10,38,2017
Johnny O'Bryant,PF,23,DEN,7,0,46,7,15,.467,2,3,.667,5,12,.417,.533,4,4,1.000,5,6,11,2,0,1,3,4,20,2017
Johnny O'Bryant,PF,23,CHO,4,0,34,8,15,.533,1,3,.333,7,12,.583,.567,1,2,.500,4,4,8,4,0,0,3,6,18,2017
Kyle O'Quinn,C,26,NYK,79,8,1229,215,413,.521,2,17,.118,213,396,.538,.523,64,83,.771,157,282,439,117,36,104,76,174,496,2017
Daniel Ochefu,C,23,WAS,19,0,75,12,27,.444,0,0,.000,12,27,.444,.444,0,2,.000,5,17,22,3,2,0,3,17,24,2017
Jahlil Okafor,C,21,PHI,50,33,1134,242,471,.514,0,0,.000,242,471,.514,.514,106,158,.671,81,159,240,58,20,49,91,122,590,2017
Victor Oladipo,SG,24,OKC,67,67,2222,412,932,.442,127,352,.361,285,580,.491,.510,116,154,.753,39,252,291,176,78,21,119,155,1067,2017
Kelly Olynyk,C,25,BOS,75,6,1538,260,508,.512,68,192,.354,192,316,.608,.579,90,123,.732,72,288,360,148,43,29,96,207,678,2017
Arinze Onuaku,C,29,ORL,8,0,28,2,4,.500,0,0,.000,2,4,.500,.500,0,0,.000,2,4,6,2,0,1,2,3,4,2017
Chinanu Onuaku,C,20,HOU,5,1,52,5,7,.714,0,0,.000,5,7,.714,.714,4,4,1.000,2,8,10,3,3,1,4,6,14,2017
Kelly Oubre,SF,21,WAS,79,5,1605,186,442,.421,54,188,.287,132,254,.520,.482,75,99,.758,61,199,260,47,58,17,49,195,501,2017
Zaza Pachulia,C,32,GSW,70,70,1268,164,307,.534,0,2,.000,164,305,.538,.534,98,126,.778,140,270,410,132,59,33,88,166,426,2017
Georgios Papagiannis,C,19,SAC,22,0,355,56,102,.549,0,2,.000,56,100,.560,.549,12,14,.857,24,62,86,20,3,17,24,44,124,2017
Jabari Parker,PF,21,MIL,51,50,1728,399,814,.490,65,178,.365,334,636,.525,.530,162,218,.743,79,235,314,142,51,22,92,111,1025,2017
Tony Parker,PG,34,SAS,63,63,1587,265,569,.466,23,69,.333,242,500,.484,.486,85,117,.726,9,104,113,285,33,2,89,92,638,2017
Chandler Parsons,SF,28,MEM,34,34,675,75,222,.338,25,93,.269,50,129,.388,.394,35,43,.814,6,78,84,55,20,5,24,52,210,2017
Lamar Patterson,SG,25,ATL,5,0,40,3,15,.200,1,6,.167,2,9,.222,.233,2,3,.667,1,6,7,6,1,0,4,6,9,2017
Patrick Patterson,PF,27,TOR,65,8,1599,154,384,.401,94,253,.372,60,131,.458,.523,43,60,.717,62,229,291,76,40,23,38,120,445,2017
Chris Paul,PG,31,LAC,61,61,1921,374,785,.476,124,302,.411,250,483,.518,.555,232,260,.892,41,263,304,563,118,8,147,146,1104,2017
Adreian Payne,PF,25,MIN,18,0,135,23,54,.426,3,15,.200,20,39,.513,.454,14,19,.737,9,24,33,7,8,7,8,32,63,2017
Cameron Payne,PG,22,TOT,31,0,462,64,193,.332,27,86,.314,37,107,.346,.402,5,8,.625,3,45,48,55,14,5,29,52,160,2017
Cameron Payne,PG,22,OKC,20,0,320,43,130,.331,16,52,.308,27,78,.346,.392,4,4,1.000,2,29,31,40,10,5,16,38,106,2017
Cameron Payne,PG,22,CHI,11,0,142,21,63,.333,11,34,.324,10,29,.345,.421,1,4,.250,1,16,17,15,4,0,13,14,54,2017
Elfrid Payton,PG,22,ORL,82,58,2412,430,912,.471,40,146,.274,390,766,.509,.493,146,211,.692,89,298,387,529,88,40,178,177,1046,2017
Gary Payton,PG,24,MIL,6,0,99,8,22,.364,1,9,.111,7,13,.538,.386,3,5,.600,0,12,12,13,3,4,10,9,20,2017
Paul Pierce,SF,39,LAC,25,7,277,28,70,.400,15,43,.349,13,27,.481,.507,10,13,.769,1,47,48,10,4,5,16,40,81,2017
Marshall Plumlee,C,24,NYK,21,1,170,16,30,.533,0,0,.000,16,30,.533,.533,8,19,.421,23,28,51,10,4,4,12,23,40,2017
Mason Plumlee,C,26,TOT,81,64,2148,334,623,.536,0,6,.000,334,617,.541,.536,174,300,.580,170,436,606,284,69,92,135,226,842,2017
Mason Plumlee,C,26,POR,54,54,1516,235,442,.532,0,5,.000,235,437,.538,.532,127,224,.567,120,313,433,214,50,63,89,149,597,2017
Mason Plumlee,C,26,DEN,27,10,632,99,181,.547,0,1,.000,99,180,.550,.547,47,76,.618,50,123,173,70,19,29,46,77,245,2017
Miles Plumlee,C,28,TOT,45,12,484,44,92,.478,0,0,.000,44,92,.478,.478,25,39,.641,38,57,95,21,18,13,30,73,113,2017
Miles Plumlee,C,28,MIL,32,12,310,30,68,.441,0,0,.000,30,68,.441,.441,22,35,.629,23,30,53,18,11,9,22,48,82,2017
Miles Plumlee,C,28,CHO,13,0,174,14,24,.583,0,0,.000,14,24,.583,.583,3,4,.750,15,27,42,3,7,4,8,25,31,2017
Jakob Poeltl,C,21,TOR,54,4,626,67,115,.583,0,0,.000,67,115,.583,.583,31,57,.544,78,87,165,12,17,20,29,113,165,2017
Otto Porter,SF,23,WAS,80,80,2605,414,803,.516,148,341,.434,266,462,.576,.608,99,119,.832,118,397,515,121,116,41,43,193,1075,2017
Bobby Portis,PF,21,CHI,64,13,1000,183,375,.488,32,96,.333,151,279,.541,.531,39,59,.661,75,221,296,35,16,11,37,94,437,2017
Kristaps Porzingis,PF,21,NYK,66,65,2164,443,985,.450,112,314,.357,331,671,.493,.507,198,252,.786,111,364,475,97,47,130,118,244,1196,2017
Dwight Powell,C,25,DAL,77,3,1333,194,377,.515,21,74,.284,173,303,.571,.542,107,141,.759,93,213,306,49,61,39,34,135,516,2017
Norman Powell,SG,23,TOR,76,18,1368,227,506,.449,56,173,.324,171,333,.514,.504,126,159,.792,26,142,168,82,51,14,70,127,636,2017
Alex Poythress,PF,23,PHI,6,1,157,25,54,.463,6,19,.316,19,35,.543,.519,8,10,.800,11,18,29,5,3,2,3,14,64,2017
Ronnie Price,PG,33,PHO,14,0,134,4,24,.167,3,17,.176,1,7,.143,.229,3,4,.750,3,8,11,18,11,1,3,14,14,2017
Tim Quarterman,SG,22,POR,16,0,80,13,29,.448,5,13,.385,8,16,.500,.534,0,3,.000,4,10,14,11,2,3,11,6,31,2017
Chasson Randle,PG,23,TOT,26,0,299,40,98,.408,16,47,.340,24,51,.471,.490,41,43,.953,6,26,32,34,9,2,19,39,137,2017
Chasson Randle,PG,23,PHI,8,0,74,12,26,.462,6,15,.400,6,11,.545,.577,12,12,1.000,0,5,5,6,3,1,3,11,42,2017
Chasson Randle,PG,23,NYK,18,0,225,28,72,.389,10,32,.313,18,40,.450,.458,29,31,.935,6,21,27,28,6,1,16,28,95,2017
Julius Randle,PF,22,LAL,74,73,2132,377,773,.488,17,63,.270,360,710,.507,.499,204,282,.723,151,485,636,264,49,37,173,248,975,2017
Zach Randolph,PF,35,MEM,73,5,1786,433,964,.449,21,94,.223,412,870,.474,.460,141,193,.731,182,416,598,122,38,10,99,136,1028,2017
J.J. Redick,SG,32,LAC,78,78,2198,396,890,.445,201,468,.429,195,422,.462,.558,180,202,.891,11,160,171,110,55,13,98,125,1173,2017
Willie Reed,C,26,MIA,71,5,1031,162,285,.568,1,4,.250,161,281,.573,.570,49,88,.557,129,203,332,26,18,47,31,137,374,2017
Josh Richardson,SG,23,MIA,53,34,1614,202,513,.394,75,227,.330,127,286,.444,.467,60,77,.779,35,133,168,140,60,39,65,132,539,2017
Malachi Richardson,SG,21,SAC,22,0,198,28,68,.412,8,28,.286,20,40,.500,.471,15,19,.789,3,20,23,11,5,1,8,23,79,2017
Austin Rivers,SG,24,LAC,74,29,2054,323,731,.442,111,299,.371,212,432,.491,.518,132,191,.691,20,141,161,204,48,10,115,187,889,2017
Andre Roberson,SF,25,OKC,79,79,2376,215,463,.464,45,184,.245,170,279,.609,.513,47,111,.423,98,304,402,79,94,79,51,204,522,2017
Brian Roberts,PG,31,CHO,41,2,416,46,122,.377,17,44,.386,29,78,.372,.447,33,39,.846,5,34,39,52,9,1,26,18,142,2017
Glenn Robinson,SF,23,IND,69,27,1426,158,338,.467,49,125,.392,109,213,.512,.540,54,76,.711,57,188,245,47,41,20,37,63,419,2017
Thomas Robinson,PF,25,LAL,48,1,560,105,196,.536,0,1,.000,105,195,.538,.536,31,66,.470,84,139,223,31,26,9,46,76,241,2017
Sergio Rodriguez,PG,30,PHI,68,30,1518,210,536,.392,92,252,.365,118,284,.415,.478,18,27,.667,21,136,157,344,48,4,128,95,530,2017
Rajon Rondo,PG,30,CHI,69,42,1843,229,561,.408,50,133,.376,179,428,.418,.453,30,50,.600,73,282,355,461,99,11,168,144,538,2017
Derrick Rose,PG,28,NYK,64,64,2082,460,977,.471,13,60,.217,447,917,.487,.477,221,253,.874,66,180,246,283,44,17,147,84,1154,2017
Terrence Ross,SF,25,TOT,78,24,1955,326,746,.437,142,391,.363,184,355,.518,.532,64,77,.831,18,189,207,88,88,33,68,143,858,2017
Terrence Ross,SF,25,TOR,54,0,1207,211,479,.441,96,256,.375,115,223,.516,.541,41,50,.820,14,125,139,45,54,20,33,82,559,2017
Terrence Ross,SF,25,ORL,24,24,748,115,267,.431,46,135,.341,69,132,.523,.517,23,27,.852,4,64,68,43,34,13,35,61,299,2017
Terry Rozier,PG,22,BOS,74,0,1263,151,411,.367,57,179,.318,94,232,.405,.437,51,66,.773,40,187,227,131,45,11,47,69,410,2017
Ricky Rubio,PG,26,MIN,75,75,2469,261,650,.402,60,196,.306,201,454,.443,.448,254,285,.891,68,237,305,682,128,10,195,202,836,2017
Damjan Rudez,SF,30,ORL,45,0,314,31,88,.352,20,64,.313,11,24,.458,.466,0,0,.000,5,20,25,20,12,1,9,31,82,2017
Brandon Rush,SG,31,MIN,47,33,1030,70,187,.374,44,114,.386,26,73,.356,.492,13,18,.722,16,83,99,45,22,23,28,42,197,2017
D'Angelo Russell,PG,20,LAL,63,60,1811,351,867,.405,135,384,.352,216,483,.447,.483,147,188,.782,31,191,222,303,87,16,176,130,984,2017
Domantas Sabonis,PF,20,OKC,81,66,1632,192,481,.399,51,159,.321,141,322,.438,.452,44,67,.657,45,242,287,82,39,32,83,200,479,2017
Larry Sanders,C,28,CLE,5,0,13,1,4,.250,0,0,.000,1,4,.250,.250,2,2,1.000,3,1,4,0,1,1,2,5,4,2017
Dario Saric,PF,22,PHI,81,36,2129,381,927,.411,106,341,.311,275,586,.469,.468,172,220,.782,112,401,513,182,57,30,183,162,1040,2017
Tomas Satoransky,SG,25,WAS,57,3,719,61,146,.418,9,37,.243,52,109,.477,.449,23,33,.697,25,58,83,92,26,6,38,60,154,2017
Dennis Schroder,PG,23,ATL,79,78,2485,548,1215,.451,100,294,.340,448,921,.486,.492,218,255,.855,42,206,248,499,74,16,258,149,1414,2017
Luis Scola,PF,36,BRK,36,1,461,71,151,.470,17,50,.340,54,101,.535,.526,25,37,.676,51,88,139,37,14,4,34,63,184,2017
Mike Scott,PF,28,ATL,18,0,195,17,59,.288,4,27,.148,13,32,.406,.322,7,8,.875,10,27,37,17,4,3,8,12,45,2017
Thabo Sefolosha,SF,32,ATL,62,42,1596,174,395,.441,41,120,.342,133,275,.484,.492,55,75,.733,54,216,270,107,96,31,58,97,444,2017
Wayne Selden,SG,22,TOT,14,5,236,25,58,.431,7,28,.250,18,30,.600,.491,14,22,.636,1,15,16,13,6,1,12,18,71,2017
Wayne Selden,SG,22,NOP,3,3,47,5,8,.625,4,7,.571,1,1,1.000,.875,2,4,.500,0,5,5,1,2,0,3,6,16,2017
Wayne Selden,SG,22,MEM,11,2,189,20,50,.400,3,21,.143,17,29,.586,.430,12,18,.667,1,10,11,12,4,1,9,12,55,2017
Kevin Seraphin,PF,27,IND,49,3,559,109,198,.551,0,2,.000,109,196,.556,.551,14,22,.636,41,101,142,23,7,20,29,66,232,2017
Ramon Sessions,PG,30,CHO,50,1,811,100,263,.380,21,62,.339,79,201,.393,.420,91,118,.771,11,62,73,129,26,3,46,43,312,2017
Iman Shumpert,SG,26,CLE,76,31,1937,201,489,.411,94,261,.360,107,228,.469,.507,71,90,.789,39,180,219,109,62,27,78,150,567,2017
Pascal Siakam,PF,22,TOR,55,38,859,103,205,.502,1,7,.143,102,198,.515,.505,22,32,.688,64,121,185,17,26,45,33,109,229,2017
Jonathon Simmons,SG,27,SAS,78,8,1392,177,421,.420,30,102,.294,147,319,.461,.456,99,132,.750,20,140,160,126,47,25,76,146,483,2017
Kyle Singler,SF,28,OKC,32,2,385,34,83,.410,7,37,.189,27,46,.587,.452,13,17,.765,8,40,48,9,7,5,11,29,88,2017
Marcus Smart,SG,22,BOS,79,24,2399,269,749,.359,94,332,.283,175,417,.420,.422,203,250,.812,78,228,306,364,125,34,159,192,835,2017
Ish Smith,PG,28,DET,81,32,1955,329,749,.439,28,105,.267,301,644,.467,.458,72,102,.706,21,214,235,418,61,33,112,127,758,2017
J.R. Smith,SG,31,CLE,41,35,1187,123,356,.346,95,271,.351,28,85,.329,.479,10,15,.667,17,96,113,62,40,11,26,77,351,2017
Jason Smith,C,30,WAS,74,3,1068,174,329,.529,37,78,.474,137,251,.546,.585,35,51,.686,64,194,258,37,21,55,58,168,420,2017
Tony Snell,SG,25,MIL,80,80,2336,246,541,.455,144,355,.406,102,186,.548,.588,47,58,.810,22,226,248,96,54,14,55,125,683,2017
Marreese Speights,C,29,LAC,82,2,1286,244,548,.445,103,277,.372,141,271,.520,.539,120,137,.876,88,285,373,66,23,41,69,229,711,2017
Tiago Splitter,C,32,PHI,8,0,76,14,31,.452,2,6,.333,12,25,.480,.484,9,11,.818,8,14,22,4,1,1,6,8,39,2017
Nik Stauskas,SG,23,PHI,80,27,2188,251,634,.396,132,359,.368,119,275,.433,.500,122,150,.813,21,205,226,188,45,32,128,144,756,2017
Lance Stephenson,SG,26,TOT,18,0,361,54,120,.450,6,20,.300,48,100,.480,.475,8,13,.615,4,48,52,59,5,3,26,32,122,2017
Lance Stephenson,SG,26,NOP,6,0,162,26,55,.473,1,10,.100,25,45,.556,.482,5,8,.625,3,15,18,29,2,1,11,18,58,2017
Lance Stephenson,SG,26,MIN,6,0,67,10,21,.476,0,2,.000,10,19,.526,.476,1,2,.500,0,10,10,5,0,0,4,2,21,2017
Lance Stephenson,SG,26,IND,6,0,132,18,44,.409,5,8,.625,13,36,.361,.466,2,3,.667,1,23,24,25,3,2,11,12,43,2017
Jarnell Stokes,C,23,DEN,2,0,7,1,1,1.000,0,0,.000,1,1,1.000,1.000,1,2,.500,1,1,2,2,1,0,0,3,3,2017
Diamond Stone,C,19,LAC,7,0,24,3,13,.231,0,0,.000,3,13,.231,.231,4,4,1.000,1,5,6,0,0,1,2,5,10,2017
Rodney Stuckey,PG,30,IND,39,0,696,91,244,.373,19,60,.317,72,184,.391,.412,80,107,.748,6,78,84,84,16,0,53,44,281,2017
Jared Sullinger,PF,24,TOR,11,1,118,15,48,.313,3,18,.167,12,30,.400,.344,4,8,.500,10,17,27,3,4,1,4,17,37,2017
Edy Tavares,C,24,TOT,2,0,28,4,5,.800,0,0,.000,4,5,.800,.800,0,3,.000,4,7,11,1,0,6,2,3,8,2017
Edy Tavares,C,24,ATL,1,0,4,1,1,1.000,0,0,.000,1,1,1.000,1.000,0,2,.000,0,1,1,0,0,0,0,0,2,2017
Edy Tavares,C,24,CLE,1,0,24,3,4,.750,0,0,.000,3,4,.750,.750,0,1,.000,4,6,10,1,0,6,2,3,6,2017
Isaiah Taylor,PG,22,HOU,4,0,52,1,7,.143,0,2,.000,1,5,.200,.143,1,2,.500,1,2,3,3,1,1,0,6,3,2017
Jeff Teague,PG,28,IND,82,82,2657,402,909,.442,90,252,.357,312,657,.475,.492,360,415,.867,33,298,331,639,100,32,216,165,1254,2017
Mirza Teletovic,PF,31,MIL,70,2,1133,156,418,.373,104,305,.341,52,113,.460,.498,35,45,.778,11,151,162,48,12,13,37,109,451,2017
Garrett Temple,SG,30,SAC,65,21,1728,183,432,.424,82,220,.373,101,212,.476,.519,58,74,.784,32,151,183,169,84,28,78,141,506,2017
Jason Terry,SG,39,MIL,74,0,1365,105,243,.432,73,171,.427,32,72,.444,.582,24,29,.828,15,91,106,98,45,20,36,95,307,2017
Isaiah Thomas,PG,27,BOS,76,76,2569,682,1473,.463,245,646,.379,437,827,.528,.546,590,649,.909,43,162,205,449,70,13,210,167,2199,2017
Lance Thomas,PF,28,NYK,46,15,968,97,244,.398,38,85,.447,59,159,.371,.475,43,51,.843,32,110,142,35,21,5,25,85,275,2017
Hollis Thompson,SG,25,TOT,40,9,752,77,200,.385,32,95,.337,45,105,.429,.465,19,29,.655,19,92,111,35,20,6,11,69,205,2017
Hollis Thompson,SG,25,PHI,31,1,561,66,159,.415,26,71,.366,40,88,.455,.497,13,20,.650,15,68,83,26,14,6,9,55,171,2017
Hollis Thompson,SG,25,NOP,9,8,191,11,41,.268,6,24,.250,5,17,.294,.341,6,9,.667,4,24,28,9,6,0,2,14,34,2017
Klay Thompson,SG,26,GSW,78,78,2649,644,1376,.468,268,647,.414,376,729,.516,.565,186,218,.853,49,236,285,160,66,40,128,139,1742,2017
Tristan Thompson,C,25,CLE,78,78,2336,262,437,.600,0,3,.000,262,434,.604,.600,106,213,.498,287,429,716,77,39,84,64,176,630,2017
Marcus Thornton,SG,29,WAS,33,1,575,84,210,.400,28,80,.350,56,130,.431,.467,23,27,.852,22,54,76,41,19,3,25,48,219,2017
Mike Tobey,C,22,CHO,2,0,25,1,4,.250,0,0,.000,1,4,.250,.250,0,0,.000,2,1,3,1,0,0,1,2,2,2017
Anthony Tolliver,PF,31,SAC,65,9,1477,155,351,.442,90,230,.391,65,121,.537,.570,61,82,.744,51,188,239,77,33,20,56,109,461,2017
Axel Toupane,SF,24,TOT,4,0,47,5,9,.556,1,4,.250,4,5,.800,.611,0,0,.000,0,1,1,0,1,1,0,6,11,2017
Axel Toupane,SF,24,MIL,2,0,6,0,1,.000,0,1,.000,0,0,.000,.000,0,0,.000,0,0,0,0,0,0,0,1,0,2017
Axel Toupane,SF,24,NOP,2,0,41,5,8,.625,1,3,.333,4,5,.800,.688,0,0,.000,0,1,1,0,1,1,0,5,11,2017
Karl-Anthony Towns,C,21,MIN,82,82,3030,802,1479,.542,101,275,.367,701,1204,.582,.576,356,428,.832,296,711,1007,220,57,103,212,241,2061,2017
P.J. Tucker,SF,31,TOT,81,21,2236,199,482,.413,70,196,.357,129,286,.451,.485,72,93,.774,117,355,472,99,116,19,66,196,540,2017
P.J. Tucker,SF,31,PHO,57,17,1627,147,354,.415,46,136,.338,101,218,.463,.480,61,77,.792,94,249,343,73,85,14,52,143,401,2017
P.J. Tucker,SF,31,TOR,24,4,609,52,128,.406,24,60,.400,28,68,.412,.500,11,16,.688,23,106,129,26,31,5,14,53,139,2017
Evan Turner,SF,28,POR,65,12,1658,235,552,.426,31,118,.263,204,434,.470,.454,85,103,.825,36,211,247,205,53,24,100,121,586,2017
Myles Turner,C,20,IND,81,81,2541,444,869,.511,40,115,.348,404,754,.536,.534,245,303,.809,139,448,587,106,74,173,105,262,1173,2017
Beno Udrih,PG,34,DET,39,0,560,92,197,.467,11,32,.344,81,165,.491,.495,32,34,.941,6,51,57,131,13,0,37,29,227,2017
Tyler Ulis,PG,21,PHO,61,15,1123,184,437,.421,21,79,.266,163,358,.455,.445,55,71,.775,20,75,95,226,48,5,77,73,444,2017
Jarrod Uthoff,PF,23,DAL,9,0,115,16,38,.421,3,9,.333,13,29,.448,.461,5,7,.714,8,14,22,9,2,4,3,8,40,2017
Jonas Valanciunas,C,24,TOR,80,80,2066,391,702,.557,1,2,.500,390,700,.557,.558,176,217,.811,226,533,759,57,37,63,106,216,959,2017
Denzel Valentine,SG,23,CHI,57,0,976,102,288,.354,73,208,.351,29,80,.363,.481,14,18,.778,11,140,151,63,30,7,49,86,291,2017
Fred VanVleet,PG,22,TOR,37,0,294,39,111,.351,11,29,.379,28,82,.341,.401,18,22,.818,4,38,42,35,17,2,15,36,107,2017
Anderson Varejao,C,34,GSW,14,1,92,5,14,.357,0,0,.000,5,14,.357,.357,8,11,.727,12,15,27,10,3,3,8,16,18,2017
Greivis Vasquez,PG,30,BRK,3,0,39,2,8,.250,1,3,.333,1,5,.200,.313,2,3,.667,0,2,2,5,1,1,1,6,7,2017
Rashad Vaughn,SG,20,MIL,41,2,458,57,156,.365,26,81,.321,31,75,.413,.449,2,5,.400,4,45,49,23,19,10,14,32,142,2017
Noah Vonleh,PF,21,POR,74,41,1265,130,270,.481,7,20,.350,123,250,.492,.494,60,94,.638,131,256,387,31,30,27,64,154,327,2017
Nikola Vucevic,C,26,ORL,75,55,2163,483,1031,.468,23,75,.307,460,956,.481,.480,107,160,.669,176,603,779,208,77,74,117,180,1096,2017
Sasha Vujacic,SG,32,NYK,42,4,408,42,136,.309,23,74,.311,19,62,.306,.393,17,24,.708,12,47,59,52,13,2,16,38,124,2017
Dwyane Wade,SG,35,CHI,60,59,1792,414,955,.434,45,145,.310,369,810,.456,.457,223,281,.794,64,207,271,229,86,41,138,112,1096,2017
Dion Waiters,SG,25,MIA,46,43,1384,281,663,.424,85,215,.395,196,448,.438,.488,82,127,.646,18,136,154,200,41,20,103,95,729,2017
Kemba Walker,PG,26,CHO,79,79,2739,643,1449,.444,240,602,.399,403,847,.476,.527,304,359,.847,45,263,308,435,85,22,168,119,1830,2017
John Wall,PG,26,WAS,78,78,2836,647,1435,.451,89,272,.327,558,1163,.480,.482,422,527,.801,58,268,326,831,157,49,323,151,1805,2017
Taurean Waller-Prince,SF,22,ATL,59,10,981,114,285,.400,33,102,.324,81,183,.443,.458,74,94,.787,25,132,157,55,43,27,61,96,335,2017
T.J. Warren,SF,23,PHO,66,59,2048,403,814,.495,26,98,.265,377,716,.527,.511,119,154,.773,125,214,339,75,76,39,57,175,951,2017
C.J. Watson,PG,32,ORL,62,9,1012,96,248,.387,32,105,.305,64,143,.448,.452,57,66,.864,16,73,89,114,43,2,47,84,281,2017
Briante Weber,PG,24,TOT,20,0,205,25,60,.417,1,10,.100,24,50,.480,.425,11,16,.688,8,18,26,21,12,1,8,16,62,2017
Briante Weber,PG,24,GSW,7,0,46,5,14,.357,0,3,.000,5,11,.455,.357,2,3,.667,0,4,4,5,3,1,3,4,12,2017
Briante Weber,PG,24,CHO,13,0,159,20,46,.435,1,7,.143,19,39,.487,.446,9,13,.692,8,14,22,16,9,0,5,12,50,2017
David West,C,36,GSW,68,0,854,135,252,.536,3,8,.375,132,244,.541,.542,43,56,.768,47,156,203,151,42,48,78,105,316,2017
Russell Westbrook,PG,28,OKC,81,81,2802,824,1941,.425,200,583,.343,624,1358,.459,.476,710,840,.845,137,727,864,840,133,31,438,190,2558,2017
Okaro White,PF,24,MIA,35,0,471,33,87,.379,12,34,.353,21,53,.396,.448,20,22,.909,25,57,82,21,10,10,18,52,98,2017
Isaiah Whitehead,PG,21,BRK,73,26,1643,204,508,.402,44,149,.295,160,359,.446,.445,91,113,.805,32,152,184,192,42,36,142,175,543,2017
Hassan Whiteside,C,27,MIA,77,77,2513,542,973,.557,0,0,.000,542,973,.557,.557,225,358,.628,293,795,1088,57,56,161,154,226,1309,2017
Andrew Wiggins,SF,21,MIN,82,82,3048,709,1570,.452,103,289,.356,606,1281,.473,.484,412,542,.760,103,226,329,189,82,30,187,183,1933,2017
C.J. Wilcox,SG,26,ORL,22,0,108,8,31,.258,3,15,.200,5,16,.313,.306,2,2,1.000,4,8,12,12,2,1,6,8,21,2017
Alan Williams,C,24,PHO,47,0,708,138,267,.517,0,1,.000,138,266,.519,.517,70,112,.625,94,198,292,23,27,32,37,125,346,2017
Deron Williams,PG,32,TOT,64,44,1657,263,600,.438,85,234,.363,178,366,.486,.509,90,109,.826,14,133,147,360,31,8,138,138,701,2017
Deron Williams,PG,32,DAL,40,40,1171,195,453,.430,63,181,.348,132,272,.485,.500,69,84,.821,13,89,102,274,25,2,98,96,522,2017
Deron Williams,PG,32,CLE,24,4,486,68,147,.463,22,53,.415,46,94,.489,.537,21,25,.840,1,44,45,86,6,6,40,42,179,2017
Derrick Williams,PF,25,TOT,50,11,804,108,244,.443,30,97,.309,78,147,.531,.504,58,89,.652,19,111,130,28,14,7,28,60,304,2017
Derrick Williams,PF,25,MIA,25,11,377,54,137,.394,9,45,.200,45,92,.489,.427,31,50,.620,16,57,73,14,9,5,14,33,148,2017
Derrick Williams,PF,25,CLE,25,0,427,54,107,.505,21,52,.404,33,55,.600,.603,27,39,.692,3,54,57,14,5,2,14,27,156,2017
Lou Williams,SG,30,TOT,81,1,1994,428,998,.429,163,446,.365,265,552,.480,.511,402,457,.880,26,176,202,239,80,19,160,92,1421,2017
Lou Williams,SG,30,LAL,58,1,1403,326,734,.444,122,317,.385,204,417,.489,.527,304,344,.884,14,118,132,183,65,10,120,67,1078,2017
Lou Williams,SG,30,HOU,23,0,591,102,264,.386,41,129,.318,61,135,.452,.464,98,113,.867,12,58,70,56,15,9,40,25,343,2017
Marvin Williams,PF,30,CHO,76,76,2295,297,704,.422,124,354,.350,173,350,.494,.510,131,150,.873,89,409,498,106,58,53,60,134,849,2017
Reggie Williams,SF,30,NOP,6,0,79,8,23,.348,5,11,.455,3,12,.250,.457,6,7,.857,2,4,6,4,3,0,0,2,27,2017
Troy Williams,SF,22,TOT,30,16,557,73,167,.437,18,62,.290,55,105,.524,.491,21,32,.656,15,54,69,25,27,10,33,60,185,2017
Troy Williams,SF,22,MEM,24,13,418,51,123,.415,10,41,.244,41,82,.500,.455,15,25,.600,6,39,45,19,24,9,27,42,127,2017
Troy Williams,SF,22,HOU,6,3,139,22,44,.500,8,21,.381,14,23,.609,.591,6,7,.857,9,15,24,6,3,1,6,18,58,2017
Kyle Wiltjer,PF,24,HOU,14,0,44,4,14,.286,4,13,.308,0,1,.000,.429,1,2,.500,4,6,10,2,3,1,5,4,13,2017
Justise Winslow,SF,20,MIA,18,15,625,80,225,.356,7,35,.200,73,190,.384,.371,29,47,.617,23,71,94,66,27,6,33,52,196,2017
Jeff Withey,C,26,UTA,51,1,432,55,103,.534,0,1,.000,55,102,.539,.534,36,48,.750,52,69,121,7,16,32,14,52,146,2017
Christian Wood,PF,21,CHO,13,0,107,12,23,.522,0,5,.000,12,18,.667,.522,11,15,.733,14,15,29,2,3,6,7,11,35,2017
Metta World Peace,SF,37,LAL,25,2,160,19,68,.279,9,38,.237,10,30,.333,.346,10,16,.625,5,15,20,11,9,2,7,18,57,2017
Brandan Wright,PF,29,MEM,28,5,447,83,135,.615,0,1,.000,83,134,.619,.615,23,35,.657,31,47,78,15,11,20,10,42,189,2017
Delon Wright,PG,24,TOR,27,0,446,49,116,.422,10,30,.333,39,86,.453,.466,42,55,.764,16,32,48,57,27,11,25,31,150,2017
James Young,SG,21,BOS,29,0,220,25,58,.431,12,35,.343,13,23,.565,.534,6,9,.667,6,20,26,4,10,2,4,15,68,2017
Joe Young,PG,24,IND,33,0,135,26,72,.361,5,23,.217,21,49,.429,.396,11,15,.733,1,16,17,15,4,0,5,5,68,2017
Nick Young,SG,31,LAL,60,60,1556,272,633,.430,170,421,.404,102,212,.481,.564,77,90,.856,25,112,137,58,37,14,36,137,791,2017
Thaddeus Young,PF,28,IND,74,74,2237,362,687,.527,45,118,.381,317,569,.557,.560,45,86,.523,131,318,449,122,114,30,96,135,814,2017
Cody Zeller,PF,24,CHO,62,58,1725,253,443,.571,0,1,.000,253,442,.572,.571,133,196,.679,135,270,405,99,62,58,65,189,639,2017
Tyler Zeller,C,27,BOS,51,5,525,78,158,.494,0,1,.000,78,157,.497,.494,22,39,.564,43,81,124,42,7,21,20,61,178,2017
Stephen Zimmerman,C,20,ORL,19,0,108,10,31,.323,0,0,.000,10,31,.323,.323,3,5,.600,11,24,35,4,2,5,3,17,23,2017
Paul Zipser,SF,22,CHI,44,18,843,88,221,.398,33,99,.333,55,122,.451,.473,31,40,.775,15,110,125,36,15,16,40,78,240,2017
Ivica Zubac,C,19,LAL,38,11,609,126,238,.529,0,3,.000,126,235,.536,.529,32,49,.653,41,118,159,30,14,33,30,66,284,2017
Quincy Acy,PF,25,SAC,59,29,876,119,214,.556,19,49,.388,100,165,.606,.600,50,68,.735,65,123,188,27,29,24,27,103,307,2016
Jordan Adams,SG,21,MEM,2,0,15,2,6,.333,0,1,.000,2,5,.400,.333,3,5,.600,0,2,2,3,3,0,2,2,7,2016
Steven Adams,C,22,OKC,80,80,2014,261,426,.613,0,0,.000,261,426,.613,.613,114,196,.582,219,314,533,62,42,89,84,223,636,2016
Arron Afflalo,SG,30,NYK,71,57,2371,354,799,.443,91,238,.382,263,561,.469,.500,110,131,.840,23,243,266,144,25,10,82,142,909,2016
Alexis Ajinca,C,27,NOP,59,17,861,150,315,.476,0,1,.000,150,314,.478,.476,52,62,.839,75,194,269,31,19,36,54,134,352,2016
Cole Aldrich,C,27,LAC,60,5,800,134,225,.596,0,0,.000,134,225,.596,.596,60,84,.714,86,202,288,50,47,68,64,139,328,2016
LaMarcus Aldridge,PF,30,SAS,74,74,2261,536,1045,.513,0,16,.000,536,1029,.521,.513,259,302,.858,176,456,632,110,38,81,99,151,1331,2016
Cliff Alexander,PF,20,POR,8,0,36,5,10,.500,0,0,.000,5,10,.500,.500,0,0,.000,2,4,6,0,1,2,1,1,10,2016
Lavoy Allen,PF,26,IND,79,28,1599,191,370,.516,0,0,.000,191,370,.516,.516,46,73,.630,162,262,424,76,26,42,69,147,428,2016
Tony Allen,SG,34,MEM,64,57,1620,215,469,.458,15,42,.357,200,427,.468,.474,90,138,.652,104,192,296,70,110,18,78,175,535,2016
Al-Farouq Aminu,SF,25,POR,82,82,2341,299,719,.416,126,349,.361,173,370,.468,.503,115,156,.737,98,401,499,138,72,53,120,171,839,2016
Lou Amundson,PF,33,NYK,29,0,204,19,53,.358,0,0,.000,19,53,.358,.358,14,27,.519,23,26,49,12,6,7,15,44,52,2016
Chris Andersen,C,37,TOT,27,15,402,38,72,.528,4,14,.286,34,58,.586,.556,25,36,.694,36,62,98,12,15,13,9,29,105,2016
Chris Andersen,C,37,MIA,7,1,36,4,10,.400,2,5,.400,2,5,.400,.500,3,4,.750,3,6,9,3,1,3,2,4,13,2016
Chris Andersen,C,37,MEM,20,14,366,34,62,.548,2,9,.222,32,53,.604,.565,22,32,.688,33,56,89,9,14,10,7,25,92,2016
Alan Anderson,SG,33,WAS,13,0,192,21,59,.356,12,37,.324,9,22,.409,.458,11,15,.733,1,26,27,14,4,1,2,25,65,2016
James Anderson,SG,26,SAC,51,15,721,67,178,.376,23,86,.267,44,92,.478,.441,22,29,.759,13,73,86,41,21,14,42,54,179,2016
Justin Anderson,SF,22,DAL,55,9,647,71,175,.406,22,83,.265,49,92,.533,.469,44,55,.800,18,114,132,29,19,25,24,45,208,2016
Kyle Anderson,SF,22,SAS,78,11,1245,138,295,.468,12,37,.324,126,258,.488,.488,62,83,.747,25,219,244,123,60,29,59,97,350,2016
Ryan Anderson,PF,27,NOP,66,7,2008,397,929,.427,131,358,.366,266,571,.466,.498,199,228,.873,131,265,396,73,38,25,90,109,1124,2016
Giannis Antetokounmpo,PG,21,MIL,80,79,2823,513,1013,.506,28,109,.257,485,904,.537,.520,296,409,.724,113,499,612,345,94,113,208,258,1350,2016
Thanasis Antetokounmpo,SF,23,NYK,2,0,6,3,4,.750,0,1,.000,3,3,1.000,.750,0,0,.000,0,1,1,0,0,0,0,2,6,2016
Carmelo Anthony,SF,31,NYK,72,72,2530,567,1307,.434,105,310,.339,462,997,.463,.474,334,403,.829,98,458,556,299,62,38,176,180,1573,2016
Joel Anthony,C,33,DET,19,0,96,6,10,.600,0,0,.000,6,10,.600,.600,6,8,.750,8,13,21,1,2,12,2,15,18,2016
Keith Appling,PG,23,ORL,5,0,27,2,8,.250,0,3,.000,2,5,.400,.250,2,2,1.000,0,1,1,1,1,0,3,5,6,2016
Trevor Ariza,SF,30,HOU,81,81,2859,357,859,.416,185,499,.371,172,360,.478,.523,126,161,.783,67,299,366,188,160,26,113,177,1025,2016
Darrell Arthur,PF,27,DEN,70,16,1516,221,489,.452,45,117,.385,176,372,.473,.498,40,53,.755,86,207,293,96,53,48,66,185,527,2016
Omer Asik,C,29,NOP,68,64,1178,104,195,.533,0,0,.000,104,195,.533,.533,61,112,.545,120,294,414,26,21,23,60,124,269,2016
D.J. Augustin,PG,28,TOT,62,0,1178,148,350,.423,68,168,.405,80,182,.440,.520,103,128,.805,8,87,95,198,38,4,84,85,467,2016
D.J. Augustin,PG,28,OKC,34,0,519,46,121,.380,24,61,.393,22,60,.367,.479,26,34,.765,5,38,43,66,13,2,30,41,142,2016
D.J. Augustin,PG,28,DEN,28,0,659,102,229,.445,44,107,.411,58,122,.475,.541,77,94,.819,3,49,52,132,25,2,54,44,325,2016
Jeff Ayres,C,28,LAC,17,0,107,12,23,.522,0,1,.000,12,22,.545,.522,6,6,1.000,4,18,22,5,0,3,6,18,30,2016
Luke Babbitt,SF,26,NOP,47,13,845,122,289,.422,44,109,.404,78,180,.433,.498,39,50,.780,25,123,148,53,11,7,23,90,327,2016
Cameron Bairstow,C,25,CHI,18,2,103,13,40,.325,1,5,.200,12,35,.343,.338,7,8,.875,4,24,28,6,2,3,4,19,34,2016
Leandro Barbosa,SG,33,GSW,68,0,1079,171,370,.462,39,110,.355,132,260,.508,.515,52,62,.839,28,89,117,82,44,10,53,107,433,2016
J.J. Barea,PG,31,DAL,74,16,1667,317,711,.446,100,260,.385,217,451,.481,.516,74,96,.771,26,126,152,302,26,2,113,110,808,2016
Andrea Bargnani,C,30,BRK,46,0,634,127,279,.455,3,16,.188,124,263,.471,.461,47,57,.825,28,69,97,18,4,9,26,61,304,2016
Harrison Barnes,SF,23,GSW,66,59,2042,295,633,.466,82,214,.383,213,419,.508,.531,102,134,.761,77,248,325,117,41,10,57,136,774,2016
Matt Barnes,SF,35,MEM,76,45,2190,264,693,.381,119,370,.322,145,323,.449,.467,111,138,.804,84,336,420,163,78,57,121,234,758,2016
Will Barton,SG,25,DEN,82,1,2353,425,983,.432,112,325,.345,313,658,.476,.489,216,268,.806,59,417,476,203,71,39,139,147,1178,2016
Brandon Bass,PF,30,LAL,66,0,1342,174,317,.549,0,2,.000,174,315,.552,.549,125,148,.845,104,181,285,74,33,55,42,125,473,2016
Nicolas Batum,SF,27,CHO,70,70,2448,372,873,.426,139,399,.348,233,474,.492,.506,163,192,.849,55,373,428,403,65,43,205,114,1046,2016
Jerryd Bayless,SG,27,MIL,52,18,1505,185,437,.423,101,231,.437,84,206,.408,.539,70,90,.778,21,120,141,163,47,11,73,111,541,2016
Aron Baynes,C,29,DET,81,1,1233,194,384,.505,0,2,.000,194,382,.508,.505,126,165,.764,140,244,384,51,21,52,67,151,514,2016
Kent Bazemore,SF,26,ATL,75,68,2083,320,725,.441,109,305,.357,211,420,.502,.517,123,151,.815,28,351,379,171,98,38,138,176,872,2016
Bradley Beal,SG,22,WAS,55,35,1708,359,799,.449,105,271,.387,254,528,.481,.515,135,176,.767,41,147,188,162,54,11,112,117,958,2016
Michael Beasley,PF,27,HOU,20,0,363,107,205,.522,3,9,.333,104,196,.531,.529,38,49,.776,29,69,98,16,11,9,24,39,255,2016
Marco Belinelli,SG,29,SAC,68,7,1672,245,635,.386,91,297,.306,154,338,.456,.457,115,138,.833,10,107,117,127,37,2,80,91,696,2016
Anthony Bennett,PF,22,TOR,19,0,84,8,27,.296,3,14,.214,5,13,.385,.352,9,10,.900,6,17,23,0,5,0,4,8,28,2016
Patrick Beverley,PG,27,HOU,71,63,2041,258,594,.434,124,310,.400,134,284,.472,.539,60,88,.682,73,177,250,239,94,26,91,234,700,2016
Bismack Biyombo,C,23,TOR,82,22,1808,156,288,.542,0,1,.000,156,287,.544,.542,142,226,.628,182,473,655,29,19,133,71,225,454,2016
Nemanja Bjelica,PF,27,MIN,60,0,1075,110,235,.468,48,125,.384,62,110,.564,.570,40,55,.727,49,161,210,83,26,21,47,154,308,2016
Tarik Black,C,24,LAL,39,0,496,57,104,.548,0,0,.000,57,104,.548,.548,19,45,.422,44,113,157,16,14,18,22,78,133,2016
DeJuan Blair,C,26,WAS,29,0,218,28,68,.412,0,1,.000,28,67,.418,.412,5,13,.385,20,37,57,11,8,2,15,53,61,2016
Steve Blake,PG,35,DET,58,2,986,93,240,.388,52,151,.344,41,89,.461,.496,16,20,.800,9,80,89,200,24,5,81,70,254,2016
Eric Bledsoe,PG,26,PHO,31,31,1059,223,492,.453,48,129,.372,175,363,.482,.502,138,172,.802,18,107,125,190,63,19,110,75,632,2016
Bojan Bogdanovic,SF,26,BRK,79,39,2115,324,749,.433,129,338,.382,195,411,.474,.519,110,132,.833,36,219,255,99,29,5,115,119,887,2016
Andrew Bogut,C,31,GSW,70,66,1451,175,279,.627,1,1,1.000,174,278,.626,.629,24,50,.480,121,371,492,162,33,114,83,221,375,2016
Matt Bonner,C,35,SAS,30,2,206,29,57,.509,15,34,.441,14,23,.609,.640,3,4,.750,3,24,27,9,6,1,3,16,76,2016
Devin Booker,SG,19,PHO,76,51,2108,367,867,.423,99,289,.343,268,578,.464,.480,215,256,.840,27,160,187,200,44,20,160,225,1048,2016
Trevor Booker,PF,28,UTA,79,2,1632,190,388,.490,12,41,.293,178,347,.513,.505,71,106,.670,166,286,452,84,59,41,81,169,463,2016
Chris Bosh,PF,31,MIA,53,53,1778,358,767,.467,81,222,.365,277,545,.508,.520,213,268,.795,48,342,390,128,36,34,78,101,1010,2016
Avery Bradley,SG,25,BOS,76,72,2536,456,1019,.447,147,407,.361,309,612,.505,.520,96,123,.780,48,172,220,158,117,19,109,164,1155,2016
Elton Brand,C,36,PHI,17,1,225,31,72,.431,0,1,.000,31,71,.437,.431,8,9,.889,9,54,63,18,9,8,11,32,70,2016
Corey Brewer,SF,29,HOU,82,12,1669,212,552,.384,61,224,.272,151,328,.460,.439,105,140,.750,42,157,199,109,84,19,78,168,590,2016
Aaron Brooks,PG,31,CHI,69,0,1108,188,469,.401,66,185,.357,122,284,.430,.471,49,64,.766,21,80,101,180,30,10,82,132,491,2016
Anthony Brown,SF,23,LAL,29,11,599,39,126,.310,20,70,.286,19,56,.339,.389,17,20,.850,9,61,70,19,14,5,15,34,115,2016
Lorenzo Brown,PG,25,PHO,8,0,61,8,25,.320,1,8,.125,7,17,.412,.340,3,4,.750,0,7,7,11,3,1,9,4,20,2016
Markel Brown,SG,24,BRK,62,6,982,127,322,.394,38,121,.314,89,201,.443,.453,71,94,.755,23,99,122,91,38,15,54,94,363,2016
Kobe Bryant,SF,37,LAL,66,66,1863,398,1113,.358,133,467,.285,265,646,.410,.417,232,281,.826,41,206,247,184,62,13,129,115,1161,2016
Chase Budinger,SF,27,TOT,66,2,929,104,239,.435,24,86,.279,80,153,.523,.485,39,56,.696,43,107,150,64,32,10,44,62,271,2016
Chase Budinger,SF,27,IND,49,2,729,81,194,.418,20,69,.290,61,125,.488,.469,34,48,.708,31,90,121,49,29,9,31,46,216,2016
Chase Budinger,SF,27,PHO,17,0,200,23,45,.511,4,17,.235,19,28,.679,.556,5,8,.625,12,17,29,15,3,1,13,16,55,2016
Reggie Bullock,SF,24,DET,37,0,429,43,98,.439,22,53,.415,21,45,.467,.551,14,15,.933,14,54,68,27,10,2,8,29,122,2016
Trey Burke,PG,23,UTA,64,0,1366,262,634,.413,88,256,.344,174,378,.460,.483,67,82,.817,18,94,112,148,35,6,80,86,679,2016
Alec Burks,SG,24,UTA,31,3,797,137,334,.410,32,79,.405,105,255,.412,.458,106,141,.752,16,93,109,63,18,4,51,71,412,2016
Caron Butler,SF,35,SAC,17,1,176,25,59,.424,3,18,.167,22,41,.537,.449,10,12,.833,5,17,22,10,9,1,3,19,63,2016
Jimmy Butler,SG,26,CHI,67,67,2474,470,1035,.454,64,205,.312,406,830,.489,.485,395,475,.832,79,279,358,321,110,43,132,124,1399,2016
Rasual Butler,SF,36,SAS,46,0,432,49,104,.471,15,49,.306,34,55,.618,.543,11,16,.688,3,53,56,24,13,23,8,11,124,2016
Bruno Caboclo,SF,20,TOR,6,1,43,1,12,.083,1,7,.143,0,5,.000,.125,0,0,.000,1,1,2,1,2,1,4,2,3,2016
Jose Calderon,PG,34,NYK,72,72,2024,209,455,.459,84,203,.414,125,252,.496,.552,42,48,.875,22,207,229,298,63,7,87,135,544,2016
Kentavious Caldwell-Pope,SG,22,DET,76,76,2789,403,960,.420,114,369,.309,289,591,.489,.479,185,228,.811,70,212,282,138,110,17,105,167,1105,2016
Isaiah Canaan,SG,24,PHI,77,39,1966,260,722,.360,176,485,.363,84,237,.354,.482,150,180,.833,20,154,174,137,56,12,91,133,846,2016
Clint Capela,C,21,HOU,77,35,1471,231,397,.582,0,1,.000,231,396,.583,.582,80,211,.379,194,300,494,47,59,92,60,190,542,2016
DeMarre Carroll,SF,29,TOR,26,22,786,105,270,.389,46,118,.390,59,152,.388,.474,30,50,.600,31,91,122,27,44,6,28,63,286,2016
Vince Carter,SG,39,MEM,60,3,1005,133,343,.388,59,169,.349,74,174,.425,.474,70,84,.833,31,115,146,56,38,16,35,101,395,2016
Michael Carter-Williams,PG,24,MIL,54,37,1649,251,555,.452,15,55,.273,236,500,.472,.466,106,162,.654,48,228,276,281,80,41,153,162,623,2016
Omri Casspi,SF,27,SAC,69,21,1880,299,622,.481,112,274,.409,187,348,.537,.571,103,159,.648,58,352,410,95,56,17,94,154,813,2016
Willie Cauley-Stein,C,22,SAC,66,39,1412,191,339,.563,0,2,.000,191,337,.567,.563,81,125,.648,134,218,352,37,48,66,46,146,463,2016
Mario Chalmers,PG,29,TOT,61,7,1373,182,444,.410,46,149,.309,136,295,.461,.462,218,262,.832,24,133,157,230,88,13,110,181,628,2016
Mario Chalmers,PG,29,MIA,6,0,120,10,32,.313,1,11,.091,9,21,.429,.328,12,13,.923,1,13,14,19,8,1,9,16,33,2016
Mario Chalmers,PG,29,MEM,55,7,1253,172,412,.417,45,138,.326,127,274,.464,.472,206,249,.827,23,120,143,211,80,12,101,165,595,2016
Tyson Chandler,C,33,PHO,66,60,1618,183,314,.583,0,1,.000,183,313,.585,.583,106,171,.620,175,401,576,64,36,44,93,145,472,2016
Rakeem Christmas,PF,24,IND,1,0,6,2,2,1.000,0,0,.000,2,2,1.000,1.000,0,0,.000,1,0,1,0,0,0,0,1,4,2016
Ian Clark,SG,24,GSW,66,1,578,89,202,.441,30,84,.357,59,118,.500,.515,28,34,.824,13,55,68,64,17,13,43,58,236,2016
Coty Clarke,SF,23,BOS,3,0,6,2,4,.500,2,2,1.000,0,2,.000,.750,0,0,.000,0,1,1,0,0,0,1,0,6,2016
Jordan Clarkson,SG,23,LAL,79,79,2552,475,1098,.433,111,320,.347,364,778,.468,.483,164,204,.804,93,220,313,192,88,7,135,168,1225,2016
Norris Cole,PG,27,NOP,45,23,1198,196,484,.405,33,102,.324,163,382,.427,.439,52,65,.800,10,141,151,167,37,5,75,102,477,2016
Darren Collison,PG,28,SAC,74,15,2219,377,776,.486,87,217,.401,290,559,.519,.542,194,226,.858,28,141,169,318,76,4,130,142,1035,2016
Nick Collison,PF,35,OKC,59,4,699,50,109,.459,0,2,.000,50,107,.467,.459,23,33,.697,68,103,171,52,15,16,50,107,123,2016
Mike Conley,PG,28,MEM,56,56,1761,294,696,.422,78,215,.363,216,481,.449,.478,191,229,.834,26,138,164,342,67,16,84,100,857,2016
Pat Connaughton,SG,23,POR,34,0,143,13,49,.265,5,21,.238,8,28,.286,.316,5,5,1.000,11,21,32,10,2,0,10,6,36,2016
Chris Copeland,PF,31,MIL,24,1,156,17,51,.333,10,36,.278,7,15,.467,.431,6,7,.857,1,9,10,11,2,0,6,17,50,2016
Bryce Cotton,PG,23,TOT,8,0,39,4,10,.400,0,3,.000,4,7,.571,.400,0,0,.000,0,0,0,3,3,0,5,2,8,2016
Bryce Cotton,PG,23,PHO,3,0,33,2,8,.250,0,3,.000,2,5,.400,.250,0,0,.000,0,0,0,3,3,0,5,2,4,2016
Bryce Cotton,PG,23,MEM,5,0,6,2,2,1.000,0,0,.000,2,2,1.000,1.000,0,0,.000,0,0,0,0,0,0,0,0,4,2016
DeMarcus Cousins,C,25,SAC,65,65,2246,601,1332,.451,70,210,.333,531,1122,.473,.477,476,663,.718,158,589,747,214,101,92,249,236,1748,2016
Robert Covington,SF,25,PHI,67,49,1903,274,712,.385,170,482,.353,104,230,.452,.504,140,177,.791,65,354,419,97,105,40,143,232,858,2016
Allen Crabbe,SG,23,POR,81,8,2105,311,678,.459,112,285,.393,199,393,.506,.541,98,113,.867,27,189,216,99,63,16,64,192,832,2016
Jamal Crawford,SG,35,LAC,79,5,2126,379,939,.404,117,344,.340,262,595,.440,.466,245,271,.904,20,125,145,183,52,12,113,122,1120,2016
Jae Crowder,SF,25,BOS,73,73,2308,360,813,.443,122,363,.336,238,450,.529,.518,196,239,.820,70,303,373,135,126,35,83,198,1038,2016
Dante Cunningham,SF,28,NOP,80,46,1971,186,412,.451,55,174,.316,131,238,.550,.518,57,82,.695,57,179,236,77,42,33,41,173,484,2016
Jared Cunningham,SG,24,TOT,44,3,410,36,105,.343,12,39,.308,24,66,.364,.400,36,55,.655,3,35,38,20,14,2,21,41,120,2016
Jared Cunningham,SG,24,CLE,40,3,355,32,91,.352,10,32,.313,22,59,.373,.407,30,48,.625,3,26,29,19,12,2,18,37,104,2016
Jared Cunningham,SG,24,MIL,4,0,55,4,14,.286,2,7,.286,2,7,.286,.357,6,7,.857,0,9,9,1,2,0,3,4,16,2016
Seth Curry,PG,25,SAC,44,9,692,102,224,.455,50,111,.450,52,113,.460,.567,45,54,.833,9,51,60,67,22,3,36,41,299,2016
Stephen Curry,PG,27,GSW,79,79,2700,805,1598,.504,402,886,.454,403,712,.566,.630,363,400,.908,68,362,430,527,169,15,262,161,2375,2016
Troy Daniels,SG,24,CHO,43,0,476,89,187,.476,59,122,.484,30,65,.462,.634,5,9,.556,7,50,57,21,11,3,24,40,242,2016
Anthony Davis,C,22,NOP,61,61,2164,560,1136,.493,35,108,.324,525,1028,.511,.508,326,430,.758,130,497,627,116,78,125,121,148,1481,2016
Ed Davis,PF,26,POR,81,0,1684,206,337,.611,0,0,.000,206,337,.611,.611,114,204,.559,224,375,599,88,57,72,64,202,526,2016
Branden Dawson,PF,22,LAC,6,0,29,2,5,.400,0,0,.000,2,5,.400,.400,1,1,1.000,2,2,4,0,0,1,0,2,5,2016
Dewayne Dedmon,C,26,ORL,58,20,705,99,177,.559,0,0,.000,99,177,.559,.559,57,76,.750,67,161,228,13,22,46,32,109,255,2016
Bryce Dejean-Jones,SG,23,NOP,14,11,279,28,69,.406,12,32,.375,16,37,.432,.493,11,21,.524,8,40,48,15,10,2,11,17,79,2016
Sam Dekker,SF,21,HOU,3,0,6,0,0,.000,0,0,.000,0,0,.000,.000,0,0,.000,0,1,1,0,1,0,0,0,0,2016
Matthew Dellavedova,PG,25,CLE,76,14,1867,207,511,.405,98,239,.410,109,272,.401,.501,57,66,.864,33,129,162,337,44,9,116,178,569,2016
Luol Deng,PF,30,MIA,74,73,2394,339,745,.455,88,256,.344,251,489,.513,.514,145,192,.755,108,335,443,140,74,29,81,122,911,2016
DeMar DeRozan,SG,26,TOR,78,78,2804,614,1377,.446,47,139,.338,567,1238,.458,.463,555,653,.850,64,285,349,315,81,21,175,167,1830,2016
Boris Diaw,PF,33,SAS,76,4,1386,202,383,.527,25,69,.362,177,314,.564,.560,56,76,.737,58,175,233,176,26,21,97,102,485,2016
Gorgui Dieng,C,26,MIN,82,39,2220,308,579,.532,6,20,.300,302,559,.540,.537,205,248,.827,157,428,585,143,94,96,140,219,827,2016
Spencer Dinwiddie,PG,22,DET,12,0,159,19,54,.352,1,10,.100,18,44,.409,.361,19,33,.576,4,13,17,22,3,0,7,20,58,2016
Toney Douglas,PG,29,NOP,61,18,1262,183,445,.411,81,203,.399,102,242,.421,.502,84,99,.848,25,118,143,157,70,5,64,131,531,2016
Goran Dragic,PG,29,MIA,72,72,2363,417,875,.477,64,205,.312,353,670,.527,.513,120,165,.727,54,223,277,419,71,17,185,188,1018,2016
Andre Drummond,C,22,DET,81,81,2666,552,1060,.521,2,6,.333,550,1054,.522,.522,208,586,.355,395,803,1198,67,119,112,155,245,1314,2016
Jared Dudley,PF,30,WAS,81,41,2098,233,487,.478,100,238,.420,133,249,.534,.581,72,98,.735,54,232,286,170,75,18,80,190,638,2016
Duje Dukan,SF,24,SAC,1,0,24,2,10,.200,2,5,.400,0,5,.000,.300,0,0,.000,2,2,4,1,1,0,0,2,6,2016
Tim Duncan,C,39,SAS,61,60,1536,215,441,.488,0,2,.000,215,439,.490,.488,92,131,.702,115,332,447,163,47,78,90,125,522,2016
Mike Dunleavy,SF,35,CHI,31,30,703,77,188,.410,39,99,.394,38,89,.427,.513,29,37,.784,8,75,83,39,14,10,26,66,222,2016
Kevin Durant,SF,27,OKC,72,72,2578,698,1381,.505,186,481,.387,512,900,.569,.573,447,498,.898,45,544,589,361,69,85,250,137,2029,2016
Cleanthony Early,SF,24,NYK,17,2,154,12,40,.300,4,15,.267,8,25,.320,.350,3,4,.750,4,22,26,6,2,3,9,16,31,2016
Jarell Eddie,SF,24,WAS,26,0,147,20,65,.308,15,47,.319,5,18,.278,.423,8,8,1.000,2,21,23,5,5,1,1,5,63,2016
Wayne Ellington,SG,28,BRK,76,41,1615,218,561,.389,96,268,.358,122,293,.416,.474,54,63,.857,20,154,174,83,48,5,45,82,586,2016
Monta Ellis,SG,30,IND,81,81,2734,436,1021,.427,87,282,.309,349,739,.472,.470,162,206,.786,42,229,271,383,150,37,203,174,1121,2016
James Ennis,SF,25,TOT,22,5,329,54,113,.478,26,58,.448,28,55,.509,.593,25,34,.735,21,21,42,21,16,5,19,28,159,2016
James Ennis,SF,25,MIA,3,0,7,0,0,.000,0,0,.000,0,0,.000,.000,0,0,.000,0,0,0,1,0,0,0,1,0,2016
James Ennis,SF,25,MEM,10,0,40,4,13,.308,2,8,.250,2,5,.400,.385,6,10,.600,4,3,7,2,4,2,2,1,16,2016
James Ennis,SF,25,NOP,9,5,282,50,100,.500,24,50,.480,26,50,.520,.620,19,24,.792,17,18,35,18,12,3,17,26,143,2016
Tyler Ennis,PG,21,MIL,46,7,654,84,187,.449,13,39,.333,71,148,.480,.484,25,34,.735,13,62,75,95,25,1,46,64,206,2016
Jeremy Evans,SF,28,DAL,30,2,251,26,48,.542,4,16,.250,22,32,.688,.583,15,21,.714,11,43,54,2,6,9,7,19,71,2016
Tyreke Evans,SG,26,NOP,25,25,765,136,314,.433,33,85,.388,103,229,.450,.486,74,93,.796,20,109,129,164,32,8,73,66,379,2016
Festus Ezeli,C,26,GSW,46,13,770,125,228,.548,0,0,.000,125,228,.548,.548,70,132,.530,91,166,257,32,18,50,38,94,320,2016
Kenneth Faried,PF,26,DEN,67,64,1694,349,626,.558,1,2,.500,348,624,.558,.558,136,222,.613,235,346,581,79,32,60,91,169,835,2016
Jordan Farmar,PG,29,MEM,12,10,291,42,100,.420,16,45,.356,26,55,.473,.500,10,10,1.000,4,21,25,37,15,2,18,22,110,2016
Derrick Favors,PF,24,UTA,62,59,1983,418,811,.515,0,4,.000,418,807,.518,.515,180,254,.709,169,334,503,94,74,91,104,150,1016,2016
Cristiano Felicio,C,23,CHI,31,4,321,40,72,.556,0,4,.000,40,68,.588,.556,25,35,.714,30,72,102,26,6,13,13,31,105,2016
Raymond Felton,PG,31,DAL,80,31,2192,277,682,.406,60,213,.282,217,469,.463,.450,149,176,.847,36,222,258,284,68,15,121,141,763,2016
Evan Fournier,SF,23,ORL,79,71,2566,429,929,.462,156,390,.400,273,539,.506,.546,199,238,.836,33,192,225,213,96,2,133,214,1213,2016
Randy Foye,SG,32,TOT,81,8,1642,169,482,.351,75,250,.300,94,232,.405,.428,61,74,.824,24,132,156,161,39,29,86,131,474,2016
Randy Foye,SG,32,DEN,54,7,1070,117,333,.351,50,169,.296,67,164,.409,.426,39,47,.830,16,89,105,112,26,16,58,83,323,2016
Randy Foye,SG,32,OKC,27,1,572,52,149,.349,25,81,.309,27,68,.397,.433,22,27,.815,8,43,51,49,13,13,28,48,151,2016
Tim Frazier,PG,25,TOT,51,2,741,96,229,.419,16,48,.333,80,181,.442,.454,53,74,.716,26,84,110,162,33,2,65,73,261,2016
Tim Frazier,PG,25,POR,35,1,272,20,60,.333,3,17,.176,17,43,.395,.358,8,15,.533,11,28,39,42,10,1,27,31,51,2016
Tim Frazier,PG,25,NOP,16,1,469,76,169,.450,13,31,.419,63,138,.457,.488,45,59,.763,15,56,71,120,23,1,38,42,210,2016
Jimmer Fredette,SG,26,TOT,6,0,18,2,5,.400,1,2,.500,1,3,.333,.500,4,5,.800,0,0,0,1,1,0,2,2,9,2016
Jimmer Fredette,SG,26,NOP,4,0,13,1,4,.250,0,1,.000,1,3,.333,.250,0,0,.000,0,0,0,1,1,0,1,1,2,2016
Jimmer Fredette,SG,26,NYK,2,0,5,1,1,1.000,1,1,1.000,0,0,1.500,.000,4,5,.800,0,0,0,0,0,0,1,1,7,2016
Channing Frye,PF-C,32,TOT,70,32,1200,152,347,.438,91,235,.387,61,112,.545,.569,30,35,.857,35,199,234,71,29,28,43,127,425,2016
Channing Frye,PF,32,ORL,44,29,754,81,186,.435,48,121,.397,33,65,.508,.565,19,21,.905,23,118,141,45,21,20,30,71,229,2016
Channing Frye,C,32,CLE,26,3,446,71,161,.441,43,114,.377,28,47,.596,.575,11,14,.786,12,81,93,26,8,8,13,56,196,2016
Danilo Gallinari,SF,27,DEN,53,53,1839,287,700,.410,87,239,.364,200,461,.434,.472,375,432,.868,52,229,281,135,42,19,77,87,1036,2016
Langston Galloway,PG,24,NYK,82,7,2033,231,588,.393,77,224,.344,154,364,.423,.458,86,114,.754,43,245,288,207,77,22,61,177,625,2016
Kevin Garnett,PF,39,MIN,38,38,556,54,115,.470,0,1,.000,54,114,.474,.470,14,21,.667,15,135,150,62,28,10,16,70,122,2016
Marc Gasol,C,31,MEM,52,52,1791,328,707,.464,2,3,.667,326,704,.463,.465,203,245,.829,58,304,362,196,50,70,118,141,861,2016
Pau Gasol,C,35,CHI,72,72,2291,467,995,.469,24,69,.348,443,926,.478,.481,229,289,.792,155,638,793,294,42,146,164,148,1187,2016
Rudy Gay,SF,29,SAC,70,70,2379,466,1007,.463,74,215,.344,392,792,.495,.500,198,254,.780,103,353,456,120,100,51,139,184,1204,2016
Alonzo Gee,SF,28,NOP,73,38,1632,132,255,.518,17,60,.283,115,195,.590,.551,44,66,.667,60,185,245,72,63,13,55,169,325,2016
Paul George,SF,25,IND,81,81,2819,605,1449,.418,210,566,.371,395,883,.447,.490,454,528,.860,79,484,563,329,152,29,265,230,1874,2016
Taj Gibson,PF,30,CHI,73,55,1936,263,500,.526,0,3,.000,263,497,.529,.526,101,146,.692,206,298,504,106,47,77,78,180,627,2016
Manu Ginobili,SG,38,SAS,58,0,1134,197,435,.453,70,179,.391,127,256,.496,.533,91,112,.813,26,120,146,177,66,11,99,99,555,2016
Rudy Gobert,C,23,UTA,61,60,1932,198,354,.559,0,0,.000,198,354,.559,.559,161,283,.569,208,460,668,91,45,135,114,163,557,2016
Drew Gooden,PF,34,WAS,30,0,305,33,103,.320,7,41,.171,26,62,.419,.354,9,14,.643,28,57,85,13,8,11,13,40,82,2016
Archie Goodwin,PG,21,PHO,57,13,1114,176,422,.417,23,99,.232,153,323,.474,.444,130,193,.674,27,115,142,118,27,13,100,84,505,2016
Aaron Gordon,PF,20,ORL,78,37,1863,274,579,.473,42,142,.296,232,437,.531,.509,129,193,.668,154,353,507,128,59,55,66,153,719,2016
Eric Gordon,SG,27,NOP,45,44,1481,231,552,.418,113,294,.384,118,258,.457,.521,111,125,.888,10,89,99,121,43,14,73,98,686,2016
Marcin Gortat,C,31,WAS,75,74,2256,433,764,.567,0,1,.000,433,763,.567,.567,146,207,.705,222,519,741,106,47,96,121,193,1012,2016
Andrew Goudelock,PG,27,HOU,8,0,50,9,20,.450,1,9,.111,8,11,.727,.475,3,4,.750,1,1,2,4,6,2,7,4,22,2016
Jerami Grant,SF,21,PHI,77,52,2066,251,599,.419,35,146,.240,216,453,.477,.448,212,322,.658,99,262,361,135,54,127,110,215,749,2016
Jerian Grant,PG,23,NYK,76,6,1265,154,391,.394,22,100,.220,132,291,.454,.422,96,123,.780,23,120,143,177,50,10,87,97,426,2016
Danny Green,SG,28,SAS,79,79,2062,211,561,.376,116,349,.332,95,212,.448,.480,34,46,.739,48,255,303,141,79,64,75,141,572,2016
Draymond Green,PF,25,GSW,81,81,2808,401,819,.490,100,258,.388,301,561,.537,.551,229,329,.696,134,635,769,598,119,113,259,240,1131,2016
Erick Green,PG,24,TOT,9,0,42,5,13,.385,1,5,.200,4,8,.500,.423,2,2,1.000,3,3,6,3,1,0,0,4,13,2016
Erick Green,PG,24,DEN,3,0,7,0,1,.000,0,1,.000,0,0,.000,.000,0,0,.000,0,1,1,1,0,0,0,0,0,2016
Erick Green,PG,24,UTA,6,0,35,5,12,.417,1,4,.250,4,8,.500,.458,2,2,1.000,3,2,5,2,1,0,0,4,13,2016
Gerald Green,SG,30,MIA,69,14,1557,230,587,.392,84,260,.323,146,327,.446,.463,72,92,.783,25,138,163,56,38,19,46,123,616,2016
JaMychal Green,PF,25,MEM,78,15,1446,230,495,.465,15,45,.333,215,450,.478,.480,103,137,.752,139,234,373,67,46,33,83,189,578,2016
Jeff Green,SF,29,TOT,80,41,2253,354,824,.430,67,213,.315,287,611,.470,.470,164,220,.745,74,258,332,138,58,40,93,164,939,2016
Jeff Green,SF,29,MEM,53,31,1544,240,557,.431,42,136,.309,198,421,.470,.469,124,155,.800,55,186,241,98,40,19,69,102,646,2016
Jeff Green,SF,29,LAC,27,10,709,114,267,.427,25,77,.325,89,190,.468,.474,40,65,.615,19,72,91,40,18,21,24,62,293,2016
Blake Griffin,PF,26,LAC,35,35,1170,301,603,.499,6,18,.333,295,585,.504,.504,141,194,.727,51,243,294,170,28,17,83,95,749,2016
Jorge Gutierrez,PG,27,CHO,12,0,63,6,11,.545,0,2,.000,6,9,.667,.545,10,11,.909,0,7,7,17,3,0,6,3,22,2016
P.J. Hairston,SF,23,TOT,66,52,1313,145,408,.355,70,241,.290,75,167,.449,.441,50,64,.781,25,149,174,38,32,11,41,137,410,2016
P.J. Hairston,SF,23,CHO,48,43,938,99,276,.359,54,172,.314,45,104,.433,.457,34,42,.810,18,110,128,29,24,7,24,106,286,2016
P.J. Hairston,SF,23,MEM,18,9,375,46,132,.348,16,69,.232,30,63,.476,.409,16,22,.727,7,39,46,9,8,4,17,31,124,2016
Jordan Hamilton,SF,25,NOP,11,4,304,49,116,.422,13,45,.289,36,71,.507,.478,14,21,.667,12,50,62,25,8,3,17,24,125,2016
Tyler Hansbrough,PF,30,CHO,44,0,343,32,71,.451,2,3,.667,30,68,.441,.465,38,65,.585,40,49,89,8,12,7,12,55,104,2016
Tim Hardaway,SG,23,ATL,51,1,864,114,265,.430,48,142,.338,66,123,.537,.521,50,56,.893,7,79,86,51,21,7,23,48,326,2016
James Harden,SG,26,HOU,82,82,3125,710,1617,.439,236,657,.359,474,960,.494,.512,720,837,.860,63,438,501,612,139,51,374,229,2376,2016
Maurice Harkless,SF,22,POR,78,14,1457,195,411,.474,39,140,.279,156,271,.576,.522,69,111,.622,101,179,280,67,49,35,62,124,498,2016
Justin Harper,PF,26,DET,5,0,35,4,10,.400,4,9,.444,0,1,.000,.600,1,2,.500,0,1,1,0,1,0,2,3,13,2016
Montrezl Harrell,PF,22,HOU,39,1,379,58,90,.644,0,1,.000,58,89,.652,.644,24,46,.522,25,40,65,17,11,11,17,48,140,2016
Devin Harris,PG,32,DAL,64,0,1280,167,374,.447,52,158,.329,115,216,.532,.516,101,140,.721,18,120,138,118,60,13,66,124,487,2016
Gary Harris,SG,21,DEN,76,76,2439,359,765,.469,105,297,.354,254,468,.543,.538,109,133,.820,54,166,220,147,97,18,98,143,932,2016
Joe Harris,SG,24,CLE,5,0,15,1,4,.250,1,4,.250,0,0,.375,.000,0,0,.000,0,3,3,2,0,0,1,1,3,2016
Tobias Harris,PF,23,TOT,76,74,2513,417,889,.469,80,239,.335,337,650,.518,.514,202,243,.831,96,414,510,169,65,40,108,153,1116,2016
Tobias Harris,PF,23,ORL,49,49,1610,251,541,.464,47,151,.311,204,390,.523,.507,120,153,.784,71,271,342,99,47,28,78,91,669,2016
Tobias Harris,PF,23,DET,27,25,903,166,348,.477,33,88,.375,133,260,.512,.524,82,90,.911,25,143,168,70,18,12,30,62,447,2016
Aaron Harrison,SG,21,CHO,21,0,93,5,19,.263,3,10,.300,2,9,.222,.342,5,12,.417,4,11,15,2,6,0,4,10,18,2016
Udonis Haslem,PF,35,MIA,37,0,260,23,61,.377,1,9,.111,22,52,.423,.385,12,16,.750,10,65,75,14,5,2,5,25,59,2016
Spencer Hawes,PF,27,CHO,57,6,1035,124,306,.405,38,102,.373,86,204,.422,.467,54,65,.831,51,193,244,109,22,27,58,111,340,2016
Chuck Hayes,C,32,HOU,2,0,24,1,2,.500,0,0,.000,1,2,.500,.500,2,2,1.000,0,8,8,2,0,0,3,6,4,2016
Gordon Hayward,SF,25,UTA,80,80,2893,521,1202,.433,143,410,.349,378,792,.477,.493,393,477,.824,61,336,397,296,95,27,202,183,1578,2016
Gerald Henderson,SG,28,POR,72,0,1431,232,529,.439,48,136,.353,184,393,.468,.484,112,146,.767,30,181,211,75,39,19,68,87,624,2016
John Henson,C,25,MIL,57,1,960,164,291,.564,0,1,.000,164,290,.566,.564,69,117,.590,87,134,221,54,18,109,64,131,397,2016
Mario Hezonja,SF,20,ORL,79,9,1413,181,418,.433,67,192,.349,114,226,.504,.513,49,54,.907,28,148,176,109,39,17,97,124,478,2016
Roy Hibbert,C,29,LAL,81,81,1878,182,411,.443,0,2,.000,182,409,.445,.443,117,145,.807,132,266,398,95,32,110,76,252,481,2016
J.J. Hickson,C,27,TOT,35,9,436,80,155,.516,0,1,.000,80,154,.519,.516,46,103,.447,39,93,132,23,15,14,25,47,206,2016
J.J. Hickson,C,27,DEN,20,9,305,55,109,.505,0,0,.000,55,109,.505,.505,27,59,.458,22,65,87,16,10,12,16,35,137,2016
J.J. Hickson,C,27,WAS,15,0,131,25,46,.543,0,1,.000,25,45,.556,.543,19,44,.432,17,28,45,7,5,2,9,12,69,2016
Nene Hilario,PF,33,WAS,57,11,1094,209,384,.544,0,3,.000,209,381,.549,.544,107,185,.578,52,207,259,97,54,26,76,156,525,2016
George Hill,PG,29,IND,74,73,2524,326,739,.441,128,314,.408,198,425,.466,.528,114,150,.760,58,240,298,259,83,17,101,149,894,2016
Jordan Hill,C,28,IND,73,11,1513,278,549,.506,0,1,.000,278,548,.507,.506,89,125,.712,156,295,451,87,36,37,92,155,645,2016
Solomon Hill,SF,24,IND,59,3,866,93,208,.447,24,74,.324,69,134,.515,.505,36,42,.857,39,127,166,57,37,11,33,68,246,2016
Darrun Hilliard,SG,22,DET,38,2,383,52,131,.397,19,50,.380,33,81,.407,.469,29,40,.725,5,40,45,27,9,1,19,28,152,2016
Kirk Hinrich,PG,35,TOT,46,7,631,49,129,.380,24,62,.387,25,67,.373,.473,15,16,.938,8,62,70,73,15,2,30,64,137,2016
Kirk Hinrich,PG,35,CHI,35,7,555,47,118,.398,23,56,.411,24,62,.387,.496,15,16,.938,7,51,58,59,13,1,27,63,132,2016
Kirk Hinrich,PG,35,ATL,11,0,76,2,11,.182,1,6,.167,1,5,.200,.227,0,0,.000,1,11,12,14,2,1,3,1,5,2016
Jrue Holiday,PG,25,NOP,65,23,1831,410,935,.439,87,259,.336,323,676,.478,.485,182,216,.843,27,168,195,391,88,22,167,148,1089,2016
Justin Holiday,SG,26,TOT,53,5,773,88,228,.386,36,105,.343,52,123,.423,.465,27,37,.730,12,78,90,56,32,19,39,61,239,2016
Justin Holiday,SG,26,ATL,26,1,263,24,73,.329,10,45,.222,14,28,.500,.397,5,10,.500,4,23,27,11,13,4,13,21,63,2016
Justin Holiday,SG,26,CHI,27,4,510,64,155,.413,26,60,.433,38,95,.400,.497,22,27,.815,8,55,63,45,19,15,26,40,176,2016
Ryan Hollins,C,31,TOT,37,12,460,49,79,.620,0,0,.000,49,79,.620,.620,26,42,.619,47,51,98,10,6,21,24,62,124,2016
Ryan Hollins,C,31,WAS,5,3,48,4,7,.571,0,0,.000,4,7,.571,.571,0,0,.000,7,4,11,0,0,1,3,4,8,2016
Ryan Hollins,C,31,MEM,32,9,412,45,72,.625,0,0,.000,45,72,.625,.625,26,42,.619,40,47,87,10,6,20,21,58,116,2016
Rondae Hollis-Jefferson,SF,21,BRK,29,17,615,63,138,.457,4,14,.286,59,124,.476,.471,37,52,.712,39,115,154,43,39,16,26,61,167,2016
Richaun Holmes,PF,22,PHI,51,1,702,114,222,.514,8,44,.182,106,178,.596,.532,51,74,.689,62,73,135,33,19,40,32,92,287,2016
Rodney Hood,SG,23,UTA,79,79,2541,408,972,.420,161,449,.359,247,523,.472,.503,172,200,.860,38,229,267,213,73,16,125,202,1149,2016
Al Horford,C,29,ATL,82,82,2631,529,1048,.505,88,256,.344,441,792,.557,.547,103,129,.798,148,448,596,263,68,121,107,163,1249,2016
Dwight Howard,C,30,HOU,71,71,2280,372,600,.620,0,6,.000,372,594,.626,.620,232,474,.489,238,597,835,98,69,113,166,219,976,2016
Marcelo Huertas,PG,32,LAL,53,0,869,97,230,.422,16,61,.262,81,169,.479,.457,27,29,.931,18,72,90,182,26,7,80,76,237,2016
Josh Huestis,PF,24,OKC,5,0,55,5,12,.417,4,6,.667,1,6,.167,.583,0,4,.000,2,8,10,0,1,2,3,3,14,2016
Kris Humphries,PF,30,TOT,53,17,835,121,295,.410,34,108,.315,87,187,.465,.468,67,84,.798,57,161,218,36,16,23,38,94,343,2016
Kris Humphries,PF,30,WAS,28,14,466,64,158,.405,23,67,.343,41,91,.451,.478,29,31,.935,26,89,115,16,3,14,20,42,180,2016
Kris Humphries,PF,30,PHO,4,3,74,10,36,.278,3,10,.300,7,26,.269,.319,6,8,.750,11,21,32,7,3,2,4,8,29,2016
Kris Humphries,PF,30,ATL,21,0,295,47,101,.465,8,31,.258,39,70,.557,.505,32,45,.711,20,51,71,13,10,7,14,44,134,2016
R.J. Hunter,SG,22,BOS,36,0,315,36,98,.367,19,63,.302,17,35,.486,.464,6,7,.857,2,35,37,13,14,4,11,29,97,2016
Serge Ibaka,PF,26,OKC,78,78,2500,416,869,.479,60,184,.326,356,685,.520,.513,91,121,.752,141,392,533,66,38,148,108,211,983,2016
Andre Iguodala,SF,32,GSW,65,1,1732,176,368,.478,54,154,.351,122,214,.570,.552,51,83,.614,52,211,263,219,73,19,79,102,457,2016
Ersan Ilyasova,PF,28,TOT,74,56,1881,280,661,.424,96,259,.371,184,402,.458,.496,111,154,.721,144,259,403,67,52,33,71,171,767,2016
Ersan Ilyasova,PF,28,DET,52,52,1434,216,508,.425,78,215,.363,138,293,.471,.502,79,109,.725,99,183,282,55,38,27,59,120,589,2016
Ersan Ilyasova,PF,28,ORL,22,4,447,64,153,.418,18,44,.409,46,109,.422,.477,32,45,.711,45,76,121,12,14,6,12,51,178,2016
Joe Ingles,SF,28,UTA,81,2,1241,124,291,.426,81,210,.386,43,81,.531,.565,13,18,.722,19,132,151,96,55,4,65,98,342,2016
Damien Inglis,SF,20,MIL,20,1,156,13,37,.351,3,13,.231,10,24,.417,.392,7,8,.875,2,29,31,10,6,3,11,11,36,2016
Kyrie Irving,PG,23,CLE,53,53,1667,394,879,.448,84,262,.321,310,617,.502,.496,169,191,.885,44,113,157,249,56,18,124,107,1041,2016
Jarrett Jack,PG,32,BRK,32,32,1027,140,358,.391,31,102,.304,109,256,.426,.434,100,112,.893,9,127,136,236,34,7,94,77,411,2016
Reggie Jackson,PG,25,DET,79,79,2424,540,1244,.434,118,334,.353,422,910,.464,.482,291,337,.864,58,195,253,492,59,11,223,187,1489,2016
LeBron James,SF,31,CLE,76,76,2709,737,1416,.520,87,282,.309,650,1134,.573,.551,359,491,.731,111,454,565,514,104,49,249,143,1920,2016
Al Jefferson,C,31,CHO,47,18,1096,245,505,.485,0,0,.000,245,505,.485,.485,72,111,.649,57,244,301,70,30,41,34,117,562,2016
Cory Jefferson,PF,25,PHO,8,0,50,9,22,.409,0,1,.000,9,21,.429,.409,4,6,.667,6,10,16,0,0,1,0,8,22,2016
Richard Jefferson,SF,35,CLE,74,5,1326,143,312,.458,66,173,.382,77,139,.554,.564,58,87,.667,15,113,128,59,33,14,43,129,410,2016
John Jenkins,SG,24,TOT,43,3,480,71,160,.444,16,51,.314,55,109,.505,.494,20,24,.833,8,49,57,35,8,1,27,22,178,2016
John Jenkins,SG,24,DAL,21,1,193,29,70,.414,3,19,.158,26,51,.510,.436,8,9,.889,4,18,22,9,3,0,11,11,69,2016
John Jenkins,SG,24,PHO,22,2,287,42,90,.467,13,32,.406,29,58,.500,.539,12,15,.800,4,31,35,26,5,1,16,11,109,2016
Brandon Jennings,PG,26,TOT,48,7,868,112,304,.368,51,155,.329,61,149,.409,.452,57,78,.731,16,80,96,170,29,7,57,57,332,2016
Brandon Jennings,PG,26,DET,23,1,416,53,143,.371,24,77,.312,29,66,.439,.455,27,38,.711,5,41,46,70,11,2,22,24,157,2016
Brandon Jennings,PG,26,ORL,25,6,452,59,161,.366,27,78,.346,32,83,.386,.450,30,40,.750,11,39,50,100,18,5,35,33,175,2016
Jonas Jerebko,PF,28,BOS,78,0,1176,118,286,.413,43,108,.398,75,178,.421,.488,61,78,.782,77,211,288,62,20,24,52,137,340,2016
Amir Johnson,PF,28,BOS,79,76,1800,249,426,.585,10,43,.233,239,383,.624,.596,69,121,.570,178,327,505,138,52,83,94,214,577,2016
Chris Johnson,SF,25,UTA,70,2,857,72,194,.371,27,99,.273,45,95,.474,.441,34,42,.810,27,105,132,45,32,20,40,100,205,2016
James Johnson,PF,28,TOR,57,32,926,114,240,.475,20,66,.303,94,174,.540,.517,39,68,.574,28,98,126,67,29,33,54,84,287,2016
Joe Johnson,SF,34,TOT,81,81,2703,377,859,.439,120,313,.383,257,546,.471,.509,118,142,.831,49,243,292,318,61,4,159,146,992,2016
Joe Johnson,SF,34,BRK,57,57,1934,247,608,.406,85,229,.371,162,379,.427,.476,92,108,.852,34,190,224,232,40,2,116,100,671,2016
Joe Johnson,SF,34,MIA,24,24,769,130,251,.518,35,84,.417,95,167,.569,.588,26,34,.765,15,53,68,86,21,2,43,46,321,2016
Orlando Johnson,SG,26,TOT,7,1,101,9,34,.265,2,10,.200,7,24,.292,.294,6,8,.750,4,11,15,2,3,3,4,9,26,2016
Orlando Johnson,SG,26,PHO,2,0,47,5,17,.294,1,5,.200,4,12,.333,.324,5,6,.833,3,6,9,0,2,3,1,5,16,2016
Orlando Johnson,SG,26,NOP,5,1,54,4,17,.235,1,5,.200,3,12,.250,.265,1,2,.500,1,5,6,2,1,0,3,4,10,2016
Stanley Johnson,SF,19,DET,73,6,1687,225,600,.375,63,205,.307,162,395,.410,.428,80,102,.784,58,248,306,118,55,12,114,178,593,2016
Tyler Johnson,SG,23,MIA,36,5,863,118,243,.486,27,71,.380,91,172,.529,.541,51,64,.797,28,81,109,79,24,14,47,66,314,2016
Wesley Johnson,SF,28,LAC,80,9,1666,208,515,.404,103,309,.333,105,206,.510,.504,30,46,.652,37,211,248,49,89,56,54,173,549,2016
Nikola Jokic,C,20,DEN,80,55,1733,307,600,.512,28,84,.333,279,516,.541,.535,154,190,.811,181,379,560,189,79,50,104,208,796,2016
Dahntay Jones,SF,35,CLE,1,0,42,6,14,.429,1,2,.500,5,12,.417,.464,0,0,.000,1,4,5,2,1,2,0,6,13,2016
James Jones,SF,35,CLE,48,0,463,58,142,.408,41,104,.394,17,38,.447,.553,21,26,.808,8,42,50,14,11,10,13,50,178,2016
Terrence Jones,PF,24,HOU,50,11,1044,166,367,.452,25,79,.316,141,288,.490,.486,77,116,.664,62,149,211,41,23,39,49,86,434,2016
Tyus Jones,PG,19,MIN,37,0,573,56,156,.359,16,53,.302,40,103,.388,.410,28,39,.718,7,40,47,108,31,3,33,33,156,2016
DeAndre Jordan,C,27,LAC,77,77,2598,357,508,.703,0,1,.000,357,507,.704,.703,266,619,.430,267,792,1059,90,51,177,107,207,980,2016
Cory Joseph,SG,24,TOR,80,4,2046,257,585,.439,30,110,.273,227,475,.478,.465,133,174,.764,39,171,210,250,63,20,102,131,677,2016
Chris Kaman,C,33,POR,16,2,112,20,43,.465,1,4,.250,19,39,.487,.477,3,3,1.000,7,17,24,11,1,1,8,15,44,2016
Frank Kaminsky,C,22,CHO,81,3,1708,215,525,.410,68,202,.337,147,323,.455,.474,108,148,.730,69,266,335,98,38,43,58,126,606,2016
Enes Kanter,C,23,OKC,82,1,1721,414,719,.576,10,21,.476,404,698,.579,.583,200,251,.797,249,415,664,33,26,33,115,166,1038,2016
Sergey Karasev,SF,22,BRK,40,5,399,30,74,.405,11,37,.297,19,37,.514,.480,26,28,.929,8,50,58,35,6,2,22,27,97,2016
Sasha Kaun,C,30,CLE,25,0,95,9,17,.529,0,0,.000,9,17,.529,.529,5,11,.455,12,14,26,3,4,5,7,11,23,2016
Ryan Kelly,PF,24,LAL,36,0,470,55,149,.369,5,37,.135,50,112,.446,.386,37,54,.685,21,100,121,20,13,10,18,39,152,2016
Michael Kidd-Gilchrist,SF,22,CHO,7,7,205,33,61,.541,3,7,.429,30,54,.556,.566,20,29,.690,12,33,45,9,3,3,8,9,89,2016
Sean Kilpatrick,SG,26,TOT,31,0,616,123,270,.456,39,114,.342,84,156,.538,.528,60,67,.896,12,44,56,29,12,2,31,37,345,2016
Sean Kilpatrick,SG,26,DEN,8,0,82,8,21,.381,4,17,.235,4,4,1.000,.476,7,8,.875,2,4,6,3,2,0,4,7,27,2016
Sean Kilpatrick,SG,26,BRK,23,0,534,115,249,.462,35,97,.361,80,152,.526,.532,53,59,.898,10,40,50,26,10,2,27,30,318,2016
Brandon Knight,SG,24,PHO,52,50,1870,371,895,.415,120,351,.342,251,544,.461,.482,156,183,.852,36,166,202,263,61,20,177,124,1018,2016
Kyle Korver,SG,34,ATL,80,80,2401,268,616,.435,158,397,.398,110,219,.502,.563,45,54,.833,14,246,260,164,60,35,98,161,739,2016
Kosta Koufos,C,26,SAC,78,14,1482,236,444,.532,0,0,.000,236,444,.532,.532,57,104,.548,169,254,423,33,40,70,48,185,529,2016
Jeremy Lamb,SG,23,CHO,66,0,1227,230,510,.451,56,181,.309,174,329,.529,.506,64,88,.727,44,208,252,77,42,30,50,105,580,2016
Carl Landry,PF,32,PHI,36,12,569,139,250,.556,6,13,.462,133,237,.561,.568,67,91,.736,49,97,146,32,12,9,22,69,351,2016
Shane Larkin,PG,23,BRK,78,17,1751,222,502,.442,39,108,.361,183,394,.464,.481,83,107,.776,28,152,180,342,95,12,146,121,566,2016
Joffrey Lauvergne,C,24,DEN,59,15,1041,195,380,.513,13,53,.245,182,327,.557,.530,62,69,.899,77,213,290,56,13,15,54,115,465,2016
Zach LaVine,SG,20,MIN,82,33,2294,433,959,.452,123,316,.389,310,643,.482,.516,161,203,.793,27,201,228,251,69,17,155,193,1150,2016
Ty Lawson,PG,28,TOT,66,13,1411,139,354,.393,36,108,.333,103,246,.419,.444,59,86,.686,26,94,120,237,53,7,95,87,373,2016
Ty Lawson,PG,28,HOU,53,12,1176,111,287,.387,31,94,.330,80,193,.415,.441,56,80,.700,20,69,89,180,43,6,82,71,309,2016
Ty Lawson,PG,28,IND,13,1,235,28,67,.418,5,14,.357,23,53,.434,.455,3,6,.500,6,25,31,57,10,1,13,16,64,2016
Courtney Lee,SG,30,TOT,79,65,2334,290,639,.454,82,217,.378,208,422,.493,.518,99,118,.839,29,176,205,136,85,28,72,134,761,2016
Courtney Lee,SG,30,MEM,51,37,1489,192,419,.458,51,138,.370,141,281,.502,.519,76,92,.826,19,99,118,76,52,16,49,79,511,2016
Courtney Lee,SG,30,CHO,28,28,845,98,220,.445,31,79,.392,67,141,.475,.516,23,26,.885,10,77,87,60,33,12,23,55,250,2016
David Lee,PF,32,TOT,55,5,903,178,335,.531,0,1,.000,178,334,.533,.531,71,93,.763,101,204,305,84,22,28,66,114,427,2016
David Lee,PF,32,BOS,30,4,470,87,192,.453,0,1,.000,87,191,.455,.453,40,51,.784,41,89,130,54,12,13,38,51,214,2016
David Lee,PF,32,DAL,25,1,433,91,143,.636,0,0,.000,91,143,.636,.636,31,42,.738,60,115,175,30,10,15,28,63,213,2016
Alex Len,C,22,PHO,78,46,1821,264,624,.423,1,7,.143,263,617,.426,.424,174,239,.728,178,416,594,97,38,62,145,230,703,2016
Kawhi Leonard,SF,24,SAS,72,72,2380,551,1090,.506,129,291,.443,422,799,.528,.565,292,334,.874,95,398,493,186,128,71,105,133,1523,2016
Meyers Leonard,PF,23,POR,61,10,1333,195,435,.448,86,228,.377,109,207,.527,.547,35,46,.761,51,263,314,92,8,18,77,183,511,2016
Jon Leuer,PF,26,PHO,67,27,1255,224,466,.481,42,110,.382,182,356,.511,.526,77,101,.762,76,297,373,72,38,30,75,125,567,2016
Damian Lillard,PG,25,POR,75,75,2676,618,1474,.419,229,610,.375,389,864,.450,.497,414,464,.892,45,257,302,512,65,28,242,165,1879,2016
Jeremy Lin,SG,27,CHO,78,13,2048,300,728,.412,76,226,.336,224,502,.446,.464,238,292,.815,42,211,253,235,58,42,150,165,914,2016
Shaun Livingston,PG,30,GSW,78,3,1520,203,379,.536,2,12,.167,201,367,.548,.538,80,93,.860,42,127,169,237,57,27,78,140,488,2016
Kevon Looney,PF,19,GSW,5,0,21,4,7,.571,1,2,.500,3,5,.600,.643,0,0,.000,4,6,10,0,0,0,1,2,9,2016
Brook Lopez,C,27,BRK,73,73,2457,591,1157,.511,2,14,.143,589,1143,.515,.512,317,403,.787,204,369,573,147,58,124,175,215,1501,2016
Robin Lopez,C,27,NYK,82,82,2219,357,662,.539,0,1,.000,357,661,.540,.539,128,161,.795,268,334,602,114,16,129,133,182,842,2016
Kevin Love,PF,27,CLE,77,77,2424,409,977,.419,158,439,.360,251,538,.467,.499,258,314,.822,149,613,762,186,58,41,142,159,1234,2016
Kyle Lowry,PG,29,TOR,77,77,2851,512,1198,.427,212,547,.388,300,651,.461,.516,398,491,.811,55,310,365,494,158,34,225,211,1634,2016
Trey Lyles,PF,20,UTA,80,33,1382,191,436,.438,49,128,.383,142,308,.461,.494,57,82,.695,59,240,299,59,26,18,65,114,488,2016
Shelvin Mack,PG,25,TOT,52,27,1058,182,415,.439,39,125,.312,143,290,.493,.486,45,61,.738,13,115,128,187,34,3,95,72,448,2016
Shelvin Mack,PG,25,ATL,24,0,179,40,95,.421,4,27,.148,36,68,.529,.442,9,12,.750,2,20,22,38,8,0,14,7,93,2016
Shelvin Mack,PG,25,UTA,28,27,879,142,320,.444,35,98,.357,107,222,.482,.498,36,49,.735,11,95,106,149,26,3,81,65,355,2016
Ian Mahinmi,C,29,IND,71,71,1816,264,448,.589,0,0,.000,264,448,.589,.589,132,225,.587,138,369,507,104,65,75,100,220,660,2016
Devyn Marble,SG,23,ORL,28,0,249,21,71,.296,8,32,.250,13,39,.333,.352,10,24,.417,6,32,38,12,13,1,7,25,60,2016
Boban Marjanovic,C,27,SAS,54,4,508,105,174,.603,0,0,.000,105,174,.603,.603,87,114,.763,73,121,194,21,12,23,29,54,297,2016
Kendall Marshall,PG,24,PHI,30,6,400,43,118,.364,16,49,.327,27,69,.391,.432,9,13,.692,2,26,28,73,16,2,43,30,111,2016
Jarell Martin,PF,21,MEM,27,0,380,54,116,.466,0,2,.000,54,114,.474,.466,45,62,.726,39,47,86,15,8,7,19,58,153,2016
Kevin Martin,SG,32,TOT,55,13,1095,156,419,.372,49,136,.360,107,283,.378,.431,153,172,.890,14,96,110,58,26,3,54,83,514,2016
Kevin Martin,SG,32,MIN,39,12,834,126,334,.377,38,103,.369,88,231,.381,.434,125,142,.880,10,71,81,46,17,1,41,68,415,2016
Kevin Martin,SG,32,SAS,16,1,261,30,85,.353,11,33,.333,19,52,.365,.418,28,30,.933,4,25,29,12,9,2,13,15,99,2016
Wesley Matthews,SF,29,DAL,78,78,2644,331,854,.388,189,525,.360,142,329,.432,.498,126,146,.863,27,211,238,151,78,17,78,179,977,2016
O.J. Mayo,SG,28,MIL,41,24,1090,119,321,.371,52,162,.321,67,159,.421,.452,31,40,.775,13,92,105,118,48,8,72,126,321,2016
Luc Mbah a Moute,PF,29,LAC,75,61,1274,94,207,.454,13,40,.325,81,167,.485,.486,30,57,.526,60,111,171,30,44,19,34,100,231,2016
James Michael McAdoo,PF,23,GSW,41,1,262,45,84,.536,1,2,.500,44,82,.537,.542,26,49,.531,30,28,58,17,10,8,16,39,117,2016
Ray McCallum,PG,24,TOT,41,6,475,55,146,.377,15,42,.357,40,104,.385,.428,12,15,.800,8,39,47,60,12,7,24,29,137,2016
Ray McCallum,PG,24,SAS,31,3,256,27,67,.403,5,16,.313,22,51,.431,.440,9,10,.900,6,25,31,33,5,4,11,14,68,2016
Ray McCallum,PG,24,MEM,10,3,219,28,79,.354,10,26,.385,18,53,.340,.418,3,5,.600,2,14,16,27,7,3,13,15,69,2016
C.J. McCollum,SG,24,POR,80,80,2780,641,1431,.448,197,472,.417,444,959,.463,.517,187,226,.827,47,212,259,341,97,23,196,187,1666,2016
T.J. McConnell,PG,23,PHI,81,17,1606,218,464,.470,31,89,.348,187,375,.499,.503,26,41,.634,43,207,250,367,95,10,140,114,493,2016
Chris McCullough,PF,20,BRK,24,4,362,44,109,.404,13,34,.382,31,75,.413,.463,11,23,.478,25,43,68,9,28,12,15,39,112,2016
K.J. McDaniels,SF,22,HOU,37,1,235,29,72,.403,7,25,.280,22,47,.468,.451,24,30,.800,16,26,42,10,7,6,17,30,89,2016
Doug McDermott,SF,24,CHI,81,4,1861,291,644,.452,110,259,.425,181,385,.470,.537,72,84,.857,37,158,195,59,14,6,53,127,764,2016
Mitch McGary,PF,23,OKC,20,0,72,11,23,.478,0,4,.000,11,19,.579,.478,4,10,.400,4,14,18,3,1,2,7,10,26,2016
JaVale McGee,C,28,DAL,34,2,370,77,134,.575,0,1,.000,77,133,.579,.575,18,36,.500,53,80,133,3,5,26,21,49,172,2016
Ben McLemore,SG,22,SAC,68,53,1443,195,455,.429,67,185,.362,128,270,.474,.502,74,103,.718,34,114,148,79,52,10,99,140,531,2016
Jordan McRae,PG,24,TOT,22,1,195,34,78,.436,10,22,.455,24,56,.429,.500,21,28,.750,4,16,20,25,3,1,15,17,99,2016
Jordan McRae,PG,24,PHO,7,0,82,11,26,.423,3,11,.273,8,15,.533,.481,12,15,.800,2,6,8,10,3,0,6,7,37,2016
Jordan McRae,PG,24,CLE,15,1,113,23,52,.442,7,11,.636,16,41,.390,.510,9,13,.692,2,10,12,15,0,1,9,10,62,2016
Josh McRoberts,PF,28,MIA,42,1,595,55,148,.372,12,49,.245,43,99,.434,.412,28,40,.700,22,83,105,81,18,7,30,68,150,2016
Jodie Meeks,SG,28,DET,3,0,43,7,20,.350,4,9,.444,3,11,.273,.450,4,4,1.000,1,4,5,3,0,0,1,2,22,2016
Salah Mejri,C,29,DAL,34,6,397,49,78,.628,0,1,.000,49,77,.636,.628,27,46,.587,41,82,123,10,8,36,23,54,125,2016
Jordan Mickey,PF,21,BOS,16,0,57,8,22,.364,0,0,.000,8,22,.364,.364,5,10,.500,6,7,13,1,0,11,1,5,21,2016
Khris Middleton,SG,24,MIL,79,79,2852,507,1142,.444,143,361,.396,364,781,.466,.507,277,312,.888,44,258,302,331,131,19,180,204,1434,2016
C.J. Miles,SF,28,IND,64,24,1464,259,634,.409,142,387,.367,117,247,.474,.521,93,124,.750,25,150,175,63,53,29,70,142,753,2016
Andre Miller,PG,39,TOT,39,4,461,59,106,.557,2,8,.250,57,98,.582,.566,24,32,.750,12,39,51,87,16,0,37,46,144,2016
Andre Miller,PG,39,MIN,26,0,280,36,58,.621,1,4,.250,35,54,.648,.629,15,19,.789,6,18,24,58,9,0,25,32,88,2016
Andre Miller,PG,39,SAS,13,4,181,23,48,.479,1,4,.250,22,44,.500,.490,9,13,.692,6,21,27,29,7,0,12,14,56,2016
Mike Miller,SF,35,DEN,47,2,373,22,62,.355,19,52,.365,3,10,.300,.508,0,0,.000,6,47,53,40,13,4,17,53,63,2016
Patty Mills,PG,27,SAS,81,3,1662,260,612,.425,123,320,.384,137,292,.469,.525,47,58,.810,27,131,158,226,59,6,76,102,690,2016
Elijah Millsap,SG,28,UTA,20,0,173,11,39,.282,1,12,.083,10,27,.370,.295,13,18,.722,6,29,35,19,7,3,9,33,36,2016
Paul Millsap,PF,30,ATL,81,81,2647,501,1066,.470,74,232,.319,427,834,.512,.505,309,408,.757,198,534,732,265,147,139,191,237,1385,2016
Nikola Mirotic,PF,24,CHI,66,38,1646,248,609,.407,135,346,.390,113,263,.430,.518,146,181,.807,58,304,362,100,58,46,102,151,777,2016
Nazr Mohammed,C,38,OKC,5,0,19,3,5,.600,0,0,.000,3,5,.600,.600,2,2,1.000,1,3,4,0,0,0,3,4,8,2016
Greg Monroe,C,25,MIL,79,67,2314,491,941,.522,0,1,.000,491,940,.522,.522,228,308,.740,218,478,696,178,72,67,129,163,1210,2016
Luis Montero,SG,22,POR,12,0,42,5,19,.263,1,9,.111,4,10,.400,.289,3,4,.750,0,4,4,1,0,0,4,1,14,2016
E'Twaun Moore,SG,26,CHI,59,22,1263,187,389,.481,47,104,.452,140,285,.491,.541,22,35,.629,19,114,133,99,37,18,53,103,443,2016
Eric Moreland,PF,24,SAC,8,0,48,3,6,.500,0,0,.000,3,6,.500,.500,2,4,.500,3,8,11,1,0,4,3,4,8,2016
Marcus Morris,SF,26,DET,80,80,2856,410,945,.434,108,298,.362,302,647,.467,.491,203,271,.749,91,313,404,201,67,23,140,170,1131,2016
Markieff Morris,PF,26,TOT,64,45,1629,305,718,.425,47,155,.303,258,563,.458,.458,108,147,.735,73,279,352,124,58,34,135,184,765,2016
Markieff Morris,PF,26,PHO,37,24,917,171,431,.397,22,76,.289,149,355,.420,.422,66,92,.717,43,151,194,87,33,17,90,104,430,2016
Markieff Morris,PF,26,WAS,27,21,712,134,287,.467,25,79,.316,109,208,.524,.510,42,55,.764,30,128,158,37,25,17,45,80,335,2016
Anthony Morrow,SG,30,OKC,68,6,926,136,333,.408,79,204,.387,57,129,.442,.527,29,39,.744,10,52,62,24,22,5,17,64,380,2016
Donatas Motiejunas,PF,25,HOU,37,22,547,90,205,.439,16,57,.281,74,148,.500,.478,34,53,.642,37,72,109,41,17,5,44,69,230,2016
Timofey Mozgov,C,29,CLE,76,48,1326,203,359,.565,1,7,.143,202,352,.574,.567,68,95,.716,110,227,337,33,22,57,71,159,475,2016
Emmanuel Mudiay,PG,19,DEN,68,66,2068,329,905,.364,74,232,.319,255,673,.379,.404,140,209,.670,32,200,232,372,65,35,217,141,872,2016
Shabazz Muhammad,SF,23,MIN,82,0,1682,317,681,.465,44,152,.289,273,529,.516,.498,185,242,.764,100,167,267,52,24,7,70,94,863,2016
Xavier Munford,SG,23,MEM,14,0,244,32,77,.416,9,23,.391,23,54,.426,.474,7,14,.500,3,28,31,22,13,3,15,25,80,2016
Mike Muscala,C,24,ATL,60,0,565,76,152,.500,12,39,.308,64,113,.566,.539,31,39,.795,38,79,117,34,13,27,27,72,195,2016
Larry Nance Jr.,PF,23,LAL,63,22,1266,158,300,.527,1,10,.100,157,290,.541,.528,32,47,.681,101,211,312,44,54,23,41,124,349,2016
Shabazz Napier,PG,24,ORL,55,0,600,68,201,.338,34,104,.327,34,97,.351,.423,33,45,.733,9,46,55,97,23,1,46,38,203,2016
Gary Neal,SG,31,WAS,40,2,807,151,325,.465,41,100,.410,110,225,.489,.528,47,55,.855,11,72,83,47,20,1,29,55,390,2016
Jameer Nelson,PG,33,DEN,39,15,1036,113,307,.368,43,144,.299,70,163,.429,.438,30,35,.857,19,96,115,190,25,5,66,100,299,2016
Raul Neto,PG,23,UTA,81,53,1499,180,418,.431,64,162,.395,116,256,.453,.507,52,70,.743,17,103,120,174,62,2,109,122,476,2016
Andrew Nicholson,PF,26,ORL,56,0,823,146,310,.471,41,114,.360,105,196,.536,.537,51,65,.785,34,167,201,25,10,22,41,69,384,2016
Joakim Noah,C,30,CHI,29,2,635,51,133,.383,0,1,.000,51,132,.386,.383,22,45,.489,87,168,255,110,18,29,52,77,124,2016
Nerlens Noel,C,21,PHI,67,62,1965,306,587,.521,1,2,.500,305,585,.521,.522,134,227,.590,154,388,542,122,118,100,158,192,747,2016
Lucas Nogueira,C,23,TOR,29,1,225,28,44,.636,1,3,.333,27,41,.659,.648,8,15,.533,18,28,46,7,12,12,11,29,65,2016
Steve Novak,PF,32,TOT,10,0,44,8,18,.444,7,15,.467,1,3,.333,.639,1,1,1.000,0,5,5,0,0,0,1,3,24,2016
Steve Novak,PF,32,OKC,7,0,24,6,12,.500,5,9,.556,1,3,.333,.708,0,0,.000,0,4,4,0,0,0,1,1,17,2016
Steve Novak,PF,32,MIL,3,0,20,2,6,.333,2,6,.333,0,0,.500,.000,1,1,1.000,0,1,1,0,0,0,0,2,7,2016
Dirk Nowitzki,PF,37,DAL,75,75,2364,498,1112,.448,126,342,.368,372,770,.483,.504,250,280,.893,52,437,489,132,52,52,84,161,1372,2016
Jusuf Nurkic,C,21,DEN,32,3,547,101,242,.417,0,3,.000,101,239,.423,.417,61,99,.616,65,110,175,40,24,44,55,91,263,2016
J.J. O'Brien,SF,23,UTA,2,0,6,0,1,.000,0,0,.000,0,1,.000,.000,0,0,.000,0,1,1,0,1,0,0,1,0,2016
Johnny O'Bryant,PF,22,MIL,66,4,857,86,209,.411,1,1,1.000,85,208,.409,.414,27,40,.675,65,111,176,32,18,8,31,100,200,2016
Kyle O'Quinn,PF,25,NYK,65,1,764,129,271,.476,5,22,.227,124,249,.498,.485,46,60,.767,76,174,250,72,20,49,61,107,309,2016
Jahlil Okafor,C,20,PHI,53,48,1591,397,781,.508,1,6,.167,396,775,.511,.509,133,194,.686,122,251,373,65,22,61,124,140,928,2016
Victor Oladipo,SG,23,ORL,72,52,2379,425,970,.438,98,282,.348,327,688,.475,.489,205,247,.830,48,297,345,282,116,54,153,174,1153,2016
Kelly Olynyk,C,24,BOS,69,8,1395,253,556,.455,85,210,.405,168,346,.486,.531,96,128,.750,72,209,281,105,52,33,74,163,687,2016
Kelly Oubre,SF,20,WAS,63,9,671,90,211,.427,25,79,.316,65,132,.492,.486,31,49,.633,25,108,133,13,22,7,34,100,236,2016
Zaza Pachulia,C,31,DAL,76,69,2004,219,470,.466,0,3,.000,219,467,.469,.466,212,276,.768,249,469,718,128,64,22,119,181,650,2016
Kostas Papanikolaou,SF,25,DEN,26,6,294,24,66,.364,10,32,.313,14,34,.412,.439,9,14,.643,8,32,40,16,13,5,21,24,67,2016
Jabari Parker,PF,20,MIL,76,72,2408,443,899,.493,9,35,.257,434,864,.502,.498,175,228,.768,123,272,395,130,69,29,116,154,1070,2016
Tony Parker,PG,33,SAS,72,72,1980,350,710,.493,27,65,.415,323,645,.501,.512,130,171,.760,17,159,176,379,54,11,131,114,857,2016
Chandler Parsons,SF,27,DAL,61,51,1799,320,651,.492,104,251,.414,216,400,.540,.571,93,136,.684,29,256,285,169,46,21,95,114,837,2016
Lamar Patterson,SG,24,ATL,35,0,395,28,80,.350,12,49,.245,16,31,.516,.425,16,22,.727,4,46,50,39,9,2,23,45,84,2016
Patrick Patterson,PF,26,TOR,79,0,2020,204,493,.414,106,293,.362,98,200,.490,.521,29,34,.853,77,265,342,94,53,32,65,128,543,2016
Chris Paul,PG,30,LAC,74,74,2420,515,1114,.462,122,329,.371,393,785,.501,.517,294,328,.896,39,271,310,738,152,13,194,185,1446,2016
Adreian Payne,PF,24,MIN,52,2,486,53,145,.366,9,32,.281,44,113,.389,.397,17,26,.654,20,91,111,29,16,11,36,77,132,2016
Cameron Payne,PG,21,OKC,57,1,698,114,278,.410,36,111,.324,78,167,.467,.475,19,24,.792,9,76,85,108,36,6,44,80,283,2016
Elfrid Payton,PG,21,ORL,73,69,2145,318,730,.436,30,92,.326,288,638,.451,.456,112,190,.589,77,184,261,468,89,20,177,159,778,2016
Nikola Pekovic,C,30,MIN,12,3,156,19,50,.380,0,0,.000,19,50,.380,.380,16,20,.800,7,14,21,11,1,0,9,22,54,2016
Kendrick Perkins,C,31,NOP,37,5,542,40,75,.533,0,0,.000,40,75,.533,.533,11,25,.440,25,103,128,31,11,11,41,64,91,2016
Paul Pierce,SF,38,LAC,68,38,1231,144,397,.363,75,242,.310,69,155,.445,.457,54,66,.818,12,174,186,71,33,17,58,129,417,2016
Tibor Pleiss,C,26,UTA,12,0,82,11,25,.440,0,2,.000,11,23,.478,.440,2,2,1.000,6,9,15,2,1,2,8,19,24,2016
Mason Plumlee,C,25,POR,82,82,2084,267,517,.516,0,4,.000,267,513,.520,.516,215,335,.642,201,427,628,226,68,85,154,253,749,2016
Miles Plumlee,C,27,MIL,61,14,870,140,233,.601,0,0,.000,140,233,.601,.601,34,59,.576,94,138,232,16,21,50,40,73,314,2016
Otto Porter,SF,22,WAS,75,73,2276,339,717,.473,98,267,.367,241,450,.536,.541,95,126,.754,97,294,391,120,105,32,70,163,871,2016
Bobby Portis,PF,20,CHI,62,4,1102,186,436,.427,16,52,.308,170,384,.443,.445,48,66,.727,123,214,337,52,25,22,54,100,436,2016
Kristaps Porzingis,PF,20,NYK,72,72,2047,373,886,.421,81,243,.333,292,643,.454,.467,201,240,.838,132,394,526,94,53,134,121,205,1028,2016
Dwight Powell,PF,24,DAL,69,2,992,146,296,.493,2,16,.125,144,280,.514,.497,105,142,.739,84,189,273,44,36,24,40,118,399,2016
Norman Powell,SG,22,TOR,49,24,725,97,229,.424,36,89,.404,61,140,.436,.502,43,53,.811,16,95,111,47,29,10,32,59,273,2016
Phil Pressey,PG,24,TOT,23,0,283,30,78,.385,4,18,.222,26,60,.433,.410,13,25,.520,3,28,31,75,18,4,33,28,77,2016
Phil Pressey,PG,24,PHI,14,0,170,21,55,.382,4,13,.308,17,42,.405,.418,9,18,.500,0,23,23,46,11,1,19,14,55,2016
Phil Pressey,PG,24,PHO,9,0,113,9,23,.391,0,5,.000,9,18,.500,.391,4,7,.571,3,5,8,29,7,3,14,14,22,2016
Ronnie Price,PG,32,PHO,62,18,1211,116,302,.384,68,196,.347,48,106,.453,.497,31,41,.756,25,74,99,147,74,13,70,161,331,2016
Pablo Prigioni,PG,38,LAC,59,3,823,55,147,.374,28,95,.295,27,52,.519,.469,7,8,.875,38,76,114,130,53,1,49,82,145,2016
Tayshaun Prince,SF,35,MIN,77,44,1462,102,229,.445,4,23,.174,98,206,.476,.454,13,19,.684,32,115,147,73,36,13,27,62,221,2016
Julius Randle,PF,21,LAL,81,60,2286,358,835,.429,10,36,.278,348,799,.436,.435,193,270,.715,172,657,829,144,53,29,149,242,919,2016
Zach Randolph,PF,34,MEM,68,53,2016,431,907,.475,6,26,.231,425,881,.482,.479,172,216,.796,179,350,529,142,43,13,105,146,1040,2016
J.J. Redick,SG,31,LAC,75,75,2097,422,880,.480,200,421,.475,222,459,.484,.593,182,205,.888,10,129,139,106,42,5,78,135,1226,2016
Willie Reed,C,25,BRK,39,2,426,76,133,.571,0,0,.000,76,133,.571,.571,30,55,.545,49,73,122,10,6,30,16,47,182,2016
Josh Richardson,SG,22,MIA,52,2,1107,123,272,.452,53,115,.461,70,157,.446,.550,42,63,.667,21,86,107,73,36,25,35,107,341,2016
Austin Rivers,SG,23,LAC,67,7,1464,226,516,.438,62,185,.335,164,331,.495,.498,79,116,.681,22,108,130,99,48,9,61,137,593,2016
Andre Roberson,SG,24,OKC,70,70,1553,136,274,.496,32,103,.311,104,171,.608,.555,33,54,.611,79,172,251,47,53,42,35,133,337,2016
Brian Roberts,PG,30,TOT,51,0,470,74,165,.448,15,42,.357,59,123,.480,.494,42,47,.894,6,35,41,54,10,2,23,35,205,2016
Brian Roberts,PG,30,CHO,30,0,333,51,115,.443,9,27,.333,42,88,.477,.483,34,37,.919,4,25,29,38,7,1,16,23,145,2016
Brian Roberts,PG,30,POR,21,0,137,23,50,.460,6,15,.400,17,35,.486,.520,8,10,.800,2,10,12,16,3,1,7,12,60,2016
Glenn Robinson,SF,22,IND,45,4,508,65,151,.430,14,37,.378,51,114,.447,.477,27,39,.692,12,56,68,26,17,9,18,21,171,2016
Nate Robinson,PG,31,NOP,2,1,23,0,1,.000,0,1,.000,0,0,.000,.000,0,0,.000,0,0,0,4,1,0,0,5,0,2016
Thomas Robinson,PF,24,BRK,71,7,917,130,291,.447,0,1,.000,130,290,.448,.447,47,109,.431,136,223,359,46,39,36,69,111,307,2016
Rajon Rondo,PG,29,SAC,72,72,2537,355,782,.454,62,170,.365,293,612,.479,.494,87,150,.580,77,358,435,839,141,10,278,175,859,2016
Derrick Rose,PG,27,CHI,66,66,2097,447,1048,.427,44,150,.293,403,898,.449,.448,142,179,.793,46,179,225,311,44,14,175,84,1080,2016
Terrence Ross,SF,24,TOR,73,7,1747,270,626,.431,131,339,.386,139,287,.484,.536,49,62,.790,21,164,185,56,54,25,46,120,720,2016
Terry Rozier,PG,21,BOS,39,0,311,29,106,.274,6,27,.222,23,79,.291,.302,8,10,.800,24,39,63,37,6,1,19,23,72,2016
Ricky Rubio,PG,25,MIN,76,76,2323,219,586,.374,62,190,.326,157,396,.396,.427,266,314,.847,40,286,326,658,162,10,193,201,766,2016
Damjan Rudez,SF,29,MIN,33,0,277,25,62,.403,17,50,.340,8,12,.667,.540,8,8,1.000,5,15,20,11,3,1,13,33,75,2016
Brandon Rush,SG,30,GSW,72,25,1055,111,260,.427,65,157,.414,46,103,.447,.552,18,28,.643,21,160,181,57,20,23,33,57,305,2016
D'Angelo Russell,PG,19,LAL,80,48,2259,392,956,.410,130,370,.351,262,586,.447,.478,140,190,.737,47,227,274,266,93,13,196,142,1054,2016
Robert Sacre,C,26,LAL,25,1,320,31,75,.413,0,0,.000,31,75,.413,.413,25,38,.658,32,40,72,14,4,10,12,43,87,2016
JaKarr Sampson,SF,22,TOT,73,40,1160,140,317,.442,14,63,.222,126,254,.496,.464,80,122,.656,46,144,190,46,23,33,70,142,374,2016
JaKarr Sampson,SF,22,PHI,47,18,691,86,202,.426,6,34,.176,80,168,.476,.441,62,97,.639,30,99,129,30,11,16,51,91,240,2016
JaKarr Sampson,SF,22,DEN,26,22,469,54,115,.470,8,29,.276,46,86,.535,.504,18,25,.720,16,45,61,16,12,17,19,51,134,2016
Dennis Schroder,PG,22,ATL,80,6,1621,329,781,.421,77,239,.322,252,542,.465,.471,144,182,.791,25,179,204,349,70,9,183,138,879,2016
Luis Scola,PF,35,TOR,76,76,1636,269,598,.450,65,161,.404,204,437,.467,.504,61,84,.726,84,276,360,66,46,27,68,178,664,2016
Mike Scott,PF,27,ATL,75,0,1146,176,376,.468,62,158,.392,114,218,.523,.551,50,63,.794,53,153,206,78,25,17,42,102,464,2016
Thabo Sefolosha,SF,31,ATL,75,11,1758,188,372,.505,42,124,.339,146,248,.589,.562,62,99,.626,52,282,334,107,85,37,68,109,480,2016
Kevin Seraphin,C,26,NYK,48,0,526,84,205,.410,0,2,.000,84,203,.414,.410,19,23,.826,31,95,126,47,8,36,43,67,187,2016
Ramon Sessions,PG,29,WAS,82,5,1667,280,592,.473,36,111,.324,244,481,.507,.503,214,283,.756,25,178,203,239,46,5,115,102,810,2016
Iman Shumpert,SG,25,CLE,54,5,1316,114,305,.374,43,146,.295,71,159,.447,.444,40,51,.784,32,171,203,92,54,19,57,119,311,2016
Jonathon Simmons,SG,26,SAS,55,2,813,122,242,.504,18,47,.383,104,195,.533,.541,69,92,.750,16,80,96,58,24,5,53,103,331,2016
Henry Sims,C,25,BRK,14,4,263,33,77,.429,0,0,.000,33,77,.429,.429,25,30,.833,21,51,72,9,9,14,12,37,91,2016
Kyle Singler,SF,27,OKC,68,2,977,86,221,.389,30,97,.309,56,124,.452,.457,29,44,.659,50,91,141,24,30,9,32,120,231,2016
Donald Sloan,PG,28,BRK,61,33,1318,154,350,.440,38,99,.384,116,251,.462,.494,78,104,.750,17,156,173,268,32,4,80,73,424,2016
Marcus Smart,PG,21,BOS,61,10,1667,184,529,.348,61,241,.253,123,288,.427,.405,129,166,.777,76,179,255,185,91,18,80,183,558,2016
Greg Smith,PF,25,MIN,18,0,192,18,32,.563,0,0,.000,18,32,.563,.563,7,17,.412,12,30,42,6,4,1,7,28,43,2016
Ish Smith,PG,27,TOT,77,53,2239,397,967,.411,56,170,.329,341,797,.428,.440,122,176,.693,43,262,305,502,88,24,175,133,972,2016
Ish Smith,PG,27,NOP,27,3,617,98,228,.430,10,33,.303,88,195,.451,.452,33,43,.767,14,78,92,154,24,6,45,38,239,2016
Ish Smith,PG,27,PHI,50,50,1622,299,739,.405,46,137,.336,253,602,.420,.436,89,133,.669,29,184,213,348,64,18,130,95,733,2016
J.R. Smith,SG,30,CLE,77,77,2362,353,850,.415,204,510,.400,149,340,.438,.535,45,71,.634,43,174,217,130,81,21,59,204,955,2016
Jason Smith,C,29,ORL,76,2,1181,244,503,.485,4,16,.250,240,487,.493,.489,54,67,.806,53,166,219,62,33,65,57,163,546,2016
Josh Smith,PF,30,TOT,55,7,880,127,349,.364,41,143,.287,86,206,.417,.423,37,67,.552,51,141,192,90,34,47,77,118,332,2016
Josh Smith,PF,30,LAC,32,1,459,69,180,.383,18,58,.310,51,122,.418,.433,25,42,.595,33,92,125,42,18,34,41,62,181,2016
Josh Smith,PF,30,HOU,23,6,421,58,169,.343,23,85,.271,35,84,.417,.411,12,25,.480,18,49,67,48,16,13,36,56,151,2016
Russ Smith,PG,24,MEM,15,0,66,7,22,.318,1,5,.200,6,17,.353,.341,8,13,.615,1,8,9,11,5,1,7,5,23,2016
Tony Snell,SF,24,CHI,64,33,1301,126,339,.372,56,155,.361,70,184,.380,.454,30,33,.909,19,180,199,63,16,17,52,100,338,2016
Marreese Speights,C,28,GSW,72,0,832,197,456,.432,24,62,.387,173,394,.439,.458,94,114,.825,77,162,239,61,19,34,66,117,512,2016
Tiago Splitter,C,31,ATL,36,2,579,81,155,.523,0,2,.000,81,153,.529,.523,39,48,.813,45,75,120,30,20,12,24,71,201,2016
Nik Stauskas,SG,22,PHI,73,35,1809,210,545,.385,106,325,.326,104,220,.473,.483,91,118,.771,23,160,183,138,44,20,94,115,617,2016
Lance Stephenson,SF,25,TOT,69,13,1372,228,474,.481,30,78,.385,198,396,.500,.513,87,111,.784,40,183,223,133,43,9,94,135,573,2016
Lance Stephenson,SF,25,LAC,43,10,680,82,166,.494,19,47,.404,63,119,.529,.551,21,30,.700,19,89,108,60,24,3,48,79,204,2016
Lance Stephenson,SF,25,MEM,26,3,692,146,308,.474,11,31,.355,135,277,.487,.492,66,81,.815,21,94,115,73,19,6,46,56,369,2016
Alex Stepheson,PF,28,TOT,8,0,73,9,27,.333,0,0,.000,9,27,.333,.333,4,12,.333,19,9,28,2,1,5,0,12,22,2016
Alex Stepheson,PF,28,LAC,4,0,12,1,1,1.000,0,0,.000,1,1,1.000,1.000,0,2,.000,1,1,2,0,0,2,0,4,2,2016
Alex Stepheson,PF,28,MEM,4,0,61,8,26,.308,0,0,.000,8,26,.308,.308,4,10,.400,18,8,26,2,1,3,0,8,20,2016
Jarnell Stokes,C,22,TOT,7,0,18,3,5,.600,0,0,.000,3,5,.600,.600,1,2,.500,1,3,4,1,1,0,0,1,7,2016
Jarnell Stokes,C,22,MEM,2,0,4,0,0,.000,0,0,.000,0,0,.000,.000,0,0,.000,1,1,2,0,0,0,0,0,0,2016
Jarnell Stokes,C,22,MIA,5,0,14,3,5,.600,0,0,.000,3,5,.600,.600,1,2,.500,0,2,2,1,1,0,0,1,7,2016
Amar'e Stoudemire,C,33,MIA,52,36,762,125,221,.566,0,0,.000,125,221,.566,.566,50,67,.746,65,157,222,27,18,41,47,92,300,2016
Rodney Stuckey,PG,29,IND,58,1,1275,183,443,.413,20,83,.241,163,360,.453,.436,131,158,.829,19,137,156,142,43,8,76,77,517,2016
Jared Sullinger,PF,23,BOS,81,73,1915,351,806,.435,29,103,.282,322,703,.458,.453,103,161,.640,194,479,673,187,75,47,102,209,834,2016
Walter Tavares,C,23,ATL,11,0,73,11,19,.579,0,0,.000,11,19,.579,.579,3,8,.375,7,14,21,3,1,6,5,8,25,2016
Jeff Teague,PG,27,ATL,79,78,2255,434,988,.439,110,275,.400,324,713,.454,.495,261,312,.837,33,181,214,470,97,24,218,167,1239,2016
Mirza Teletovic,PF,30,PHO,79,1,1686,332,777,.427,181,460,.393,151,317,.476,.544,120,155,.774,55,247,302,89,32,21,84,159,965,2016
Garrett Temple,SF,29,WAS,80,43,1951,201,505,.398,89,258,.345,112,247,.453,.486,91,125,.728,36,176,212,140,69,18,64,195,582,2016
Jason Terry,SG,38,HOU,72,7,1258,151,376,.402,93,261,.356,58,115,.504,.525,27,33,.818,14,65,79,103,47,9,49,91,422,2016
Isaiah Thomas,PG,26,BOS,82,79,2644,591,1382,.428,167,465,.359,424,917,.462,.488,474,544,.871,46,197,243,509,91,9,220,167,1823,2016
Lance Thomas,PF,27,NYK,59,5,1313,169,382,.442,44,109,.404,125,273,.458,.500,102,119,.857,34,97,131,53,22,7,57,109,484,2016
Hollis Thompson,SG,24,PHI,77,17,2154,270,680,.397,149,392,.380,121,288,.420,.507,69,96,.719,54,218,272,99,36,24,76,187,758,2016
Jason Thompson,C,29,TOT,47,7,471,52,108,.481,5,15,.333,47,93,.505,.505,38,54,.704,32,102,134,29,12,20,15,80,147,2016
Jason Thompson,C,29,GSW,28,1,179,20,42,.476,0,0,.000,20,42,.476,.476,20,32,.625,10,44,54,19,4,8,7,40,60,2016
Jason Thompson,C,29,TOR,19,6,292,32,66,.485,5,15,.333,27,51,.529,.523,18,22,.818,22,58,80,10,8,12,8,40,87,2016
Klay Thompson,SG,25,GSW,80,80,2666,651,1386,.470,276,650,.425,375,736,.510,.569,193,221,.873,35,271,306,166,60,49,138,152,1771,2016
Tristan Thompson,PF,24,CLE,82,34,2269,247,420,.588,0,0,.000,247,420,.588,.588,149,242,.616,268,470,738,62,38,51,61,202,643,2016
Marcus Thornton,SG,28,TOT,61,8,1109,216,542,.399,91,270,.337,125,272,.460,.482,67,79,.848,38,112,150,85,47,4,51,90,590,2016
Marcus Thornton,SG,28,HOU,47,6,885,174,435,.400,73,216,.338,101,219,.461,.484,51,58,.879,31,84,115,66,34,3,40,73,472,2016
Marcus Thornton,SG,28,WAS,14,2,224,42,107,.393,18,54,.333,24,53,.453,.477,16,21,.762,7,28,35,19,13,1,11,17,118,2016
Anthony Tolliver,PF,30,DET,72,5,1341,128,332,.386,98,272,.360,30,60,.500,.533,29,47,.617,39,190,229,52,26,16,28,86,383,2016
Axel Toupane,SF,23,DEN,21,0,305,25,70,.357,13,40,.325,12,30,.400,.450,13,17,.765,8,23,31,15,7,6,6,40,76,2016
Karl-Anthony Towns,C,20,MIN,82,82,2627,625,1153,.542,30,88,.341,595,1065,.559,.555,223,275,.811,229,629,858,161,58,138,183,245,1503,2016
P.J. Tucker,SF,30,PHO,82,80,2540,239,582,.411,68,206,.330,171,376,.455,.469,106,142,.746,165,347,512,177,106,20,111,202,652,2016
Evan Turner,SG,27,BOS,81,12,2271,343,753,.456,20,83,.241,323,670,.482,.469,148,179,.827,50,347,397,359,80,28,169,139,854,2016
Myles Turner,C,19,IND,60,30,1367,264,530,.498,3,14,.214,261,516,.506,.501,88,121,.727,68,264,332,41,25,86,67,158,619,2016
Beno Udrih,PG,33,TOT,44,5,707,86,198,.434,15,44,.341,71,154,.461,.472,18,20,.900,8,64,72,116,14,1,53,51,205,2016
Beno Udrih,PG,33,MEM,8,0,120,20,46,.435,4,11,.364,16,35,.457,.478,3,3,1.000,2,7,9,26,3,1,11,11,47,2016
Beno Udrih,PG,33,MIA,36,5,587,66,152,.434,11,33,.333,55,119,.462,.470,15,17,.882,6,57,63,90,11,0,42,40,158,2016
Jonas Valanciunas,C,23,TOR,60,59,1557,303,536,.565,0,0,.000,303,536,.565,.565,162,213,.761,184,363,547,42,25,80,85,158,768,2016
Anderson Varejao,C,33,TOT,53,0,496,53,124,.427,0,1,.000,53,123,.431,.427,32,50,.640,37,104,141,35,16,10,22,70,138,2016
Anderson Varejao,C,33,CLE,31,0,310,32,76,.421,0,1,.000,32,75,.427,.421,16,21,.762,24,67,91,20,11,5,16,35,80,2016
Anderson Varejao,C,33,GSW,22,0,186,21,48,.438,0,0,.000,21,48,.438,.438,16,29,.552,13,37,50,15,5,5,6,35,58,2016
Greivis Vasquez,PG,29,MIL,23,0,460,45,138,.326,18,73,.247,27,65,.415,.391,22,26,.846,5,42,47,91,10,0,40,42,130,2016
Rashad Vaughn,SG,19,MIL,70,6,1001,81,266,.305,43,147,.293,38,119,.319,.385,12,15,.800,11,77,88,39,29,16,28,73,217,2016
Charlie Villanueva,PF,31,DAL,62,4,665,125,327,.382,47,172,.273,78,155,.503,.454,22,24,.917,24,128,152,24,18,15,31,71,319,2016
Noah Vonleh,PF,20,POR,78,56,1174,117,278,.421,11,46,.239,106,232,.457,.441,38,51,.745,91,214,305,30,27,26,50,152,283,2016
Nikola Vucevic,C,25,ORL,65,60,2037,533,1046,.510,2,9,.222,531,1037,.512,.511,113,150,.753,174,402,576,179,53,70,123,173,1181,2016
Sasha Vujacic,SG,31,NYK,61,25,908,106,277,.383,52,143,.364,54,134,.403,.477,32,39,.821,26,123,149,84,34,5,44,83,296,2016
Dwyane Wade,SG,34,MIA,74,73,2258,540,1183,.456,7,44,.159,533,1139,.468,.459,322,406,.793,82,220,302,344,79,42,203,116,1409,2016
Dion Waiters,SG,24,OKC,78,15,2152,282,706,.399,86,240,.358,196,466,.421,.460,112,157,.713,36,166,202,154,81,15,120,143,762,2016
Kemba Walker,PG,25,CHO,81,81,2885,568,1331,.427,182,490,.371,386,841,.459,.495,371,438,.847,56,301,357,421,126,39,171,111,1689,2016
John Wall,PG,25,WAS,77,77,2784,572,1349,.424,115,328,.351,457,1021,.448,.467,272,344,.791,42,337,379,789,145,59,318,159,1531,2016
T.J. Warren,SF,22,PHO,47,4,1070,221,441,.501,28,70,.400,193,371,.520,.533,45,64,.703,57,90,147,44,37,16,32,94,515,2016
C.J. Watson,PG,31,ORL,33,2,656,47,137,.343,14,48,.292,33,89,.371,.394,34,39,.872,10,56,66,88,19,5,25,49,142,2016
Briante Weber,PG,23,TOT,7,4,169,14,39,.359,0,5,.000,14,34,.412,.359,3,4,.750,8,17,25,21,9,3,9,12,31,2016
Briante Weber,PG,23,MEM,6,4,166,13,38,.342,0,5,.000,13,33,.394,.342,3,4,.750,8,16,24,20,9,3,9,11,29,2016
Briante Weber,PG,23,MIA,1,0,3,1,1,1.000,0,0,.000,1,1,1.000,1.000,0,0,.000,0,1,1,1,0,0,0,1,2,2016
Sonny Weems,SG-SF,29,TOT,43,0,499,42,110,.382,15,41,.366,27,69,.391,.450,8,15,.533,7,46,53,49,10,1,41,47,107,2016
Sonny Weems,SG,29,PHO,36,0,421,35,89,.393,13,32,.406,22,57,.386,.466,7,13,.538,6,35,41,47,10,1,37,40,90,2016
Sonny Weems,SF,29,PHI,7,0,78,7,21,.333,2,9,.222,5,12,.417,.381,1,2,.500,1,11,12,2,0,0,4,7,17,2016
David West,PF,35,SAS,78,19,1404,244,448,.545,3,7,.429,241,441,.546,.548,63,80,.788,72,237,309,143,44,55,68,142,554,2016
Russell Westbrook,PG,27,OKC,80,80,2750,656,1444,.454,101,341,.296,555,1103,.503,.489,465,573,.812,145,481,626,834,163,20,342,200,1878,2016
Hassan Whiteside,C,26,MIA,73,43,2125,413,682,.606,0,0,.000,413,682,.606,.606,214,329,.650,238,627,865,30,44,269,137,201,1040,2016
Shayne Whittington,PF,24,IND,7,0,41,5,11,.455,0,2,.000,5,9,.556,.455,1,2,.500,5,7,12,3,1,1,5,7,11,2016
Andrew Wiggins,SF,20,MIN,81,81,2845,594,1294,.459,57,190,.300,537,1104,.486,.481,430,565,.761,105,186,291,164,78,46,182,165,1675,2016
C.J. Wilcox,SG,25,LAC,23,0,167,26,66,.394,9,23,.391,17,43,.395,.462,9,12,.750,1,11,12,10,10,2,2,15,70,2016
Alan Williams,PF,23,PHO,10,0,68,10,24,.417,0,0,.000,10,24,.417,.417,9,14,.643,14,24,38,5,4,5,6,15,29,2016
Deron Williams,PG,31,DAL,65,63,2106,321,775,.414,97,282,.344,224,493,.454,.477,179,206,.869,19,171,190,378,61,14,150,155,918,2016
Derrick Williams,SF,24,NYK,80,9,1435,254,565,.450,44,150,.293,210,415,.506,.488,194,256,.758,47,249,296,75,29,9,61,69,746,2016
Elliot Williams,PG,26,MEM,5,0,45,2,10,.200,1,4,.250,1,6,.167,.250,3,4,.750,1,3,4,4,0,0,1,2,8,2016
Lou Williams,SG,29,LAL,67,35,1907,283,693,.408,110,320,.344,173,373,.464,.488,352,424,.830,31,138,169,167,62,19,107,107,1028,2016
Marvin Williams,PF,29,CHO,81,81,2338,338,747,.452,152,378,.402,186,369,.504,.554,120,144,.833,127,394,521,110,58,77,62,133,948,2016
Mo Williams,PG,33,CLE,41,14,748,132,302,.437,36,102,.353,96,200,.480,.497,38,42,.905,6,66,72,98,14,5,57,60,338,2016
Justise Winslow,SF,19,MIA,78,8,2232,195,462,.422,32,116,.276,163,346,.471,.457,80,117,.684,81,322,403,117,68,26,95,184,502,2016
Jeff Withey,C,25,UTA,51,10,658,87,162,.537,0,2,.000,87,160,.544,.537,43,59,.729,56,117,173,20,21,53,28,75,217,2016
Christian Wood,PF,20,PHI,17,0,145,22,53,.415,4,11,.364,18,42,.429,.453,13,21,.619,13,25,38,3,5,7,2,11,61,2016
Metta World Peace,SF,36,LAL,35,5,590,55,177,.311,26,84,.310,29,93,.312,.384,40,57,.702,19,70,89,27,22,11,15,67,176,2016
Brandan Wright,PF,28,MEM,12,2,212,35,52,.673,0,0,.000,35,52,.673,.673,13,24,.542,14,29,43,6,5,15,10,21,83,2016
Delon Wright,PG,23,TOR,27,1,229,36,80,.450,5,13,.385,31,67,.463,.481,26,35,.743,8,29,37,31,8,3,16,7,103,2016
Tony Wroten,PG,22,PHI,8,3,144,22,65,.338,3,17,.176,19,48,.396,.362,20,37,.541,2,19,21,20,3,0,29,11,67,2016
James Young,SG,20,BOS,29,0,199,11,36,.306,6,26,.231,5,10,.500,.389,1,4,.250,4,22,26,9,6,1,5,17,29,2016
Joe Young,PG,23,IND,41,0,384,62,169,.367,10,46,.217,52,123,.423,.396,20,25,.800,6,44,50,65,15,0,33,30,154,2016
Nick Young,SG,30,LAL,54,2,1033,126,372,.339,77,237,.325,49,135,.363,.442,63,76,.829,14,83,97,34,23,7,30,50,392,2016
Thaddeus Young,PF,27,BRK,73,73,2407,495,963,.514,7,30,.233,488,933,.523,.518,105,163,.644,176,484,660,135,112,37,136,182,1102,2016
Cody Zeller,C,23,CHO,73,60,1774,231,437,.529,1,10,.100,230,427,.539,.530,175,232,.754,138,317,455,71,57,63,68,204,638,2016
Tyler Zeller,C,26,BOS,60,3,710,138,290,.476,0,0,.000,138,290,.476,.476,88,108,.815,62,116,178,29,10,22,46,97,364,2016
Quincy Acy,PF,24,NYK,68,22,1287,152,331,.459,18,60,.300,134,271,.494,.486,76,97,.784,79,222,301,68,27,22,60,147,398,2015
Jordan Adams,SG,20,MEM,30,0,248,35,86,.407,10,25,.400,25,61,.410,.465,14,23,.609,9,19,28,16,16,7,14,24,94,2015
Steven Adams,C,21,OKC,70,67,1771,217,399,.544,0,2,.000,217,397,.547,.544,103,205,.502,199,324,523,66,38,86,99,222,537,2015
Jeff Adrien,PF,28,MIN,17,0,215,19,44,.432,0,0,.000,19,44,.432,.432,22,38,.579,23,54,77,15,4,9,9,30,60,2015
Arron Afflalo,SG,29,TOT,78,72,2502,375,884,.424,118,333,.354,257,551,.466,.491,167,198,.843,27,220,247,129,41,7,116,167,1035,2015
Arron Afflalo,SG,29,DEN,53,53,1750,281,657,.428,82,243,.337,199,414,.481,.490,127,151,.841,21,159,180,101,32,5,83,108,771,2015
Arron Afflalo,SG,29,POR,25,19,752,94,227,.414,36,90,.400,58,137,.423,.493,40,47,.851,6,61,67,28,9,2,33,59,264,2015
Alexis Ajinca,C,26,NOP,68,8,957,181,329,.550,0,0,.000,181,329,.550,.550,81,99,.818,104,211,315,47,21,51,69,151,443,2015
Furkan Aldemir,PF,23,PHI,41,9,540,40,78,.513,0,5,.000,40,73,.548,.513,13,27,.481,78,98,176,28,17,16,17,96,93,2015
Cole Aldrich,C,26,NYK,61,16,976,144,301,.478,0,0,.000,144,301,.478,.478,50,64,.781,101,237,338,75,37,65,59,122,338,2015
LaMarcus Aldridge,PF,29,POR,71,71,2512,659,1415,.466,37,105,.352,622,1310,.475,.479,306,362,.845,177,549,726,124,48,68,122,125,1661,2015
Lavoy Allen,C,25,IND,63,0,1070,141,299,.472,0,0,.000,141,299,.472,.472,33,47,.702,123,200,323,73,15,42,40,102,315,2015
Tony Allen,SG,33,MEM,63,41,1648,225,455,.495,10,29,.345,215,426,.505,.505,79,126,.627,103,177,280,86,129,30,86,166,539,2015
Al-Farouq Aminu,SF,24,DAL,74,3,1366,147,357,.412,34,124,.274,113,233,.485,.459,84,118,.712,114,228,342,59,70,62,55,137,412,2015
Lou Amundson,PF,32,TOT,53,35,937,109,255,.427,0,1,.000,109,254,.429,.427,41,87,.471,94,174,268,70,22,52,62,126,259,2015
Lou Amundson,PF,32,CLE,12,0,79,4,12,.333,0,0,.000,4,12,.333,.333,3,5,.600,5,15,20,5,1,0,5,11,11,2015
Lou Amundson,PF,32,NYK,41,35,858,105,243,.432,0,1,.000,105,242,.434,.432,38,82,.463,89,159,248,65,21,52,57,115,248,2015
Chris Andersen,C,36,MIA,60,20,1132,120,207,.580,4,13,.308,116,194,.598,.589,76,114,.667,76,223,299,43,26,61,40,88,320,2015
Alan Anderson,SG,32,BRK,74,19,1744,195,440,.443,73,210,.348,122,230,.530,.526,82,101,.812,31,173,204,83,56,5,60,148,545,2015
Kyle Anderson,SF,21,SAS,33,8,358,31,89,.348,3,11,.273,28,78,.359,.365,9,14,.643,5,67,72,28,15,7,10,28,74,2015
Ryan Anderson,PF,26,NOP,61,5,1675,291,729,.399,122,359,.340,169,370,.457,.483,129,151,.854,108,187,295,55,33,20,62,113,833,2015
Giannis Antetokounmpo,SG,20,MIL,81,71,2541,383,780,.491,7,44,.159,376,736,.511,.496,257,347,.741,100,442,542,207,73,85,173,254,1030,2015
Carmelo Anthony,SF,30,NYK,40,40,1428,358,806,.444,61,179,.341,297,627,.474,.482,189,237,.797,72,192,264,122,40,17,89,87,966,2015
Joel Anthony,C,32,DET,49,0,406,36,62,.581,0,0,.000,36,62,.581,.581,15,22,.682,32,61,93,5,12,49,12,55,87,2015
Pero Antic,C,32,ATL,63,3,1037,108,296,.365,52,173,.301,56,123,.455,.453,88,123,.715,58,131,189,49,18,14,49,132,356,2015
Trevor Ariza,SF,29,HOU,82,82,2930,366,910,.402,194,555,.350,172,355,.485,.509,122,143,.853,77,382,459,209,152,17,141,186,1048,2015
Darrell Arthur,PF,26,DEN,58,4,988,155,384,.404,26,110,.236,129,274,.471,.438,46,59,.780,53,118,171,57,48,26,47,146,382,2015
Omer Asik,C,28,NOP,76,76,1982,213,412,.517,0,0,.000,213,412,.517,.517,131,225,.582,244,504,748,72,29,54,95,144,557,2015
D.J. Augustin,PG,27,TOT,82,14,1964,258,647,.399,83,246,.337,175,401,.436,.463,178,205,.868,20,141,161,353,49,3,145,93,777,2015
D.J. Augustin,PG,27,DET,54,13,1287,189,461,.410,49,150,.327,140,311,.450,.463,147,169,.870,13,87,100,265,33,2,110,61,574,2015
D.J. Augustin,PG,27,OKC,28,1,677,69,186,.371,34,96,.354,35,90,.389,.462,31,36,.861,7,54,61,88,16,1,35,32,203,2015
Jeff Ayres,PF,27,SAS,51,0,383,55,95,.579,0,0,.000,55,95,.579,.579,27,36,.750,37,80,117,14,8,8,26,60,137,2015
Luke Babbitt,SF,25,NOP,63,19,830,92,192,.479,59,115,.513,33,77,.429,.633,13,19,.684,12,99,111,24,17,11,26,63,256,2015
Cameron Bairstow,PF,24,CHI,18,1,64,3,14,.214,0,0,.000,3,14,.214,.214,4,5,.800,6,2,8,1,2,1,3,8,10,2015
Leandro Barbosa,SG,32,GSW,66,1,982,183,386,.474,43,112,.384,140,274,.511,.530,58,74,.784,23,68,91,99,41,8,44,87,467,2015
J.J. Barea,PG,30,DAL,77,10,1362,225,536,.420,54,167,.323,171,369,.463,.470,76,94,.809,23,111,134,263,33,1,70,104,580,2015
Andrea Bargnani,C,29,NYK,29,22,785,164,361,.454,15,41,.366,149,320,.466,.475,87,107,.813,32,95,127,46,2,27,42,53,430,2015
Harrison Barnes,SF,22,GSW,82,82,2318,316,656,.482,87,215,.405,229,441,.519,.548,108,150,.720,117,336,453,116,61,19,71,146,827,2015
Matt Barnes,SF,34,LAC,76,74,2271,277,624,.444,136,376,.362,141,248,.569,.553,74,95,.779,51,251,302,114,67,50,87,240,764,2015
Earl Barron,C,33,PHO,16,1,143,12,39,.308,2,4,.500,10,35,.286,.333,6,12,.500,14,14,28,5,4,2,5,26,32,2015
Will Barton,SG,24,TOT,58,0,983,150,353,.425,23,85,.271,127,268,.474,.458,74,94,.787,26,136,162,81,48,19,61,70,397,2015
Will Barton,SG,24,POR,30,0,300,38,100,.380,4,18,.222,34,82,.415,.400,10,15,.667,3,31,34,27,14,4,17,20,90,2015
Will Barton,SG,24,DEN,28,0,683,112,253,.443,19,67,.284,93,186,.500,.480,64,79,.810,23,105,128,54,34,15,44,50,307,2015
Brandon Bass,PF,29,BOS,82,43,1929,344,683,.504,9,32,.281,335,651,.515,.510,169,214,.790,139,259,398,104,41,32,83,140,866,2015
Nicolas Batum,SF,26,POR,71,71,2380,240,600,.400,100,309,.324,140,291,.481,.483,84,98,.857,62,354,416,341,78,40,132,106,664,2015
Jerryd Bayless,PG,26,MIL,77,4,1717,220,516,.426,37,120,.308,183,396,.462,.462,121,137,.883,22,189,211,233,59,12,133,163,598,2015
Aron Baynes,C,28,SAS,70,17,1122,185,327,.566,1,4,.250,184,323,.570,.567,90,104,.865,109,209,318,35,16,22,65,162,461,2015
Kent Bazemore,SG,25,ATL,75,10,1324,141,331,.426,48,132,.364,93,199,.467,.498,60,100,.600,21,201,222,78,52,33,73,127,390,2015
Bradley Beal,SG,21,WAS,63,59,2107,363,851,.427,106,259,.409,257,592,.434,.489,130,166,.783,57,184,241,194,76,18,123,136,962,2015
Michael Beasley,PF,26,MIA,24,1,505,92,212,.434,8,34,.235,84,178,.472,.453,20,26,.769,12,77,89,32,15,13,37,66,212,2015
Marco Belinelli,SG,28,SAS,62,9,1388,199,470,.423,86,230,.374,113,240,.471,.515,84,99,.848,26,131,157,94,31,3,61,85,568,2015
Jerrelle Benimon,PF,23,UTA,2,0,3,0,0,.000,0,0,.000,0,0,.000,.000,0,0,.000,1,2,3,0,0,0,1,0,0,2015
Anthony Bennett,PF,21,MIN,57,3,894,125,297,.421,7,23,.304,118,274,.431,.433,41,64,.641,52,164,216,48,27,16,36,87,298,2015
Patrick Beverley,PG,26,HOU,56,55,1727,204,532,.383,115,323,.356,89,209,.426,.492,45,60,.750,67,170,237,192,59,23,83,182,568,2015
Sim Bhullar,C,22,SAC,3,0,3,1,2,.500,0,0,.000,1,2,.500,.500,0,0,.000,0,1,1,1,0,1,0,0,2,2015
Bismack Biyombo,C,22,CHO,64,21,1243,101,186,.543,0,0,.000,101,186,.543,.543,102,175,.583,159,248,407,16,18,99,52,140,304,2015
Tarik Black,C,23,TOT,63,39,1196,157,273,.575,0,1,.000,157,272,.577,.575,65,118,.551,142,226,368,42,19,24,48,158,379,2015
Tarik Black,C,23,HOU,25,12,393,45,83,.542,0,1,.000,45,82,.549,.542,15,29,.517,58,69,127,8,6,2,19,56,105,2015
Tarik Black,C,23,LAL,38,27,803,112,190,.589,0,0,.000,112,190,.589,.589,50,89,.562,84,157,241,34,13,22,29,102,274,2015
DeJuan Blair,PF,25,WAS,29,0,180,26,57,.456,0,0,.000,26,57,.456,.456,4,6,.667,16,40,56,3,7,1,13,41,56,2015
Steve Blake,PG,34,POR,81,0,1529,122,327,.373,77,219,.352,45,108,.417,.491,29,41,.707,16,121,137,288,41,5,104,118,350,2015
Eric Bledsoe,PG,25,PHO,81,81,2800,468,1046,.447,88,272,.324,380,774,.491,.489,353,441,.800,72,351,423,493,127,45,274,189,1377,2015
Vander Blue,SG,22,LAL,2,1,74,9,30,.300,2,10,.200,7,20,.350,.333,2,5,.400,2,7,9,8,3,0,6,4,22,2015
Bojan Bogdanovic,SF,25,BRK,78,28,1854,261,576,.453,91,256,.355,170,320,.531,.532,87,106,.821,50,163,213,68,34,9,78,104,700,2015
Andrew Bogut,C,30,GSW,67,65,1583,200,355,.563,0,0,.000,200,355,.563,.563,22,42,.524,141,402,543,180,39,113,106,188,422,2015
Matt Bonner,PF,34,SAS,72,19,935,94,230,.409,46,126,.365,48,104,.462,.509,30,37,.811,29,86,115,47,10,12,11,65,264,2015
Trevor Booker,PF,27,UTA,79,5,1564,226,464,.487,29,84,.345,197,380,.518,.518,86,148,.581,139,258,397,83,43,41,88,144,567,2015
Carlos Boozer,PF,33,LAL,71,26,1692,371,743,.499,0,0,.000,371,743,.499,.499,94,150,.627,111,371,482,95,41,12,92,184,836,2015
Chris Bosh,C,30,MIA,44,44,1556,343,745,.460,63,168,.375,280,577,.485,.503,179,232,.772,46,264,310,95,41,25,95,69,928,2015
Avery Bradley,SG,24,BOS,77,77,2428,434,1012,.429,124,352,.352,310,660,.470,.490,79,100,.790,46,195,241,135,82,15,109,177,1071,2015
Elton Brand,C,35,ATL,36,4,486,42,95,.442,0,1,.000,42,94,.447,.442,12,23,.522,28,72,100,22,17,25,18,54,96,2015
Corey Brewer,SF,28,TOT,80,17,2087,343,805,.426,63,235,.268,280,570,.491,.465,168,226,.743,80,217,297,173,114,19,131,173,917,2015
Corey Brewer,SF,28,MIN,24,16,680,94,225,.418,8,41,.195,86,184,.467,.436,55,78,.705,32,62,94,78,54,4,50,62,251,2015
Corey Brewer,SF,28,HOU,56,1,1407,249,580,.429,55,194,.284,194,386,.503,.477,113,148,.764,48,155,203,95,60,15,81,111,666,2015
Aaron Brooks,PG,30,CHI,82,21,1885,344,817,.421,121,313,.387,223,504,.442,.495,145,174,.833,32,134,166,261,54,15,157,189,954,2015
Jabari Brown,SG,22,LAL,19,5,568,70,170,.412,23,62,.371,47,108,.435,.479,64,85,.753,3,33,36,40,12,2,32,33,227,2015
Lorenzo Brown,PG,24,MIN,29,7,549,52,122,.426,6,28,.214,46,94,.489,.451,12,19,.632,14,56,70,90,28,6,30,49,122,2015
Markel Brown,SG,23,BRK,47,29,781,76,210,.362,17,64,.266,59,146,.404,.402,47,57,.825,16,91,107,39,31,12,27,57,216,2015
Shannon Brown,SG,29,MIA,5,2,89,7,19,.368,3,7,.429,4,12,.333,.447,3,4,.750,0,1,1,3,4,0,4,8,20,2015
Kobe Bryant,SG,36,LAL,35,35,1207,266,713,.373,54,184,.293,212,529,.401,.411,196,241,.813,26,173,199,197,47,7,128,65,782,2015
Chase Budinger,SF,26,MIN,67,4,1286,169,390,.433,52,143,.364,117,247,.474,.500,67,81,.827,33,165,198,64,44,10,49,72,457,2015
Reggie Bullock,SF,23,TOT,36,2,338,24,70,.343,15,46,.326,9,24,.375,.450,6,9,.667,1,49,50,8,10,4,8,19,69,2015
Reggie Bullock,SF,23,LAC,25,2,263,23,54,.426,15,39,.385,8,15,.533,.565,4,5,.800,0,40,40,6,9,2,6,17,65,2015
Reggie Bullock,SF,23,PHO,11,0,75,1,16,.063,0,7,.000,1,9,.111,.063,2,4,.500,1,9,10,2,1,2,2,2,4,2015
Trey Burke,PG,22,UTA,76,43,2288,370,1005,.368,124,390,.318,246,615,.400,.430,109,145,.752,31,173,204,328,65,15,124,119,973,2015
Alec Burks,SG,23,UTA,27,27,899,121,300,.403,26,68,.382,95,232,.409,.447,106,129,.822,19,95,114,82,17,5,52,64,374,2015
Caron Butler,SF,34,DET,78,21,1623,161,396,.407,83,219,.379,78,177,.441,.511,55,61,.902,21,175,196,79,43,4,49,120,460,2015
Jimmy Butler,SG,25,CHI,65,65,2513,421,912,.462,73,193,.378,348,719,.484,.502,386,463,.834,114,265,379,212,114,36,93,108,1301,2015
Rasual Butler,SF,35,WAS,75,1,1505,218,517,.422,91,235,.387,127,282,.450,.510,53,67,.791,27,170,197,63,29,22,48,98,580,2015
Dwight Buycks,PG,25,LAL,6,0,123,18,40,.450,7,11,.636,11,29,.379,.538,9,10,.900,2,10,12,14,3,0,12,3,52,2015
Will Bynum,SG,32,WAS,7,0,67,10,31,.323,0,9,.000,10,22,.455,.323,2,4,.500,2,4,6,18,1,1,8,9,22,2015
Bruno Caboclo,SF,19,TOR,8,0,23,4,12,.333,2,3,.667,2,9,.222,.417,0,0,.000,1,1,2,0,0,1,4,3,10,2015
Nick Calathes,SG,25,MEM,58,0,838,104,247,.421,11,43,.256,93,204,.456,.443,24,45,.533,19,87,106,146,63,5,61,100,243,2015
Jose Calderon,PG,33,NYK,42,42,1270,147,354,.415,59,142,.415,88,212,.415,.499,29,32,.906,19,105,124,198,31,0,75,76,382,2015
Kentavious Caldwell-Pope,SG,21,DET,82,82,2587,390,972,.401,153,444,.345,237,528,.449,.480,110,158,.696,46,209,255,109,93,18,94,161,1043,2015
Isaiah Canaan,PG,23,TOT,47,21,938,146,378,.386,91,246,.370,55,132,.417,.507,49,60,.817,18,69,87,98,29,3,62,83,432,2015
Isaiah Canaan,PG,23,HOU,25,9,369,53,131,.405,32,84,.381,21,47,.447,.527,16,21,.762,11,22,33,29,14,0,23,28,154,2015
Isaiah Canaan,PG,23,PHI,22,12,569,93,247,.377,59,162,.364,34,85,.400,.496,33,39,.846,7,47,54,69,15,3,39,55,278,2015
Clint Capela,C,20,HOU,12,0,90,14,29,.483,0,0,.000,14,29,.483,.483,4,23,.174,10,26,36,2,1,9,5,14,32,2015
DeMarre Carroll,SF,28,ATL,70,69,2189,318,653,.487,120,304,.395,198,349,.567,.579,127,181,.702,99,273,372,118,94,17,75,154,883,2015
Vince Carter,SG,38,MEM,66,1,1091,135,406,.333,69,232,.297,66,174,.379,.417,45,57,.789,27,106,133,79,43,14,43,102,384,2015
Michael Carter-Williams,PG,23,TOT,66,63,2149,364,919,.396,36,153,.235,328,766,.428,.416,202,291,.694,64,289,353,442,111,30,253,167,966,2015
Michael Carter-Williams,PG,23,PHI,41,38,1391,232,611,.380,32,125,.256,200,486,.412,.406,117,182,.643,43,211,254,302,60,18,174,103,613,2015
Michael Carter-Williams,PG,23,MIL,25,25,758,132,308,.429,4,28,.143,128,280,.457,.435,85,109,.780,21,78,99,140,51,12,79,64,353,2015
Omri Casspi,SF,26,SAC,67,19,1416,209,427,.489,35,87,.402,174,340,.512,.530,140,191,.733,54,206,260,102,31,9,88,107,593,2015
Mario Chalmers,PG,28,MIA,80,37,2368,267,663,.403,73,248,.294,194,415,.467,.458,206,266,.774,24,182,206,307,122,10,173,251,813,2015
Tyson Chandler,C,32,DAL,75,75,2286,293,440,.666,0,0,.000,293,440,.666,.666,185,257,.720,294,570,864,84,42,91,105,169,771,2015
Wilson Chandler,SF,27,DEN,78,75,2471,418,975,.429,139,406,.342,279,569,.490,.500,110,142,.775,96,379,475,134,58,29,110,231,1085,2015
Will Cherry,PG,23,CLE,8,0,69,5,19,.263,2,9,.222,3,10,.300,.316,3,6,.500,1,4,5,8,6,1,4,10,15,2015
Patrick Christopher,SG,26,UTA,4,1,29,3,12,.250,0,4,.000,3,8,.375,.250,0,0,.000,2,4,6,0,1,0,1,6,6,2015
Earl Clark,PF,27,BRK,10,0,93,11,30,.367,4,14,.286,7,16,.438,.433,1,4,.250,1,22,23,3,3,4,6,12,27,2015
Ian Clark,SG,23,TOT,30,0,192,19,55,.345,10,30,.333,9,25,.360,.436,9,9,1.000,4,12,16,12,9,3,9,20,57,2015
Ian Clark,SG,23,UTA,23,0,161,15,44,.341,9,25,.360,6,19,.316,.443,5,5,1.000,4,9,13,10,6,2,7,12,44,2015
Ian Clark,SG,23,DEN,7,0,31,4,11,.364,1,5,.200,3,6,.500,.409,4,4,1.000,0,3,3,2,3,1,2,8,13,2015
Jordan Clarkson,PG,22,LAL,59,38,1476,267,596,.448,38,121,.314,229,475,.482,.480,131,158,.829,56,135,191,206,51,12,96,109,703,2015
Victor Claver,SF,26,POR,10,0,76,9,20,.450,6,11,.545,3,9,.333,.600,0,0,.000,3,17,20,1,1,1,4,12,24,2015
Norris Cole,PG,26,TOT,75,25,1831,230,558,.412,55,176,.313,175,382,.458,.461,58,81,.716,13,146,159,255,57,15,99,124,573,2015
Norris Cole,PG,26,MIA,47,23,1148,118,306,.386,27,102,.265,91,204,.446,.430,32,46,.696,12,96,108,165,42,8,58,75,295,2015
Norris Cole,PG,26,NOP,28,2,683,112,252,.444,28,74,.378,84,178,.472,.500,26,35,.743,1,50,51,90,15,7,41,49,278,2015
Darren Collison,PG,27,SAC,45,45,1565,260,550,.473,60,161,.373,200,389,.514,.527,145,184,.788,19,124,143,252,67,14,112,95,725,2015
Nick Collison,PF,34,OKC,66,2,1101,106,253,.419,16,60,.267,90,193,.466,.451,45,65,.692,90,160,250,90,35,25,45,156,273,2015
Mike Conley,PG,27,MEM,70,70,2225,393,882,.446,107,277,.386,286,605,.473,.506,214,249,.859,29,180,209,375,89,14,156,139,1107,2015
Jack Cooley,PF,23,UTA,16,0,87,9,22,.409,0,0,.000,9,22,.409,.409,9,21,.429,10,15,25,1,6,3,3,23,27,2015
Chris Copeland,SF,30,IND,50,12,828,112,310,.361,52,167,.311,60,143,.420,.445,33,45,.733,23,88,111,51,11,11,59,78,309,2015
Bryce Cotton,PG,22,UTA,15,0,159,29,69,.420,7,20,.350,22,49,.449,.471,15,18,.833,3,15,18,15,4,0,12,6,80,2015
DeMarcus Cousins,C,24,SAC,59,59,2013,498,1066,.467,2,8,.250,496,1058,.469,.468,423,541,.782,185,562,747,210,90,103,254,241,1421,2015
Robert Covington,SF,24,PHI,70,49,1956,299,756,.396,167,446,.374,132,310,.426,.506,178,217,.820,65,251,316,105,97,31,128,189,943,2015
Allen Crabbe,SG,22,POR,51,9,683,63,153,.412,30,85,.353,33,68,.485,.510,12,16,.750,7,66,73,39,19,15,15,74,168,2015
Jamal Crawford,SG,34,LAC,64,4,1703,332,839,.396,119,364,.327,213,475,.448,.467,227,252,.901,18,106,124,158,59,14,92,108,1010,2015
Jae Crowder,SF,24,TOT,82,17,1647,229,545,.420,61,208,.293,168,337,.499,.476,109,141,.773,72,221,293,94,72,25,49,137,628,2015
Jae Crowder,SF,24,DAL,25,0,265,33,76,.434,13,38,.342,20,38,.526,.520,10,11,.909,12,17,29,12,15,5,10,26,89,2015
Jae Crowder,SF,24,BOS,57,17,1382,196,469,.418,48,170,.282,148,299,.495,.469,99,130,.762,60,204,264,82,57,20,39,111,539,2015
Dante Cunningham,PF,27,NOP,66,27,1652,155,339,.457,1,10,.100,154,329,.468,.459,29,47,.617,70,186,256,50,46,37,35,101,340,2015
Jared Cunningham,SG,23,LAC,19,0,89,12,33,.364,4,13,.308,8,20,.400,.424,7,13,.538,1,8,9,10,3,0,7,12,35,2015
Seth Curry,PG,24,PHO,2,0,8,0,3,.000,0,1,.000,0,2,.000,.000,0,0,.000,0,2,2,1,0,0,0,2,0,2015
Stephen Curry,PG,26,GSW,80,80,2613,653,1341,.487,286,646,.443,367,695,.528,.594,308,337,.914,56,285,341,619,163,16,249,158,1900,2015
Samuel Dalembert,C,33,NYK,32,21,544,57,130,.438,0,0,.000,57,130,.438,.438,14,20,.700,53,115,168,29,14,41,39,70,128,2015
Troy Daniels,SG,23,TOT,47,0,397,61,165,.370,43,118,.364,18,47,.383,.500,11,13,.846,8,25,33,22,6,1,20,40,176,2015
Troy Daniels,SG,23,HOU,17,0,108,15,47,.319,13,43,.302,2,4,.500,.457,3,4,.750,0,6,6,4,0,0,5,14,46,2015
Troy Daniels,SG,23,MIN,19,0,154,19,59,.322,13,39,.333,6,20,.300,.432,2,2,1.000,6,13,19,13,3,0,8,14,53,2015
Troy Daniels,SG,23,CHO,11,0,135,27,59,.458,17,36,.472,10,23,.435,.602,6,7,.857,2,6,8,5,3,1,7,12,77,2015
Luigi Datome,SF,27,TOT,21,1,209,43,89,.483,18,40,.450,25,49,.510,.584,1,1,1.000,3,26,29,9,2,7,9,15,105,2015
Luigi Datome,SF,27,DET,3,0,17,5,12,.417,1,4,.250,4,8,.500,.458,0,0,.000,1,3,4,2,1,0,2,1,11,2015
Luigi Datome,SF,27,BOS,18,1,192,38,77,.494,17,36,.472,21,41,.512,.604,1,1,1.000,2,23,25,7,1,7,7,14,94,2015
Brandon Davies,PF,23,TOT,27,6,423,55,137,.401,8,34,.235,47,103,.456,.431,24,37,.649,38,45,83,30,18,7,29,59,142,2015
Brandon Davies,PF,23,PHI,20,6,379,49,119,.412,7,30,.233,42,89,.472,.441,21,33,.636,35,38,73,28,17,4,25,54,126,2015
Brandon Davies,PF,23,BRK,7,0,44,6,18,.333,1,4,.250,5,14,.357,.361,3,4,.750,3,7,10,2,1,3,4,5,16,2015
Anthony Davis,PF,21,NOP,68,68,2455,642,1199,.535,1,12,.083,641,1187,.540,.536,371,461,.805,173,523,696,149,100,200,95,141,1656,2015
Ed Davis,PF,25,LAL,79,24,1840,282,469,.601,0,0,.000,282,469,.601,.601,92,189,.487,230,370,600,94,49,98,58,202,656,2015
Glen Davis,PF,29,LAC,74,0,904,117,255,.459,0,4,.000,117,251,.466,.459,60,95,.632,43,126,169,39,41,21,39,132,294,2015
Andre Dawkins,SG,23,MIA,4,0,22,1,6,.167,1,6,.167,0,0,.250,.000,0,0,.000,0,2,2,1,0,0,1,3,3,2015
Austin Daye,SF,26,TOT,34,4,344,50,141,.355,24,71,.338,26,70,.371,.440,5,6,.833,10,65,75,17,12,5,23,39,129,2015
Austin Daye,SF,26,SAS,26,4,268,40,115,.348,19,57,.333,21,58,.362,.430,4,4,1.000,6,55,61,9,8,3,18,30,103,2015
Austin Daye,SF,26,ATL,8,0,76,10,26,.385,5,14,.357,5,12,.417,.481,1,2,.500,4,10,14,8,4,2,5,9,26,2015
Dewayne Dedmon,C,25,ORL,59,15,845,91,162,.562,0,1,.000,91,161,.565,.562,34,64,.531,118,177,295,9,16,50,51,141,216,2015
Matthew Dellavedova,SG,24,CLE,67,13,1380,111,307,.362,68,167,.407,43,140,.307,.472,29,38,.763,37,89,126,204,24,2,61,152,319,2015
Luol Deng,SF,29,MIA,72,72,2421,369,787,.469,78,220,.355,291,567,.513,.518,191,251,.761,103,273,376,139,65,22,108,109,1007,2015
DeMar DeRozan,SG,25,TOR,60,60,2100,409,990,.413,25,88,.284,384,902,.426,.426,361,434,.832,41,236,277,210,73,11,137,122,1204,2015
Boris Diaw,PF,32,SAS,81,15,1984,291,632,.460,54,169,.320,237,463,.512,.503,72,93,.774,78,270,348,233,36,23,126,148,708,2015
Gorgui Dieng,C,25,MIN,73,49,2193,259,512,.506,1,6,.167,258,506,.510,.507,191,244,.783,223,386,609,146,71,126,126,188,710,2015
Spencer Dinwiddie,PG,21,DET,34,1,455,51,169,.302,12,65,.185,39,104,.375,.337,31,34,.912,4,44,48,104,19,6,33,53,145,2015
Joey Dorsey,PF,31,HOU,69,17,854,80,145,.552,0,1,.000,80,144,.556,.552,24,83,.289,103,176,279,25,40,25,41,157,184,2015
Toney Douglas,SG,28,NOP,12,0,177,19,51,.373,5,18,.278,14,33,.424,.422,8,13,.615,2,20,22,24,11,4,10,20,51,2015
Chris Douglas-Roberts,SG,28,LAC,12,0,103,5,21,.238,1,7,.143,4,14,.286,.262,8,8,1.000,1,11,12,4,1,0,0,14,19,2015
Goran Dragic,SG-PG,28,TOT,78,78,2640,502,1002,.501,90,259,.347,412,743,.555,.546,181,234,.774,81,193,274,350,78,15,173,195,1275,2015
Goran Dragic,SG,28,PHO,52,52,1735,340,679,.501,66,186,.355,274,493,.556,.549,97,130,.746,51,134,185,211,50,9,114,120,843,2015
Goran Dragic,PG,28,MIA,26,26,905,162,323,.502,24,73,.329,138,250,.552,.539,84,104,.808,30,59,89,139,28,6,59,75,432,2015
Zoran Dragic,SG,25,TOT,16,1,75,11,30,.367,3,14,.214,8,16,.500,.417,3,5,.600,5,3,8,5,2,0,5,6,28,2015
Zoran Dragic,SG,25,PHO,6,0,13,2,8,.250,0,5,.000,2,3,.667,.250,2,3,.667,2,1,3,1,0,0,0,1,6,2015
Zoran Dragic,SG,25,MIA,10,1,62,9,22,.409,3,9,.333,6,13,.462,.477,1,2,.500,3,2,5,4,2,0,5,5,22,2015
Larry Drew,PG,24,PHI,12,1,219,20,58,.345,4,26,.154,16,32,.500,.379,2,3,.667,1,14,15,45,6,0,25,13,46,2015
Andre Drummond,C,21,DET,82,82,2502,494,961,.514,0,2,.000,494,959,.515,.514,142,365,.389,437,667,1104,55,73,153,120,285,1130,2015
Jared Dudley,SG,29,MIL,72,22,1717,198,423,.468,74,192,.385,124,231,.537,.556,48,67,.716,45,175,220,130,72,11,62,113,518,2015
Tim Duncan,C,38,SAS,77,77,2227,419,819,.512,2,7,.286,417,812,.514,.513,230,311,.740,170,534,704,230,63,151,131,165,1070,2015
Mike Dunleavy,SF,34,CHI,63,63,1838,209,481,.435,107,263,.407,102,218,.468,.546,70,87,.805,28,220,248,114,39,21,60,123,595,2015
Kevin Durant,SF,26,OKC,27,27,913,238,467,.510,64,159,.403,174,308,.565,.578,146,171,.854,16,162,178,110,24,25,74,40,686,2015
Cleanthony Early,SF,23,NYK,39,7,647,76,214,.355,22,84,.262,54,130,.415,.407,36,48,.750,22,75,97,36,24,12,40,57,210,2015
Wayne Ellington,SG,27,LAL,65,36,1675,254,617,.412,90,243,.370,164,374,.439,.485,52,64,.813,31,179,210,105,33,2,50,77,650,2015
Monta Ellis,SG,29,DAL,80,80,2699,602,1354,.445,81,284,.285,521,1070,.487,.475,228,303,.752,34,156,190,329,148,25,198,197,1513,2015
James Ennis,SF,24,MIA,62,3,1051,101,247,.409,31,95,.326,70,152,.461,.472,79,94,.840,51,125,176,48,25,17,39,89,312,2015
Tyler Ennis,PG,20,TOT,33,1,411,52,144,.361,12,43,.279,40,101,.396,.403,5,7,.714,7,28,35,73,18,5,42,36,121,2015
Tyler Ennis,PG,20,PHO,8,0,58,9,21,.429,2,6,.333,7,15,.467,.476,2,2,1.000,1,6,7,14,0,2,8,3,22,2015
Tyler Ennis,PG,20,MIL,25,1,353,43,123,.350,10,37,.270,33,86,.384,.390,3,5,.600,6,22,28,59,18,3,34,33,99,2015
Jeremy Evans,SF,27,UTA,38,0,266,32,58,.552,2,5,.400,30,53,.566,.569,24,29,.828,26,45,71,13,11,12,5,29,90,2015
Reggie Evans,PF,34,SAC,47,7,764,58,137,.423,0,2,.000,58,135,.430,.423,60,97,.619,97,202,299,32,22,5,45,91,176,2015
Tyreke Evans,SG,25,NOP,79,76,2690,521,1165,.447,69,227,.304,452,938,.482,.477,202,291,.694,82,334,416,521,100,37,246,198,1313,2015
Dante Exum,PG,19,UTA,82,41,1817,145,416,.349,83,264,.314,62,152,.408,.448,20,32,.625,27,104,131,198,41,14,118,147,393,2015
Festus Ezeli,C,25,GSW,46,7,504,76,139,.547,0,0,.000,76,139,.547,.547,49,78,.628,60,95,155,9,7,42,32,77,201,2015
Kenneth Faried,PF,25,DEN,75,71,2086,373,736,.507,1,8,.125,372,728,.511,.507,199,288,.691,242,426,668,89,62,57,118,211,946,2015
Jordan Farmar,PG,28,LAC,36,0,529,61,158,.386,35,97,.361,26,61,.426,.497,10,11,.909,8,34,42,67,20,5,32,52,167,2015
Derrick Favors,PF,23,UTA,74,74,2280,482,918,.525,1,6,.167,481,912,.527,.526,222,332,.669,196,411,607,112,60,123,121,210,1187,2015
Raymond Felton,PG,30,DAL,29,3,281,43,106,.406,10,34,.294,33,72,.458,.453,12,15,.800,2,24,26,41,11,4,18,17,108,2015
Landry Fields,SF,26,TOR,26,9,216,20,41,.488,1,2,.500,19,39,.487,.500,5,6,.833,10,16,26,15,11,0,8,9,46,2015
Evan Fournier,SG,22,ORL,58,32,1661,253,575,.440,85,225,.378,168,350,.480,.514,107,147,.728,28,125,153,120,40,2,82,116,698,2015
Randy Foye,SG,31,DEN,50,21,1087,148,402,.368,94,263,.357,54,139,.388,.485,45,55,.818,9,76,85,119,34,11,60,97,435,2015
Jamaal Franklin,SG,23,DEN,3,0,13,1,2,.500,1,2,.500,0,0,.750,.000,0,0,.000,1,1,2,3,0,1,3,4,3,2015
Tim Frazier,PG,24,TOT,11,3,239,21,61,.344,5,17,.294,16,44,.364,.385,10,21,.476,6,22,28,60,8,0,25,26,57,2015
Tim Frazier,PG,24,PHI,6,3,171,13,43,.302,3,11,.273,10,32,.313,.337,5,15,.333,4,15,19,43,6,0,18,16,34,2015
Tim Frazier,PG,24,POR,5,0,68,8,18,.444,2,6,.333,6,12,.500,.500,5,6,.833,2,7,9,17,2,0,7,10,23,2015
Jimmer Fredette,PG,25,NOP,50,0,509,63,166,.380,9,48,.188,54,118,.458,.407,43,45,.956,8,32,40,58,15,2,33,43,178,2015
Joel Freeland,C,27,POR,48,8,617,74,151,.490,0,0,.000,74,151,.490,.490,21,25,.840,62,129,191,16,9,23,23,93,169,2015
Channing Frye,PF,31,ORL,75,51,1870,191,487,.392,136,346,.393,55,141,.390,.532,31,35,.886,27,266,293,94,47,39,78,191,549,2015
Danilo Gallinari,SF,26,DEN,59,27,1426,228,568,.401,107,301,.355,121,267,.453,.496,171,191,.895,31,187,218,83,47,20,57,94,734,2015
Langston Galloway,PG,23,NYK,45,41,1457,204,511,.399,62,176,.352,142,335,.424,.460,63,78,.808,37,153,190,150,52,12,61,129,533,2015
Francisco Garcia,SF,33,HOU,14,0,200,17,63,.270,10,45,.222,7,18,.389,.349,1,4,.250,3,14,17,15,9,5,10,20,45,2015
Kevin Garnett,PF,38,TOT,47,47,952,143,306,.467,1,7,.143,142,299,.475,.469,36,45,.800,48,263,311,77,46,17,46,109,323,2015
Kevin Garnett,PF,38,BRK,42,42,854,125,275,.455,1,6,.167,124,269,.461,.456,34,41,.829,46,239,285,69,41,13,45,96,285,2015
Kevin Garnett,PF,38,MIN,5,5,98,18,31,.581,0,1,.000,18,30,.600,.581,2,4,.500,2,24,26,8,5,4,1,13,38,2015
Marc Gasol,C,30,MEM,81,81,2687,530,1072,.494,3,17,.176,527,1055,.500,.496,350,440,.795,115,515,630,307,70,131,176,208,1413,2015
Pau Gasol,PF,34,CHI,78,78,2681,570,1153,.494,12,26,.462,558,1127,.495,.500,294,366,.803,220,699,919,210,25,147,158,147,1446,2015
Rudy Gay,SF,28,SAC,68,67,2408,508,1116,.455,79,220,.359,429,896,.479,.491,337,393,.858,98,301,399,250,71,41,183,157,1432,2015
Alonzo Gee,SF,27,TOT,54,2,662,87,186,.468,13,35,.371,74,151,.490,.503,54,77,.701,37,57,94,25,35,7,33,58,241,2015
Alonzo Gee,SF,27,DEN,39,0,511,66,137,.482,10,24,.417,56,113,.496,.518,48,65,.738,29,41,70,19,28,6,25,42,190,2015
Alonzo Gee,SF,27,POR,15,2,151,21,49,.429,3,11,.273,18,38,.474,.459,6,12,.500,8,16,24,6,7,1,8,16,51,2015
Paul George,SF,24,IND,6,0,91,18,49,.367,9,22,.409,9,27,.333,.459,8,11,.727,4,18,22,6,5,1,12,11,53,2015
Taj Gibson,PF,29,CHI,62,17,1692,254,506,.502,0,0,.000,254,506,.502,.502,132,184,.717,162,234,396,71,36,75,77,162,640,2015
Manu Ginobili,SG,37,SAS,70,0,1587,251,589,.426,89,258,.345,162,331,.489,.502,147,204,.721,28,183,211,293,67,20,154,138,738,2015
Rudy Gobert,C,22,UTA,82,37,2158,258,427,.604,0,2,.000,258,425,.607,.604,170,273,.623,265,510,775,109,64,189,111,175,686,2015
Drew Gooden,PF,33,WAS,51,7,864,110,276,.399,23,59,.390,87,217,.401,.440,34,44,.773,72,151,223,49,21,9,28,91,277,2015
Archie Goodwin,SG,20,PHO,41,2,535,79,201,.393,12,41,.293,67,160,.419,.423,61,83,.735,27,47,74,44,18,9,48,55,231,2015
Aaron Gordon,PF,19,ORL,47,8,797,93,208,.447,13,48,.271,80,160,.500,.478,44,61,.721,46,123,169,33,21,22,38,83,243,2015
Ben Gordon,SG,31,ORL,56,0,790,129,295,.437,35,97,.361,94,198,.475,.497,56,67,.836,6,57,63,50,14,1,55,60,349,2015
Drew Gordon,PF,24,PHI,9,0,71,8,19,.421,0,3,.000,8,16,.500,.421,1,2,.500,7,11,18,2,1,0,8,7,17,2015
Eric Gordon,SG,26,NOP,61,60,2018,285,694,.411,141,315,.448,144,379,.380,.512,107,133,.805,28,131,159,229,50,14,122,145,818,2015
Marcin Gortat,C,30,WAS,82,82,2453,439,775,.566,0,3,.000,439,772,.569,.566,123,175,.703,180,537,717,97,49,110,100,191,1001,2015
Danny Granger,SF,31,MIA,30,6,613,65,162,.401,30,84,.357,35,78,.449,.494,28,37,.757,20,60,80,17,13,6,24,67,188,2015
Jerami Grant,SF,20,PHI,65,11,1377,124,352,.352,49,156,.314,75,196,.383,.422,114,193,.591,49,149,198,79,40,68,85,144,411,2015
Danny Green,SG,27,SAS,81,80,2312,322,738,.436,191,457,.418,131,281,.466,.566,111,127,.874,54,289,343,158,101,87,93,163,946,2015
Draymond Green,PF,24,GSW,79,79,2490,339,765,.443,111,329,.337,228,436,.523,.516,132,200,.660,114,533,647,291,123,99,133,253,921,2015
Erick Green,PG,23,DEN,43,1,410,61,162,.377,14,47,.298,47,115,.409,.420,10,12,.833,7,24,31,39,12,0,14,26,146,2015
Gerald Green,SG,29,PHO,74,4,1446,324,778,.416,137,387,.354,187,391,.478,.504,99,120,.825,33,153,186,91,42,12,104,145,884,2015
JaMychal Green,PF,24,TOT,24,1,164,27,47,.574,0,6,.000,27,41,.659,.574,8,10,.800,19,26,45,4,5,5,14,25,62,2015
JaMychal Green,PF,24,SAS,4,0,25,4,7,.571,0,2,.000,4,5,.800,.571,0,0,.000,3,3,6,0,0,2,2,6,8,2015
JaMychal Green,PF,24,MEM,20,1,139,23,40,.575,0,4,.000,23,36,.639,.575,8,10,.800,16,23,39,4,5,3,12,19,54,2015
Jeff Green,SF,28,TOT,78,70,2454,416,967,.430,97,292,.332,319,675,.473,.480,239,287,.833,64,264,328,134,53,34,108,147,1168,2015
Jeff Green,SF,28,BOS,33,33,1093,206,475,.434,47,154,.305,159,321,.495,.483,121,144,.840,21,120,141,53,27,13,56,66,580,2015
Jeff Green,SF,28,MEM,45,37,1361,210,492,.427,50,138,.362,160,354,.452,.478,118,143,.825,43,144,187,81,26,21,52,81,588,2015
Willie Green,SG,33,ORL,52,2,951,118,306,.386,42,121,.347,76,185,.411,.454,28,34,.824,14,65,79,68,26,5,48,81,306,2015
Blake Griffin,PF,25,LAC,67,67,2356,574,1144,.502,10,25,.400,564,1119,.504,.506,311,427,.728,126,382,508,354,63,35,152,196,1469,2015
Jorge Gutierrez,PG,26,TOT,20,1,175,22,41,.537,0,3,.000,22,38,.579,.537,9,13,.692,5,20,25,22,6,0,12,25,53,2015
Jorge Gutierrez,PG,26,BRK,10,0,44,7,14,.500,0,1,.000,7,13,.538,.500,2,3,.667,0,7,7,7,1,0,3,9,16,2015
Jorge Gutierrez,PG,26,MIL,10,1,131,15,27,.556,0,2,.000,15,25,.600,.556,7,10,.700,5,13,18,15,5,0,9,16,37,2015
P.J. Hairston,SG,22,CHO,45,2,687,87,269,.323,49,163,.301,38,106,.358,.414,31,36,.861,22,70,92,21,21,13,22,61,254,2015
Jordan Hamilton,SF,24,LAC,14,2,122,14,35,.400,10,21,.476,4,14,.286,.543,0,0,.000,2,14,16,7,2,0,4,14,38,2015
Justin Hamilton,C,24,TOT,41,14,712,85,178,.478,10,31,.323,75,147,.510,.506,39,47,.830,57,77,134,36,27,30,26,70,219,2015
Justin Hamilton,C,24,MIA,24,5,289,27,65,.415,6,19,.316,21,46,.457,.462,6,7,.857,24,24,48,12,8,5,8,33,66,2015
Justin Hamilton,C,24,MIN,17,9,423,58,113,.513,4,12,.333,54,101,.535,.531,33,40,.825,33,53,86,24,19,25,18,37,153,2015
Tyler Hansbrough,PF,29,TOR,74,8,1058,86,165,.521,1,7,.143,85,158,.538,.524,97,139,.698,106,159,265,21,30,15,20,141,270,2015
Tim Hardaway,SG,22,NYK,70,30,1681,279,717,.389,121,354,.342,158,363,.435,.474,125,156,.801,12,144,156,127,20,14,82,119,804,2015
James Harden,SG,25,HOU,81,81,2981,647,1470,.440,208,555,.375,439,915,.480,.511,715,824,.868,75,384,459,565,154,60,321,208,2217,2015
Maurice Harkless,SF,21,ORL,45,4,674,63,158,.399,10,56,.179,53,102,.520,.430,22,41,.537,38,68,106,25,32,9,27,66,158,2015
Devin Harris,PG,31,DAL,76,3,1685,219,524,.418,95,266,.357,124,258,.481,.509,132,162,.815,13,122,135,237,78,14,85,147,665,2015
Gary Harris,SG,20,DEN,55,6,719,66,217,.304,21,103,.204,45,114,.395,.353,35,47,.745,21,43,64,29,39,7,38,71,188,2015
Joe Harris,SG,23,CLE,51,1,493,48,120,.400,31,84,.369,17,36,.472,.529,9,15,.600,7,34,41,26,7,2,27,62,136,2015
Tobias Harris,SF,22,ORL,68,63,2369,442,949,.466,87,239,.364,355,710,.500,.512,193,245,.788,73,357,430,124,69,36,115,134,1164,2015
Udonis Haslem,PF,34,MIA,62,25,995,107,239,.448,2,10,.200,105,229,.459,.452,45,64,.703,71,187,258,46,21,13,41,113,261,2015
Spencer Hawes,PF,26,LAC,73,15,1274,163,415,.393,55,176,.313,108,239,.452,.459,44,68,.647,30,228,258,88,24,53,61,173,425,2015
Chuck Hayes,C,31,TOR,29,0,255,22,46,.478,0,0,.000,22,46,.478,.478,6,11,.545,18,33,51,20,10,4,8,37,50,2015
Gordon Hayward,SF,24,UTA,76,76,2618,484,1087,.445,120,330,.364,364,757,.481,.500,375,462,.812,54,319,373,313,108,30,206,131,1463,2015
Brendan Haywood,C,35,CLE,22,1,119,14,30,.467,0,0,.000,14,30,.467,.467,7,13,.538,6,23,29,2,2,10,10,17,35,2015
Gerald Henderson,SG,27,CHO,80,72,2315,370,847,.437,45,136,.331,325,711,.457,.463,184,217,.848,36,237,273,206,51,22,110,135,969,2015
Xavier Henry,SF,23,LAL,9,0,86,3,13,.231,0,0,.000,3,13,.231,.231,14,24,.583,2,2,4,3,3,0,3,6,20,2015
John Henson,C,24,MIL,67,11,1228,196,346,.566,0,0,.000,196,346,.566,.566,78,137,.569,124,188,312,59,28,135,87,152,470,2015
Roy Hibbert,C,28,IND,76,76,1926,317,710,.446,0,2,.000,317,708,.448,.446,168,204,.824,156,384,540,84,18,125,107,216,802,2015
J.J. Hickson,C,26,DEN,73,8,1411,218,459,.475,0,2,.000,218,457,.477,.475,116,201,.577,150,302,452,57,36,35,96,136,552,2015
Nene Hilario,PF,32,WAS,67,58,1693,307,601,.511,1,5,.200,306,596,.513,.512,122,202,.604,84,261,345,123,66,22,124,180,737,2015
George Hill,PG,28,IND,43,36,1267,255,535,.477,69,193,.358,186,342,.544,.541,113,143,.790,25,154,179,220,44,14,69,111,692,2015
Jordan Hill,C,27,LAL,70,57,1874,357,777,.459,3,11,.273,354,766,.462,.461,124,168,.738,174,382,556,103,34,52,106,164,841,2015
Solomon Hill,SF,23,IND,82,78,2381,251,634,.396,68,208,.327,183,426,.430,.450,159,193,.824,70,244,314,184,66,18,115,177,729,2015
Kirk Hinrich,SG,34,CHI,66,22,1610,142,381,.373,58,168,.345,84,213,.394,.449,35,50,.700,20,101,121,148,46,14,73,144,377,2015
Jrue Holiday,PG,24,NOP,40,37,1303,238,534,.446,51,135,.378,187,399,.469,.493,65,76,.855,32,103,135,274,63,23,91,110,592,2015
Justin Holiday,SG,25,GSW,59,4,657,91,235,.387,35,109,.321,56,126,.444,.462,37,45,.822,12,61,73,48,40,12,29,54,254,2015
Ryan Hollins,C,30,SAC,46,9,441,53,82,.646,0,0,.000,53,82,.646,.646,31,54,.574,36,67,103,14,6,19,25,65,137,2015
Rodney Hood,SG,22,UTA,50,21,1064,155,374,.414,62,170,.365,93,204,.456,.497,61,80,.763,9,108,117,83,30,12,45,119,433,2015
Al Horford,C,28,ATL,76,76,2318,519,965,.538,11,36,.306,508,929,.547,.544,107,141,.759,131,413,544,244,68,98,100,121,1156,2015
Dwight Howard,C,29,HOU,41,41,1223,251,423,.593,1,2,.500,250,421,.594,.595,143,271,.528,110,321,431,50,28,53,115,137,646,2015
Lester Hudson,SG,30,LAC,5,0,56,6,14,.429,3,6,.500,3,8,.375,.536,3,4,.750,1,7,8,5,6,1,3,4,18,2015
Robbie Hummel,SF,25,MIN,45,4,742,79,172,.459,16,51,.314,63,121,.521,.506,24,29,.828,31,103,134,27,16,9,18,86,198,2015
Kris Humphries,PF,29,WAS,64,17,1345,211,446,.473,0,7,.000,211,439,.481,.473,87,117,.744,118,298,416,57,34,25,46,130,509,2015
Serge Ibaka,PF,25,OKC,64,64,2116,374,786,.476,77,205,.376,297,581,.511,.525,92,110,.836,135,364,499,55,30,155,97,194,917,2015
Andre Iguodala,SF,31,GSW,77,0,2069,231,496,.466,74,212,.349,157,284,.553,.540,68,114,.596,44,213,257,228,89,25,88,100,604,2015
Ersan Ilyasova,PF,27,MIL,58,36,1319,263,557,.472,74,190,.389,189,367,.515,.539,69,107,.645,80,197,277,56,36,19,45,149,669,2015
Joe Ingles,SF,27,UTA,79,32,1673,147,354,.415,72,202,.356,75,152,.493,.517,30,40,.750,22,153,175,182,72,10,98,124,396,2015
Kyrie Irving,PG,22,CLE,75,75,2730,578,1235,.468,157,378,.415,421,857,.491,.532,315,365,.863,55,182,237,389,114,20,186,146,1628,2015
Jarrett Jack,PG,31,BRK,80,27,2241,359,817,.439,39,146,.267,320,671,.477,.463,200,227,.881,19,226,245,373,75,13,191,143,957,2015
Reggie Jackson,PG,24,TOT,77,40,2268,432,996,.434,72,241,.299,360,755,.477,.470,181,218,.830,56,271,327,462,62,9,186,167,1117,2015
Reggie Jackson,PG,24,OKC,50,13,1398,249,576,.432,44,158,.278,205,418,.490,.470,99,115,.861,28,173,201,214,42,5,91,94,641,2015
Reggie Jackson,PG,24,DET,27,27,870,183,420,.436,28,83,.337,155,337,.460,.469,82,103,.796,28,98,126,248,20,4,95,73,476,2015
Bernard James,C,29,DAL,16,2,158,12,27,.444,0,0,.000,12,27,.444,.444,20,23,.870,18,21,39,4,2,15,6,17,44,2015
LeBron James,SF,30,CLE,69,69,2493,624,1279,.488,120,339,.354,504,940,.536,.535,375,528,.710,51,365,416,511,109,49,272,135,1743,2015
Al Jefferson,C,30,CHO,65,61,1992,486,1010,.481,2,5,.400,484,1005,.482,.482,108,165,.655,99,449,548,113,47,84,68,139,1082,2015
Cory Jefferson,PF,24,BRK,50,1,531,75,167,.449,2,15,.133,73,152,.480,.455,31,54,.574,47,98,145,16,10,21,20,61,183,2015
Richard Jefferson,SF,34,DAL,74,18,1244,144,324,.444,66,155,.426,78,169,.462,.546,78,114,.684,25,158,183,61,32,11,52,115,432,2015
John Jenkins,SG,23,ATL,24,3,297,49,99,.495,21,52,.404,28,47,.596,.601,16,19,.842,2,37,39,13,10,0,8,15,135,2015
Brandon Jennings,PG,25,DET,41,41,1173,218,543,.401,76,211,.360,142,332,.428,.471,120,143,.839,21,83,104,272,44,4,90,64,632,2015
Jonas Jerebko,PF,27,TOT,75,0,1230,169,379,.446,54,140,.386,115,239,.481,.517,56,66,.848,93,189,282,71,46,18,44,135,448,2015
Jonas Jerebko,PF,27,DET,46,0,703,91,198,.460,28,76,.368,63,122,.516,.530,31,36,.861,47,95,142,41,27,11,26,77,241,2015
Jonas Jerebko,PF,27,BOS,29,0,527,78,181,.431,26,64,.406,52,117,.444,.503,25,30,.833,46,94,140,30,19,7,18,58,207,2015
Grant Jerrett,PF,21,TOT,8,0,51,7,26,.269,1,15,.067,6,11,.545,.288,1,1,1.000,2,7,9,3,2,2,3,11,16,2015
Grant Jerrett,PF,21,OKC,5,0,25,3,17,.176,1,13,.077,2,4,.500,.206,0,0,.000,1,3,4,1,0,2,2,7,7,2015
Grant Jerrett,PF,21,UTA,3,0,26,4,9,.444,0,2,.000,4,7,.571,.444,1,1,1.000,1,4,5,2,2,0,1,4,9,2015
Amir Johnson,PF,27,TOR,75,72,1979,298,519,.574,19,46,.413,279,473,.590,.592,79,129,.612,159,297,456,117,44,59,110,225,694,2015
Chris Johnson,SF,24,TOT,29,2,526,62,154,.403,28,95,.295,34,59,.576,.494,14,16,.875,8,47,55,15,26,7,15,44,166,2015
Chris Johnson,SF,24,PHI,9,2,187,19,60,.317,10,39,.256,9,21,.429,.400,6,8,.750,3,23,26,3,9,5,9,19,54,2015
Chris Johnson,SF,24,UTA,12,0,211,31,64,.484,13,38,.342,18,26,.692,.586,6,6,1.000,3,15,18,7,12,0,6,18,81,2015
Chris Johnson,SF,24,MIL,8,0,128,12,30,.400,5,18,.278,7,12,.583,.483,2,2,1.000,2,9,11,5,5,2,0,7,31,2015
James Johnson,PF,27,TOR,70,17,1370,238,404,.589,11,51,.216,227,353,.643,.603,67,102,.657,61,196,257,95,54,70,79,155,554,2015
Joe Johnson,SG,33,BRK,80,80,2791,446,1025,.435,121,337,.359,325,688,.472,.494,141,176,.801,53,331,384,292,59,14,137,120,1154,2015
Nick Johnson,SG,22,HOU,28,0,262,26,75,.347,5,21,.238,21,54,.389,.380,17,25,.680,13,26,39,11,7,3,19,34,74,2015
Tyler Johnson,SG,22,MIA,32,2,603,70,167,.419,18,48,.375,52,119,.437,.473,32,47,.681,14,67,81,42,33,9,30,42,190,2015
Wesley Johnson,SF,27,LAL,76,59,2245,286,691,.414,91,259,.351,195,432,.451,.480,90,112,.804,67,252,319,124,59,45,87,162,753,2015
Dahntay Jones,SF,34,LAC,33,0,123,6,21,.286,0,4,.000,6,17,.353,.286,9,11,.818,1,10,11,2,3,0,1,23,21,2015
James Jones,SF,34,CLE,57,2,669,74,201,.368,63,175,.360,11,26,.423,.525,39,46,.848,9,53,62,24,13,8,13,67,250,2015
Perry Jones,SF,23,OKC,43,13,631,73,184,.397,14,60,.233,59,124,.476,.435,24,37,.649,6,70,76,18,17,8,24,50,184,2015
Terrence Jones,PF,23,HOU,33,24,889,158,299,.528,13,37,.351,145,262,.553,.550,57,94,.606,78,142,220,36,18,59,37,78,386,2015
DeAndre Jordan,C,26,LAC,82,82,2820,379,534,.710,1,4,.250,378,530,.713,.711,187,471,.397,397,829,1226,61,81,183,109,245,946,2015
Jerome Jordan,C,28,BRK,44,0,383,50,94,.532,0,0,.000,50,94,.532,.532,38,44,.864,52,53,105,13,8,15,22,58,138,2015
Cory Joseph,PG,23,SAS,79,14,1444,207,411,.504,16,44,.364,191,367,.520,.523,105,143,.734,44,148,192,188,46,17,67,105,535,2015
Chris Kaman,C,32,POR,74,13,1398,283,549,.515,0,0,.000,283,549,.515,.515,72,102,.706,149,335,484,65,18,54,108,140,638,2015
Enes Kanter,C,22,TOT,75,74,2135,482,928,.519,16,45,.356,466,883,.528,.528,183,234,.782,277,394,671,55,36,29,145,189,1163,2015
Enes Kanter,C,22,UTA,49,48,1326,286,582,.491,13,41,.317,273,541,.505,.503,93,118,.788,147,237,384,26,23,16,93,114,678,2015
Enes Kanter,C,22,OKC,26,26,809,196,346,.566,3,4,.750,193,342,.564,.571,90,116,.776,130,157,287,29,13,13,52,75,485,2015
Sergey Karasev,SG,21,BRK,33,16,555,54,134,.403,16,54,.296,38,80,.475,.463,29,38,.763,22,44,66,46,23,1,24,45,153,2015
Ryan Kelly,PF,23,LAL,52,34,1233,104,309,.337,45,134,.336,59,175,.337,.409,79,95,.832,13,133,146,92,30,24,37,118,332,2015
Michael Kidd-Gilchrist,SF,21,CHO,55,52,1587,224,482,.465,0,0,.000,224,482,.465,.465,150,214,.701,109,307,416,77,30,38,63,115,598,2015
Sean Kilpatrick,SG,25,MIN,4,0,72,7,20,.350,4,13,.308,3,7,.429,.450,4,4,1.000,1,5,6,4,3,0,2,3,22,2015
Andrei Kirilenko,SF,33,BRK,7,0,36,0,5,.000,0,0,.000,0,5,.000,.000,3,4,.750,2,6,8,1,1,0,1,1,3,2015
Alex Kirk,C,23,CLE,5,0,14,1,4,.250,0,0,.000,1,4,.250,.250,2,2,1.000,1,0,1,1,0,0,0,1,4,2015
Brandon Knight,PG-SG,23,TOT,63,61,2035,375,888,.422,125,321,.389,250,567,.441,.493,195,223,.874,28,216,244,330,90,10,189,114,1070,2015
Brandon Knight,PG,23,MIL,52,52,1688,324,745,.435,104,254,.409,220,491,.448,.505,171,194,.881,26,195,221,281,84,9,166,93,923,2015
Brandon Knight,SG,23,PHO,11,9,347,51,143,.357,21,67,.313,30,76,.395,.430,24,29,.828,2,21,23,49,6,1,23,21,147,2015
Kyle Korver,SG,33,ATL,75,75,2418,292,600,.487,221,449,.492,71,151,.470,.671,106,118,.898,15,289,304,196,52,42,107,140,911,2015
Kosta Koufos,C,25,MEM,81,3,1348,182,358,.508,0,0,.000,182,358,.508,.508,55,85,.647,121,305,426,37,29,63,69,148,419,2015
Ognjen Kuzmic,C,24,GSW,16,0,72,8,12,.667,0,0,.000,8,12,.667,.667,4,4,1.000,7,10,17,6,2,1,5,13,20,2015
Jeremy Lamb,SG,22,OKC,47,8,633,104,250,.416,38,111,.342,66,139,.475,.492,49,55,.891,8,99,107,44,21,6,27,52,295,2015
Carl Landry,PF,31,SAC,70,15,1192,190,369,.515,0,0,.000,190,369,.515,.515,123,150,.820,99,169,268,26,15,17,54,132,503,2015
Shane Larkin,PG,22,NYK,76,22,1865,187,432,.433,35,116,.302,152,316,.481,.473,61,78,.782,29,147,176,226,93,9,83,150,470,2015
Joffrey Lauvergne,C,23,DEN,24,1,268,36,89,.404,3,16,.188,33,73,.452,.421,18,28,.643,27,50,77,13,8,10,22,43,93,2015
Zach LaVine,PG,19,MIN,77,40,1902,286,677,.422,57,167,.341,229,510,.449,.465,149,177,.842,27,187,214,276,54,10,193,158,778,2015
Ty Lawson,PG,27,DEN,75,75,2665,404,926,.436,70,205,.341,334,721,.463,.474,265,363,.730,42,192,234,720,92,9,185,128,1143,2015
Ricky Ledo,SG,22,TOT,17,0,244,32,96,.333,10,27,.370,22,69,.319,.385,16,22,.727,16,20,36,19,6,1,26,21,90,2015
Ricky Ledo,SG,22,DAL,5,0,11,0,6,.000,0,3,.000,0,3,.000,.000,1,2,.500,1,1,2,1,0,0,2,1,1,2015
Ricky Ledo,SG,22,NYK,12,0,233,32,90,.356,10,24,.417,22,66,.333,.411,15,20,.750,15,19,34,18,6,1,24,20,89,2015
Courtney Lee,SG,29,MEM,77,74,2354,288,643,.448,90,224,.402,198,419,.473,.518,111,129,.860,21,157,178,151,75,12,78,129,777,2015
David Lee,PF,31,GSW,49,4,904,160,313,.511,0,2,.000,160,311,.514,.511,68,104,.654,81,176,257,85,31,26,49,83,388,2015
Malcolm Lee,SG,24,PHI,1,0,2,0,1,.000,0,0,.000,0,1,.000,.000,0,0,.000,0,0,0,0,0,0,0,0,0,2015
Alex Len,C,21,PHO,69,44,1518,179,353,.507,1,3,.333,178,350,.509,.508,73,104,.702,142,312,454,32,34,105,74,213,432,2015
Kawhi Leonard,SF,23,SAS,64,64,2033,394,822,.479,67,192,.349,327,630,.519,.520,202,252,.802,85,376,461,161,148,48,97,128,1057,2015
Meyers Leonard,C,22,POR,55,7,847,125,245,.510,47,112,.420,78,133,.586,.606,30,32,.938,46,204,250,32,10,14,39,113,327,2015
Jon Leuer,PF,25,MEM,63,6,824,121,273,.443,7,29,.241,114,244,.467,.456,37,59,.627,50,157,207,46,17,9,35,86,286,2015
Damian Lillard,PG,24,POR,82,82,2925,590,1360,.434,196,572,.343,394,788,.500,.506,344,398,.864,49,329,378,507,97,21,222,164,1720,2015
Jeremy Lin,PG,26,LAL,74,30,1907,277,654,.424,65,176,.369,212,478,.444,.473,213,268,.795,26,170,196,339,82,32,166,189,832,2015
Shaun Livingston,PG,29,GSW,78,2,1468,198,396,.500,0,2,.000,198,394,.503,.500,65,91,.714,43,140,183,259,49,20,102,110,461,2015
Brook Lopez,C,26,BRK,72,44,2100,506,987,.513,1,10,.100,505,977,.517,.513,223,274,.814,214,321,535,50,43,126,104,206,1236,2015
Robin Lopez,C,26,POR,59,59,1638,234,437,.535,0,1,.000,234,436,.537,.535,98,127,.772,190,204,394,55,16,84,73,122,566,2015
Kevin Love,PF,26,CLE,75,75,2532,413,952,.434,144,392,.367,269,560,.480,.509,258,321,.804,142,589,731,168,51,39,122,140,1228,2015
Kyle Lowry,PG,28,TOR,70,70,2414,430,1043,.412,132,391,.338,298,652,.457,.476,252,312,.808,54,274,328,473,109,13,173,212,1244,2015
Kalin Lucas,PG,25,MEM,1,0,6,0,1,.000,0,0,.000,0,1,.000,.000,0,0,.000,0,0,0,0,1,0,0,1,0,2015
John Lucas III,PG,32,DET,21,0,272,42,104,.404,9,29,.310,33,75,.440,.447,5,5,1.000,4,12,16,60,8,0,16,18,98,2015
Shelvin Mack,PG,24,ATL,55,0,833,117,292,.401,40,127,.315,77,165,.467,.469,25,31,.806,8,71,79,155,30,2,49,32,299,2015
Ian Mahinmi,C,28,IND,61,6,1146,117,212,.552,0,0,.000,117,212,.552,.552,31,102,.304,105,251,356,33,30,46,59,172,265,2015
Devyn Marble,SG,22,ORL,16,7,208,14,44,.318,4,22,.182,10,22,.455,.364,5,16,.313,5,26,31,17,9,2,9,14,37,2015
Shawn Marion,SF,36,CLE,57,24,1101,119,267,.446,12,46,.261,107,221,.484,.468,26,34,.765,64,138,202,51,27,27,33,58,276,2015
Kendall Marshall,PG,23,MIL,28,3,417,46,101,.455,18,46,.391,28,55,.509,.545,8,9,.889,2,26,28,86,21,0,35,26,118,2015
Cartier Martin,SF,30,DET,23,0,198,15,53,.283,6,33,.182,9,20,.450,.340,0,0,.000,0,20,20,11,3,1,5,20,36,2015
Kenyon Martin,PF,37,MIL,11,0,104,9,22,.409,0,0,.000,9,22,.409,.409,2,2,1.000,6,13,19,5,5,6,3,13,20,2015
Kevin Martin,SG,31,MIN,39,36,1302,267,625,.427,75,191,.393,192,434,.442,.487,170,193,.881,19,123,142,89,33,1,76,76,779,2015
Wesley Matthews,SG,28,POR,60,60,2024,337,752,.448,173,445,.389,164,307,.534,.563,109,145,.752,38,184,222,139,77,10,81,132,956,2015
Jason Maxiell,PF,31,CHO,61,0,878,81,192,.422,0,0,.000,81,192,.422,.422,41,71,.577,86,117,203,19,18,44,29,96,203,2015
O.J. Mayo,SG,27,MIL,71,15,1697,296,701,.422,99,277,.357,197,424,.465,.493,115,139,.827,30,157,187,197,57,18,128,165,806,2015
Luc Mbah a Moute,PF,28,PHI,67,61,1916,251,636,.395,62,202,.307,189,434,.435,.443,96,163,.589,82,246,328,106,81,21,99,104,660,2015
James Michael McAdoo,PF,22,GSW,15,0,137,24,44,.545,0,0,.000,24,44,.545,.545,14,25,.560,15,22,37,2,5,9,6,21,62,2015
Ray McCallum,PG,23,SAC,68,30,1436,206,470,.438,34,111,.306,172,359,.479,.474,57,84,.679,52,128,180,188,45,11,85,92,503,2015
C.J. McCollum,SG,23,POR,62,3,973,159,365,.436,55,139,.396,104,226,.460,.511,51,73,.699,14,77,91,64,43,8,48,81,424,2015
K.J. McDaniels,SG,21,TOT,62,15,1352,172,434,.396,43,150,.287,129,284,.454,.446,100,133,.752,65,135,200,72,44,70,105,126,487,2015
K.J. McDaniels,SG,21,PHI,52,15,1319,167,419,.399,43,147,.293,124,272,.456,.450,99,131,.756,64,131,195,70,44,68,104,121,476,2015
K.J. McDaniels,SG,21,HOU,10,0,33,5,15,.333,0,3,.000,5,12,.417,.333,1,2,.500,1,4,5,2,0,2,1,5,11,2015
Doug McDermott,SF,23,CHI,36,0,321,43,107,.402,13,41,.317,30,66,.455,.463,10,15,.667,6,37,43,6,4,1,17,29,109,2015
Mitch McGary,PF,22,OKC,32,2,485,88,165,.533,0,2,.000,88,163,.540,.533,25,40,.625,53,112,165,14,16,16,31,72,201,2015
JaVale McGee,C,27,TOT,23,0,256,42,79,.532,0,0,.000,42,79,.532,.532,22,33,.667,18,43,61,3,2,20,18,30,106,2015
JaVale McGee,C,27,DEN,17,0,195,34,61,.557,0,0,.000,34,61,.557,.557,20,29,.690,14,34,48,1,2,19,13,28,88,2015
JaVale McGee,C,27,PHI,6,0,61,8,18,.444,0,0,.000,8,18,.444,.444,2,4,.500,4,9,13,2,0,1,5,2,18,2015
Ben McLemore,SG,21,SAC,82,82,2670,363,831,.437,140,391,.358,223,440,.507,.521,130,160,.813,31,210,241,140,77,19,138,219,996,2015
Jerel McNeal,PG,27,PHO,6,0,36,3,11,.273,1,2,.500,2,9,.222,.318,2,2,1.000,0,3,3,2,3,1,5,5,9,2015
Josh McRoberts,PF,27,MIA,17,4,296,28,53,.528,8,19,.421,20,34,.588,.604,8,13,.615,7,38,45,33,12,3,22,41,72,2015
Jodie Meeks,SG,27,DET,60,0,1462,222,534,.416,74,212,.349,148,322,.460,.485,145,160,.906,12,92,104,79,59,6,57,76,663,2015
Gal Mekel,PG,26,NOP,4,0,43,3,20,.150,0,3,.000,3,17,.176,.150,0,0,.000,0,1,1,13,2,0,2,1,6,2015
Khris Middleton,SF,23,MIL,79,58,2378,406,869,.467,109,268,.407,297,601,.494,.530,134,156,.859,48,299,347,182,122,11,113,183,1055,2015
C.J. Miles,SG,27,IND,70,40,1841,329,827,.398,154,446,.345,175,381,.459,.491,130,161,.807,18,196,214,75,60,26,73,132,942,2015
Andre Miller,PG,38,TOT,81,0,1253,145,290,.500,7,34,.206,138,256,.539,.512,58,77,.753,37,116,153,284,32,6,104,103,355,2015
Andre Miller,PG,38,WAS,51,0,631,77,142,.542,1,8,.125,76,134,.567,.546,28,39,.718,21,56,77,143,14,2,46,56,183,2015
Andre Miller,PG,38,SAC,30,0,622,68,148,.459,6,26,.231,62,122,.508,.480,30,38,.789,16,60,76,141,18,4,58,47,172,2015
Darius Miller,SF,24,NOP,5,1,43,1,7,.143,0,1,.000,1,6,.167,.143,0,0,.000,0,1,1,2,1,0,1,8,2,2015
Mike Miller,SF,34,CLE,52,15,701,37,114,.325,32,98,.327,5,16,.313,.465,3,4,.750,4,87,91,46,14,4,23,74,109,2015
Quincy Miller,PF,22,TOT,10,0,119,9,38,.237,3,18,.167,6,20,.300,.276,8,11,.727,4,16,20,8,7,5,5,9,29,2015
Quincy Miller,PF,22,SAC,6,0,61,4,18,.222,1,7,.143,3,11,.273,.250,8,11,.727,2,10,12,3,6,3,3,4,17,2015
Quincy Miller,PF,22,DET,4,0,58,5,20,.250,2,11,.182,3,9,.333,.300,0,0,.000,2,6,8,5,1,2,2,5,12,2015
Patty Mills,PG,26,SAS,51,0,801,128,336,.381,62,182,.341,66,154,.429,.473,33,40,.825,21,54,75,87,28,2,35,58,351,2015
Elijah Millsap,SG,27,UTA,47,5,924,81,238,.340,28,90,.311,53,148,.358,.399,58,86,.674,28,122,150,58,56,16,67,124,248,2015
Paul Millsap,PF,29,ATL,73,73,2390,443,930,.476,77,216,.356,366,714,.513,.518,255,337,.757,139,431,570,223,130,69,166,201,1218,2015
Nikola Mirotic,PF,23,CHI,82,3,1654,253,624,.405,99,313,.316,154,311,.495,.485,228,284,.803,63,341,404,97,54,54,89,172,833,2015
Nazr Mohammed,C,37,CHI,23,0,128,13,30,.433,0,0,.000,13,30,.433,.433,1,3,.333,11,27,38,3,4,5,7,16,27,2015
Greg Monroe,PF,24,DET,69,57,2137,423,853,.496,0,0,.000,423,853,.496,.496,252,336,.750,229,475,704,142,78,34,149,148,1098,2015
E'Twaun Moore,SG,25,CHI,56,0,504,62,139,.446,13,38,.342,49,101,.485,.493,12,20,.600,12,34,46,33,20,6,14,45,149,2015
Eric Moreland,PF,23,SAC,3,0,2,1,1,1.000,0,0,.000,1,1,1.000,1.000,0,0,.000,0,1,1,0,0,0,0,1,2,2015
Darius Morris,PG,24,BRK,38,0,299,36,106,.340,7,33,.212,29,73,.397,.373,4,9,.444,7,20,27,48,9,0,21,20,83,2015
Marcus Morris,PF,25,PHO,81,35,2045,331,763,.434,112,313,.358,219,450,.487,.507,71,113,.628,73,312,385,133,63,16,73,188,845,2015
Markieff Morris,PF,25,PHO,82,82,2581,512,1100,.465,57,179,.318,455,921,.494,.491,177,232,.763,110,396,506,192,101,39,170,245,1258,2015
Anthony Morrow,SG,29,OKC,74,0,1806,285,615,.463,141,325,.434,144,290,.497,.578,79,89,.888,40,155,195,60,54,11,38,135,790,2015
Donatas Motiejunas,PF,24,HOU,71,62,2037,353,700,.504,49,133,.368,304,567,.536,.539,100,166,.602,137,284,421,130,56,34,123,203,855,2015
Timofey Mozgov,C,28,TOT,81,80,2045,314,566,.555,2,6,.333,312,560,.557,.557,155,216,.718,203,388,591,55,33,97,116,227,785,2015
Timofey Mozgov,C,28,DEN,35,35,897,117,232,.504,2,6,.333,115,226,.509,.509,63,86,.733,91,181,272,16,15,41,47,114,299,2015
Timofey Mozgov,C,28,CLE,46,45,1148,197,334,.590,0,0,.000,197,334,.590,.590,92,130,.708,112,207,319,39,18,56,69,113,486,2015
Shabazz Muhammad,SG,22,MIN,38,13,866,194,397,.489,20,51,.392,174,346,.503,.514,104,145,.717,63,91,154,44,18,7,35,49,512,2015
Toure' Murry,SG-PG,25,TOT,5,0,18,2,5,.400,0,0,.000,2,5,.400,.400,2,2,1.000,1,0,1,1,1,0,4,2,6,2015
Toure' Murry,PG,25,UTA,1,0,1,0,1,.000,0,0,.000,0,1,.000,.000,0,0,.000,0,0,0,0,0,0,0,0,0,2015
Toure' Murry,SG,25,WAS,4,0,17,2,4,.500,0,0,.000,2,4,.500,.500,2,2,1.000,1,0,1,1,1,0,4,2,6,2015
Mike Muscala,PF,23,ATL,40,8,502,83,151,.550,9,22,.409,74,129,.574,.579,22,25,.880,52,67,119,25,16,19,21,52,197,2015
Shabazz Napier,PG,23,MIA,51,10,1012,87,228,.382,43,118,.364,44,110,.400,.476,44,56,.786,17,96,113,130,40,4,81,76,261,2015
Gary Neal,SG,30,TOT,54,1,1193,188,503,.374,50,164,.305,138,339,.407,.423,117,135,.867,14,115,129,100,23,1,65,88,543,2015
Gary Neal,SG,30,CHO,43,0,931,143,398,.359,39,133,.293,104,265,.392,.408,88,102,.863,14,80,94,80,16,1,55,70,413,2015
Gary Neal,SG,30,MIN,11,1,262,45,105,.429,11,31,.355,34,74,.459,.481,29,33,.879,0,35,35,20,7,0,10,18,130,2015
Jameer Nelson,PG,32,TOT,63,29,1407,205,504,.407,89,258,.345,116,246,.472,.495,24,36,.667,33,113,146,253,47,6,109,136,523,2015
Jameer Nelson,PG,32,DAL,23,23,584,61,163,.374,38,103,.369,23,60,.383,.491,7,8,.875,14,49,63,95,15,2,39,53,167,2015
Jameer Nelson,PG,32,BOS,6,1,121,9,41,.220,5,25,.200,4,16,.250,.280,6,9,.667,3,14,17,33,7,0,9,13,29,2015
Jameer Nelson,PG,32,DEN,34,5,702,135,300,.450,46,130,.354,89,170,.524,.527,11,19,.579,16,50,66,125,25,4,61,70,327,2015
Andrew Nicholson,PF,25,ORL,40,3,492,83,190,.437,13,41,.317,70,149,.470,.471,15,25,.600,17,65,82,22,6,12,24,51,194,2015
Joakim Noah,C,29,CHI,67,67,2049,190,427,.445,0,2,.000,190,425,.447,.445,105,174,.603,219,427,646,312,48,74,123,203,485,2015
Nerlens Noel,C,20,PHI,75,71,2311,302,653,.462,0,0,.000,302,653,.462,.462,140,230,.609,185,426,611,128,133,142,146,208,744,2015
Lucas Nogueira,C,22,TOR,6,0,23,2,8,.250,0,0,.000,2,8,.250,.250,2,4,.500,2,9,11,1,2,0,2,6,6,2015
Steve Novak,SF-PF,31,TOT,35,0,197,22,56,.393,19,48,.396,3,8,.375,.563,0,2,.000,2,20,22,11,0,2,5,23,63,2015
Steve Novak,SF,31,UTA,22,0,109,16,35,.457,16,33,.485,0,2,.000,.686,0,2,.000,1,15,16,6,0,1,3,13,48,2015
Steve Novak,PF,31,OKC,13,0,88,6,21,.286,3,15,.200,3,6,.500,.357,0,0,.000,1,5,6,5,0,1,2,10,15,2015
Dirk Nowitzki,PF,36,DAL,77,77,2282,487,1062,.459,104,274,.380,383,788,.486,.508,255,289,.882,44,413,457,143,39,33,82,160,1333,2015
Jusuf Nurkic,C,20,DEN,62,27,1103,171,383,.446,0,2,.000,171,381,.449,.446,84,132,.636,125,257,382,50,52,68,86,207,426,2015
Johnny O'Bryant,PF,21,MIL,34,15,368,44,120,.367,0,0,.000,44,120,.367,.367,12,27,.444,26,38,64,17,5,4,25,44,100,2015
Kyle O'Quinn,PF,24,ORL,51,17,824,119,242,.492,12,43,.279,107,199,.538,.517,44,57,.772,46,153,199,59,31,39,55,110,294,2015
Victor Oladipo,SG,22,ORL,72,71,2573,473,1086,.436,84,248,.339,389,838,.464,.474,262,320,.819,51,251,302,295,120,19,204,187,1292,2015
Kelly Olynyk,C,23,BOS,64,13,1423,251,528,.475,61,175,.349,190,353,.538,.533,93,136,.684,92,211,303,109,64,39,98,213,656,2015
Arinze Onuaku,C,27,MIN,6,1,68,12,14,.857,0,0,.000,12,14,.857,.857,3,8,.375,7,14,21,4,1,3,2,6,27,2015
Zaza Pachulia,C,30,MIL,73,45,1730,240,529,.454,0,3,.000,240,526,.456,.454,126,160,.788,197,303,500,178,80,21,133,170,606,2015
Kostas Papanikolaou,SF,24,HOU,43,1,795,69,197,.350,31,106,.292,38,91,.418,.429,13,18,.722,39,79,118,85,29,13,55,71,182,2015
Jannero Pargo,PG,35,CHO,9,0,73,15,35,.429,9,22,.409,6,13,.462,.557,2,2,1.000,0,3,3,8,0,0,3,8,41,2015
Jabari Parker,PF,19,MIL,25,25,738,129,263,.490,4,16,.250,125,247,.506,.498,46,66,.697,50,88,138,42,31,5,47,42,308,2015
Tony Parker,PG,32,SAS,68,68,1953,404,832,.486,38,89,.427,366,743,.493,.508,130,166,.783,15,114,129,335,44,2,146,108,976,2015
Chandler Parsons,SF,26,DAL,66,66,2186,383,829,.462,132,347,.380,251,482,.521,.542,139,193,.720,64,259,323,161,69,19,96,140,1037,2015
Patrick Patterson,PF,25,TOR,81,4,2156,240,535,.449,105,283,.371,135,252,.536,.547,63,80,.788,127,306,433,155,60,44,54,149,648,2015
Chris Paul,PG,29,LAC,82,82,2857,568,1170,.485,139,349,.398,429,821,.523,.545,289,321,.900,52,324,376,838,156,15,190,203,1564,2015
Adreian Payne,PF,23,TOT,32,22,739,91,220,.414,1,9,.111,90,211,.427,.416,30,46,.652,48,114,162,30,19,9,44,88,213,2015
Adreian Payne,PF,23,ATL,3,0,19,2,7,.286,0,1,.000,2,6,.333,.286,1,2,.500,1,3,4,0,1,0,0,4,5,2015
Adreian Payne,PF,23,MIN,29,22,720,89,213,.418,1,8,.125,88,205,.429,.420,29,44,.659,47,111,158,30,18,9,44,84,208,2015
Elfrid Payton,PG,20,ORL,82,63,2489,301,708,.425,11,42,.262,290,666,.435,.433,118,214,.551,107,242,349,533,142,20,203,193,731,2015
Nikola Pekovic,C,29,MIN,31,29,815,139,328,.424,0,0,.000,139,328,.424,.424,108,129,.837,89,145,234,27,19,12,42,59,386,2015
Kendrick Perkins,C,30,TOT,68,3,1148,102,227,.449,0,1,.000,102,226,.451,.449,42,83,.506,91,229,320,51,16,42,95,162,246,2015
Kendrick Perkins,C,30,OKC,51,3,981,82,186,.441,0,1,.000,82,185,.443,.441,38,75,.507,80,199,279,43,14,38,74,135,202,2015
Kendrick Perkins,C,30,CLE,17,0,167,20,41,.488,0,0,.000,20,41,.488,.488,4,8,.500,11,30,41,8,2,4,21,27,44,2015
Paul Pierce,SF,37,WAS,73,73,1914,293,656,.447,118,303,.389,175,353,.496,.537,164,210,.781,45,249,294,144,46,24,92,160,868,2015
Mason Plumlee,C,24,BRK,82,45,1743,280,489,.573,0,3,.000,280,486,.576,.573,157,317,.495,175,337,512,74,65,63,106,207,717,2015
Miles Plumlee,C,26,TOT,73,28,1194,136,254,.535,0,0,.000,136,254,.535,.535,22,46,.478,112,208,320,34,41,66,51,111,294,2015
Miles Plumlee,C,26,PHO,54,28,1005,107,195,.549,0,0,.000,107,195,.549,.549,19,38,.500,95,179,274,27,35,55,45,99,233,2015
Miles Plumlee,C,26,MIL,19,0,189,29,59,.492,0,0,.000,29,59,.492,.492,3,8,.375,17,29,46,7,6,11,6,12,61,2015
Quincy Pondexter,SF-SG,26,TOT,75,30,1793,188,447,.421,91,244,.373,97,203,.478,.522,71,96,.740,53,142,195,94,19,24,51,150,538,2015
Quincy Pondexter,SG,26,MEM,30,2,540,48,135,.356,17,73,.233,31,62,.500,.419,21,30,.700,20,37,57,28,5,5,10,47,134,2015
Quincy Pondexter,SF,26,NOP,45,28,1253,140,312,.449,74,171,.433,66,141,.468,.567,50,66,.758,33,105,138,66,14,19,41,103,404,2015
Otto Porter,SF,21,WAS,74,13,1432,176,391,.450,35,104,.337,141,287,.491,.495,58,79,.734,70,151,221,65,44,30,52,97,445,2015
Dwight Powell,PF,23,TOT,29,0,236,31,67,.463,3,11,.273,28,56,.500,.485,25,33,.758,18,32,50,9,9,6,11,40,90,2015
Dwight Powell,PF,23,BOS,5,0,9,4,5,.800,0,0,.000,4,5,.800,.800,1,2,.500,0,1,1,0,2,0,2,1,9,2015
Dwight Powell,PF,23,DAL,24,0,227,27,62,.435,3,11,.273,24,51,.471,.460,24,31,.774,18,31,49,9,7,6,9,39,81,2015
Phil Pressey,PG,23,BOS,50,0,600,64,174,.368,16,65,.246,48,109,.440,.414,33,49,.673,13,67,80,117,30,6,41,54,177,2015
A.J. Price,PG,28,TOT,26,0,324,51,137,.372,15,57,.263,36,80,.450,.427,16,24,.667,6,26,32,46,7,0,14,15,133,2015
A.J. Price,PG,28,IND,10,0,193,39,89,.438,15,39,.385,24,50,.480,.522,12,18,.667,2,12,14,27,4,0,10,9,105,2015
A.J. Price,PG,28,CLE,11,0,87,9,34,.265,0,11,.000,9,23,.391,.265,4,6,.667,4,11,15,13,3,0,3,1,22,2015
A.J. Price,PG,28,PHO,5,0,44,3,14,.214,0,7,.000,3,7,.429,.214,0,0,.000,0,3,3,6,0,0,1,5,6,2015
Ronnie Price,PG,31,LAL,43,20,982,77,223,.345,31,109,.284,46,114,.404,.415,36,45,.800,19,50,69,165,67,4,52,118,221,2015
Pablo Prigioni,PG,37,TOT,67,3,1197,91,228,.399,57,166,.343,34,62,.548,.524,35,41,.854,30,89,119,171,79,1,62,88,274,2015
Pablo Prigioni,PG,37,NYK,43,3,795,68,161,.422,43,115,.374,25,46,.543,.556,22,26,.846,18,62,80,104,52,1,47,53,201,2015
Pablo Prigioni,PG,37,HOU,24,0,402,23,67,.343,14,51,.275,9,16,.563,.448,13,15,.867,12,27,39,67,27,0,15,35,73,2015
Tayshaun Prince,SF,34,TOT,58,16,1397,177,402,.440,31,67,.463,146,335,.436,.479,49,65,.754,52,158,210,93,29,16,35,55,434,2015
Tayshaun Prince,SF,34,MEM,26,9,628,75,183,.410,15,33,.455,60,150,.400,.451,25,30,.833,21,62,83,37,9,6,15,22,190,2015
Tayshaun Prince,SF,34,BOS,9,0,198,33,59,.559,5,8,.625,28,51,.549,.602,5,6,.833,6,24,30,18,5,2,4,7,76,2015
Tayshaun Prince,SF,34,DET,23,7,571,69,160,.431,11,26,.423,58,134,.433,.466,19,29,.655,25,72,97,38,15,8,16,26,168,2015
Miroslav Raduljica,C,27,MIN,5,0,23,3,8,.375,0,0,.000,3,8,.375,.375,2,2,1.000,2,3,5,0,1,0,2,8,8,2015
Julius Randle,PF,20,LAL,1,0,14,1,3,.333,0,0,.000,1,3,.333,.333,0,2,.000,0,0,0,0,0,0,1,1,2,2015
Shavlik Randolph,PF,31,TOT,21,0,126,9,35,.257,0,5,.000,9,30,.300,.257,6,12,.500,16,22,38,4,5,3,3,16,24,2015
Shavlik Randolph,PF,31,PHO,16,0,101,6,25,.240,0,4,.000,6,21,.286,.240,5,10,.500,12,14,26,3,4,2,2,13,17,2015
Shavlik Randolph,PF,31,BOS,5,0,25,3,10,.300,0,1,.000,3,9,.333,.300,1,2,.500,4,8,12,1,1,1,1,3,7,2015
Zach Randolph,PF,33,MEM,71,71,2304,454,932,.487,7,20,.350,447,912,.490,.491,228,298,.765,225,522,747,153,69,14,156,175,1143,2015
J.J. Redick,SG,30,LAC,78,78,2409,447,938,.477,200,458,.437,247,480,.515,.583,183,203,.901,22,145,167,137,39,8,95,134,1277,2015
Glen Rice,SG,24,WAS,5,0,43,3,15,.200,1,7,.143,2,8,.250,.233,4,6,.667,2,2,4,2,0,0,2,11,11,2015
Jason Richardson,SG,34,PHI,19,15,416,62,178,.348,31,96,.323,31,82,.378,.435,17,22,.773,13,53,66,38,13,3,16,28,172,2015
Luke Ridnour,PG,33,ORL,47,0,683,75,176,.426,20,63,.317,55,113,.487,.483,18,21,.857,8,60,68,96,20,4,38,67,188,2015
Austin Rivers,PG-SG,22,TOT,76,5,1563,203,496,.409,39,131,.298,164,365,.449,.449,85,126,.675,27,125,152,155,48,14,65,146,530,2015
Austin Rivers,SG,22,NOP,35,3,772,86,222,.387,14,50,.280,72,172,.419,.419,53,71,.746,12,56,68,87,18,7,30,65,239,2015
Austin Rivers,PG,22,LAC,41,2,791,117,274,.427,25,81,.309,92,193,.477,.473,32,55,.582,15,69,84,68,30,7,35,81,291,2015
Andre Roberson,SG,23,OKC,67,65,1286,92,201,.458,21,85,.247,71,116,.612,.510,23,48,.479,60,195,255,70,53,29,46,141,228,2015
Brian Roberts,PG,29,CHO,72,10,1330,176,452,.389,62,193,.321,114,259,.440,.458,66,74,.892,13,96,109,162,33,6,57,75,480,2015
Glenn Robinson,SG-SF,21,TOT,35,1,261,26,67,.388,5,19,.263,21,48,.438,.425,16,24,.667,15,24,39,11,6,1,11,15,73,2015
Glenn Robinson,SG,21,MIN,25,0,108,8,24,.333,1,6,.167,7,18,.389,.354,12,16,.750,4,10,14,3,3,0,3,5,29,2015
Glenn Robinson,SF,21,PHI,10,1,153,18,43,.419,4,13,.308,14,30,.467,.465,4,8,.500,11,14,25,8,3,1,8,10,44,2015
Nate Robinson,PG,30,TOT,42,1,591,88,255,.345,31,112,.277,57,143,.399,.406,31,46,.674,17,33,50,97,20,3,30,76,238,2015
Nate Robinson,PG,30,DEN,33,1,465,71,204,.348,24,92,.261,47,112,.420,.407,26,40,.650,14,25,39,77,14,3,22,68,192,2015
Nate Robinson,PG,30,LAC,9,0,126,17,51,.333,7,20,.350,10,31,.323,.402,5,6,.833,3,8,11,20,6,0,8,8,46,2015
Thomas Robinson,PF,23,TOT,54,4,798,126,260,.485,0,2,.000,126,258,.488,.485,56,106,.528,95,208,303,33,32,20,59,104,308,2015
Thomas Robinson,PF,23,POR,32,4,391,47,91,.516,0,0,.000,47,91,.516,.516,21,48,.438,33,100,133,9,16,11,33,54,115,2015
Thomas Robinson,PF,23,PHI,22,0,407,79,169,.467,0,2,.000,79,167,.473,.467,35,58,.603,62,108,170,24,16,9,26,50,193,2015
Rajon Rondo,PG,28,TOT,68,68,2018,275,645,.426,27,86,.314,248,559,.444,.447,31,78,.397,73,300,373,538,91,7,210,153,608,2015
Rajon Rondo,PG,28,BOS,22,22,699,81,200,.405,8,32,.250,73,168,.435,.425,12,36,.333,25,140,165,237,37,3,75,42,182,2015
Rajon Rondo,PG,28,DAL,46,46,1319,194,445,.436,19,54,.352,175,391,.448,.457,19,42,.452,48,160,208,301,54,4,135,111,426,2015
Derrick Rose,PG,26,CHI,51,51,1530,338,835,.405,76,271,.280,262,564,.465,.450,152,187,.813,35,126,161,251,36,16,161,63,904,2015
Terrence Ross,SF,23,TOR,82,61,2092,309,753,.410,145,390,.372,164,363,.452,.507,44,56,.786,32,194,226,86,53,25,69,136,807,2015
Ricky Rubio,PG,24,MIN,22,22,692,78,219,.356,13,51,.255,65,168,.387,.386,57,71,.803,19,106,125,193,38,1,64,59,226,2015
Damjan Rudez,SF,28,IND,68,2,1047,119,263,.452,69,170,.406,50,93,.538,.584,16,23,.696,8,39,47,53,16,5,47,79,323,2015
Brandon Rush,SG,29,GSW,33,0,271,11,54,.204,3,27,.111,8,27,.296,.231,5,11,.455,4,37,41,12,5,12,11,27,30,2015
Robert Sacre,C,25,LAL,67,18,1133,126,306,.412,0,1,.000,126,305,.413,.412,55,82,.671,89,144,233,55,28,43,36,121,307,2015
John Salmons,SF,35,NOP,21,0,270,16,48,.333,8,26,.308,8,22,.364,.417,2,4,.500,4,17,21,13,9,4,5,25,42,2015
JaKarr Sampson,SF,21,PHI,74,32,1131,146,346,.422,31,127,.244,115,219,.525,.467,63,94,.670,35,128,163,77,38,26,76,135,386,2015
Larry Sanders,C,26,MIL,27,26,586,86,172,.500,0,0,.000,86,172,.500,.500,24,48,.500,67,99,166,23,26,39,28,104,196,2015
Dennis Schroder,PG,21,ATL,77,10,1516,284,665,.427,52,148,.351,232,517,.449,.466,148,179,.827,29,135,164,317,49,4,150,127,768,2015
Luis Scola,PF,34,IND,81,16,1659,300,642,.467,5,20,.250,295,622,.474,.471,158,226,.699,138,388,526,105,47,18,94,192,763,2015
Mike Scott,PF,26,ATL,68,0,1123,201,453,.444,66,192,.344,135,261,.517,.517,61,77,.792,45,154,199,75,25,3,39,83,529,2015
Thabo Sefolosha,SF,30,ATL,52,7,976,104,249,.418,25,78,.321,79,171,.462,.468,45,58,.776,53,170,223,75,53,21,38,67,278,2015
Kevin Seraphin,C,25,WAS,79,0,1235,231,450,.513,0,2,.000,231,448,.516,.513,58,82,.707,87,201,288,59,10,59,98,197,520,2015
Ramon Sessions,PG,28,TOT,64,10,1188,125,334,.374,19,60,.317,106,274,.387,.403,133,173,.769,23,121,144,182,29,0,86,73,402,2015
Ramon Sessions,PG,28,SAC,36,7,642,63,183,.344,6,28,.214,57,155,.368,.361,64,88,.727,13,56,69,96,13,0,51,45,196,2015
Ramon Sessions,PG,28,WAS,28,3,546,62,151,.411,13,32,.406,49,119,.412,.454,69,85,.812,10,65,75,86,16,0,35,28,206,2015
Iman Shumpert,SG,24,TOT,62,25,1545,193,471,.410,67,196,.342,126,275,.458,.481,43,64,.672,55,169,224,135,81,16,91,138,496,2015
Iman Shumpert,SG,24,NYK,24,24,625,88,215,.409,23,66,.348,65,149,.436,.463,25,37,.676,22,59,81,78,30,3,42,67,224,2015
Iman Shumpert,SG,24,CLE,38,1,920,105,256,.410,44,130,.338,61,126,.484,.496,18,27,.667,33,110,143,57,51,13,49,71,272,2015
Alexey Shved,SG,26,TOT,42,9,767,133,335,.397,47,139,.338,86,196,.439,.467,121,150,.807,23,76,99,106,30,6,48,48,434,2015
Alexey Shved,SG,26,PHI,17,0,285,52,130,.400,17,57,.298,35,73,.479,.465,48,57,.842,8,14,22,46,14,1,18,21,169,2015
Alexey Shved,SG,26,HOU,9,0,59,8,24,.333,4,12,.333,4,12,.333,.417,9,11,.818,1,3,4,3,1,0,5,2,29,2015
Alexey Shved,SG,26,NYK,16,9,423,73,181,.403,26,70,.371,47,111,.423,.475,64,82,.780,14,59,73,57,15,5,25,25,236,2015
Henry Sims,C,24,PHI,73,32,1399,238,502,.474,4,22,.182,234,480,.488,.478,106,137,.774,121,238,359,79,39,30,99,135,586,2015
Kyle Singler,SF,26,TOT,80,58,1743,172,446,.386,96,241,.398,76,205,.371,.493,40,52,.769,33,161,194,85,47,21,55,153,480,2015
Kyle Singler,SF,26,DET,54,40,1287,140,350,.400,76,187,.406,64,163,.393,.509,29,36,.806,23,116,139,67,33,14,42,98,385,2015
Kyle Singler,SF,26,OKC,26,18,456,32,96,.333,20,54,.370,12,42,.286,.438,11,16,.688,10,45,55,18,14,7,13,55,95,2015
Donald Sloan,PG,27,IND,53,21,1107,145,355,.408,41,131,.313,104,224,.464,.466,60,77,.779,12,131,143,190,23,0,65,47,391,2015
Marcus Smart,PG,20,BOS,67,38,1808,175,477,.367,91,272,.335,84,205,.410,.462,82,127,.646,61,161,222,208,99,18,90,176,523,2015
Greg Smith,PF,24,DAL,42,2,363,30,49,.612,0,0,.000,30,49,.612,.612,20,39,.513,26,53,79,9,7,11,11,53,80,2015
Ish Smith,PG,26,TOT,55,14,832,143,367,.390,18,60,.300,125,307,.407,.414,34,57,.596,15,85,100,180,36,6,78,50,338,2015
Ish Smith,PG,26,OKC,30,0,155,15,45,.333,1,5,.200,14,40,.350,.344,6,9,.667,5,22,27,28,4,1,9,12,37,2015
Ish Smith,PG,26,PHI,25,14,677,128,322,.398,17,55,.309,111,267,.416,.424,28,48,.583,10,63,73,152,32,5,69,38,301,2015
J.R. Smith,SG,29,TOT,70,51,2080,315,755,.417,163,426,.383,152,329,.462,.525,54,72,.750,30,188,218,195,82,22,97,163,847,2015
J.R. Smith,SG,29,NYK,24,6,619,101,251,.402,32,90,.356,69,161,.429,.466,27,39,.692,4,54,58,81,18,4,45,44,261,2015
J.R. Smith,SG,29,CLE,46,45,1461,214,504,.425,131,336,.390,83,168,.494,.555,27,33,.818,26,134,160,114,64,18,52,119,586,2015
Jason Smith,C,28,NYK,82,31,1785,257,592,.434,15,42,.357,242,550,.440,.447,127,153,.830,98,226,324,140,32,44,104,205,656,2015
Josh Smith,PF,29,TOT,83,35,2300,414,987,.419,72,228,.316,342,759,.451,.456,127,255,.498,152,378,530,277,87,116,206,228,1027,2015
Josh Smith,PF,29,DET,28,28,896,153,391,.391,9,37,.243,144,354,.407,.403,52,111,.468,52,150,202,132,37,48,72,82,367,2015
Josh Smith,PF,29,HOU,55,7,1404,261,596,.438,63,191,.330,198,405,.489,.491,75,144,.521,100,228,328,145,50,68,134,146,660,2015
Russ Smith,PG,23,TOT,12,0,65,8,25,.320,2,11,.182,6,14,.429,.360,12,13,.923,1,5,6,8,3,0,12,13,30,2015
Russ Smith,PG,23,NOP,6,0,29,2,10,.200,1,6,.167,1,4,.250,.250,0,0,.000,0,3,3,2,0,0,7,6,5,2015
Russ Smith,PG,23,MEM,6,0,36,6,15,.400,1,5,.200,5,10,.500,.433,12,13,.923,1,2,3,6,3,0,5,7,25,2015
Tony Snell,SF,23,CHI,72,22,1412,159,371,.429,73,197,.371,86,174,.494,.527,44,55,.800,31,145,176,62,32,11,48,86,435,2015
Marreese Speights,C,27,GSW,76,9,1207,318,646,.492,5,18,.278,313,628,.498,.496,150,178,.843,109,216,325,72,20,34,82,189,791,2015
Tiago Splitter,C,30,SAS,52,35,1030,169,303,.558,0,0,.000,169,303,.558,.558,90,120,.750,91,161,252,78,35,37,60,103,428,2015
Nik Stauskas,SG,21,SAC,73,1,1127,108,296,.365,48,149,.322,60,147,.408,.446,55,64,.859,11,77,88,67,20,17,40,92,319,2015
Lance Stephenson,SG,24,CHO,61,25,1573,207,550,.376,18,105,.171,189,445,.425,.393,69,110,.627,39,238,277,240,38,8,128,134,501,2015
Greg Stiemsma,C,29,TOR,17,0,66,6,8,.750,0,0,.000,6,8,.750,.750,2,4,.500,9,6,15,3,2,0,7,15,14,2015
David Stockton,PG,23,SAC,3,0,33,2,6,.333,1,2,.500,1,4,.250,.417,3,6,.500,0,2,2,9,2,0,4,1,8,2015
Jarnell Stokes,PF,21,MEM,19,2,126,21,37,.568,0,0,.000,21,37,.568,.568,15,28,.536,16,18,34,4,5,5,7,25,57,2015
Amar'e Stoudemire,PF,32,TOT,59,15,1245,273,490,.557,0,4,.000,273,486,.562,.557,134,186,.720,110,219,329,45,29,38,78,161,680,2015
Amar'e Stoudemire,PF,32,NYK,36,14,865,169,311,.543,0,3,.000,169,308,.549,.543,94,127,.740,83,162,245,37,20,34,63,111,432,2015
Amar'e Stoudemire,PF,32,DAL,23,1,380,104,179,.581,0,1,.000,104,178,.584,.581,40,59,.678,27,57,84,8,9,4,15,50,248,2015
Rodney Stuckey,PG,28,IND,71,36,1874,332,754,.440,55,141,.390,277,613,.452,.477,177,216,.819,36,212,248,219,56,10,118,131,896,2015
Jared Sullinger,PF,22,BOS,58,49,1566,311,708,.439,52,184,.283,259,524,.494,.476,96,129,.744,147,294,441,134,44,42,78,153,770,2015
Jeffery Taylor,SF,25,CHO,29,13,430,45,114,.395,11,36,.306,34,78,.436,.443,26,41,.634,14,39,53,22,12,1,19,36,127,2015
Jeff Teague,PG,26,ATL,73,72,2228,408,887,.460,71,207,.343,337,680,.496,.500,275,319,.862,30,154,184,513,125,31,205,139,1162,2015
Mirza Teletovic,PF,29,BRK,40,4,892,122,319,.382,62,193,.321,60,126,.476,.480,33,46,.717,27,167,194,46,14,16,53,74,339,2015
Sebastian Telfair,PG,29,OKC,16,1,327,46,125,.368,18,60,.300,28,65,.431,.440,24,34,.706,2,28,30,45,10,0,18,29,134,2015
Garrett Temple,SG,28,WAS,52,18,735,68,170,.400,33,88,.375,35,82,.427,.497,35,48,.729,24,66,90,56,42,9,34,76,204,2015
Jason Terry,SG,37,HOU,77,18,1641,188,446,.422,126,323,.390,62,123,.504,.563,39,48,.813,15,106,121,147,66,19,74,116,541,2015
Isaiah Thomas,PG,25,TOT,67,1,1726,335,797,.420,129,346,.373,206,451,.457,.501,302,348,.868,33,120,153,284,57,5,143,150,1101,2015
Isaiah Thomas,PG,25,PHO,46,1,1181,218,512,.426,81,207,.391,137,305,.449,.505,184,211,.872,26,83,109,171,45,5,89,105,701,2015
Isaiah Thomas,PG,25,BOS,21,0,545,117,285,.411,48,139,.345,69,146,.473,.495,118,137,.861,7,37,44,113,12,0,54,45,400,2015
Lance Thomas,PF-SF,26,TOT,62,37,1490,182,442,.412,7,22,.318,175,420,.417,.420,72,99,.727,65,130,195,69,37,8,74,101,443,2015
Lance Thomas,SF,26,OKC,22,13,450,45,126,.357,0,1,.000,45,125,.360,.357,23,33,.697,28,47,75,20,11,0,17,38,113,2015
Lance Thomas,PF,26,NYK,40,24,1040,137,316,.434,7,21,.333,130,295,.441,.445,49,66,.742,37,83,120,49,26,8,57,63,330,2015
Malcolm Thomas,PF,26,PHI,17,0,194,18,40,.450,0,7,.000,18,33,.545,.450,9,13,.692,16,40,56,7,3,1,13,17,45,2015
Tyrus Thomas,PF,28,MEM,2,0,7,1,1,1.000,0,0,.000,1,1,1.000,1.000,2,2,1.000,0,0,0,1,0,0,0,0,4,2015
Hollis Thompson,SG,23,PHI,71,23,1776,224,543,.413,115,287,.401,109,256,.426,.518,63,89,.708,53,145,198,85,57,26,66,141,626,2015
Jason Thompson,PF,28,SAC,81,63,1991,201,428,.470,0,1,.000,201,427,.471,.470,89,143,.622,139,391,530,85,33,57,84,239,491,2015
Klay Thompson,SG,24,GSW,77,77,2455,602,1299,.463,239,545,.439,363,754,.481,.555,225,256,.879,27,220,247,222,87,60,149,122,1668,2015
Tristan Thompson,PF,23,CLE,82,15,2194,267,488,.547,0,0,.000,267,488,.547,.547,159,248,.641,274,383,657,39,34,61,83,189,693,2015
Marcus Thornton,SG,27,TOT,48,0,721,140,345,.406,54,143,.378,86,202,.426,.484,46,56,.821,23,63,86,36,27,7,27,38,380,2015
Marcus Thornton,SG,27,BOS,39,0,640,127,305,.416,52,124,.419,75,181,.414,.502,42,51,.824,19,54,73,34,21,7,22,35,348,2015
Marcus Thornton,SG,27,PHO,9,0,81,13,40,.325,2,19,.105,11,21,.524,.350,4,5,.800,4,9,13,2,6,0,5,3,32,2015
Anthony Tolliver,PF,29,TOT,76,11,1432,161,393,.410,106,290,.366,55,103,.534,.545,54,69,.783,51,185,236,59,24,16,51,137,482,2015
Anthony Tolliver,PF,29,PHO,24,0,272,26,74,.351,24,62,.387,2,12,.167,.514,4,6,.667,6,38,44,10,4,1,11,20,80,2015
Anthony Tolliver,PF,29,DET,52,11,1160,135,319,.423,82,228,.360,53,91,.582,.552,50,63,.794,45,147,192,49,20,15,40,117,402,2015
P.J. Tucker,SF,29,PHO,78,63,2383,261,596,.438,87,252,.345,174,344,.506,.511,104,143,.727,114,388,502,122,107,23,96,179,713,2015
Ronny Turiaf,C,32,MIN,2,0,19,0,0,.000,0,0,.000,0,0,.000,.000,0,0,.000,0,1,1,2,0,0,0,0,0,2015
Hedo Turkoglu,SF,35,LAC,62,2,705,83,188,.441,60,139,.432,23,49,.469,.601,6,11,.545,5,94,99,37,19,7,29,66,232,2015
Evan Turner,SG,26,BOS,82,57,2260,320,746,.429,33,119,.277,287,627,.458,.451,106,141,.752,40,377,417,449,83,19,198,180,779,2015
Ekpe Udoh,PF,27,LAC,33,0,128,11,24,.458,0,0,.000,11,24,.458,.458,7,9,.778,7,19,26,8,8,7,7,20,29,2015
Beno Udrih,PG,32,MEM,79,12,1494,246,505,.487,26,97,.268,220,408,.539,.513,87,102,.853,20,123,143,220,46,8,89,88,605,2015
Jonas Valanciunas,C,22,TOR,80,80,2096,373,652,.572,0,1,.000,373,651,.573,.572,217,276,.786,215,478,693,39,33,95,109,222,963,2015
Anderson Varejao,C,32,CLE,26,26,636,111,200,.555,0,2,.000,111,198,.561,.555,33,45,.733,57,113,170,35,19,16,35,58,255,2015
Greivis Vasquez,PG,28,TOR,82,29,1991,296,725,.408,133,351,.379,163,374,.436,.500,50,66,.758,22,194,216,302,46,10,119,177,775,2015
Charlie Villanueva,PF,30,DAL,64,1,678,150,362,.414,83,221,.376,67,141,.475,.529,20,35,.571,30,119,149,19,15,22,28,64,403,2015
Noah Vonleh,PF,19,CHO,25,0,259,30,76,.395,5,13,.385,25,63,.397,.428,18,26,.692,28,58,86,4,4,9,11,20,83,2015
Nikola Vucevic,C,24,ORL,74,74,2529,631,1206,.523,2,6,.333,629,1200,.524,.524,164,218,.752,238,572,810,147,54,54,148,220,1428,2015
Dwyane Wade,SG,33,MIA,62,62,1971,509,1084,.470,29,102,.284,480,982,.489,.483,284,370,.768,58,161,219,299,73,21,209,105,1331,2015
Dion Waiters,SG,23,TOT,80,23,2208,375,946,.396,73,246,.297,302,700,.431,.435,117,172,.680,41,151,192,163,90,21,113,155,940,2015
Dion Waiters,SG,23,CLE,33,3,786,138,342,.404,22,86,.256,116,256,.453,.436,47,60,.783,12,45,57,74,44,10,50,59,345,2015
Dion Waiters,SG,23,OKC,47,20,1422,237,604,.392,51,160,.319,186,444,.419,.435,70,112,.625,29,106,135,89,46,11,63,96,595,2015
Henry Walker,SF,27,MIA,24,13,628,58,168,.345,45,132,.341,13,36,.361,.479,14,18,.778,7,75,82,29,24,9,24,76,175,2015
Kemba Walker,PG,24,CHO,62,58,2119,378,981,.385,85,280,.304,293,701,.418,.429,234,283,.827,35,185,220,318,89,31,100,92,1075,2015
John Wall,PG,24,WAS,79,79,2837,519,1166,.445,65,217,.300,454,949,.478,.473,284,362,.785,36,330,366,792,138,45,304,180,1387,2015
Gerald Wallace,SF,32,BOS,32,0,286,14,34,.412,1,3,.333,13,31,.419,.426,6,15,.400,17,40,57,11,15,4,18,19,35,2015
T.J. Warren,SF,21,PHO,40,1,614,113,214,.528,5,21,.238,108,193,.560,.540,14,19,.737,41,44,85,25,18,9,27,51,245,2015
C.J. Watson,PG,30,IND,57,21,1422,181,417,.434,70,175,.400,111,242,.459,.518,138,167,.826,18,145,163,208,57,9,100,107,570,2015
David Wear,PF,24,SAC,2,0,7,0,2,.000,0,1,.000,0,1,.000,.000,0,0,.000,2,0,2,1,0,0,0,1,0,2015
Travis Wear,SF,24,NYK,51,1,672,84,209,.402,11,30,.367,73,179,.408,.428,20,26,.769,31,75,106,40,15,11,35,55,199,2015
Martell Webster,SF,28,WAS,32,0,352,24,91,.264,10,43,.233,14,48,.292,.319,48,64,.750,10,36,46,17,7,1,22,24,106,2015
David West,PF,34,IND,66,66,1895,323,686,.471,4,20,.200,319,666,.479,.474,119,161,.739,108,341,449,223,48,48,120,160,769,2015
Russell Westbrook,PG,26,OKC,67,67,2302,627,1471,.426,86,288,.299,541,1183,.457,.455,546,654,.835,124,364,488,574,140,14,293,184,1886,2015
Hassan Whiteside,C,25,MIA,48,32,1142,243,387,.628,0,0,.000,243,387,.628,.628,78,156,.500,145,337,482,6,27,123,58,129,564,2015
Shayne Whittington,PF,23,IND,20,0,108,19,42,.452,1,6,.167,18,36,.500,.464,18,23,.783,10,19,29,6,5,2,5,18,57,2015
Andrew Wiggins,SF,19,MIN,82,82,2969,497,1137,.437,39,126,.310,458,1011,.453,.454,354,466,.760,134,240,374,170,86,50,177,190,1387,2015
C.J. Wilcox,SG,24,LAC,21,0,101,16,38,.421,7,19,.368,9,19,.474,.513,2,2,1.000,1,6,7,8,3,1,10,7,41,2015
Deron Williams,PG,30,BRK,68,55,2114,298,771,.387,87,237,.367,211,534,.395,.443,201,241,.834,29,208,237,448,64,17,154,157,884,2015
Derrick Williams,PF,23,SAC,74,6,1462,217,485,.447,49,156,.314,168,329,.511,.498,134,196,.684,41,161,202,50,34,4,56,67,617,2015
Elliot Williams,SG,25,TOT,13,0,119,14,37,.378,8,18,.444,6,19,.316,.486,1,4,.250,0,8,8,12,4,0,4,12,37,2015
Elliot Williams,SG,25,UTA,5,0,42,6,13,.462,5,7,.714,1,6,.167,.654,1,2,.500,0,3,3,4,2,0,4,1,18,2015
Elliot Williams,SG,25,NOP,8,0,77,8,24,.333,3,11,.273,5,13,.385,.396,0,2,.000,0,5,5,8,2,0,0,11,19,2015
Lou Williams,SG,28,TOR,80,0,2016,375,928,.404,152,447,.340,223,481,.464,.486,340,395,.861,24,127,151,164,88,10,101,103,1242,2015
Marvin Williams,PF,28,CHO,78,37,2035,210,495,.424,95,265,.358,115,230,.500,.520,62,87,.713,58,328,386,100,69,36,60,146,577,2015
Mo Williams,PG,32,TOT,68,33,1980,341,860,.397,119,348,.342,222,512,.434,.466,163,187,.872,22,152,174,424,46,14,172,162,964,2015
Mo Williams,PG,32,MIN,41,19,1149,180,447,.403,59,170,.347,121,277,.437,.469,80,94,.851,13,85,98,261,30,8,102,103,499,2015
Mo Williams,PG,32,CHO,27,14,831,161,413,.390,60,178,.337,101,235,.430,.462,83,93,.892,9,67,76,163,16,6,70,59,465,2015
Reggie Williams,SF,28,SAS,20,0,105,15,39,.385,3,19,.158,12,20,.600,.423,4,4,1.000,5,12,17,10,1,0,2,12,37,2015
Shawne Williams,SF,28,TOT,63,22,1087,121,300,.403,64,178,.360,57,122,.467,.510,35,40,.875,36,130,166,44,25,21,30,135,341,2015
Shawne Williams,SF,28,MIA,44,22,924,102,240,.425,60,152,.395,42,88,.477,.550,28,33,.848,27,112,139,36,21,17,23,116,292,2015
Shawne Williams,SF,28,DET,19,0,163,19,60,.317,4,26,.154,15,34,.441,.350,7,7,1.000,9,18,27,8,4,4,7,19,49,2015
Jeff Withey,C,24,NOP,37,0,259,32,64,.500,0,0,.000,32,64,.500,.500,34,50,.680,23,41,64,11,4,18,12,26,98,2015
Nate Wolters,PG,23,TOT,21,0,247,20,57,.351,0,7,.000,20,50,.400,.351,2,6,.333,8,26,34,21,8,2,13,18,42,2015
Nate Wolters,PG,23,MIL,11,0,142,12,31,.387,0,5,.000,12,26,.462,.387,1,4,.250,2,14,16,10,5,0,3,11,25,2015
Nate Wolters,PG,23,NOP,10,0,105,8,26,.308,0,2,.000,8,24,.333,.308,1,2,.500,6,12,18,11,3,2,10,7,17,2015
Brandan Wright,PF,27,TOT,75,7,1449,233,363,.642,0,3,.000,233,360,.647,.642,78,112,.696,128,193,321,41,50,94,34,102,544,2015
Brandan Wright,PF,27,DAL,27,0,505,101,135,.748,0,0,.000,101,135,.748,.748,36,48,.750,51,59,110,10,17,42,13,44,238,2015
Brandan Wright,PF,27,BOS,8,0,86,12,21,.571,0,0,.000,12,21,.571,.571,2,4,.500,7,10,17,8,1,5,5,4,26,2015
Brandan Wright,PF,27,PHO,40,7,858,120,207,.580,0,3,.000,120,204,.588,.580,40,60,.667,70,124,194,23,32,47,16,54,280,2015
Dorell Wright,SF,29,POR,48,2,592,72,190,.379,41,108,.380,31,82,.378,.487,34,42,.810,14,97,111,41,20,11,18,55,219,2015
Tony Wroten,PG,21,PHI,30,15,895,175,434,.403,37,142,.261,138,292,.473,.446,120,180,.667,22,64,86,157,48,8,113,72,507,2015
James Young,SG,19,BOS,31,0,332,36,102,.353,17,66,.258,19,36,.528,.436,16,29,.552,9,33,42,13,8,2,5,22,105,2015
Nick Young,SG,29,LAL,42,0,1000,174,476,.366,83,225,.369,91,251,.363,.453,132,148,.892,17,79,96,41,23,11,44,83,563,2015
Thaddeus Young,PF,26,TOT,76,68,2434,451,968,.466,38,115,.330,413,853,.484,.486,131,200,.655,127,284,411,173,124,25,117,171,1071,2015
Thaddeus Young,PF,26,MIN,48,48,1605,289,641,.451,19,65,.292,270,576,.469,.466,88,129,.682,75,170,245,135,86,17,75,115,685,2015
Thaddeus Young,PF,26,BRK,28,20,829,162,327,.495,19,50,.380,143,277,.516,.524,43,71,.606,52,114,166,38,38,8,42,56,386,2015
Cody Zeller,C,22,CHO,62,45,1487,172,373,.461,1,1,1.000,171,372,.460,.462,127,164,.774,97,265,362,100,34,49,62,156,472,2015
Tyler Zeller,C,25,BOS,82,59,1731,340,619,.549,0,0,.000,340,619,.549,.549,153,186,.823,146,319,465,113,18,52,76,205,833,2015
Quincy Acy,SF,23,TOT,63,0,847,66,141,.468,4,15,.267,62,126,.492,.482,35,53,.660,72,144,216,28,23,26,30,122,171,2014
Quincy Acy,SF,23,TOR,7,0,61,6,14,.429,2,5,.400,4,9,.444,.500,5,8,.625,5,10,15,4,4,3,2,8,19,2014
Quincy Acy,SF,23,SAC,56,0,786,60,127,.472,2,10,.200,58,117,.496,.480,30,45,.667,67,134,201,24,19,23,28,114,152,2014
Steven Adams,C,20,OKC,81,20,1197,93,185,.503,0,0,.000,93,185,.503,.503,79,136,.581,142,190,332,43,40,57,71,203,265,2014
Jeff Adrien,PF,27,TOT,53,12,961,143,275,.520,0,0,.000,143,275,.520,.520,76,119,.639,102,204,306,38,24,36,39,108,362,2014
Jeff Adrien,PF,27,CHA,25,0,256,22,40,.550,0,0,.000,22,40,.550,.550,13,25,.520,33,55,88,7,7,15,8,35,57,2014
Jeff Adrien,PF,27,MIL,28,12,705,121,235,.515,0,0,.000,121,235,.515,.515,63,94,.670,69,149,218,31,17,21,31,73,305,2014
Arron Afflalo,SG,28,ORL,73,73,2552,464,1011,.459,128,300,.427,336,711,.473,.522,274,336,.815,32,230,262,248,35,3,146,136,1330,2014
Alexis Ajinca,C,25,NOP,56,30,951,136,249,.546,0,1,.000,136,248,.548,.546,56,67,.836,94,183,277,40,23,46,63,187,328,2014
Cole Aldrich,C,25,NYK,46,2,330,33,61,.541,0,0,.000,33,61,.541,.541,26,30,.867,37,92,129,14,8,30,18,40,92,2014
LaMarcus Aldridge,PF,28,POR,69,69,2498,652,1423,.458,3,15,.200,649,1408,.461,.459,296,360,.822,166,599,765,178,63,68,123,147,1603,2014
Lavoy Allen,PF,24,TOT,65,2,1072,134,300,.447,2,13,.154,132,287,.460,.450,33,50,.660,119,192,311,71,24,33,44,126,303,2014
Lavoy Allen,PF,24,PHI,51,2,960,117,266,.440,2,13,.154,115,253,.455,.444,27,40,.675,106,171,277,65,22,27,40,115,263,2014
Lavoy Allen,PF,24,IND,14,0,112,17,34,.500,0,0,.000,17,34,.500,.500,6,10,.600,13,21,34,6,2,6,4,11,40,2014
Ray Allen,SG,38,MIA,73,9,1936,240,543,.442,116,309,.375,124,234,.530,.549,105,116,.905,23,182,205,143,54,8,84,115,701,2014
Tony Allen,SG,32,MEM,55,28,1278,204,413,.494,11,47,.234,193,366,.527,.507,76,121,.628,79,129,208,94,90,19,90,121,495,2014
Al-Farouq Aminu,SF,23,NOP,80,65,2045,234,494,.474,13,48,.271,221,446,.496,.487,91,137,.664,129,367,496,114,82,38,88,147,572,2014
Lou Amundson,PF,31,TOT,19,0,185,16,32,.500,0,0,.000,16,32,.500,.500,6,24,.250,28,27,55,6,9,11,14,49,38,2014
Lou Amundson,PF,31,NOP,18,0,184,16,32,.500,0,0,.000,16,32,.500,.500,6,24,.250,28,27,55,6,9,11,14,49,38,2014
Lou Amundson,PF,31,CHI,1,0,1,0,0,.000,0,0,.000,0,0,.000,.000,0,0,.000,0,0,0,0,0,0,0,0,0,2014
Chris Andersen,C,35,MIA,72,0,1396,177,275,.644,3,12,.250,174,263,.662,.649,120,169,.710,129,250,379,19,32,97,53,162,477,2014
Alan Anderson,SF,31,BRK,78,26,1773,194,485,.400,84,248,.339,110,237,.464,.487,92,118,.780,40,135,175,81,48,11,62,147,564,2014
James Anderson,SG,24,PHI,80,62,2309,309,717,.431,115,351,.328,194,366,.530,.511,77,106,.726,59,241,300,149,74,28,106,154,810,2014
Ryan Anderson,PF,25,NOP,22,14,795,155,354,.438,67,164,.409,88,190,.463,.532,59,62,.952,66,76,142,17,10,7,20,47,436,2014
Giannis Antetokounmpo,SF,19,MIL,77,23,1897,173,418,.414,41,118,.347,132,300,.440,.463,138,202,.683,78,261,339,150,60,61,122,173,525,2014
Carmelo Anthony,PF,29,NYK,77,77,2982,743,1643,.452,167,415,.402,576,1228,.469,.503,459,541,.848,145,477,622,242,95,51,198,224,2112,2014
Joel Anthony,C,31,TOT,33,0,186,12,32,.375,0,0,.000,12,32,.375,.375,4,8,.500,15,23,38,2,3,12,3,17,28,2014
Joel Anthony,C,31,MIA,12,0,37,2,6,.333,0,0,.000,2,6,.333,.333,2,2,1.000,2,5,7,0,0,4,1,4,6,2014
Joel Anthony,C,31,BOS,21,0,149,10,26,.385,0,0,.000,10,26,.385,.385,2,6,.333,13,18,31,2,3,8,2,13,22,2014
Pero Antic,C,31,ATL,50,26,925,123,294,.418,56,171,.327,67,123,.545,.514,50,66,.758,57,152,209,58,19,12,55,126,352,2014
Trevor Ariza,SF,28,WAS,77,77,2723,389,853,.456,180,442,.407,209,411,.509,.562,149,193,.772,99,376,475,191,126,20,132,179,1107,2014
Hilton Armstrong,C,29,GSW,15,1,97,9,19,.474,0,0,.000,9,19,.474,.474,7,16,.438,19,28,47,5,4,4,6,11,25,2014
Darrell Arthur,SF,25,DEN,68,1,1161,162,410,.395,24,64,.375,138,346,.399,.424,53,62,.855,52,158,210,61,39,47,58,185,401,2014
Omer Asik,C,27,HOU,48,19,968,101,190,.532,0,0,.000,101,190,.532,.532,78,126,.619,101,277,378,25,14,37,59,92,280,2014
D.J. Augustin,PG,26,TOT,71,9,1939,298,718,.415,133,332,.401,165,386,.427,.508,201,227,.885,15,115,130,313,53,3,125,147,930,2014
D.J. Augustin,PG,26,TOR,10,0,82,7,24,.292,1,11,.091,6,13,.462,.313,6,6,1.000,0,4,4,10,1,0,9,7,21,2014
D.J. Augustin,PG,26,CHI,61,9,1857,291,694,.419,132,321,.411,159,373,.426,.514,195,221,.882,15,111,126,303,52,3,116,140,909,2014
Gustavo Ayon,C,28,ATL,26,14,429,52,102,.510,0,0,.000,52,102,.510,.510,8,20,.400,42,83,125,28,25,10,29,47,112,2014
Jeff Ayres,PF,26,SAS,73,10,952,101,174,.580,0,0,.000,101,174,.580,.580,38,55,.691,89,169,258,60,13,25,63,146,240,2014
Chris Babb,SG,23,BOS,14,0,132,8,30,.267,6,27,.222,2,3,.667,.367,0,0,.000,4,13,17,3,6,0,3,13,22,2014
Luke Babbitt,PF,24,NOP,27,2,473,60,154,.390,36,95,.379,24,59,.407,.506,14,18,.778,18,70,88,29,7,11,15,52,170,2014
Leandro Barbosa,PG,31,PHO,20,0,368,56,131,.427,7,25,.280,49,106,.462,.454,31,39,.795,5,32,37,32,7,4,19,30,150,2014
J.J. Barea,PG,29,MIN,79,1,1471,254,656,.387,73,231,.316,181,425,.426,.443,79,100,.790,16,138,154,303,26,0,125,129,660,2014
Andrea Bargnani,C,28,NYK,42,39,1257,222,502,.442,30,108,.278,192,394,.487,.472,84,102,.824,69,153,222,45,14,52,58,100,558,2014
Harrison Barnes,SF,21,GSW,78,24,2204,271,679,.399,66,190,.347,205,489,.419,.448,130,181,.718,66,245,311,116,65,20,84,158,738,2014
Matt Barnes,SF,33,LAC,63,40,1735,231,527,.438,97,283,.343,134,244,.549,.530,66,90,.733,60,232,292,125,56,28,85,185,625,2014
Will Barton,SG,23,POR,41,0,387,65,156,.417,10,33,.303,55,123,.447,.449,26,32,.813,16,58,74,33,9,7,18,31,166,2014
Brandon Bass,PF,28,BOS,82,73,2266,352,725,.486,2,6,.333,350,719,.487,.487,205,239,.858,161,309,470,87,36,71,102,190,911,2014
Shane Battier,SF,35,MIA,73,56,1468,105,275,.382,73,210,.348,32,65,.492,.515,15,23,.652,34,104,138,63,50,39,21,124,298,2014
Nicolas Batum,SF,25,POR,82,82,2956,381,819,.465,145,402,.361,236,417,.566,.554,163,203,.803,116,495,611,420,75,57,208,156,1070,2014
Jerryd Bayless,PG,25,TOT,72,19,1686,248,617,.402,76,212,.358,172,405,.425,.464,94,118,.797,22,123,145,194,60,9,82,161,666,2014
Jerryd Bayless,PG,25,MEM,31,5,650,90,239,.377,25,83,.301,65,156,.417,.429,45,57,.789,8,51,59,66,20,5,22,72,250,2014
Jerryd Bayless,PG,25,BOS,41,14,1036,158,378,.418,51,129,.395,107,249,.430,.485,49,61,.803,14,72,86,128,40,4,60,89,416,2014
Aron Baynes,C,27,SAS,53,4,491,71,163,.436,0,0,.000,71,163,.436,.436,19,21,.905,57,88,145,34,2,5,36,77,161,2014
Kent Bazemore,SG,24,TOT,67,15,911,147,343,.429,43,128,.336,104,215,.484,.491,66,109,.606,10,107,117,91,43,13,79,102,403,2014
Kent Bazemore,SG,24,GSW,44,0,268,36,97,.371,10,39,.256,26,58,.448,.423,19,36,.528,5,35,40,20,12,6,28,42,101,2014
Kent Bazemore,SG,24,LAL,23,15,643,111,246,.451,33,89,.371,78,157,.497,.518,47,73,.644,5,72,77,71,31,7,51,60,302,2014
Bradley Beal,SG,20,WAS,73,73,2530,481,1149,.419,138,343,.402,343,806,.426,.479,149,189,.788,54,219,273,243,71,18,128,153,1249,2014
Michael Beasley,SF,25,MIA,55,2,831,177,355,.499,21,54,.389,156,301,.518,.528,61,79,.772,31,141,172,42,23,21,57,93,436,2014
Marco Belinelli,SF,27,SAS,80,25,2016,337,695,.485,126,293,.430,211,402,.525,.576,111,131,.847,18,208,226,179,50,7,95,130,911,2014
Anthony Bennett,PF,20,CLE,52,0,663,80,225,.356,13,53,.245,67,172,.390,.384,44,69,.638,49,106,155,17,21,8,47,93,217,2014
Patrick Beverley,PG,25,HOU,56,55,1751,199,481,.414,92,255,.361,107,226,.473,.509,83,102,.814,72,124,196,151,77,23,66,174,573,2014
Andris Biedrins,C,27,UTA,6,0,45,1,1,1.000,0,0,.000,1,1,1.000,1.000,1,6,.167,2,15,17,0,0,0,2,6,3,2014
Chauncey Billups,SG,37,DET,19,7,309,24,79,.304,14,48,.292,10,31,.323,.392,10,12,.833,4,24,28,42,8,1,25,25,72,2014
Bismack Biyombo,C,21,CHA,77,9,1072,88,144,.611,0,0,.000,88,144,.611,.611,46,89,.517,105,261,366,8,7,86,40,124,222,2014
DeJuan Blair,PF,24,DAL,78,13,1214,210,393,.534,0,2,.000,210,391,.537,.534,77,121,.636,139,229,368,70,60,21,77,192,497,2014
Steve Blake,PG,33,TOT,55,28,1498,133,353,.377,79,210,.376,54,143,.378,.489,33,43,.767,13,146,159,307,54,8,102,85,378,2014
Steve Blake,PG,33,LAL,27,27,891,88,233,.378,52,131,.397,36,102,.353,.489,28,35,.800,8,95,103,205,34,2,71,49,256,2014
Steve Blake,PG,33,GSW,28,1,607,45,120,.375,27,79,.342,18,41,.439,.488,5,8,.625,5,51,56,102,20,6,31,36,122,2014
Andray Blatche,PF,27,BRK,73,7,1618,321,674,.476,15,54,.278,306,620,.494,.487,164,221,.742,120,270,390,112,75,38,110,166,821,2014
Eric Bledsoe,PG,24,PHO,43,40,1416,265,556,.477,50,140,.357,215,416,.517,.522,183,237,.772,27,175,202,235,69,14,143,99,763,2014
Vander Blue,SG,21,BOS,3,0,15,2,4,.500,0,1,.000,2,3,.667,.500,1,5,.200,0,3,3,1,0,0,2,1,5,2014
Keith Bogans,SG,33,BOS,6,0,55,3,6,.500,3,6,.500,0,0,.750,.000,3,3,1.000,0,3,3,3,1,0,1,2,12,2014
Andrew Bogut,C,29,GSW,67,67,1769,235,375,.627,0,0,.000,235,375,.627,.627,22,64,.344,182,489,671,112,47,121,97,210,492,2014
Matt Bonner,PF,33,SAS,61,0,690,73,164,.445,42,98,.429,31,66,.470,.573,9,12,.750,16,114,130,31,15,11,16,49,197,2014
Trevor Booker,PF,26,WAS,72,45,1553,222,403,.551,0,2,.000,222,401,.554,.551,47,76,.618,149,230,379,64,41,45,58,131,491,2014
Carlos Boozer,PF,32,CHI,76,76,2141,447,980,.456,0,2,.000,447,978,.457,.456,148,193,.767,137,495,632,118,53,22,154,216,1042,2014
Chris Bosh,C,29,MIA,79,79,2531,492,953,.516,74,218,.339,418,735,.569,.555,223,272,.820,98,424,522,87,80,78,125,192,1281,2014
Avery Bradley,PG,23,BOS,60,58,1855,361,825,.438,79,200,.395,282,625,.451,.485,90,112,.804,48,178,226,85,63,11,96,145,891,2014
Elton Brand,C,34,ATL,73,15,1414,179,332,.539,0,2,.000,179,330,.542,.539,61,94,.649,97,264,361,74,40,88,60,192,419,2014
Corey Brewer,SF,27,MIN,81,81,2609,388,807,.481,59,211,.280,329,596,.552,.517,163,227,.718,63,144,207,135,151,30,105,210,998,2014
Ronnie Brewer,SF,28,TOT,24,3,160,3,15,.200,1,8,.125,2,7,.286,.233,0,2,.000,2,12,14,10,6,1,2,4,7,2014
Ronnie Brewer,SF,28,HOU,23,3,158,3,15,.200,1,8,.125,2,7,.286,.233,0,2,.000,2,12,14,10,6,1,2,4,7,2014
Ronnie Brewer,SF,28,CHI,1,0,2,0,0,.000,0,0,.000,0,0,.000,.000,0,0,.000,0,0,0,0,0,0,0,0,0,2014
Aaron Brooks,PG,29,TOT,72,12,1557,233,581,.401,96,248,.387,137,333,.411,.484,83,95,.874,43,97,140,233,52,13,117,146,645,2014
Aaron Brooks,PG,29,HOU,43,0,716,104,263,.395,54,132,.409,50,131,.382,.498,37,44,.841,23,39,62,83,25,6,51,76,299,2014
Aaron Brooks,PG,29,DEN,29,12,841,129,318,.406,42,116,.362,87,202,.431,.472,46,51,.902,20,58,78,150,27,7,66,70,346,2014
MarShon Brooks,SG,25,TOT,35,0,316,57,125,.456,13,25,.520,44,100,.440,.508,32,44,.727,10,44,54,25,14,4,24,21,159,2014
MarShon Brooks,SG,25,BOS,10,0,73,9,24,.375,2,4,.500,7,20,.350,.417,11,14,.786,1,18,19,4,1,1,7,5,31,2014
MarShon Brooks,SG,25,GSW,7,0,15,5,13,.385,0,2,.000,5,11,.455,.385,3,4,.750,1,4,5,0,1,0,0,0,13,2014
MarShon Brooks,SG,25,LAL,18,0,228,43,88,.489,11,19,.579,32,69,.464,.551,18,26,.692,8,22,30,21,12,3,17,16,115,2014
Lorenzo Brown,PG,23,PHI,26,0,224,26,86,.302,3,30,.100,23,56,.411,.320,9,13,.692,8,20,28,41,13,3,16,19,64,2014
Shannon Brown,SG,28,TOT,29,1,251,24,66,.364,0,2,.000,24,64,.375,.364,15,21,.714,7,21,28,9,13,0,18,24,63,2014
Shannon Brown,SG,28,SAS,10,1,103,8,28,.286,0,2,.000,8,26,.308,.286,7,9,.778,1,12,13,5,1,0,8,12,23,2014
Shannon Brown,SG,28,NYK,19,0,148,16,38,.421,0,0,.000,16,38,.421,.421,8,12,.667,6,9,15,4,12,0,10,12,40,2014
Kobe Bryant,SG,35,LAL,6,6,177,31,73,.425,3,16,.188,28,57,.491,.445,18,21,.857,2,24,26,38,7,1,34,9,83,2014
Chase Budinger,SF,25,MIN,41,8,751,100,254,.394,42,120,.350,58,134,.433,.476,32,39,.821,19,84,103,31,19,2,24,58,274,2014
Reggie Bullock,SF,22,LAC,43,0,395,43,121,.355,22,73,.301,21,48,.438,.446,7,9,.778,11,43,54,12,9,1,13,26,115,2014
Trey Burke,PG,21,UTA,70,68,2262,341,897,.380,111,336,.330,230,561,.410,.442,102,113,.903,37,171,208,396,42,6,131,145,895,2014
Alec Burks,SG,22,UTA,78,12,2193,380,831,.457,50,143,.350,330,688,.480,.487,279,373,.748,59,198,257,212,69,14,149,190,1089,2014
Caron Butler,SF,33,TOT,56,13,1419,213,540,.394,98,249,.394,115,291,.395,.485,63,75,.840,21,208,229,82,47,17,60,120,587,2014
Caron Butler,SF,33,MIL,34,13,821,137,354,.387,53,147,.361,84,207,.406,.462,47,56,.839,16,142,158,56,23,11,52,64,374,2014
Caron Butler,SF,33,OKC,22,0,598,76,186,.409,45,102,.441,31,84,.369,.530,16,19,.842,5,66,71,26,24,6,8,56,213,2014
Jimmy Butler,SG,24,CHI,67,67,2591,275,693,.397,68,240,.283,207,453,.457,.446,260,338,.769,87,243,330,175,127,36,102,106,878,2014
Rasual Butler,SG,34,IND,50,2,378,51,110,.464,26,62,.419,25,48,.521,.582,8,14,.571,6,35,41,17,7,9,11,30,136,2014
Dwight Buycks,PG,24,TOR,14,0,146,15,48,.313,5,17,.294,10,31,.323,.365,8,9,.889,4,19,23,10,8,0,10,11,43,2014
Andrew Bynum,C,26,TOT,26,19,516,94,225,.418,0,0,.000,94,225,.418,.418,37,49,.755,53,92,145,29,6,29,34,31,225,2014
Andrew Bynum,C,26,CLE,24,19,480,85,203,.419,0,0,.000,85,203,.419,.419,32,42,.762,47,79,126,27,6,28,30,28,202,2014
Andrew Bynum,C,26,IND,2,0,36,9,22,.409,0,0,.000,9,22,.409,.409,5,7,.714,6,13,19,2,0,1,4,3,23,2014
Will Bynum,PG,31,DET,56,3,1054,184,430,.428,20,62,.323,164,368,.446,.451,97,121,.802,24,75,99,216,39,7,103,121,485,2014
Nick Calathes,SG,24,MEM,71,7,1173,142,311,.457,19,61,.311,123,250,.492,.487,44,72,.611,23,114,137,207,66,8,101,117,347,2014
Jose Calderon,PG,32,DAL,81,81,2468,341,748,.456,191,425,.449,150,323,.464,.584,52,63,.825,29,163,192,377,69,11,103,136,925,2014
Kentavious Caldwell-Pope,SG,20,DET,80,41,1583,182,460,.396,59,185,.319,123,275,.447,.460,47,61,.770,38,118,156,55,75,12,28,145,470,2014
Isaiah Canaan,PG,22,HOU,22,0,252,31,87,.356,18,55,.327,13,32,.406,.460,21,29,.724,7,17,24,22,8,4,21,25,101,2014
DeMarre Carroll,SF,27,ATL,73,73,2341,302,642,.470,97,268,.362,205,374,.548,.546,109,141,.773,107,296,403,134,108,21,79,188,810,2014
Vince Carter,SG,37,DAL,81,0,1973,330,811,.407,146,371,.394,184,440,.418,.497,161,196,.821,67,217,284,212,61,35,108,209,967,2014
Michael Carter-Williams,PG,22,PHI,70,70,2414,427,1054,.405,55,208,.264,372,846,.440,.431,258,367,.703,101,336,437,441,130,43,247,213,1167,2014
Omri Casspi,PF,25,HOU,71,2,1283,173,410,.422,61,176,.347,112,234,.479,.496,83,122,.680,55,205,260,88,44,14,72,100,490,2014
Mario Chalmers,PG,27,MIA,73,73,2178,254,560,.454,87,226,.385,167,334,.500,.531,121,163,.742,41,173,214,357,119,16,162,210,716,2014
Tyson Chandler,C,31,NYK,55,55,1662,191,322,.593,0,1,.000,191,321,.595,.593,98,155,.632,159,370,529,59,36,63,71,145,480,2014
Wilson Chandler,SF,26,DEN,62,55,1927,307,738,.416,122,351,.348,185,387,.478,.499,110,152,.724,58,236,294,114,46,31,79,193,846,2014
Josh Childress,SF,30,NOP,4,0,24,0,0,.000,0,0,.000,0,0,.000,.000,0,0,.000,0,3,3,2,1,0,1,1,0,2014
Dionte Christmas,SF,27,PHO,31,0,198,22,62,.355,9,31,.290,13,31,.419,.427,18,24,.750,13,25,38,8,2,3,6,19,71,2014
Earl Clark,PF,26,TOT,54,17,768,97,261,.372,41,122,.336,56,139,.403,.450,22,34,.647,22,121,143,18,17,25,31,67,257,2014
Earl Clark,PF,26,CLE,45,17,698,90,240,.375,40,116,.345,50,124,.403,.458,14,24,.583,20,107,127,16,16,19,30,61,234,2014
Earl Clark,PF,26,NYK,9,0,70,7,21,.333,1,6,.167,6,15,.400,.357,8,10,.800,2,14,16,2,1,6,1,6,23,2014
Ian Clark,SG,22,UTA,23,0,172,26,67,.388,11,31,.355,15,36,.417,.470,5,7,.714,3,16,19,15,8,2,14,24,68,2014
Victor Claver,SF,25,POR,21,0,184,17,42,.405,3,18,.167,14,24,.583,.440,10,11,.909,9,30,39,12,3,3,11,16,47,2014
Norris Cole,PG,25,MIA,82,6,2014,207,500,.414,60,174,.345,147,326,.451,.474,53,68,.779,17,143,160,248,77,5,127,156,527,2014
Jason Collins,C,35,BRK,22,1,172,11,24,.458,0,3,.000,11,21,.524,.458,3,4,.750,7,12,19,4,8,1,7,30,25,2014
Darren Collison,PG,26,LAC,80,35,2069,324,694,.467,71,189,.376,253,505,.501,.518,192,224,.857,47,141,188,297,93,15,132,150,911,2014
Nick Collison,PF,33,OKC,81,0,1353,134,241,.556,4,17,.235,130,224,.580,.564,66,93,.710,116,177,293,104,30,28,71,187,338,2014
Mike Conley,PG,26,MEM,73,73,2446,463,1030,.450,105,291,.361,358,739,.484,.500,225,276,.815,41,172,213,441,110,13,150,141,1256,2014
Chris Copeland,SF,29,IND,41,0,265,55,117,.470,33,79,.418,22,38,.579,.611,10,14,.714,7,25,32,18,3,7,14,38,153,2014
DeMarcus Cousins,C,23,SAC,71,71,2298,591,1191,.496,0,7,.000,591,1184,.499,.496,432,595,.726,218,613,831,207,109,91,251,270,1614,2014
Robert Covington,SF,23,HOU,7,0,34,6,14,.429,4,11,.364,2,3,.667,.571,0,0,.000,2,3,5,0,2,0,1,3,16,2014
Allen Crabbe,SG,21,POR,15,0,100,12,33,.364,6,14,.429,6,19,.316,.455,3,4,.750,1,8,9,6,2,1,3,10,33,2014
Jamal Crawford,SG,33,LAC,69,24,2094,421,1011,.416,161,446,.361,260,565,.460,.496,279,322,.866,34,124,158,223,59,12,135,120,1282,2014
Jordan Crawford,SG,25,TOT,81,35,1859,327,788,.415,90,285,.316,237,503,.471,.472,146,169,.864,28,155,183,281,47,5,134,120,890,2014
Jordan Crawford,SG,25,BOS,39,35,1198,188,455,.413,50,157,.318,138,298,.463,.468,110,126,.873,18,102,120,224,34,3,84,76,536,2014
Jordan Crawford,SG,25,GSW,42,0,661,139,333,.417,40,128,.313,99,205,.483,.477,36,43,.837,10,53,63,57,13,2,50,44,354,2014
Jae Crowder,SF,23,DAL,78,8,1254,130,296,.439,50,151,.331,80,145,.552,.524,46,61,.754,46,148,194,60,59,21,41,100,356,2014
Dante Cunningham,PF,26,MIN,81,7,1635,236,509,.464,0,5,.000,236,504,.468,.464,38,67,.567,112,218,330,83,62,58,42,146,510,2014
Jared Cunningham,SG,22,TOT,13,0,80,6,21,.286,1,7,.143,5,14,.357,.310,13,16,.813,1,5,6,8,3,0,2,16,26,2014
Jared Cunningham,SG,22,ATL,5,0,22,1,2,.500,0,1,.000,1,1,1.000,.500,0,2,.000,0,1,1,3,0,0,2,3,2,2014
Jared Cunningham,SG,22,SAC,8,0,58,5,19,.263,1,6,.167,4,13,.308,.289,13,14,.929,1,4,5,5,3,0,0,13,24,2014
Seth Curry,PG,23,TOT,2,0,13,1,3,.333,1,1,1.000,0,2,.000,.500,0,0,.000,0,1,1,0,2,0,0,0,3,2014
Seth Curry,PG,23,MEM,1,0,4,0,0,.000,0,0,.000,0,0,.000,.000,0,0,.000,0,0,0,0,0,0,0,0,0,2014
Seth Curry,PG,23,CLE,1,0,9,1,3,.333,1,1,1.000,0,2,.000,.500,0,0,.000,0,1,1,0,2,0,0,0,3,2014
Stephen Curry,PG,25,GSW,78,78,2846,652,1383,.471,261,615,.424,391,768,.509,.566,308,348,.885,46,288,334,666,128,14,294,194,1873,2014
Samuel Dalembert,C,32,DAL,80,68,1614,214,377,.568,0,1,.000,214,376,.569,.568,101,137,.737,200,341,541,38,41,94,90,210,529,2014
Troy Daniels,SG,22,HOU,5,1,75,15,31,.484,12,25,.480,3,6,.500,.677,0,0,.000,0,4,4,5,0,0,3,6,42,2014
Luigi Datome,SF,26,DET,34,0,238,34,97,.351,7,39,.179,27,58,.466,.387,8,10,.800,14,32,46,11,6,1,11,20,83,2014
Brandon Davies,PF,22,PHI,51,0,575,54,128,.422,2,10,.200,52,118,.441,.430,34,53,.642,38,71,109,28,24,8,35,92,144,2014
Anthony Davis,PF,20,NOP,67,66,2358,522,1005,.519,2,9,.222,520,996,.522,.520,348,440,.791,207,466,673,105,89,189,109,200,1394,2014
Ed Davis,PF,24,MEM,63,4,956,155,290,.534,0,0,.000,155,290,.534,.534,47,89,.528,92,168,260,27,17,43,40,114,357,2014
Glen Davis,PF,28,TOT,68,44,1662,271,593,.457,4,11,.364,267,582,.459,.460,95,137,.693,108,243,351,77,58,29,76,159,641,2014
Glen Davis,PF,28,ORL,45,43,1354,232,512,.453,4,10,.400,228,502,.454,.457,77,114,.675,87,195,282,70,46,22,59,111,545,2014
Glen Davis,PF,28,LAC,23,1,308,39,81,.481,0,1,.000,39,80,.488,.481,18,23,.783,21,48,69,7,12,7,17,48,96,2014
Austin Daye,SF,25,TOT,22,1,148,24,68,.353,12,37,.324,12,31,.387,.441,6,10,.600,5,22,27,8,4,4,5,18,66,2014
Austin Daye,SF,25,TOR,8,0,33,3,13,.231,0,8,.000,3,5,.600,.231,2,3,.667,2,5,7,2,0,0,0,4,8,2014
Austin Daye,SF,25,SAS,14,1,115,21,55,.382,12,29,.414,9,26,.346,.491,4,7,.571,3,17,20,6,4,4,5,14,58,2014
Nando De Colo,SF,26,TOT,47,3,494,64,153,.418,18,53,.340,46,100,.460,.477,31,35,.886,14,59,73,65,22,6,35,48,177,2014
Nando De Colo,SF,26,SAS,26,3,301,42,93,.452,10,31,.323,32,62,.516,.505,18,22,.818,6,39,45,32,15,3,21,25,112,2014
Nando De Colo,SF,26,TOR,21,0,193,22,60,.367,8,22,.364,14,38,.368,.433,13,13,1.000,8,20,28,33,7,3,14,23,65,2014
Dewayne Dedmon,C,24,TOT,31,6,390,38,83,.458,0,0,.000,38,83,.458,.458,21,32,.656,38,89,127,5,7,22,18,66,97,2014
Dewayne Dedmon,C,24,GSW,4,0,6,0,1,.000,0,0,.000,0,1,.000,.000,1,2,.500,0,0,0,0,0,0,0,1,1,2014
Dewayne Dedmon,C,24,PHI,11,0,150,15,29,.517,0,0,.000,15,29,.517,.517,7,13,.538,11,38,49,3,0,9,9,28,37,2014
Dewayne Dedmon,C,24,ORL,16,6,234,23,53,.434,0,0,.000,23,53,.434,.434,13,17,.765,27,51,78,2,7,13,9,37,59,2014
Matthew Dellavedova,SG,23,CLE,72,4,1271,122,296,.412,57,155,.368,65,141,.461,.508,38,48,.792,29,94,123,187,33,5,60,121,339,2014
Luol Deng,SF,28,TOT,63,63,2213,371,860,.431,57,189,.302,314,671,.468,.465,212,268,.791,99,262,361,183,62,9,114,111,1011,2014
Luol Deng,SF,28,CHI,23,23,860,160,354,.452,17,62,.274,143,292,.490,.476,101,124,.815,40,118,158,85,24,4,59,53,438,2014
Luol Deng,SF,28,CLE,40,40,1353,211,506,.417,40,127,.315,171,379,.451,.457,111,144,.771,59,144,203,98,38,5,55,58,573,2014
DeMar DeRozan,SG,24,TOR,79,79,3017,604,1407,.429,64,210,.305,540,1197,.451,.452,519,630,.824,51,292,343,313,86,28,176,197,1791,2014
Boris Diaw,PF,31,SAS,79,24,1974,302,580,.521,45,112,.402,257,468,.549,.559,68,92,.739,74,252,326,222,44,32,121,140,717,2014
Gorgui Dieng,C,24,MIN,60,15,818,113,227,.498,1,1,1.000,112,226,.496,.500,59,93,.634,103,197,300,39,30,50,54,108,286,2014
Toney Douglas,PG,27,TOT,51,17,675,73,190,.384,31,102,.304,42,88,.477,.466,25,34,.735,18,69,87,68,19,5,34,81,202,2014
Toney Douglas,PG,27,GSW,24,0,265,32,86,.372,19,59,.322,13,27,.481,.483,5,8,.625,4,22,26,19,6,2,16,34,88,2014
Toney Douglas,PG,27,MIA,27,17,410,41,104,.394,12,43,.279,29,61,.475,.452,20,26,.769,14,47,61,49,13,3,18,47,114,2014
Chris Douglas-Roberts,SF,27,CHA,49,8,1016,111,252,.440,51,132,.386,60,120,.500,.542,66,82,.805,16,103,119,51,29,16,36,61,339,2014
Goran Dragic,SG,27,PHO,76,75,2668,552,1093,.505,122,299,.408,430,794,.542,.561,316,416,.760,69,176,245,447,104,22,213,206,1542,2014
Andre Drummond,C,20,DET,81,81,2619,479,769,.623,0,2,.000,479,767,.625,.623,137,328,.418,440,631,1071,35,101,131,110,273,1095,2014
Jared Dudley,SF,28,LAC,74,43,1729,196,447,.438,81,225,.360,115,222,.518,.529,38,58,.655,36,124,160,104,41,10,56,146,511,2014
Tim Duncan,C,37,SAS,74,74,2158,444,906,.490,0,5,.000,444,901,.493,.490,231,316,.731,158,563,721,220,43,139,159,134,1119,2014
Mike Dunleavy,SF,33,CHI,82,61,2584,333,774,.430,123,324,.380,210,450,.467,.510,140,164,.854,46,299,345,186,64,46,108,163,929,2014
Kevin Durant,SF,25,OKC,81,81,3122,849,1688,.503,192,491,.391,657,1197,.549,.560,703,805,.873,58,540,598,445,103,59,285,174,2593,2014
Shane Edwards,SF,26,CLE,2,0,12,1,3,.333,0,0,.000,1,3,.333,.333,0,0,.000,1,1,2,0,0,0,1,1,2,2014
Wayne Ellington,SG,26,DAL,45,1,393,55,126,.437,25,59,.424,30,67,.448,.536,10,11,.909,8,35,43,19,16,2,11,33,145,2014
Monta Ellis,SG,28,DAL,82,82,3023,576,1278,.451,69,209,.330,507,1069,.474,.478,339,430,.788,38,257,295,471,141,23,264,197,1560,2014
Melvin Ely,C,35,NOP,2,0,27,3,6,.500,0,0,.000,3,6,.500,.500,0,0,.000,0,1,1,0,0,1,0,5,6,2014
Jeremy Evans,SF,26,UTA,66,4,1209,175,332,.527,0,2,.000,175,330,.530,.527,51,75,.680,120,190,310,44,42,46,40,139,401,2014
Reggie Evans,PF,33,TOT,54,20,899,71,150,.473,0,0,.000,71,150,.473,.473,72,130,.554,115,219,334,21,37,3,58,119,214,2014
Reggie Evans,PF,33,BRK,30,6,399,23,59,.390,0,0,.000,23,59,.390,.390,35,65,.538,53,96,149,5,13,2,28,54,81,2014
Reggie Evans,PF,33,SAC,24,14,500,48,91,.527,0,0,.000,48,91,.527,.527,37,65,.569,62,123,185,16,24,1,30,65,133,2014
Tyreke Evans,SF,24,NOP,72,22,2028,391,897,.436,21,95,.221,370,802,.461,.448,239,310,.771,76,265,341,363,84,21,175,155,1042,2014
Kenneth Faried,PF,24,DEN,80,77,2178,447,820,.545,0,3,.000,447,817,.547,.545,202,311,.650,238,446,684,96,70,69,135,193,1096,2014
Jordan Farmar,PG,27,LAL,41,5,912,151,364,.415,70,160,.438,81,204,.397,.511,44,59,.746,20,84,104,199,38,8,95,65,416,2014
Vitor Faverani,C,25,BOS,37,8,488,64,147,.435,12,40,.300,52,107,.486,.476,24,37,.649,42,86,128,16,14,27,41,74,164,2014
Derrick Favors,PF,22,UTA,73,73,2201,390,747,.522,0,1,.000,390,746,.523,.522,190,284,.669,199,438,637,91,75,108,129,236,970,2014
Carrick Felix,SG,23,CLE,7,0,38,7,14,.500,2,5,.400,5,9,.556,.571,3,4,.750,1,5,6,4,0,0,4,4,19,2014
Raymond Felton,PG,29,NYK,65,65,2017,240,608,.395,62,195,.318,178,413,.431,.446,88,122,.721,54,143,197,365,78,27,129,157,630,2014
Landry Fields,SF,25,TOR,30,2,322,27,67,.403,0,5,.000,27,62,.435,.403,14,22,.636,15,44,59,20,10,3,11,25,68,2014
Derek Fisher,SG,39,OKC,81,0,1428,141,361,.391,88,229,.384,53,132,.402,.512,55,71,.775,12,110,122,117,70,3,49,157,425,2014
Evan Fournier,SG,21,DEN,76,4,1503,228,544,.419,89,237,.376,139,307,.453,.501,93,123,.756,34,168,202,112,34,7,100,179,638,2014
Randy Foye,SG,30,DEN,81,78,2485,361,875,.413,189,498,.380,172,377,.456,.521,157,185,.849,36,196,232,287,67,39,145,205,1068,2014
Jamaal Franklin,SG,22,MEM,21,0,161,16,39,.410,5,11,.455,11,28,.393,.474,2,2,1.000,4,19,23,6,4,2,11,23,39,2014
Jimmer Fredette,SG,24,TOT,49,0,519,107,227,.471,40,84,.476,67,143,.469,.559,19,21,.905,8,44,52,64,14,3,48,35,273,2014
Jimmer Fredette,SG,24,SAC,41,0,463,94,198,.475,36,73,.493,58,125,.464,.566,17,19,.895,7,38,45,61,14,3,44,28,241,2014
Jimmer Fredette,SG,24,CHI,8,0,56,13,29,.448,4,11,.364,9,18,.500,.517,2,2,1.000,1,6,7,3,0,0,4,7,32,2014
Joel Freeland,C,26,POR,52,0,727,77,162,.475,0,2,.000,77,160,.481,.475,20,29,.690,88,120,208,36,10,22,32,95,174,2014
Channing Frye,PF,30,PHO,82,82,2312,336,778,.432,160,432,.370,176,346,.509,.535,78,95,.821,73,343,416,98,60,63,89,245,910,2014
Francisco Garcia,SF,32,HOU,55,4,1083,118,294,.401,69,193,.358,49,101,.485,.519,10,19,.526,21,101,122,63,27,33,30,120,315,2014
Kevin Garnett,C,37,BRK,54,54,1109,157,356,.441,0,3,.000,157,353,.445,.441,38,47,.809,60,298,358,82,43,40,69,123,352,2014
Diante Garrett,PG,25,UTA,71,0,1048,101,265,.381,36,96,.375,65,169,.385,.449,10,12,.833,11,86,97,120,41,5,75,75,248,2014
Marc Gasol,C,29,MEM,59,59,1970,336,711,.473,2,11,.182,334,700,.477,.474,185,241,.768,84,340,424,215,59,76,111,150,859,2014
Pau Gasol,C,33,LAL,60,60,1884,425,885,.480,4,14,.286,421,871,.483,.482,187,254,.736,124,456,580,201,27,92,141,124,1041,2014
Rudy Gay,SF,27,TOT,73,73,2531,537,1179,.455,65,197,.330,472,982,.481,.483,318,387,.822,113,324,437,209,95,56,224,171,1457,2014
Rudy Gay,SF,27,TOR,18,18,639,130,335,.388,22,59,.373,108,276,.391,.421,68,88,.773,29,104,133,40,28,23,59,47,350,2014
Rudy Gay,SF,27,SAC,55,55,1892,407,844,.482,43,138,.312,364,706,.516,.508,250,299,.836,84,220,304,169,67,33,165,124,1107,2014
Alonzo Gee,SF,26,CLE,65,24,1020,98,236,.415,19,58,.328,79,178,.444,.456,43,61,.705,35,114,149,47,39,15,44,96,258,2014
Paul George,SF,23,IND,80,80,2898,577,1362,.424,182,500,.364,395,862,.458,.490,401,464,.864,64,478,542,283,151,22,224,198,1737,2014
Taj Gibson,PF,28,CHI,82,8,2351,429,896,.479,0,7,.000,429,889,.483,.479,211,281,.751,200,358,558,91,41,112,150,207,1069,2014
Manu Ginobili,SG,36,SAS,68,3,1550,294,627,.469,90,258,.349,204,369,.553,.541,160,188,.851,30,172,202,293,70,17,139,128,838,2014
Rudy Gobert,C,21,UTA,45,0,434,36,74,.486,0,0,.000,36,74,.486,.486,32,65,.492,51,104,155,7,8,41,32,57,104,2014
Ryan Gomes,SF,31,OKC,5,0,34,3,8,.375,0,2,.000,3,6,.500,.375,0,0,.000,0,4,4,1,0,0,1,5,6,2014
Drew Gooden,C,32,WAS,22,0,395,76,143,.531,7,17,.412,69,126,.548,.556,24,27,.889,37,77,114,15,10,7,17,53,183,2014
Archie Goodwin,SG,19,PHO,52,0,533,76,167,.455,5,36,.139,71,131,.542,.470,37,55,.673,25,62,87,20,20,11,44,45,194,2014
Ben Gordon,SG,30,CHA,19,0,279,37,108,.343,8,29,.276,29,79,.367,.380,17,21,.810,3,24,27,21,10,2,21,18,99,2014
Eric Gordon,SG,25,NOP,64,64,2057,356,817,.436,101,258,.391,255,559,.456,.498,175,223,.785,30,135,165,208,74,12,134,114,988,2014
Marcin Gortat,C,29,WAS,81,80,2655,455,840,.542,1,1,1.000,454,839,.541,.542,157,229,.686,202,565,767,138,41,121,126,201,1068,2014
Danny Granger,SF,30,TOT,41,2,847,116,307,.378,43,128,.336,73,179,.408,.448,63,67,.940,31,102,133,41,12,17,46,62,338,2014
Danny Granger,SF,30,IND,29,2,653,80,223,.359,31,94,.330,49,129,.380,.428,51,53,.962,24,81,105,33,9,13,36,41,242,2014
Danny Granger,SF,30,LAC,12,0,194,36,84,.429,12,34,.353,24,50,.480,.500,12,14,.857,7,21,28,8,3,4,10,21,96,2014
Aaron Gray,C,29,TOT,37,6,355,27,61,.443,0,1,.000,27,60,.450,.443,11,20,.550,42,69,111,22,10,8,31,64,65,2014
Aaron Gray,C,29,TOR,4,0,20,2,3,.667,0,0,.000,2,3,.667,.667,1,2,.500,3,5,8,3,0,0,4,7,5,2014
Aaron Gray,C,29,SAC,33,6,335,25,58,.431,0,1,.000,25,57,.439,.431,10,18,.556,39,64,103,19,10,8,27,57,60,2014
Danny Green,SG,26,SAS,68,59,1651,218,505,.432,132,318,.415,86,187,.460,.562,50,63,.794,25,204,229,104,65,61,76,107,618,2014
Draymond Green,SF,23,GSW,82,12,1797,187,459,.407,55,165,.333,132,294,.449,.467,82,123,.667,86,323,409,152,102,72,91,231,511,2014
Gerald Green,SG,28,PHO,82,48,2330,448,1006,.445,204,510,.400,244,496,.492,.547,195,230,.848,48,227,275,122,70,42,145,220,1295,2014
Jeff Green,SF,27,BOS,82,82,2805,482,1171,.412,135,396,.341,347,775,.448,.469,283,356,.795,54,326,380,138,57,47,165,180,1382,2014
Willie Green,SG,32,LAC,55,9,869,102,271,.376,41,121,.339,61,150,.407,.452,28,34,.824,12,66,78,50,22,11,34,96,273,2014
Blake Griffin,PF,24,LAC,80,80,2863,718,1359,.528,12,44,.273,706,1315,.537,.533,482,674,.715,192,565,757,309,92,51,224,265,1930,2014
Jorge Gutierrez,PG,25,BRK,15,2,244,25,54,.463,3,12,.250,22,42,.524,.491,9,12,.750,3,19,22,30,10,1,14,37,62,2014
Jordan Hamilton,SF,23,TOT,60,12,1019,147,376,.391,70,198,.354,77,178,.433,.484,40,51,.784,32,162,194,52,44,20,46,67,404,2014
Jordan Hamilton,SF,23,DEN,39,11,670,99,254,.390,45,129,.349,54,125,.432,.478,23,31,.742,23,110,133,34,31,13,27,31,266,2014
Jordan Hamilton,SF,23,HOU,21,1,349,48,122,.393,25,69,.362,23,53,.434,.496,17,20,.850,9,52,61,18,13,7,19,36,138,2014
Justin Hamilton,C,23,TOT,8,0,72,9,20,.450,3,9,.333,6,11,.545,.525,5,5,1.000,4,3,7,0,5,0,4,8,26,2014
Justin Hamilton,C,23,CHA,1,0,4,0,0,.000,0,0,.000,0,0,.000,.000,0,0,.000,0,0,0,0,1,0,1,0,0,2014
Justin Hamilton,C,23,MIA,7,0,68,9,20,.450,3,9,.333,6,11,.545,.525,5,5,1.000,4,3,7,0,4,0,3,8,26,2014
Tyler Hansbrough,PF,28,TOR,64,4,978,93,196,.474,0,2,.000,93,194,.479,.474,126,185,.681,120,167,287,17,28,19,47,132,312,2014
Tim Hardaway,SG,21,NYK,81,1,1875,294,687,.428,130,358,.363,164,329,.498,.523,106,128,.828,19,102,121,66,44,7,47,144,824,2014
James Harden,SG,24,HOU,73,73,2777,549,1205,.456,177,483,.366,372,722,.515,.529,576,665,.866,61,283,344,446,115,29,265,177,1851,2014
Maurice Harkless,SF,20,ORL,80,41,1950,224,483,.464,59,154,.383,165,329,.502,.525,85,143,.594,69,195,264,80,97,50,86,140,592,2014
Josh Harrellson,C,24,DET,32,0,317,38,82,.463,12,31,.387,26,51,.510,.537,5,7,.714,30,46,76,15,6,15,10,44,93,2014
Al Harrington,PF,33,WAS,34,0,511,82,207,.396,34,100,.340,48,107,.449,.478,27,35,.771,15,65,80,28,14,0,34,72,225,2014
Devin Harris,PG,30,DAL,40,0,818,96,254,.378,31,101,.307,65,153,.425,.439,92,115,.800,8,77,85,178,28,2,59,72,315,2014
Elias Harris,SF,24,LAL,2,0,11,0,1,.000,0,0,.000,0,1,.000,.000,0,0,.000,1,0,1,1,1,0,0,0,0,2014
Manny Harris,SG,24,LAL,9,0,180,28,70,.400,7,20,.350,21,50,.420,.450,10,12,.833,7,27,34,11,4,1,9,10,73,2014
Mike Harris,PF,30,UTA,20,0,225,29,61,.475,0,2,.000,29,59,.492,.475,26,27,.963,15,18,33,5,16,7,11,36,84,2014
Tobias Harris,PF,21,ORL,61,36,1850,332,716,.464,32,126,.254,300,590,.508,.486,197,244,.807,88,336,424,82,41,24,78,143,893,2014
Udonis Haslem,PF,33,MIA,46,18,653,74,146,.507,0,0,.000,74,146,.507,.507,25,44,.568,42,133,175,13,11,15,24,79,173,2014
Spencer Hawes,C,25,TOT,80,78,2470,403,883,.456,128,308,.416,275,575,.478,.529,119,152,.783,131,529,660,240,44,94,173,237,1053,2014
Spencer Hawes,C,25,PHI,53,53,1666,264,586,.451,81,203,.399,183,383,.478,.520,79,101,.782,88,364,452,176,31,67,119,154,688,2014
Spencer Hawes,C,25,CLE,27,25,804,139,297,.468,47,105,.448,92,192,.479,.547,40,51,.784,43,165,208,64,13,27,54,83,365,2014
Chuck Hayes,C,30,TOT,61,1,754,56,130,.431,0,1,.000,56,129,.434,.431,20,25,.800,69,141,210,35,34,12,33,95,132,2014
Chuck Hayes,C,30,SAC,16,1,179,14,32,.438,0,0,.000,14,32,.438,.438,5,7,.714,20,27,47,6,11,2,7,18,33,2014
Chuck Hayes,C,30,TOR,45,0,575,42,98,.429,0,1,.000,42,97,.433,.429,15,18,.833,49,114,163,29,23,10,26,77,99,2014
Gordon Hayward,SF,23,UTA,77,77,2800,426,1032,.413,85,280,.304,341,752,.453,.454,311,381,.816,62,329,391,400,110,40,212,155,1248,2014
Gerald Henderson,SG,26,CHA,77,77,2461,403,930,.433,40,115,.348,363,815,.445,.455,235,309,.761,31,279,310,199,51,32,113,159,1081,2014
Xavier Henry,SF,22,LAL,43,5,908,144,345,.417,28,81,.346,116,264,.439,.458,116,177,.655,25,89,114,51,44,7,57,79,432,2014
John Henson,PF,23,MIL,70,23,1856,344,639,.538,0,1,.000,344,638,.539,.538,91,177,.514,171,326,497,113,41,116,114,185,779,2014
Roy Hibbert,C,27,IND,81,81,2409,331,754,.439,2,5,.400,329,749,.439,.440,207,269,.770,202,336,538,91,29,182,148,269,871,2014
J.J. Hickson,PF,25,DEN,69,52,1859,332,654,.508,0,8,.000,332,646,.514,.508,150,290,.517,206,426,632,96,47,51,128,177,814,2014
Nene Hilario,PF,31,WAS,53,37,1560,299,594,.503,1,5,.200,298,589,.506,.504,155,266,.583,65,229,294,153,64,47,117,164,754,2014
George Hill,PG,27,IND,76,76,2434,272,616,.442,95,260,.365,177,356,.497,.519,142,176,.807,53,230,283,265,75,23,92,158,781,2014
Jordan Hill,PF,26,LAL,72,32,1500,286,521,.549,0,1,.000,286,520,.550,.549,124,181,.685,194,341,535,54,29,64,75,172,696,2014
Solomon Hill,SF,22,IND,28,0,226,17,40,.425,7,23,.304,10,17,.588,.513,6,7,.857,9,32,41,12,5,2,13,19,47,2014
Kirk Hinrich,PG,33,CHI,73,61,2116,243,619,.393,85,242,.351,158,377,.419,.461,95,125,.760,31,161,192,286,80,26,120,203,666,2014
Jrue Holiday,PG,23,NOP,34,34,1143,203,454,.447,30,77,.390,173,377,.459,.480,51,63,.810,28,114,142,268,56,12,105,92,487,2014
Ryan Hollins,PF,29,LAC,61,0,482,53,72,.736,0,0,.000,53,72,.736,.736,35,56,.625,31,59,90,8,9,31,29,87,141,2014
Scotty Hopson,SG,24,CLE,2,0,7,0,4,.000,0,2,.000,0,2,.000,.000,1,2,.500,0,0,0,1,1,0,0,0,1,2014
Al Horford,C,27,ATL,29,29,958,238,420,.567,4,11,.364,234,409,.572,.571,58,85,.682,66,178,244,76,27,44,64,56,538,2014
Dwight Howard,C,28,HOU,71,71,2396,473,800,.591,2,7,.286,471,793,.594,.593,349,638,.547,231,635,866,131,60,128,229,240,1297,2014
Robbie Hummel,SF,24,MIN,53,5,655,67,177,.379,32,89,.360,35,88,.398,.469,15,16,.938,35,97,132,23,16,2,10,57,181,2014
Kris Humphries,PF,28,BOS,69,30,1376,231,461,.501,0,2,.000,231,459,.503,.501,117,144,.813,127,282,409,67,31,61,64,136,579,2014
Serge Ibaka,PF,24,OKC,81,81,2666,524,978,.536,23,60,.383,501,918,.546,.548,156,199,.784,224,485,709,85,39,219,123,233,1227,2014
Andre Iguodala,SF,30,GSW,63,63,2040,220,458,.480,62,175,.354,158,283,.558,.548,86,132,.652,53,240,293,263,95,18,100,103,588,2014
Ersan Ilyasova,PF,26,MIL,55,47,1478,237,579,.409,37,131,.282,200,448,.446,.441,107,130,.823,107,235,342,72,46,8,61,135,618,2014
Kyrie Irving,PG,21,CLE,71,71,2496,532,1237,.430,123,344,.358,409,893,.458,.480,291,338,.861,52,207,259,433,108,23,190,163,1478,2014
Royal Ivey,SG,32,OKC,2,0,5,0,2,.000,0,1,.000,0,1,.000,.000,0,0,.000,0,1,1,0,0,0,0,1,0,2014
Jarrett Jack,PG,30,CLE,80,31,2252,286,698,.410,63,185,.341,223,513,.435,.455,125,149,.839,22,201,223,324,56,22,133,133,760,2014
Reggie Jackson,PG,23,OKC,80,36,2277,403,916,.440,83,245,.339,320,671,.477,.485,158,177,.893,43,270,313,331,85,9,168,142,1047,2014
Stephen Jackson,SF,35,LAC,9,0,107,6,26,.231,1,14,.071,5,12,.417,.250,2,4,.500,2,8,10,5,6,1,6,11,15,2014
Bernard James,C,28,DAL,30,0,146,11,23,.478,0,1,.000,11,22,.500,.478,6,11,.545,15,27,42,3,3,8,10,24,28,2014
Damion James,SF,26,SAS,5,1,50,2,9,.222,0,2,.000,2,7,.286,.222,2,2,1.000,1,11,12,3,0,1,1,3,6,2014
LeBron James,PF,29,MIA,77,77,2902,767,1353,.567,116,306,.379,651,1047,.622,.610,439,585,.750,81,452,533,488,121,26,270,126,2089,2014
Mike James,PG,38,CHI,11,0,77,5,21,.238,1,5,.200,4,16,.250,.262,0,2,.000,0,7,7,17,2,0,5,11,11,2014
Antawn Jamison,PF,37,LAC,22,0,248,29,92,.315,8,41,.195,21,51,.412,.359,18,25,.720,9,46,55,7,9,3,7,29,84,2014
Othyus Jeffers,SG,28,TOT,6,1,47,3,6,.500,0,2,.000,3,4,.750,.500,3,4,.750,1,8,9,1,0,0,1,3,9,2014
Othyus Jeffers,SG,28,SAS,4,1,34,3,5,.600,0,1,.000,3,4,.750,.600,1,2,.500,1,5,6,1,0,0,0,2,7,2014
Othyus Jeffers,SG,28,MIN,2,0,13,0,1,.000,0,1,.000,0,0,.000,.000,2,2,1.000,0,3,3,0,0,0,1,1,2,2014
Al Jefferson,C,29,CHA,73,73,2553,700,1376,.509,3,15,.200,697,1361,.512,.510,191,277,.690,156,636,792,155,67,79,124,176,1594,2014
Richard Jefferson,SF,33,UTA,82,78,2213,294,654,.450,123,301,.409,171,353,.484,.544,120,162,.741,18,201,219,130,56,14,94,168,831,2014
John Jenkins,SG,22,ATL,13,0,158,16,42,.381,4,18,.222,12,24,.500,.429,4,4,1.000,3,19,22,11,1,1,11,11,40,2014
Brandon Jennings,PG,24,DET,80,79,2728,423,1135,.373,154,457,.337,269,678,.397,.441,241,321,.751,59,185,244,609,101,8,215,157,1241,2014
Jonas Jerebko,PF,26,DET,64,0,741,98,208,.471,31,74,.419,67,134,.500,.546,43,59,.729,51,124,175,39,21,6,43,85,270,2014
Amir Johnson,PF,26,TOR,77,72,2214,344,612,.562,20,66,.303,324,546,.593,.578,91,143,.636,172,333,505,115,56,88,123,271,799,2014
Chris Johnson,SF,23,BOS,40,0,789,85,214,.397,43,127,.339,42,87,.483,.498,37,43,.860,31,66,97,31,27,4,22,63,250,2014
James Johnson,SF,26,MEM,52,4,956,143,308,.464,22,87,.253,121,221,.548,.500,76,90,.844,60,106,166,111,42,57,66,102,384,2014
Joe Johnson,SG,32,BRK,79,79,2575,462,1018,.454,162,404,.401,300,614,.489,.533,159,195,.815,48,222,270,216,47,10,120,129,1245,2014
Orlando Johnson,SG,24,TOT,45,0,392,36,113,.319,9,47,.191,27,66,.409,.358,19,26,.731,9,46,55,20,6,2,15,26,100,2014
Orlando Johnson,SG,24,IND,38,0,342,33,96,.344,8,41,.195,25,55,.455,.385,17,22,.773,7,44,51,16,6,1,14,23,91,2014
Orlando Johnson,SG,24,SAC,7,0,50,3,17,.176,1,6,.167,2,11,.182,.206,2,4,.500,2,2,4,4,0,1,1,3,9,2014
Wesley Johnson,SF,26,LAL,79,62,2240,277,651,.425,100,271,.369,177,380,.466,.502,61,77,.792,70,278,348,124,86,77,90,207,715,2014
Darius Johnson-Odom,SG,24,PHI,3,0,15,0,7,.000,0,3,.000,0,4,.000,.000,0,2,.000,0,2,2,1,1,0,2,3,0,2014
James Jones,SF,33,MIA,20,6,236,31,68,.456,28,54,.519,3,14,.214,.662,7,11,.636,2,21,23,9,3,4,4,6,97,2014
Perry Jones,PF,22,OKC,62,7,764,83,181,.459,22,61,.361,61,120,.508,.519,28,42,.667,28,86,114,26,14,19,21,62,216,2014
Solomon Jones,PF,29,ORL,11,0,85,6,17,.353,0,0,.000,6,17,.353,.353,2,4,.500,8,8,16,2,2,2,2,12,14,2014
Terrence Jones,PF,22,HOU,76,71,2078,386,712,.542,31,101,.307,355,611,.581,.564,118,195,.605,162,366,528,87,53,99,71,139,921,2014
DeAndre Jordan,C,25,LAC,82,82,2870,348,515,.676,0,0,.000,348,515,.676,.676,160,374,.428,331,783,1114,74,80,203,123,264,856,2014
Cory Joseph,SG,22,SAS,68,19,936,126,265,.475,12,38,.316,114,227,.502,.498,79,96,.823,32,75,107,114,35,14,43,84,343,2014
Chris Kaman,C,31,LAL,39,13,736,176,346,.509,0,3,.000,176,343,.513,.509,52,68,.765,54,175,229,58,11,40,74,93,404,2014
Enes Kanter,C,21,UTA,80,37,2138,419,853,.491,0,1,.000,419,852,.492,.491,149,204,.730,222,376,598,75,28,42,144,230,987,2014
Sergey Karasev,SF,20,CLE,22,1,156,12,35,.343,4,19,.211,8,16,.500,.400,9,10,.900,0,16,16,6,3,1,11,22,37,2014
Ryan Kelly,PF,22,LAL,59,25,1312,157,371,.423,48,142,.338,109,229,.476,.488,110,135,.815,42,177,219,95,32,45,47,147,472,2014
Michael Kidd-Gilchrist,SF,20,CHA,62,62,1502,167,353,.473,1,9,.111,166,344,.483,.475,113,184,.614,109,215,324,52,43,39,60,145,448,2014
Andrei Kirilenko,PF,32,BRK,45,4,857,82,160,.513,1,5,.200,81,155,.523,.516,61,119,.513,55,91,146,72,40,19,54,65,226,2014
Brandon Knight,PG,22,MIL,72,69,2400,461,1092,.422,110,338,.325,351,754,.466,.473,259,323,.802,46,209,255,352,69,17,188,146,1291,2014
Kyle Korver,SG,32,ATL,71,71,2408,289,609,.475,185,392,.472,104,217,.479,.626,87,94,.926,22,260,282,208,70,24,102,147,850,2014
Kosta Koufos,C,24,MEM,80,22,1349,227,459,.495,0,0,.000,227,459,.495,.495,60,93,.645,160,258,418,39,32,71,67,182,514,2014
Viacheslav Kravtsov,C,26,PHO,20,0,59,8,15,.533,0,0,.000,8,15,.533,.533,4,8,.500,9,8,17,1,0,1,6,7,20,2014
Ognjen Kuzmic,C,23,GSW,21,0,92,5,13,.385,0,0,.000,5,13,.385,.385,5,11,.455,10,11,21,2,3,4,10,17,15,2014
Doron Lamb,SG,22,ORL,53,0,695,63,160,.394,36,90,.400,27,70,.386,.506,29,36,.806,8,41,49,43,11,1,27,54,191,2014
Jeremy Lamb,SG,21,OKC,78,0,1538,263,609,.432,88,247,.356,175,362,.483,.504,51,64,.797,27,162,189,115,56,26,61,143,665,2014
Carl Landry,PF,30,SAC,18,1,233,31,60,.517,0,0,.000,31,60,.517,.517,14,17,.824,15,42,57,5,3,1,9,34,76,2014
Shane Larkin,PG,21,DAL,48,0,489,52,137,.380,12,38,.316,40,99,.404,.423,16,25,.640,11,31,42,71,26,1,39,46,132,2014
Ty Lawson,PG,26,DEN,62,61,2222,347,806,.431,72,202,.356,275,604,.455,.475,324,406,.798,40,175,215,543,100,10,200,113,1090,2014
Ricky Ledo,SG,21,DAL,11,0,33,6,17,.353,3,8,.375,3,9,.333,.441,4,4,1.000,0,2,2,2,1,0,2,2,19,2014
Courtney Lee,SG,28,TOT,79,47,1973,295,614,.480,72,194,.371,223,420,.531,.539,99,112,.884,29,158,187,115,65,28,73,127,761,2014
Courtney Lee,SG,28,BOS,30,0,504,90,183,.492,23,52,.442,67,131,.511,.555,18,22,.818,8,41,49,32,20,9,25,37,221,2014
Courtney Lee,SG,28,MEM,49,47,1469,205,431,.476,49,142,.345,156,289,.540,.532,81,90,.900,21,117,138,83,45,19,48,90,540,2014
David Lee,PF,30,GSW,69,67,2288,513,981,.523,0,1,.000,513,980,.523,.523,231,296,.780,182,461,643,147,48,26,152,206,1257,2014
Alex Len,C,20,PHO,42,3,362,33,78,.423,0,0,.000,33,78,.423,.423,20,31,.645,39,60,99,4,4,18,26,68,86,2014
Kawhi Leonard,SF,22,SAS,66,65,1923,337,645,.522,69,182,.379,268,463,.579,.576,101,126,.802,76,336,412,133,114,50,80,127,844,2014
Meyers Leonard,C,21,POR,40,0,355,41,91,.451,0,6,.000,41,85,.482,.451,16,21,.762,26,85,111,18,7,5,15,76,98,2014
Jon Leuer,PF,24,MEM,49,0,642,121,246,.492,23,49,.469,98,197,.497,.539,37,47,.787,37,121,158,20,18,13,27,63,302,2014
Rashard Lewis,SF,34,MIA,60,6,971,98,236,.415,46,134,.343,52,102,.510,.513,26,33,.788,24,86,110,57,53,8,35,90,268,2014
DeAndre Liggins,SG,25,MIA,1,0,1,1,1,1.000,0,0,.000,1,1,1.000,1.000,0,0,.000,1,0,1,0,0,0,0,0,2,2014
Damian Lillard,PG,23,POR,82,82,2937,553,1304,.424,218,554,.394,335,750,.447,.508,371,426,.871,35,253,288,457,64,22,193,197,1695,2014
Jeremy Lin,PG,25,HOU,71,33,2054,295,662,.446,82,229,.358,213,433,.492,.508,218,265,.823,34,153,187,294,68,27,176,166,890,2014
Shaun Livingston,PG,28,BRK,76,54,1974,235,487,.483,1,6,.167,234,481,.486,.484,158,191,.827,67,179,246,245,93,31,105,172,629,2014
Brook Lopez,C,25,BRK,17,17,533,129,229,.563,0,1,.000,129,228,.566,.563,94,115,.817,39,63,102,16,9,30,28,52,352,2014
Robin Lopez,C,25,POR,82,82,2603,355,644,.551,0,1,.000,355,643,.552,.551,198,242,.818,326,374,700,73,25,139,84,196,908,2014
Kevin Love,PF,25,MIN,77,77,2797,650,1421,.457,190,505,.376,460,916,.502,.524,520,633,.821,224,739,963,341,59,35,196,136,2010,2014
Kyle Lowry,PG,27,TOR,79,79,2862,457,1080,.423,190,500,.380,267,580,.460,.511,313,385,.813,88,281,369,586,121,15,194,267,1417,2014
John Lucas III,PG,31,UTA,42,6,591,62,190,.326,25,84,.298,37,106,.349,.392,10,16,.625,12,27,39,42,14,0,22,41,159,2014
Shelvin Mack,PG,23,ATL,73,11,1490,209,501,.417,62,184,.337,147,317,.464,.479,64,74,.865,21,139,160,271,50,2,89,100,544,2014
Ian Mahinmi,C,27,IND,77,1,1248,91,189,.481,0,1,.000,91,188,.484,.481,90,145,.621,107,150,257,24,41,72,58,207,272,2014
Shawn Marion,SF,35,DAL,76,76,2409,341,708,.482,58,162,.358,283,546,.518,.523,51,65,.785,132,365,497,124,90,37,95,125,791,2014
Kendall Marshall,PG,22,LAL,54,45,1564,170,419,.406,71,178,.399,99,241,.411,.490,19,36,.528,15,140,155,477,48,4,150,76,430,2014
Cartier Martin,SF,29,TOT,59,6,870,111,264,.420,59,151,.391,52,113,.460,.532,48,65,.738,13,97,110,33,27,7,34,71,329,2014
Cartier Martin,SF,29,ATL,53,6,822,106,256,.414,56,146,.384,50,110,.455,.523,46,61,.754,12,93,105,31,26,7,33,68,314,2014
Cartier Martin,SF,29,CHI,6,0,48,5,8,.625,3,5,.600,2,3,.667,.813,2,4,.500,1,4,5,2,1,0,1,3,15,2014
Kenyon Martin,PF,36,NYK,32,15,633,63,123,.512,0,1,.000,63,122,.516,.512,11,19,.579,36,98,134,50,25,27,26,85,137,2014
Kevin Martin,SG,30,MIN,68,68,2177,440,1023,.430,115,297,.387,325,726,.448,.486,303,340,.891,34,169,203,121,66,6,106,123,1298,2014
Roger Mason,SG,33,MIA,25,2,260,25,67,.373,17,48,.354,8,19,.421,.500,7,7,1.000,1,21,22,19,6,1,9,26,74,2014
Wesley Matthews,SG,27,POR,82,82,2780,445,1009,.441,201,511,.393,244,498,.490,.541,252,301,.837,51,238,289,197,76,14,110,176,1343,2014
Jason Maxiell,PF,30,ORL,34,13,488,47,105,.448,0,0,.000,47,105,.448,.448,15,31,.484,28,58,86,9,8,20,14,47,109,2014
Eric Maynor,PG,26,TOT,31,0,327,32,101,.317,12,37,.324,20,64,.313,.376,6,11,.545,9,30,39,52,9,3,29,17,82,2014
Eric Maynor,PG,26,WAS,23,0,215,21,72,.292,8,25,.320,13,47,.277,.347,2,3,.667,7,17,24,40,5,1,17,13,52,2014
Eric Maynor,PG,26,PHI,8,0,112,11,29,.379,4,12,.333,7,17,.412,.448,4,8,.500,2,13,15,12,4,2,12,4,30,2014
O.J. Mayo,SG,26,MIL,52,23,1346,224,550,.407,84,227,.370,140,323,.433,.484,76,88,.864,24,100,124,113,28,13,95,111,608,2014
Luc Mbah a Moute,PF-SF,27,TOT,64,7,1003,87,193,.451,4,17,.235,83,176,.472,.461,46,67,.687,56,90,146,36,30,14,40,68,224,2014
Luc Mbah a Moute,SF,27,SAC,9,5,196,15,32,.469,1,3,.333,14,29,.483,.484,9,13,.692,9,18,27,15,9,5,4,18,40,2014
Luc Mbah a Moute,PF,27,MIN,55,2,807,72,161,.447,3,14,.214,69,147,.469,.457,37,54,.685,47,72,119,21,21,9,36,50,184,2014
Ray McCallum,PG,22,SAC,45,10,897,113,300,.377,22,59,.373,91,241,.378,.413,32,43,.744,18,61,79,120,22,9,39,69,280,2014
C.J. McCollum,SG,22,POR,38,0,476,74,178,.416,30,80,.375,44,98,.449,.500,23,34,.676,7,41,48,27,14,2,35,53,201,2014
JaVale McGee,C,26,DEN,5,5,79,17,38,.447,0,0,.000,17,38,.447,.447,1,1,1.000,10,7,17,2,1,7,8,16,35,2014
Ben McLemore,SG,20,SAC,82,55,2187,255,679,.376,95,297,.320,160,382,.419,.446,115,143,.804,53,182,235,82,45,18,96,201,720,2014
Josh McRoberts,PF,26,CHA,78,78,2360,247,566,.436,105,291,.361,142,275,.516,.529,62,85,.729,85,288,373,333,58,46,83,189,661,2014
Jodie Meeks,SG,26,LAL,77,70,2556,413,892,.463,162,404,.401,251,488,.514,.554,221,258,.857,30,164,194,138,111,4,111,119,1209,2014
Gal Mekel,PG,25,DAL,31,1,292,30,86,.349,5,20,.250,25,66,.379,.378,8,12,.667,5,22,27,63,4,1,31,31,73,2014
Khris Middleton,SF,22,MIL,82,64,2460,376,854,.440,120,290,.414,256,564,.454,.511,118,137,.861,60,250,310,169,83,20,123,243,990,2014
C.J. Miles,SG,26,CLE,51,34,984,178,409,.435,83,211,.393,95,198,.480,.537,64,75,.853,18,85,103,52,46,15,44,103,503,2014
Andre Miller,SG,37,TOT,58,2,982,106,231,.459,11,21,.524,95,210,.452,.483,60,77,.779,28,102,130,197,34,9,61,75,283,2014
Andre Miller,SG,37,DEN,30,2,570,66,144,.458,9,18,.500,57,126,.452,.490,35,47,.745,16,57,73,100,15,7,33,32,176,2014
Andre Miller,SG,37,WAS,28,0,412,40,87,.460,2,3,.667,38,84,.452,.471,25,30,.833,12,45,57,97,19,2,28,43,107,2014
Darius Miller,SF,23,NOP,45,7,723,73,166,.440,25,77,.325,48,89,.539,.515,29,36,.806,9,43,52,43,24,9,22,88,200,2014
Mike Miller,SF,33,MEM,82,4,1707,213,443,.481,107,233,.459,106,210,.505,.602,46,56,.821,30,177,207,130,26,5,77,95,579,2014
Quincy Miller,PF,21,DEN,52,16,789,94,256,.367,30,94,.319,64,162,.395,.426,39,55,.709,36,111,147,26,22,32,48,70,257,2014
Patty Mills,PG,25,SAS,81,2,1527,309,666,.464,135,318,.425,174,348,.500,.565,73,82,.890,34,135,169,149,68,9,63,114,826,2014
Paul Millsap,PF,28,ATL,74,73,2482,483,1047,.461,76,212,.358,407,835,.487,.498,286,391,.731,154,473,627,232,129,78,185,210,1328,2014
Tony Mitchell,SF,24,MIL,3,0,10,3,5,.600,0,1,.000,3,4,.750,.600,0,0,.000,1,0,1,1,1,0,0,0,6,2014
Tony Mitchell,PF,21,DET,21,0,79,5,12,.417,1,1,1.000,4,11,.364,.458,11,19,.579,15,11,26,2,6,3,4,9,22,2014
Nazr Mohammed,C,36,CHI,80,1,562,54,126,.429,0,0,.000,54,126,.429,.429,16,30,.533,66,109,175,20,14,30,37,77,124,2014
Greg Monroe,PF,23,DET,82,82,2690,504,1015,.497,0,1,.000,504,1014,.497,.497,241,367,.657,256,504,760,171,91,47,166,205,1249,2014
E'Twaun Moore,SG,24,ORL,79,3,1506,195,456,.428,57,161,.354,138,295,.468,.490,52,68,.765,29,107,136,112,60,13,55,106,499,2014
Darius Morris,PG,23,TOT,27,0,313,39,96,.406,12,38,.316,27,58,.466,.469,17,26,.654,7,19,26,44,13,0,27,33,107,2014
Darius Morris,PG,23,PHI,12,0,193,29,67,.433,10,24,.417,19,43,.442,.507,15,21,.714,3,10,13,31,8,0,19,21,83,2014
Darius Morris,PG,23,LAC,10,0,54,4,13,.308,0,7,.000,4,6,.667,.308,1,2,.500,0,5,5,5,2,0,2,9,9,2014
Darius Morris,PG,23,MEM,5,0,66,6,16,.375,2,7,.286,4,9,.444,.438,1,3,.333,4,4,8,8,3,0,6,3,15,2014
Marcus Morris,SF,24,PHO,82,1,1800,288,651,.442,99,260,.381,189,391,.483,.518,121,159,.761,84,235,319,88,72,18,95,157,796,2014
Markieff Morris,PF,24,PHO,81,0,2153,411,845,.486,34,108,.315,377,737,.512,.507,259,327,.792,139,346,485,144,68,51,147,232,1115,2014
Anthony Morrow,SG,28,NOP,76,9,1426,238,520,.458,88,195,.451,150,325,.462,.542,72,87,.828,29,111,140,59,38,12,51,102,636,2014
Donatas Motiejunas,PF,23,HOU,62,3,952,131,296,.443,21,84,.250,110,212,.519,.478,58,96,.604,60,165,225,34,20,21,49,132,341,2014
Arnett Moultrie,PF,23,PHI,12,2,187,16,38,.421,0,0,.000,16,38,.421,.421,4,5,.800,11,24,35,2,8,4,7,22,36,2014
Timofey Mozgov,C,27,DEN,82,30,1770,285,545,.523,4,24,.167,281,521,.539,.527,196,260,.754,171,357,528,62,27,100,122,213,770,2014
Shabazz Muhammad,SG,21,MIN,37,0,290,57,124,.460,3,11,.273,54,113,.478,.472,26,40,.650,24,29,53,6,8,1,16,24,143,2014
Byron Mullens,C,24,TOT,45,0,414,73,165,.442,33,89,.371,40,76,.526,.542,10,20,.500,24,68,92,14,15,11,27,64,189,2014
Byron Mullens,C,24,LAC,27,0,167,26,64,.406,13,39,.333,13,25,.520,.508,2,6,.333,7,25,32,6,6,3,13,33,67,2014
Byron Mullens,C,24,PHI,18,0,247,47,101,.465,20,50,.400,27,51,.529,.564,8,14,.571,17,43,60,8,9,8,14,31,122,2014
Erik Murphy,C,23,CHI,24,0,62,3,13,.231,0,3,.000,3,10,.300,.231,0,0,.000,2,6,8,2,0,4,2,7,6,2014
Toure' Murry,PG,24,NYK,51,0,373,56,129,.434,5,12,.417,51,117,.436,.453,23,39,.590,13,31,44,49,19,1,34,46,140,2014
Mike Muscala,PF,22,ATL,20,0,215,31,73,.425,0,3,.000,31,70,.443,.425,14,14,1.000,17,35,52,7,3,10,12,29,76,2014
Hamady N'Diaye,C,27,SAC,14,0,74,3,9,.333,0,0,.000,3,9,.333,.333,0,1,.000,5,13,18,3,0,4,3,15,6,2014
Steve Nash,PG,39,LAL,15,10,313,36,94,.383,8,24,.333,28,70,.400,.426,22,24,.917,4,25,29,86,7,2,31,18,102,2014
Gary Neal,SG,29,TOT,52,3,1114,193,471,.410,68,180,.378,125,291,.430,.482,94,105,.895,10,80,90,83,18,0,64,65,548,2014
Gary Neal,SG,29,MIL,30,2,607,108,277,.390,40,111,.360,68,166,.410,.462,45,54,.833,8,42,50,46,7,0,39,26,301,2014
Gary Neal,SG,29,CHA,22,1,507,85,194,.438,28,69,.406,57,125,.456,.510,49,51,.961,2,38,40,37,11,0,25,39,247,2014
Nemanja Nedovic,SG,22,GSW,24,0,142,8,39,.205,3,18,.167,5,21,.238,.244,7,8,.875,3,12,15,13,0,1,13,13,26,2014
Jameer Nelson,PG,31,ORL,68,68,2179,294,747,.394,136,391,.348,158,356,.444,.485,96,112,.857,29,202,231,476,52,5,166,146,820,2014
Andrew Nicholson,PF,24,ORL,76,5,1174,180,420,.429,28,89,.315,152,331,.459,.462,47,57,.825,53,202,255,25,18,23,51,150,435,2014
Joakim Noah,C,28,CHI,80,80,2820,380,800,.475,0,2,.000,380,798,.476,.475,247,335,.737,282,618,900,431,99,121,194,245,1007,2014
Steve Novak,PF,30,TOR,54,1,540,60,146,.411,52,122,.426,8,24,.333,.589,6,6,1.000,8,50,58,13,12,4,5,44,178,2014
Dirk Nowitzki,PF,35,DAL,80,80,2628,633,1273,.497,131,329,.398,502,944,.532,.549,338,376,.899,40,458,498,216,73,45,117,165,1735,2014
James Nunnally,SF,23,TOT,13,0,165,15,46,.326,8,25,.320,7,21,.333,.413,6,9,.667,1,18,19,8,6,2,7,11,44,2014
James Nunnally,SF,23,ATL,4,0,54,6,18,.333,3,10,.300,3,8,.375,.417,3,4,.750,1,7,8,2,1,1,4,2,18,2014
James Nunnally,SF,23,PHI,9,0,111,9,28,.321,5,15,.333,4,13,.308,.411,3,5,.600,0,11,11,6,5,1,3,9,26,2014
Jermaine O'Neal,PF,35,GSW,44,13,883,125,248,.504,0,0,.000,125,248,.504,.504,99,132,.750,85,157,242,25,14,40,52,102,349,2014
Kyle O'Quinn,C,23,ORL,69,19,1188,186,371,.501,0,3,.000,186,368,.505,.501,57,83,.687,100,264,364,78,39,88,78,165,429,2014
Greg Oden,C,26,MIA,23,6,212,27,49,.551,0,0,.000,27,49,.551,.551,13,23,.565,23,31,54,1,7,13,12,52,67,2014
Victor Oladipo,PG,21,ORL,80,44,2487,392,936,.419,74,226,.327,318,710,.448,.458,248,318,.780,43,286,329,327,129,37,256,210,1106,2014
Kelly Olynyk,C,22,BOS,70,9,1400,234,502,.466,40,114,.351,194,388,.500,.506,99,122,.811,140,225,365,109,35,27,106,227,607,2014
Arinze Onuaku,PF,26,TOT,5,0,30,1,5,.200,0,0,.000,1,5,.200,.200,1,2,.500,2,6,8,3,0,0,1,3,3,2014
Arinze Onuaku,PF,26,NOP,3,0,25,1,4,.250,0,0,.000,1,4,.250,.250,1,2,.500,2,5,7,3,0,0,1,3,3,2014
Arinze Onuaku,PF,26,CLE,2,0,5,0,1,.000,0,0,.000,0,1,.000,.000,0,0,.000,0,1,1,0,0,0,0,0,0,2014
Daniel Orton,C,23,PHI,22,4,251,21,47,.447,0,0,.000,21,47,.447,.447,23,30,.767,16,45,61,15,6,16,18,38,65,2014
Travis Outlaw,SF,29,SAC,63,4,1065,130,326,.399,41,117,.350,89,209,.426,.462,42,52,.808,36,132,168,48,20,19,26,94,343,2014
Zaza Pachulia,C,29,MIL,53,43,1325,149,349,.427,0,1,.000,149,348,.428,.427,110,130,.846,141,192,333,136,45,14,92,124,408,2014
Jannero Pargo,PG,34,CHA,29,0,242,52,118,.441,24,60,.400,28,58,.483,.542,8,11,.727,1,19,20,52,14,1,26,17,136,2014
Tony Parker,PG,31,SAS,68,68,1997,456,914,.499,25,67,.373,431,847,.509,.513,197,243,.811,17,138,155,388,36,9,151,86,1134,2014
Chandler Parsons,SF,25,HOU,74,74,2783,466,987,.472,130,351,.370,336,636,.528,.538,164,221,.742,69,340,409,298,88,29,144,168,1226,2014
Patrick Patterson,PF,24,TOT,65,13,1533,225,489,.460,55,151,.364,170,338,.503,.516,50,71,.704,117,225,342,78,55,37,65,159,555,2014
Patrick Patterson,PF,24,SAC,17,6,415,50,122,.410,9,39,.231,41,83,.494,.447,9,16,.563,34,65,99,15,13,3,16,39,118,2014
Patrick Patterson,PF,24,TOR,48,7,1118,175,367,.477,46,112,.411,129,255,.506,.540,41,55,.745,83,160,243,63,42,34,49,120,437,2014
Chris Paul,PG,28,LAC,62,62,2171,406,870,.467,78,212,.368,328,658,.498,.511,295,345,.855,38,230,268,663,154,4,145,157,1185,2014
Nikola Pekovic,C,28,MIN,54,54,1663,379,701,.541,0,0,.000,379,701,.541,.541,186,249,.747,206,262,468,50,30,23,84,129,944,2014
Kendrick Perkins,C,29,OKC,62,62,1207,87,193,.451,0,1,.000,87,192,.453,.451,37,67,.552,82,223,305,67,26,32,90,177,211,2014
Paul Pierce,SF,36,BRK,75,68,2098,321,712,.451,112,300,.373,209,412,.507,.529,256,310,.826,26,322,348,178,86,31,153,190,1010,2014
Dexter Pittman,C,25,ATL,2,0,3,0,1,.000,0,0,.000,0,1,.000,.000,0,2,.000,3,0,3,0,0,0,0,0,0,2014
Mason Plumlee,C,23,BRK,70,22,1275,199,302,.659,0,3,.000,199,299,.666,.659,122,195,.626,99,209,308,60,49,55,77,171,520,2014
Miles Plumlee,C,25,PHO,80,79,1964,286,553,.517,0,0,.000,286,553,.517,.517,74,132,.561,198,428,626,43,50,90,111,185,646,2014
Quincy Pondexter,SG,25,MEM,15,2,270,31,79,.392,11,34,.324,20,45,.444,.462,21,26,.808,10,16,26,20,5,1,15,18,94,2014
Otto Porter,SF,20,WAS,37,0,319,33,91,.363,4,21,.190,29,70,.414,.385,8,12,.667,21,36,57,10,8,1,14,26,78,2014
Josh Powell,PF,31,HOU,1,0,19,2,6,.333,0,0,.000,2,6,.333,.333,0,0,.000,0,5,5,0,0,1,1,1,4,2014
Phil Pressey,PG,22,BOS,75,11,1132,78,253,.308,28,106,.264,50,147,.340,.364,29,45,.644,20,85,105,241,68,5,87,97,213,2014
A.J. Price,SG,27,MIN,28,0,99,19,46,.413,6,22,.273,13,24,.542,.478,0,2,.000,1,9,10,13,1,0,7,5,44,2014
Ronnie Price,SG,30,ORL,31,2,377,28,92,.304,9,43,.209,19,49,.388,.353,9,13,.692,8,35,43,66,25,2,26,50,74,2014
Pablo Prigioni,PG,36,NYK,66,27,1283,88,191,.461,65,140,.464,23,51,.451,.631,11,12,.917,36,93,129,228,67,2,60,132,252,2014
Tayshaun Prince,SF,33,MEM,76,76,1948,200,492,.407,20,69,.290,180,423,.426,.427,34,60,.567,32,202,234,119,39,19,41,63,454,2014
Miroslav Raduljica,C,26,MIL,48,2,465,68,126,.540,0,0,.000,68,126,.540,.540,45,55,.818,54,54,108,23,7,13,28,84,181,2014
Anthony Randolph,PF,24,DEN,43,5,527,68,176,.386,18,61,.295,50,115,.435,.438,52,69,.754,20,102,122,32,26,19,39,64,206,2014
Shavlik Randolph,PF,30,PHO,14,0,95,7,14,.500,0,0,.000,7,14,.500,.500,6,11,.545,7,18,25,1,3,1,5,15,20,2014
Zach Randolph,PF,32,MEM,79,79,2705,560,1198,.467,2,20,.100,558,1178,.474,.468,250,337,.742,265,530,795,200,54,23,183,210,1372,2014
J.J. Redick,SG,29,LAC,35,34,987,181,398,.455,73,185,.395,108,213,.507,.546,97,106,.915,9,65,74,78,28,3,42,65,532,2014
Glen Rice,SG,23,WAS,11,1,109,11,37,.297,5,17,.294,6,20,.300,.365,5,7,.714,4,16,20,7,6,1,9,7,32,2014
Luke Ridnour,PG,32,TOT,61,14,1141,126,327,.385,37,108,.343,89,219,.406,.442,17,26,.654,23,74,97,176,32,8,66,92,306,2014
Luke Ridnour,PG,32,MIL,36,12,763,84,219,.384,25,68,.368,59,151,.391,.441,13,19,.684,15,47,62,122,23,2,46,55,206,2014
Luke Ridnour,PG,32,CHA,25,2,378,42,108,.389,12,40,.300,30,68,.441,.444,4,7,.571,8,27,35,54,9,6,20,37,100,2014
Austin Rivers,PG,21,NOP,69,4,1339,192,474,.405,36,99,.364,156,375,.416,.443,110,173,.636,26,103,129,160,45,9,77,134,530,2014
Andre Roberson,SG,22,OKC,40,16,399,33,68,.485,2,13,.154,31,55,.564,.500,7,10,.700,36,58,94,15,19,10,19,74,75,2014
Brian Roberts,PG,28,NOP,72,42,1667,244,581,.420,64,178,.360,180,403,.447,.475,125,133,.940,17,119,136,234,43,7,95,132,677,2014
Nate Robinson,PG,29,DEN,44,1,866,164,383,.428,58,154,.377,106,229,.463,.504,71,85,.835,21,60,81,112,36,4,58,92,457,2014
Thomas Robinson,PF,22,POR,70,0,873,141,293,.481,0,1,.000,141,292,.483,.481,57,101,.564,105,202,307,34,23,20,57,131,339,2014
Rajon Rondo,PG,27,BOS,30,30,998,141,350,.403,26,90,.289,115,260,.442,.440,42,67,.627,22,142,164,294,40,2,99,65,350,2014
Derrick Rose,PG,25,CHI,10,10,311,58,164,.354,16,47,.340,42,117,.359,.402,27,32,.844,9,23,32,43,5,1,34,15,159,2014
Terrence Ross,SG,22,TOR,81,62,2159,318,751,.423,161,408,.395,157,343,.458,.531,82,98,.837,43,209,252,79,64,27,88,183,879,2014
Ricky Rubio,PG,23,MIN,82,82,2638,255,670,.381,44,133,.331,211,537,.393,.413,227,283,.802,61,281,342,704,191,11,221,218,781,2014
Brandon Rush,SG,28,UTA,38,0,418,30,90,.333,16,47,.340,14,43,.326,.422,3,5,.600,5,39,44,24,5,9,20,31,79,2014
Robert Sacre,C,24,LAL,65,13,1089,143,300,.477,0,0,.000,143,300,.477,.477,64,94,.681,82,172,254,51,24,47,44,134,350,2014
John Salmons,SG-SF,34,TOT,78,8,1726,150,413,.363,63,163,.387,87,250,.348,.439,40,52,.769,20,143,163,147,47,19,54,124,403,2014
John Salmons,SF,34,SAC,18,8,445,41,117,.350,16,42,.381,25,75,.333,.419,7,7,1.000,8,38,46,44,12,8,14,32,105,2014
John Salmons,SG,34,TOR,60,0,1281,109,296,.368,47,121,.388,62,175,.354,.448,33,45,.733,12,105,117,103,35,11,40,92,298,2014
Larry Sanders,C,25,MIL,23,20,584,76,162,.469,0,1,.000,76,161,.472,.469,26,55,.473,60,105,165,19,18,40,26,74,178,2014
Dennis Schroder,PG,20,ATL,49,0,641,72,188,.383,10,42,.238,62,146,.425,.410,29,43,.674,5,55,60,93,17,0,61,54,183,2014
Luis Scola,PF,33,IND,82,2,1399,263,560,.470,1,7,.143,262,553,.474,.471,99,136,.728,86,305,391,81,26,16,108,164,626,2014
Mike Scott,PF,25,ATL,80,6,1482,301,628,.479,62,200,.310,239,428,.558,.529,103,132,.780,62,222,284,75,30,7,79,121,767,2014
Thabo Sefolosha,SG,29,OKC,61,61,1584,141,340,.415,48,152,.316,93,188,.495,.485,53,69,.768,50,170,220,94,79,17,55,90,383,2014
Kevin Seraphin,C,24,WAS,53,1,578,111,220,.505,0,0,.000,111,220,.505,.505,27,31,.871,53,75,128,17,3,26,41,103,249,2014
Ramon Sessions,PG,27,TOT,83,19,2214,330,769,.429,35,124,.282,295,645,.457,.452,326,404,.807,38,165,203,340,49,9,148,90,1021,2014
Ramon Sessions,PG,27,CHA,55,7,1305,190,465,.409,15,68,.221,175,397,.441,.425,183,234,.782,22,95,117,206,33,6,93,50,578,2014
Ramon Sessions,PG,27,MIL,28,12,909,140,304,.461,20,56,.357,120,248,.484,.493,143,170,.841,16,70,86,134,16,3,55,40,443,2014
Mustafa Shakur,PG,29,OKC,3,0,11,0,3,.000,0,1,.000,0,2,.000,.000,1,2,.500,0,0,0,4,0,0,2,2,1,2014
Tornike Shengelia,SF,22,TOT,26,0,154,13,28,.464,0,6,.000,13,22,.591,.464,3,8,.375,4,12,16,14,3,1,12,18,29,2014
Tornike Shengelia,SF,22,BRK,17,0,137,11,24,.458,0,6,.000,11,18,.611,.458,3,8,.375,4,10,14,12,2,1,11,16,25,2014
Tornike Shengelia,SF,22,CHI,9,0,17,2,4,.500,0,0,.000,2,4,.500,.500,0,0,.000,0,2,2,2,1,0,1,2,4,2014
Iman Shumpert,SG,23,NYK,74,58,1962,183,484,.378,76,228,.333,107,256,.418,.457,53,71,.746,81,227,308,129,92,13,79,209,495,2014
Alexey Shved,SG,25,MIN,63,0,664,76,237,.321,30,102,.294,46,135,.341,.384,68,90,.756,21,60,81,68,26,16,48,36,250,2014
Henry Sims,C,23,TOT,46,25,875,130,274,.474,0,1,.000,130,273,.476,.474,90,121,.744,104,133,237,52,28,20,41,116,350,2014
Henry Sims,C,23,CLE,20,0,168,18,45,.400,0,0,.000,18,45,.400,.400,8,14,.571,22,34,56,5,5,7,8,32,44,2014
Henry Sims,C,23,PHI,26,25,707,112,229,.489,0,1,.000,112,228,.491,.489,82,107,.766,82,99,181,47,23,13,33,84,306,2014
Kyle Singler,SF,25,DET,82,36,2337,269,602,.447,94,246,.382,175,356,.492,.525,152,184,.826,116,187,303,75,61,38,79,211,784,2014
Chris Singleton,SF,24,WAS,25,0,250,25,67,.373,7,19,.368,18,48,.375,.425,18,25,.720,18,37,55,6,9,3,17,25,75,2014
Peyton Siva,SG,23,DET,24,0,224,18,57,.316,7,25,.280,11,32,.344,.377,11,15,.733,2,12,14,34,9,1,18,27,54,2014
Donald Sloan,SG,26,IND,48,1,392,44,117,.376,10,42,.238,34,75,.453,.419,12,20,.600,4,40,44,50,10,1,22,19,110,2014
Chris Smith,PG,26,NYK,2,0,2,0,0,.000,0,0,.000,0,0,.000,.000,0,0,.000,0,0,0,0,0,0,0,0,0,2014
Greg Smith,C,23,HOU,11,0,100,18,28,.643,0,0,.000,18,28,.643,.643,2,5,.400,11,16,27,0,1,2,5,17,38,2014
Ish Smith,PG,25,PHO,70,1,1006,119,281,.423,1,23,.043,118,258,.457,.425,22,39,.564,31,98,129,179,49,13,65,66,261,2014
J.R. Smith,SF,28,NYK,74,37,2421,396,955,.415,189,480,.394,207,475,.436,.514,90,138,.652,35,261,296,219,65,20,108,196,1071,2014
Jason Smith,PF,27,NOP,31,27,830,131,282,.465,0,0,.000,131,282,.465,.465,39,50,.780,51,130,181,29,11,29,28,100,301,2014
Josh Smith,SF,28,DET,77,76,2730,517,1233,.419,70,265,.264,447,968,.462,.448,160,301,.532,102,418,520,252,105,110,199,197,1264,2014
Tony Snell,SG,22,CHI,77,12,1231,129,336,.384,57,178,.320,72,158,.456,.469,31,41,.756,19,105,124,68,29,15,44,84,346,2014
James Southerland,SF,23,TOT,4,0,30,5,15,.333,3,6,.500,2,9,.222,.433,1,2,.500,0,8,8,0,1,2,1,3,14,2014
James Southerland,SF,23,CHA,1,0,3,0,3,.000,0,1,.000,0,2,.000,.000,0,0,.000,0,0,0,0,0,0,0,0,0,2014
James Southerland,SF,23,NOP,3,0,27,5,12,.417,3,5,.600,2,7,.286,.542,1,2,.500,0,8,8,0,1,2,1,3,14,2014
Marreese Speights,C,26,GSW,79,3,982,195,442,.441,8,31,.258,187,411,.455,.450,110,134,.821,101,189,290,32,10,34,66,148,508,2014
Tiago Splitter,C,29,SAS,59,50,1271,181,346,.523,0,3,.000,181,343,.528,.523,121,173,.699,123,240,363,90,29,31,75,117,483,2014
D.J. Stephens,SG,23,MIL,3,0,15,3,7,.429,0,0,.000,3,7,.429,.429,1,1,1.000,1,4,5,0,0,0,0,0,7,2014
Lance Stephenson,SG,23,IND,78,78,2752,427,870,.491,86,244,.352,341,626,.545,.540,140,197,.711,95,463,558,359,54,7,210,195,1080,2014
Greg Stiemsma,C,28,NOP,55,20,1007,70,122,.574,0,1,.000,70,121,.579,.574,19,32,.594,72,154,226,36,35,57,44,169,159,2014
Julyan Stone,SG,25,TOR,21,0,120,7,17,.412,2,8,.250,5,9,.556,.471,2,3,.667,2,18,20,12,3,0,5,13,18,2014
Amar'e Stoudemire,C,31,NYK,65,21,1466,311,558,.557,0,0,.000,311,558,.557,.557,150,203,.739,112,208,320,34,23,37,91,159,772,2014
Rodney Stuckey,SG,27,DET,73,5,1950,372,853,.436,24,88,.273,348,765,.455,.450,244,292,.836,39,130,169,152,54,10,125,131,1012,2014
Jared Sullinger,PF,21,BOS,74,44,2041,384,899,.427,56,208,.269,328,691,.475,.458,158,203,.778,241,360,601,118,35,49,119,251,982,2014
Jeffery Taylor,SF,24,CHA,26,8,629,82,218,.376,18,67,.269,64,151,.424,.417,26,47,.553,15,45,60,22,13,5,25,62,208,2014
Tyshawn Taylor,PG,23,BRK,23,3,270,31,91,.341,3,12,.250,28,79,.354,.357,24,30,.800,3,12,15,36,12,1,31,29,89,2014
Jeff Teague,PG,25,ATL,79,79,2542,456,1040,.438,74,225,.329,382,815,.469,.474,318,376,.846,34,174,208,528,89,17,232,158,1304,2014
Marquis Teague,SG,20,TOT,40,3,443,38,119,.319,5,18,.278,33,101,.327,.340,26,35,.743,1,39,40,58,10,5,39,46,107,2014
Marquis Teague,SG,20,CHI,19,2,242,16,66,.242,2,10,.200,14,56,.250,.258,11,16,.688,1,18,19,28,2,4,17,25,45,2014
Marquis Teague,SG,20,BRK,21,1,201,22,53,.415,3,8,.375,19,45,.422,.443,15,19,.789,0,21,21,30,8,1,22,21,62,2014
Mirza Teletovic,SF,28,BRK,72,7,1396,221,529,.418,136,349,.390,85,180,.472,.546,44,62,.710,60,206,266,57,29,23,54,143,622,2014
Garrett Temple,SG,27,WAS,75,0,638,51,141,.362,6,29,.207,45,112,.402,.383,30,43,.698,21,47,68,72,35,11,42,72,138,2014
Jason Terry,PG,36,BRK,35,0,570,55,152,.362,39,103,.379,16,49,.327,.490,10,15,.667,4,33,37,56,13,0,27,48,159,2014
Hasheem Thabeet,C,26,OKC,23,0,192,13,23,.565,0,0,.000,13,23,.565,.565,1,5,.200,9,31,40,1,4,9,14,47,27,2014
Adonis Thomas,SF,20,TOT,6,1,37,6,14,.429,1,5,.200,5,9,.556,.464,1,1,1.000,0,3,3,3,0,0,1,6,14,2014
Adonis Thomas,SF,20,ORL,4,0,24,3,9,.333,0,3,.000,3,6,.500,.333,1,1,1.000,0,3,3,2,0,0,0,2,7,2014
Adonis Thomas,SF,20,PHI,2,1,13,3,5,.600,1,2,.500,2,3,.667,.700,0,0,.000,0,0,0,1,0,0,1,4,7,2014
Isaiah Thomas,PG,24,SAC,72,54,2497,496,1096,.453,127,364,.349,369,732,.504,.510,346,407,.850,47,163,210,454,93,8,213,185,1465,2014
Lance Thomas,SF,25,NOP,5,0,42,2,9,.222,0,0,.000,2,9,.222,.222,2,4,.500,2,5,7,3,0,0,2,4,6,2014
Malcolm Thomas,PF,25,TOT,8,0,63,7,16,.438,1,4,.250,6,12,.500,.469,0,2,.000,5,16,21,2,0,3,9,5,15,2014
Malcolm Thomas,PF,25,SAS,1,0,15,1,4,.250,0,0,.000,1,4,.250,.250,0,2,.000,1,8,9,0,0,2,1,0,2,2014
Malcolm Thomas,PF,25,UTA,7,0,48,6,12,.500,1,4,.250,5,8,.625,.542,0,0,.000,4,8,12,2,0,1,8,5,13,2014
Hollis Thompson,SF,22,PHI,77,41,1742,171,372,.460,67,167,.401,104,205,.507,.550,52,73,.712,73,174,247,73,53,12,60,144,461,2014
Jason Thompson,PF,27,SAC,82,61,2007,251,496,.506,0,0,.000,251,496,.506,.506,84,145,.579,153,374,527,53,32,56,95,251,586,2014
Klay Thompson,SG,23,GSW,81,81,2868,559,1259,.444,223,535,.417,336,724,.464,.533,147,185,.795,38,211,249,181,74,37,135,234,1488,2014
Tristan Thompson,PF,22,CLE,82,82,2594,363,761,.477,0,1,.000,363,760,.478,.477,235,339,.693,269,485,754,72,42,35,108,188,961,2014
Marcus Thornton,SG,26,TOT,72,27,1741,252,639,.394,109,316,.345,143,323,.443,.480,90,112,.804,57,141,198,77,58,11,67,110,703,2014
Marcus Thornton,SG,26,SAC,46,26,1121,142,373,.381,57,179,.318,85,194,.438,.457,42,52,.808,39,85,124,47,31,8,38,74,383,2014
Marcus Thornton,SG,26,BRK,26,1,620,110,266,.414,52,137,.380,58,129,.450,.511,48,60,.800,18,56,74,30,27,3,29,36,320,2014
Jamaal Tinsley,PG,35,UTA,8,5,110,4,20,.200,1,15,.067,3,5,.600,.225,0,0,.000,2,9,11,23,2,0,9,10,9,2014
Anthony Tolliver,PF,28,CHA,64,9,1298,129,307,.420,102,247,.413,27,60,.450,.586,33,41,.805,33,135,168,42,19,15,23,82,393,2014
P.J. Tucker,SF,28,PHO,81,81,2490,265,615,.431,74,191,.387,191,424,.450,.491,156,201,.776,161,368,529,141,110,23,102,204,760,2014
Ronny Turiaf,C,31,MIN,31,10,606,64,107,.598,0,0,.000,64,107,.598,.598,21,50,.420,55,119,174,24,8,50,24,65,149,2014
Hedo Turkoglu,SF,34,LAC,38,0,392,42,109,.385,22,50,.440,20,59,.339,.486,9,18,.500,11,78,89,33,19,10,16,50,115,2014
Evan Turner,SF,25,TOT,81,56,2457,434,1021,.425,50,156,.321,384,865,.444,.450,213,262,.813,62,346,408,262,67,7,189,195,1131,2014
Evan Turner,SF,25,PHI,54,54,1886,356,831,.428,38,132,.288,318,699,.455,.451,189,228,.829,50,272,322,198,56,5,155,147,939,2014
Evan Turner,SF,25,IND,27,2,571,78,190,.411,12,24,.500,66,166,.398,.442,24,34,.706,12,74,86,64,11,2,34,48,192,2014
Jeremy Tyler,C,22,NYK,41,0,398,60,116,.517,0,0,.000,60,116,.517,.517,26,48,.542,38,71,109,8,6,20,26,70,146,2014
Ekpe Udoh,PF,26,MIL,42,14,804,57,143,.399,0,0,.000,57,143,.399,.399,30,47,.638,61,87,148,31,15,44,38,96,144,2014
Beno Udrih,SG,31,TOT,41,12,643,78,178,.438,19,42,.452,59,136,.434,.492,25,30,.833,10,49,59,116,23,4,47,50,200,2014
Beno Udrih,SG,31,NYK,31,12,588,68,160,.425,17,40,.425,51,120,.425,.478,20,24,.833,10,47,57,110,22,3,42,46,173,2014
Beno Udrih,SG,31,MEM,10,0,55,10,18,.556,2,2,1.000,8,16,.500,.611,5,6,.833,0,2,2,6,1,1,5,4,27,2014
Jonas Valanciunas,C,21,TOR,81,81,2282,359,676,.531,0,1,.000,359,675,.532,.531,198,260,.762,226,488,714,57,24,71,136,249,916,2014
Anderson Varejao,C,31,CLE,65,29,1800,227,459,.495,0,7,.000,227,452,.502,.495,92,135,.681,187,442,629,140,69,39,72,164,546,2014
Jarvis Varnado,PF,25,TOT,24,0,339,36,60,.600,0,0,.000,36,60,.600,.600,27,52,.519,19,44,63,13,10,29,10,62,99,2014
Jarvis Varnado,PF,25,CHI,1,0,2,0,0,.000,0,0,.000,0,0,.000,.000,0,0,.000,0,0,0,0,0,0,0,1,0,2014
Jarvis Varnado,PF,25,PHI,23,0,337,36,60,.600,0,0,.000,36,60,.600,.600,27,52,.519,19,44,63,13,10,29,10,61,99,2014
Greivis Vasquez,SG-PG,27,TOT,79,23,1779,277,658,.421,109,289,.377,168,369,.455,.504,95,108,.880,20,153,173,323,31,5,128,143,758,2014
Greivis Vasquez,PG,27,SAC,18,18,465,65,150,.433,16,50,.320,49,100,.490,.487,30,32,.938,5,29,34,95,6,1,27,38,176,2014
Greivis Vasquez,SG,27,TOR,61,5,1314,212,508,.417,93,239,.389,119,269,.442,.509,65,76,.855,15,124,139,228,25,4,101,105,582,2014
Jan Vesely,PF,23,TOT,54,1,776,89,173,.514,0,0,.000,89,173,.514,.514,19,56,.339,81,110,191,21,53,35,36,121,197,2014
Jan Vesely,PF,23,WAS,33,1,470,48,92,.522,0,0,.000,48,92,.522,.522,8,30,.267,53,60,113,10,26,19,22,64,104,2014
Jan Vesely,PF,23,DEN,21,0,306,41,81,.506,0,0,.000,41,81,.506,.506,11,26,.423,28,50,78,11,27,16,14,57,93,2014
Charlie Villanueva,PF,29,DET,20,0,180,35,92,.380,14,56,.250,21,36,.583,.457,8,14,.571,6,28,34,6,4,5,7,16,92,2014
Nikola Vucevic,C,23,ORL,57,57,1812,353,696,.507,0,0,.000,353,696,.507,.507,105,137,.766,185,441,626,104,60,47,112,169,811,2014
Sasha Vujacic,SG,29,LAC,2,0,10,2,5,.400,1,2,.500,1,3,.333,.500,0,0,.000,0,3,3,0,1,0,3,1,5,2014
Dwyane Wade,SG,32,MIA,54,53,1775,415,761,.545,9,32,.281,406,729,.557,.551,189,258,.733,60,181,241,252,79,29,161,106,1028,2014
Dion Waiters,SG,22,CLE,70,24,2072,430,993,.433,92,250,.368,338,743,.455,.479,161,235,.685,32,163,195,209,63,17,154,153,1113,2014
Kemba Walker,PG,23,CHA,73,73,2614,449,1143,.393,109,327,.333,340,816,.417,.441,282,337,.837,39,267,306,447,86,32,169,128,1289,2014
John Wall,PG,23,WAS,82,82,2980,579,1337,.433,108,308,.351,471,1029,.458,.473,317,394,.805,38,295,333,721,149,40,295,219,1583,2014
Gerald Wallace,SF,31,BOS,58,16,1416,116,230,.504,19,64,.297,97,166,.584,.546,47,101,.465,36,176,212,143,73,14,97,79,298,2014
Casper Ware,PG,24,PHI,9,0,116,18,42,.429,7,21,.333,11,21,.524,.512,5,6,.833,0,9,9,10,8,0,5,11,48,2014
C.J. Watson,PG,29,IND,63,5,1193,146,334,.437,53,145,.366,93,189,.492,.516,69,88,.784,19,82,101,107,60,8,60,66,414,2014
Earl Watson,PG,34,POR,24,0,161,3,11,.273,2,7,.286,1,4,.250,.364,4,4,1.000,5,10,15,28,5,1,17,33,12,2014
Maalik Wayns,PG,22,LAC,2,0,9,1,2,.500,0,0,.000,1,2,.500,.500,0,0,.000,0,2,2,2,2,0,0,4,2,2014
Martell Webster,SF,27,WAS,78,13,2157,254,587,.433,146,372,.392,108,215,.502,.557,105,125,.840,38,184,222,97,41,15,58,150,759,2014
David West,PF,33,IND,80,80,2472,458,939,.488,4,15,.267,454,924,.491,.490,198,251,.789,120,422,542,223,61,74,133,186,1118,2014
Russell Westbrook,PG,25,OKC,46,46,1412,346,791,.437,68,214,.318,278,577,.482,.480,242,293,.826,55,208,263,319,88,7,177,104,1002,2014
D.J. White,PF,27,CHA,2,0,10,0,1,.000,0,0,.000,0,1,.000,.000,0,0,.000,0,2,2,0,1,0,0,1,0,2014
Royce White,PF,22,SAC,3,0,9,0,1,.000,0,0,.000,0,1,.000,.000,0,0,.000,0,0,0,0,0,0,0,2,0,2014
Deron Williams,PG,29,BRK,64,58,2059,322,716,.450,98,268,.366,224,448,.500,.518,173,216,.801,15,153,168,392,93,13,143,148,915,2014
Derrick Williams,SF-PF,22,TOT,78,15,1820,206,482,.427,26,99,.263,180,383,.470,.454,186,259,.718,71,252,323,56,48,20,76,114,624,2014
Derrick Williams,PF,22,MIN,11,0,162,19,54,.352,2,15,.133,17,39,.436,.370,14,16,.875,3,23,26,1,4,4,6,9,54,2014
Derrick Williams,SF,22,SAC,67,15,1658,187,428,.437,24,84,.286,163,344,.474,.465,172,243,.708,68,229,297,55,44,16,70,105,570,2014
Elliot Williams,SG,24,PHI,67,2,1157,140,337,.415,37,125,.296,103,212,.486,.470,87,119,.731,30,100,130,72,35,3,68,126,404,2014
Lou Williams,PG,27,ATL,60,7,1445,197,493,.400,79,231,.342,118,262,.450,.480,152,179,.849,10,114,124,210,45,4,92,65,625,2014
Marvin Williams,PF,27,UTA,66,50,1674,231,526,.439,84,234,.359,147,292,.503,.519,57,73,.781,82,252,334,78,54,31,53,151,603,2014
Mo Williams,PG,31,POR,74,0,1834,280,672,.417,83,225,.369,197,447,.441,.478,78,89,.876,42,111,153,321,55,10,149,197,721,2014
Reggie Williams,SF,27,OKC,3,0,17,5,9,.556,1,3,.333,4,6,.667,.611,0,0,.000,0,0,0,1,1,0,2,1,11,2014
Shawne Williams,PF,27,LAL,36,13,751,73,192,.380,42,129,.326,31,63,.492,.490,14,20,.700,25,142,167,30,19,30,21,93,202,2014
Jeff Withey,C,23,NOP,58,4,684,69,129,.535,0,1,.000,69,128,.539,.535,52,73,.712,49,101,150,26,15,50,20,73,190,2014
Nate Wolters,PG,22,MIL,58,31,1309,170,389,.437,18,62,.290,152,327,.465,.460,59,90,.656,33,116,149,187,35,15,57,67,417,2014
Metta World Peace,SF,34,NYK,29,1,388,56,141,.397,17,54,.315,39,87,.448,.457,10,16,.625,18,41,59,17,24,8,19,44,139,2014
Brandan Wright,C,26,DAL,58,0,1077,224,331,.677,0,0,.000,224,331,.677,.677,77,106,.726,102,142,244,31,32,55,35,94,525,2014
Chris Wright,SF,25,MIL,8,0,126,21,35,.600,0,1,.000,21,34,.618,.600,6,15,.400,10,10,20,5,7,5,5,17,48,2014
Dorell Wright,SF,28,POR,68,13,984,111,297,.374,69,202,.342,42,95,.442,.490,52,69,.754,29,162,191,64,23,16,39,62,343,2014
Tony Wroten,PG,20,PHI,72,16,1765,345,808,.427,40,188,.213,305,620,.492,.452,209,326,.641,69,159,228,217,78,16,204,151,939,2014
Nick Young,SG,28,LAL,64,9,1810,387,889,.435,135,350,.386,252,539,.468,.511,235,285,.825,29,137,166,95,46,12,95,156,1144,2014
Thaddeus Young,PF,25,PHI,79,78,2718,582,1283,.454,90,292,.308,492,991,.496,.489,163,229,.712,166,310,476,182,167,36,165,213,1417,2014
Cody Zeller,C,21,CHA,82,3,1416,172,404,.426,0,1,.000,172,403,.427,.426,146,200,.730,118,235,353,92,40,41,87,170,490,2014
Tyler Zeller,C,24,CLE,70,9,1049,156,290,.538,0,1,.000,156,289,.540,.538,87,121,.719,103,179,282,36,18,38,60,137,399,2014
Quincy Acy,PF,22,TOR,29,0,342,42,75,.560,1,2,.500,41,73,.562,.567,31,38,.816,30,47,77,11,13,15,17,53,116,2013
Jeff Adrien,PF,26,CHA,52,5,713,72,168,.429,0,2,.000,72,166,.434,.429,65,100,.650,68,128,196,36,18,27,32,80,209,2013
Arron Afflalo,SF,27,ORL,64,64,2307,397,905,.439,72,240,.300,325,665,.489,.478,191,223,.857,29,210,239,206,40,11,138,137,1057,2013
Josh Akognon,PG,26,DAL,3,0,9,2,4,.500,1,2,.500,1,2,.500,.625,0,0,.000,0,1,1,1,0,0,0,3,5,2013
Cole Aldrich,C,24,TOT,45,0,388,44,80,.550,0,0,.000,44,80,.550,.550,12,20,.600,30,90,120,9,5,23,23,60,100,2013
Cole Aldrich,C,24,HOU,30,0,213,23,43,.535,0,0,.000,23,43,.535,.535,4,9,.444,12,45,57,6,3,9,14,41,50,2013
Cole Aldrich,C,24,SAC,15,0,175,21,37,.568,0,0,.000,21,37,.568,.568,8,11,.727,18,45,63,3,2,14,9,19,50,2013
LaMarcus Aldridge,PF,27,POR,74,74,2790,638,1318,.484,2,14,.143,636,1304,.488,.485,282,348,.810,175,495,670,192,62,91,143,187,1560,2013
Lavoy Allen,C,23,PHI,79,37,1669,206,454,.454,0,1,.000,206,453,.455,.454,43,60,.717,159,236,395,73,24,55,55,180,455,2013
Ray Allen,SG,37,MIA,79,0,2035,292,651,.449,139,332,.419,153,319,.480,.555,140,158,.886,40,177,217,135,67,15,103,129,863,2013
Tony Allen,SG,31,MEM,79,79,2109,284,638,.445,3,24,.125,281,614,.458,.447,134,187,.717,121,242,363,98,119,44,94,211,705,2013
Al-Farouq Aminu,SF,22,NOH,76,71,2066,225,474,.475,4,19,.211,221,455,.486,.479,101,137,.737,139,446,585,103,92,51,116,153,555,2013
Lou Amundson,PF,30,TOT,39,0,372,32,81,.395,0,0,.000,32,81,.395,.395,12,36,.333,48,58,106,11,16,12,19,53,76,2013
Lou Amundson,PF,30,MIN,20,0,161,14,38,.368,0,0,.000,14,38,.368,.368,4,20,.200,23,24,47,3,7,6,11,26,32,2013
Lou Amundson,PF,30,CHI,1,0,2,0,1,.000,0,0,.000,0,1,.000,.000,0,0,.000,1,0,1,0,0,0,0,0,0,2013
Lou Amundson,PF,30,NOH,18,0,209,18,42,.429,0,0,.000,18,42,.429,.429,8,16,.500,24,34,58,8,9,6,8,27,44,2013
Chris Andersen,C,34,MIA,42,0,624,71,123,.577,2,3,.667,69,120,.575,.585,63,93,.677,57,115,172,17,16,44,24,89,207,2013
Alan Anderson,SF,30,TOR,65,2,1495,236,616,.383,95,285,.333,141,331,.426,.460,126,147,.857,34,114,148,103,48,7,80,131,693,2013
James Anderson,SG-SF,23,TOT,39,2,401,52,126,.413,21,60,.350,31,66,.470,.496,24,28,.857,18,54,72,42,15,5,25,25,149,2013
James Anderson,SF,23,SAS,10,0,94,11,25,.440,5,11,.455,6,14,.429,.540,7,9,.778,3,11,14,9,3,2,7,7,34,2013
James Anderson,SG,23,HOU,29,2,307,41,101,.406,16,49,.327,25,52,.481,.485,17,19,.895,15,43,58,33,12,3,18,18,115,2013
Ryan Anderson,PF,24,NOH,81,22,2503,472,1115,.423,213,557,.382,259,558,.464,.519,152,180,.844,191,328,519,97,42,31,97,179,1309,2013
Carmelo Anthony,PF,28,NYK,67,67,2482,669,1489,.449,157,414,.379,512,1075,.476,.502,425,512,.830,134,326,460,171,52,32,175,205,1920,2013
Joel Anthony,C,30,MIA,62,3,566,35,68,.515,0,0,.000,35,68,.515,.515,17,28,.607,45,70,115,13,13,42,22,49,87,2013
Trevor Ariza,SF,27,WAS,56,15,1471,188,451,.417,76,209,.364,112,242,.463,.501,78,95,.821,44,222,266,113,72,20,84,72,530,2013
Darrell Arthur,PF,24,MEM,59,3,970,162,359,.451,5,18,.278,157,341,.460,.458,33,46,.717,68,101,169,33,24,33,43,126,362,2013
Omer Asik,C,26,HOU,82,82,2464,332,614,.541,0,1,.000,332,613,.542,.541,168,299,.562,275,681,956,75,46,87,173,223,832,2013
D.J. Augustin,PG,25,IND,76,5,1226,103,294,.350,67,190,.353,36,104,.346,.464,83,99,.838,20,71,91,170,34,3,68,64,356,2013
Gustavo Ayon,C,27,TOT,55,3,734,92,167,.551,0,0,.000,92,167,.551,.551,20,50,.400,60,139,199,71,22,17,47,107,204,2013
Gustavo Ayon,C,27,ORL,43,3,571,67,125,.536,0,0,.000,67,125,.536,.536,19,38,.500,40,100,140,59,13,13,38,83,153,2013
Gustavo Ayon,C,27,MIL,12,0,163,25,42,.595,0,0,.000,25,42,.595,.595,1,12,.083,20,39,59,12,9,4,9,24,51,2013
Jeff Ayres,PF,25,IND,37,0,369,61,126,.484,2,4,.500,59,122,.484,.492,21,23,.913,29,75,104,15,6,12,23,44,145,2013
Luke Babbitt,PF,23,POR,62,0,730,86,234,.368,62,178,.348,24,56,.429,.500,10,13,.769,15,122,137,29,14,5,22,82,244,2013
Leandro Barbosa,PG,30,BOS,41,2,513,83,193,.430,18,47,.383,65,146,.445,.477,31,41,.756,8,38,46,58,17,6,21,51,215,2013
J.J. Barea,PG,28,MIN,74,2,1713,316,758,.417,97,280,.346,219,478,.458,.481,105,134,.784,34,173,207,294,32,0,145,131,834,2013
Andrea Bargnani,PF,27,TOR,35,25,1003,170,426,.399,38,123,.309,132,303,.436,.444,65,77,.844,26,102,128,38,21,23,54,64,443,2013
Harrison Barnes,SF,20,GSW,81,81,2058,276,628,.439,52,145,.359,224,483,.464,.481,144,190,.758,53,280,333,98,52,14,101,140,748,2013
Matt Barnes,SF,32,LAC,80,4,2058,312,675,.462,111,325,.342,201,350,.574,.544,87,117,.744,111,255,366,123,82,63,90,233,822,2013
Earl Barron,C,31,TOT,12,2,159,18,51,.353,0,0,.000,18,51,.353,.353,3,7,.429,22,39,61,5,5,6,11,24,39,2013
Earl Barron,C,31,WAS,11,1,122,13,37,.351,0,0,.000,13,37,.351,.351,2,5,.400,16,27,43,3,5,5,10,23,28,2013
Earl Barron,C,31,NYK,1,1,37,5,14,.357,0,0,.000,5,14,.357,.357,1,2,.500,6,12,18,2,0,1,1,1,11,2013
Will Barton,SG,22,POR,73,5,894,118,309,.382,9,65,.138,109,244,.447,.396,50,65,.769,36,109,145,58,34,9,60,56,295,2013
Brandon Bass,PF,27,BOS,81,69,2239,286,589,.486,0,2,.000,286,587,.487,.486,129,150,.860,129,296,425,84,44,64,80,188,701,2013
Shane Battier,SF,34,MIA,72,20,1786,152,362,.420,136,316,.430,16,46,.348,.608,32,38,.842,37,128,165,72,41,55,34,149,472,2013
Nicolas Batum,SF,24,POR,73,73,2807,352,833,.423,165,444,.372,187,389,.481,.522,178,210,.848,97,315,412,360,91,83,190,139,1047,2013
Jerryd Bayless,PG,24,MEM,80,4,1765,260,621,.419,71,201,.353,189,420,.450,.476,102,122,.836,22,154,176,264,59,17,120,168,693,2013
Aron Baynes,C,26,SAS,16,0,141,18,36,.500,0,1,.000,18,35,.514,.500,7,12,.583,12,20,32,5,1,6,11,23,43,2013
Kent Bazemore,SG,23,GSW,61,0,267,43,116,.371,10,34,.294,33,82,.402,.414,27,44,.614,5,17,22,22,17,4,18,27,123,2013
Bradley Beal,SG,19,WAS,56,46,1745,282,687,.410,91,236,.386,191,451,.424,.477,125,159,.786,43,168,211,137,50,29,90,113,780,2013
Michael Beasley,SF,24,PHO,75,20,1554,310,766,.405,45,144,.313,265,622,.426,.434,94,126,.746,52,230,282,111,31,34,144,107,759,2013
Rodrigue Beaubois,PG,24,DAL,45,0,549,65,176,.369,21,72,.292,44,104,.423,.429,30,38,.789,9,48,57,84,19,4,33,54,181,2013
Marco Belinelli,SG,26,CHI,73,27,1882,241,610,.395,79,221,.357,162,389,.416,.460,141,168,.839,13,127,140,148,44,6,82,140,702,2013
Patrick Beverley,PG,24,HOU,41,0,713,79,189,.418,36,96,.375,43,93,.462,.513,34,41,.829,45,64,109,117,37,21,44,83,228,2013
Andris Biedrins,C,26,GSW,53,9,495,10,21,.476,0,0,.000,10,21,.476,.476,4,13,.308,34,119,153,14,15,42,14,101,24,2013
Chauncey Billups,SG,36,LAC,22,22,418,53,132,.402,33,90,.367,20,42,.476,.527,45,48,.938,2,30,32,49,12,1,26,25,184,2013
Bismack Biyombo,C,20,CHA,80,65,2186,156,346,.451,0,0,.000,156,346,.451,.451,74,142,.521,194,388,582,35,28,143,82,195,386,2013
DeJuan Blair,PF,23,SAS,61,16,851,142,271,.524,0,1,.000,142,270,.526,.524,44,70,.629,66,164,230,45,37,10,49,112,328,2013
Steve Blake,PG,32,LAL,45,13,1175,114,270,.422,72,171,.421,42,99,.424,.556,27,35,.771,21,111,132,173,34,6,62,83,327,2013
Andray Blatche,C,26,BRK,82,8,1555,346,676,.512,3,22,.136,343,654,.524,.514,148,216,.685,161,256,417,85,86,54,123,163,843,2013
Eric Bledsoe,PG,23,LAC,76,12,1553,253,568,.445,31,78,.397,222,490,.453,.473,106,134,.791,78,147,225,233,109,55,137,112,643,2013
Keith Bogans,SG,32,BRK,74,23,1408,108,284,.380,84,245,.343,24,39,.615,.528,11,17,.647,16,104,120,76,28,4,49,108,311,2013
Andrew Bogut,C,28,GSW,32,32,786,83,184,.451,1,1,1.000,82,183,.448,.454,19,38,.500,68,177,245,67,20,55,35,85,186,2013
Matt Bonner,PF,32,SAS,68,4,909,112,230,.487,53,120,.442,59,110,.536,.602,11,15,.733,25,104,129,36,17,19,16,86,288,2013
Trevor Booker,PF,25,WAS,48,14,887,108,220,.491,0,5,.000,108,215,.502,.491,40,72,.556,98,141,239,40,32,16,31,95,256,2013
Carlos Boozer,PF,31,CHI,79,79,2546,544,1140,.477,0,2,.000,544,1138,.478,.477,193,264,.731,175,596,771,179,66,28,176,239,1281,2013
Chris Bosh,C,28,MIA,74,74,2454,485,907,.535,21,74,.284,464,833,.557,.546,241,302,.798,131,370,501,123,66,101,128,168,1232,2013
Avery Bradley,PG,22,BOS,50,50,1435,192,478,.402,40,126,.317,152,352,.432,.444,37,49,.755,30,81,111,104,64,19,72,129,461,2013
Elton Brand,C,33,DAL,72,18,1527,226,478,.473,0,1,.000,226,477,.474,.473,66,93,.710,130,300,430,70,50,90,57,192,518,2013
Corey Brewer,SF,26,DEN,82,2,2003,375,883,.425,91,307,.296,284,576,.493,.476,149,216,.690,55,180,235,124,118,23,102,154,990,2013
Ronnie Brewer,SF,27,TOT,60,34,853,70,198,.354,23,76,.303,47,122,.385,.412,16,39,.410,42,98,140,50,43,6,18,33,179,2013
Ronnie Brewer,SF,27,NYK,46,34,711,64,175,.366,22,71,.310,42,104,.404,.429,16,39,.410,29,71,100,40,34,6,14,27,166,2013
Ronnie Brewer,SF,27,OKC,14,0,142,6,23,.261,1,5,.200,5,18,.278,.283,0,0,.000,13,27,40,10,9,0,4,6,13,2013
Aaron Brooks,PG,28,TOT,53,20,997,143,316,.453,50,134,.373,93,182,.511,.532,40,52,.769,13,67,80,114,30,10,67,94,376,2013
Aaron Brooks,PG,28,SAC,46,20,959,139,303,.459,48,127,.378,91,176,.517,.538,40,52,.769,12,66,78,108,29,7,63,89,366,2013
Aaron Brooks,PG,28,HOU,7,0,38,4,13,.308,2,7,.286,2,6,.333,.385,0,0,.000,1,1,2,6,1,3,4,5,10,2013
MarShon Brooks,SG,24,BRK,73,2,912,155,335,.463,15,55,.273,140,280,.500,.485,69,94,.734,32,72,104,76,34,16,69,93,394,2013
Kwame Brown,C,30,PHI,22,11,269,17,37,.459,0,0,.000,17,37,.459,.459,7,19,.368,23,51,74,9,6,10,8,37,41,2013
Shannon Brown,SG,27,PHO,59,22,1402,240,571,.420,39,141,.277,201,430,.467,.454,98,125,.784,44,105,149,108,59,15,74,92,617,2013
Kobe Bryant,SG,34,LAL,78,78,3013,738,1595,.463,132,407,.324,606,1188,.510,.504,525,626,.839,66,367,433,469,106,25,287,173,2133,2013
Chase Budinger,SF,24,MIN,23,1,508,79,191,.414,26,81,.321,53,110,.482,.482,32,42,.762,15,56,71,25,14,7,23,29,216,2013
Alec Burks,SG,21,UTA,64,0,1137,163,388,.420,33,92,.359,130,296,.439,.463,92,129,.713,37,108,145,92,35,13,74,114,451,2013
Caron Butler,SF,32,LAC,78,78,1879,305,720,.424,128,330,.388,177,390,.454,.513,75,90,.833,41,182,223,78,51,11,72,139,813,2013
Jimmy Butler,SF,23,CHI,82,20,2134,239,512,.467,40,105,.381,199,407,.489,.506,187,233,.803,136,192,328,115,78,31,62,97,705,2013
Will Bynum,PG,30,DET,65,0,1219,253,540,.469,24,76,.316,229,464,.494,.491,106,131,.809,28,69,97,231,45,5,125,128,636,2013
Jose Calderon,PG,31,TOT,73,58,2160,312,635,.491,130,282,.461,182,353,.516,.594,72,80,.900,20,156,176,518,58,8,126,99,826,2013
Jose Calderon,PG,31,TOR,45,30,1273,187,398,.470,79,184,.429,108,214,.505,.569,47,52,.904,14,92,106,333,28,6,75,58,500,2013
Jose Calderon,PG,31,DET,28,28,887,125,237,.527,51,98,.520,74,139,.532,.635,25,28,.893,6,64,70,185,30,2,51,41,326,2013
Marcus Camby,PF,38,NYK,24,4,250,17,53,.321,0,0,.000,17,53,.321,.321,8,19,.421,24,56,80,14,7,14,15,28,42,2013
DeMarre Carroll,SF,26,UTA,66,12,1111,149,324,.460,20,70,.286,129,254,.508,.491,75,98,.765,87,101,188,61,58,24,34,119,393,2013
Matt Carroll,SG,32,CHA,1,0,6,0,0,.000,0,0,.000,0,0,.000,.000,0,0,.000,0,0,0,1,0,0,0,1,0,2013
Vince Carter,SF,36,DAL,81,3,2093,372,855,.435,162,399,.406,210,456,.461,.530,182,223,.816,58,276,334,194,74,44,106,226,1088,2013
Omri Casspi,SF,24,CLE,43,1,503,63,160,.394,25,76,.329,38,84,.452,.472,22,41,.537,20,94,114,28,25,12,22,45,173,2013
Mario Chalmers,PG,26,MIA,77,77,2068,227,529,.429,123,301,.409,104,228,.456,.545,89,112,.795,19,152,171,273,118,12,119,196,666,2013
Tyson Chandler,C,30,NYK,66,66,2164,255,400,.638,0,0,.000,255,400,.638,.638,179,258,.694,269,434,703,62,42,75,87,188,689,2013
Wilson Chandler,PF,25,DEN,43,8,1079,210,455,.462,52,126,.413,158,329,.480,.519,88,111,.793,45,173,218,58,45,12,60,119,560,2013
Josh Childress,SF,29,BRK,14,0,100,6,21,.286,1,3,.333,5,18,.278,.310,1,2,.500,6,9,15,5,2,2,0,3,14,2013
Earl Clark,PF,25,LAL,59,36,1363,170,386,.440,35,104,.337,135,282,.479,.486,53,76,.697,82,243,325,65,36,44,62,102,428,2013
Victor Claver,SF,24,POR,49,16,812,74,189,.392,25,87,.287,49,102,.480,.458,14,30,.467,31,88,119,43,26,12,43,75,187,2013
Norris Cole,PG,24,MIA,80,4,1590,179,425,.421,35,98,.357,144,327,.440,.462,52,80,.650,18,112,130,164,57,7,104,155,445,2013
Jason Collins,C,34,TOT,38,9,384,9,29,.310,0,0,.000,9,29,.310,.310,23,32,.719,22,38,60,8,12,10,18,85,41,2013
Jason Collins,C,34,BOS,32,7,330,8,23,.348,0,0,.000,8,23,.348,.348,21,30,.700,21,31,52,6,10,6,16,74,37,2013
Jason Collins,C,34,WAS,6,2,54,1,6,.167,0,0,.000,1,6,.167,.167,2,2,1.000,1,7,8,2,2,4,2,11,4,2013
Darren Collison,PG,25,DAL,81,47,2372,341,724,.471,48,136,.353,293,588,.498,.504,242,275,.880,31,188,219,415,100,8,173,139,972,2013
Nick Collison,C,32,OKC,81,2,1583,176,296,.595,0,4,.000,176,292,.603,.595,60,78,.769,123,210,333,121,51,30,69,197,412,2013
Mike Conley,PG,25,MEM,80,80,2757,414,940,.440,106,293,.362,308,647,.476,.497,234,282,.830,43,182,225,487,174,24,189,171,1168,2013
Will Conroy,PG,30,MIN,4,0,20,0,9,.000,0,3,.000,0,6,.000,.000,1,2,.500,1,0,1,0,0,0,0,1,1,2013
Daequan Cook,SG,25,TOT,49,1,441,51,167,.305,26,91,.286,25,76,.329,.383,9,12,.750,7,54,61,19,8,7,15,26,137,2013
Daequan Cook,SG,25,HOU,16,1,165,21,59,.356,11,30,.367,10,29,.345,.449,2,3,.667,5,13,18,10,6,2,6,13,55,2013
Daequan Cook,SG,25,CHI,33,0,276,30,108,.278,15,61,.246,15,47,.319,.347,7,9,.778,2,41,43,9,2,5,9,13,82,2013
Chris Copeland,PF,28,NYK,56,13,862,182,380,.479,59,140,.421,123,240,.513,.557,63,83,.759,34,85,119,27,16,12,50,104,486,2013
DeMarcus Cousins,C,22,SAC,75,74,2289,482,1036,.465,4,22,.182,478,1014,.471,.467,312,423,.738,222,524,746,199,108,55,225,269,1280,2013
Jamal Crawford,SG,32,LAC,76,0,2230,445,1016,.438,149,396,.376,296,620,.477,.511,216,248,.871,22,106,128,193,79,13,146,71,1255,2013
Jordan Crawford,SG,24,TOT,70,14,1709,301,725,.415,83,246,.337,218,479,.455,.472,129,159,.811,44,165,209,225,39,7,141,106,814,2013
Jordan Crawford,SG,24,WAS,43,12,1127,211,508,.415,59,171,.345,152,337,.451,.473,87,106,.821,31,104,135,157,27,5,97,61,568,2013
Jordan Crawford,SG,24,BOS,27,2,582,90,217,.415,24,75,.320,66,142,.465,.470,42,53,.792,13,61,74,68,12,2,44,45,246,2013
Jae Crowder,SF,22,DAL,78,16,1353,141,367,.384,63,192,.328,78,175,.446,.470,47,73,.644,35,152,187,94,63,17,49,128,392,2013
Dante Cunningham,PF,25,MIN,80,9,2010,314,671,.468,0,6,.000,314,665,.472,.468,67,103,.650,142,266,408,67,84,38,56,153,695,2013
Jared Cunningham,SG,21,DAL,8,0,26,6,14,.429,2,3,.667,4,11,.364,.500,2,2,1.000,1,2,3,1,1,0,2,3,16,2013
Eddy Curry,C,30,DAL,2,0,25,4,8,.500,0,0,.000,4,8,.500,.500,1,4,.250,2,2,4,0,0,0,3,7,9,2013
Stephen Curry,PG,24,GSW,78,78,2983,626,1388,.451,272,600,.453,354,788,.449,.549,262,291,.900,59,255,314,539,126,12,240,198,1786,2013
Samuel Dalembert,C,31,MIL,47,23,765,137,253,.542,1,1,1.000,136,252,.540,.543,38,55,.691,105,171,276,21,17,53,51,90,313,2013
Marquis Daniels,SF,32,MIL,59,33,1085,132,351,.376,20,72,.278,112,279,.401,.405,40,54,.741,48,102,150,65,51,10,45,77,324,2013
Anthony Davis,PF,19,NOH,64,60,1846,349,676,.516,0,6,.000,349,670,.521,.516,169,225,.751,165,357,522,63,75,112,89,158,867,2013
Ed Davis,C-PF,23,TOT,81,28,1631,260,482,.539,0,0,.000,260,482,.539,.539,103,167,.617,152,308,460,63,38,85,63,191,623,2013
Ed Davis,C,23,TOR,45,24,1087,186,339,.549,0,0,.000,186,339,.549,.549,66,102,.647,95,205,300,55,25,38,45,111,438,2013
Ed Davis,PF,23,MEM,36,4,544,74,143,.517,0,0,.000,74,143,.517,.517,37,65,.569,57,103,160,8,13,47,18,80,185,2013
Glen Davis,PF,27,ORL,34,33,1064,214,478,.448,0,2,.000,214,476,.450,.448,84,117,.718,55,191,246,70,32,21,64,88,512,2013
Austin Daye,SF,24,TOT,55,0,676,90,208,.433,41,98,.418,49,110,.445,.531,26,34,.765,16,107,123,42,14,22,29,82,247,2013
Austin Daye,SF,24,DET,24,0,348,43,97,.443,21,40,.525,22,57,.386,.552,15,18,.833,10,53,63,21,5,8,13,43,122,2013
Austin Daye,SF,24,MEM,31,0,328,47,111,.423,20,58,.345,27,53,.509,.514,11,16,.688,6,54,60,21,9,14,16,39,125,2013
Nando De Colo,SG,25,SAS,72,6,920,105,241,.436,31,82,.378,74,159,.465,.500,35,44,.795,23,115,138,138,41,6,81,87,276,2013
Carlos Delfino,SF,30,HOU,67,5,1689,251,620,.405,158,421,.375,93,199,.467,.532,48,56,.857,18,202,220,135,68,9,72,114,708,2013
Luol Deng,SF,27,CHI,75,75,2903,466,1093,.426,75,233,.322,391,860,.455,.461,230,282,.816,162,314,476,222,81,32,144,105,1237,2013
Justin Dentmon,PG,27,DAL,2,0,4,0,2,.000,0,0,.000,0,2,.000,.000,0,0,.000,0,0,0,0,0,0,0,0,0,2013
DeMar DeRozan,SG,23,TOR,82,82,3013,548,1231,.445,34,120,.283,514,1111,.463,.459,355,427,.831,48,272,320,204,76,24,151,173,1485,2013
Boris Diaw,PF,30,SAS,75,20,1709,179,332,.539,30,78,.385,149,254,.587,.584,47,65,.723,66,188,254,180,52,27,84,143,435,2013
DeSagana Diop,C,31,CHA,22,1,226,8,27,.296,0,1,.000,8,26,.308,.296,0,1,.000,10,41,51,13,5,16,8,19,16,2013
Keyon Dooling,PG,32,MEM,7,0,82,10,21,.476,5,12,.417,5,9,.556,.595,6,7,.857,0,1,1,8,1,0,5,8,31,2013
Toney Douglas,PG,26,TOT,71,0,1289,188,466,.403,82,216,.380,106,250,.424,.491,76,84,.905,34,104,138,151,71,3,81,145,534,2013
Toney Douglas,PG,26,HOU,49,0,913,139,352,.395,61,162,.377,78,190,.411,.482,60,68,.882,23,67,90,93,40,2,56,103,399,2013
Toney Douglas,PG,26,SAC,22,0,376,49,114,.430,21,54,.389,28,60,.467,.522,16,16,1.000,11,37,48,58,31,1,25,42,135,2013
Chris Douglas-Roberts,SG,26,DAL,6,0,63,5,14,.357,0,4,.000,5,10,.500,.357,7,10,.700,0,5,5,4,2,0,1,4,17,2013
Goran Dragic,PG,26,PHO,77,77,2581,401,906,.443,88,276,.319,313,630,.497,.491,244,326,.748,60,178,238,569,124,26,212,214,1134,2013
Andre Drummond,C,19,DET,60,10,1243,208,342,.608,1,2,.500,207,340,.609,.610,59,159,.371,169,288,457,30,59,95,57,144,476,2013
Jared Dudley,SF,27,PHO,79,50,2170,313,669,.468,106,271,.391,207,398,.520,.547,129,162,.796,79,166,245,203,75,8,101,128,861,2013
Chris Duhon,PG,30,LAL,46,9,820,47,123,.382,33,91,.363,14,32,.438,.516,6,13,.462,11,57,68,133,20,1,40,56,133,2013
Tim Duncan,C,36,SAS,69,69,2078,490,976,.502,2,7,.286,488,969,.504,.503,245,300,.817,124,562,686,184,50,183,147,117,1227,2013
Mike Dunleavy,SF,32,MIL,75,3,1943,276,624,.442,128,299,.428,148,325,.455,.545,105,128,.820,31,260,291,145,39,35,90,135,785,2013
Kevin Durant,SF,24,OKC,81,81,3119,731,1433,.510,139,334,.416,592,1099,.539,.559,679,750,.905,46,594,640,374,116,105,280,143,2280,2013
Devin Ebanks,SF,23,LAL,19,3,197,24,73,.329,6,22,.273,18,51,.353,.370,11,14,.786,10,31,41,10,3,1,11,23,65,2013
Wayne Ellington,SG,25,TOT,78,21,1661,226,529,.427,94,240,.392,132,289,.457,.516,68,75,.907,25,141,166,104,45,3,57,81,614,2013
Wayne Ellington,SG,25,MEM,40,4,676,81,199,.407,41,97,.423,40,102,.392,.510,15,16,.938,5,47,52,42,16,1,24,38,218,2013
Wayne Ellington,SG,25,CLE,38,17,985,145,330,.439,53,143,.371,92,187,.492,.520,53,59,.898,20,94,114,62,29,2,33,43,396,2013
Monta Ellis,SG,27,MIL,82,82,3076,597,1436,.416,94,328,.287,503,1108,.454,.448,289,374,.773,45,271,316,496,169,36,254,164,1577,2013
Kim English,SG,24,DET,41,0,407,42,112,.375,14,50,.280,28,62,.452,.438,21,29,.724,8,29,37,26,16,3,19,46,119,2013
Jeremy Evans,PF,25,UTA,37,0,215,27,44,.614,0,1,.000,27,43,.628,.614,21,33,.636,26,32,58,11,8,13,8,30,75,2013
Reggie Evans,PF,32,BRK,80,56,1967,125,261,.479,0,0,.000,125,261,.479,.479,113,222,.509,260,628,888,43,74,13,111,199,363,2013
Tyreke Evans,SG,23,SAC,65,61,2016,366,765,.478,45,133,.338,321,632,.508,.508,210,271,.775,56,231,287,229,90,27,128,133,987,2013
Festus Ezeli,C,23,GSW,78,41,1120,74,169,.438,0,0,.000,74,169,.438,.438,43,81,.531,141,172,313,22,23,74,63,157,191,2013
Kenneth Faried,PF,23,DEN,80,80,2248,380,689,.552,0,0,.000,380,689,.552,.552,163,266,.613,260,474,734,77,81,83,113,234,923,2013
Derrick Favors,PF,21,UTA,77,8,1787,274,568,.482,0,5,.000,274,563,.487,.482,179,260,.688,184,362,546,75,67,130,129,247,727,2013
Raymond Felton,PG,28,NYK,68,68,2313,377,882,.427,93,258,.360,284,624,.455,.480,101,128,.789,51,143,194,372,94,14,155,130,948,2013
Landry Fields,SF,24,TOR,51,22,1037,102,223,.457,2,14,.143,100,209,.478,.462,34,53,.642,59,149,208,60,32,8,42,63,240,2013
Derek Fisher,SG-PG,38,TOT,33,9,575,55,161,.342,30,80,.375,25,81,.309,.435,35,38,.921,2,35,37,47,19,3,30,55,175,2013
Derek Fisher,PG,38,DAL,9,9,229,23,65,.354,10,23,.435,13,42,.310,.431,21,23,.913,0,15,15,31,5,2,18,24,77,2013
Derek Fisher,SG,38,OKC,24,0,346,32,96,.333,20,57,.351,12,39,.308,.438,14,15,.933,2,20,22,16,14,1,12,31,98,2013
Evan Fournier,SG,20,DEN,38,4,428,75,152,.493,22,54,.407,53,98,.541,.566,30,39,.769,6,29,35,44,19,1,32,65,202,2013
Randy Foye,SG,29,UTA,82,72,2249,293,738,.397,178,434,.410,115,304,.378,.518,118,144,.819,17,110,127,167,66,27,92,190,882,2013
Jimmer Fredette,SG,23,SAC,69,0,967,172,409,.421,65,156,.417,107,253,.423,.500,85,99,.859,19,52,71,92,31,3,68,64,494,2013
Joel Freeland,PF,25,POR,51,1,477,58,142,.408,0,0,.000,58,142,.408,.408,18,27,.667,40,79,119,13,13,11,19,67,134,2013
Danilo Gallinari,SF,24,DEN,71,71,2309,364,871,.418,135,362,.373,229,509,.450,.495,286,348,.822,65,302,367,176,64,36,111,130,1149,2013
Francisco Garcia,SG-SF,31,TOT,58,20,1029,118,300,.393,67,179,.374,51,121,.421,.505,18,21,.857,8,83,91,63,46,38,32,88,321,2013
Francisco Garcia,SG,31,SAC,40,15,710,77,205,.376,40,109,.367,37,96,.385,.473,12,14,.857,7,61,68,43,32,31,20,66,206,2013
Francisco Garcia,SF,31,HOU,18,5,319,41,95,.432,27,70,.386,14,25,.560,.574,6,7,.857,1,22,23,20,14,7,12,22,115,2013
Kevin Garnett,C,36,BOS,68,68,2022,422,850,.496,2,16,.125,420,834,.504,.498,158,201,.786,75,455,530,159,78,62,110,154,1004,2013
Diante Garrett,PG,24,PHO,19,0,149,16,49,.327,3,15,.200,13,34,.382,.357,5,10,.500,5,10,15,31,10,0,16,5,40,2013
Marc Gasol,C,28,MEM,80,80,2796,429,869,.494,1,14,.071,428,855,.501,.494,268,316,.848,184,438,622,318,80,139,157,255,1127,2013
Pau Gasol,PF,32,LAL,49,42,1655,270,579,.466,8,28,.286,262,551,.475,.473,125,178,.702,111,310,421,200,24,61,104,93,673,2013
Rudy Gay,SF,26,TOT,75,74,2687,521,1253,.416,84,260,.323,437,993,.440,.449,240,295,.814,99,362,461,202,113,53,198,182,1366,2013
Rudy Gay,SF,26,MEM,42,42,1541,281,688,.408,40,129,.310,241,559,.431,.438,121,156,.776,56,193,249,108,56,31,104,87,723,2013
Rudy Gay,SF,26,TOR,33,32,1146,240,565,.425,44,131,.336,196,434,.452,.464,119,139,.856,43,169,212,94,57,22,94,95,643,2013
Alonzo Gee,SF,25,CLE,82,82,2541,305,744,.410,69,219,.315,236,525,.450,.456,163,205,.795,75,245,320,133,107,29,132,199,842,2013
Mickael Gelabale,SF,29,MIN,36,13,644,72,139,.518,16,52,.308,56,87,.644,.576,21,24,.875,32,67,99,26,16,4,16,47,181,2013
Paul George,SF,22,IND,79,79,2972,493,1176,.419,170,469,.362,323,707,.457,.491,221,274,.807,88,515,603,327,143,51,233,227,1377,2013
Daniel Gibson,PG,26,CLE,46,3,919,84,247,.340,56,163,.344,28,84,.333,.453,26,37,.703,5,55,60,82,30,4,31,89,250,2013
Taj Gibson,PF,27,CHI,65,5,1459,214,441,.485,0,4,.000,214,437,.490,.485,89,131,.679,125,220,345,61,27,90,76,166,517,2013
Manu Ginobili,SG,35,SAS,60,0,1393,229,539,.425,83,235,.353,146,304,.480,.502,164,206,.796,30,171,201,274,80,13,132,114,705,2013
Drew Gooden,C,31,MIL,16,0,151,20,61,.328,1,5,.200,19,56,.339,.336,11,16,.688,13,18,31,6,5,6,9,21,52,2013
Ben Gordon,SG,29,CHA,75,0,1560,310,760,.408,113,292,.387,197,468,.421,.482,107,127,.843,18,112,130,141,35,16,136,134,840,2013
Eric Gordon,SG,24,NOH,42,40,1264,235,584,.402,56,173,.324,179,411,.436,.450,187,222,.842,10,67,77,137,45,8,117,75,713,2013
Marcin Gortat,C,28,PHO,61,61,1876,295,566,.521,0,3,.000,295,563,.524,.521,90,138,.652,128,388,516,75,40,98,99,127,680,2013
Andrew Goudelock,SG,24,LAL,1,0,6,0,2,.000,0,0,.000,0,2,.000,.000,0,0,.000,1,0,1,0,0,0,0,0,0,2013
Danny Granger,SF,29,IND,5,0,74,10,35,.286,2,10,.200,8,25,.320,.314,5,8,.625,3,6,9,3,2,1,4,6,27,2013
Aaron Gray,C,28,TOR,42,16,513,48,90,.533,0,0,.000,48,90,.533,.533,23,44,.523,48,85,133,33,7,5,36,85,119,2013
Danny Green,SG,25,SAS,80,80,2201,297,663,.448,177,413,.429,120,250,.480,.581,67,79,.848,36,208,244,141,92,54,94,124,838,2013
Draymond Green,SF,22,GSW,79,1,1061,84,257,.327,14,67,.209,70,190,.368,.354,45,55,.818,58,202,260,53,42,25,51,159,227,2013
Gerald Green,SF,27,IND,60,7,1080,155,424,.366,59,188,.314,96,236,.407,.435,52,65,.800,31,110,141,50,19,23,53,64,421,2013
Jeff Green,PF,26,BOS,81,17,2252,376,806,.467,70,182,.385,306,624,.490,.510,214,265,.808,55,263,318,128,56,68,132,175,1036,2013
Willie Green,SG,31,LAC,72,60,1188,178,386,.461,71,166,.428,107,220,.486,.553,23,32,.719,17,80,97,55,29,12,31,96,450,2013
Blake Griffin,PF,23,LAC,80,80,2598,577,1072,.538,5,28,.179,572,1044,.548,.541,281,426,.660,186,476,662,299,97,50,185,231,1440,2013
Hamed Haddadi,C,27,TOT,30,0,322,35,82,.427,0,0,.000,35,82,.427,.427,14,27,.519,43,68,111,12,6,27,31,60,84,2013
Hamed Haddadi,C,27,MEM,13,0,87,7,21,.333,0,0,.000,7,21,.333,.333,1,2,.500,10,14,24,4,1,6,4,15,15,2013
Hamed Haddadi,C,27,PHO,17,0,235,28,61,.459,0,0,.000,28,61,.459,.459,13,25,.520,33,54,87,8,5,21,27,45,69,2013
Jordan Hamilton,SF,22,DEN,40,1,397,84,201,.418,27,73,.370,57,128,.445,.485,13,26,.500,32,63,95,23,15,8,19,24,208,2013
Richard Hamilton,SG,34,CHI,50,45,1088,204,475,.429,16,52,.308,188,423,.444,.446,66,77,.857,16,67,83,119,24,5,84,93,490,2013
Ben Hansbrough,PG,25,IND,28,0,200,15,45,.333,6,23,.261,9,22,.409,.400,21,27,.778,2,16,18,21,7,2,18,23,57,2013
Tyler Hansbrough,PF,27,IND,81,8,1366,176,407,.432,0,3,.000,176,404,.436,.432,216,300,.720,161,212,373,36,29,18,78,152,568,2013
James Harden,SG,23,HOU,78,78,2985,585,1337,.438,179,486,.368,406,851,.477,.504,674,792,.851,62,317,379,455,142,38,295,178,2023,2013
Maurice Harkless,SF,19,ORL,76,59,1974,260,564,.461,32,117,.274,228,447,.510,.489,73,128,.570,122,213,335,50,88,62,69,144,625,2013
Josh Harrellson,C,23,MIA,6,0,31,4,9,.444,1,5,.200,3,4,.750,.500,1,2,.500,3,4,7,0,1,1,3,4,10,2013
Al Harrington,C,32,ORL,10,0,119,20,57,.351,8,30,.267,12,27,.444,.421,3,4,.750,6,21,27,10,4,1,7,18,51,2013
Devin Harris,SG,29,ATL,58,34,1421,194,443,.438,77,230,.335,117,213,.549,.525,112,154,.727,6,110,116,197,64,13,88,103,577,2013
Terrel Harris,SG,25,TOT,20,0,137,4,27,.148,0,8,.000,4,19,.211,.148,7,10,.700,4,22,26,9,2,3,17,17,15,2013
Terrel Harris,SG,25,MIA,7,0,29,2,8,.250,0,1,.000,2,7,.286,.250,6,8,.750,4,5,9,2,0,0,4,3,10,2013
Terrel Harris,SG,25,NOH,13,0,108,2,19,.105,0,7,.000,2,12,.167,.105,1,2,.500,0,17,17,7,2,3,13,14,5,2013
Tobias Harris,SF-PF,20,TOT,55,34,1299,233,512,.455,34,108,.315,199,404,.493,.488,103,137,.752,73,214,287,69,32,44,66,120,603,2013
Tobias Harris,SF,20,MIL,28,14,325,53,115,.461,7,21,.333,46,94,.489,.491,23,26,.885,17,40,57,13,8,7,18,31,136,2013
Tobias Harris,PF,20,ORL,27,20,974,180,397,.453,27,87,.310,153,310,.494,.487,80,111,.721,56,174,230,56,24,37,48,89,467,2013
Udonis Haslem,PF,32,MIA,75,59,1414,129,251,.514,0,0,.000,129,251,.514,.514,32,45,.711,97,307,404,38,30,15,45,173,290,2013
Spencer Hawes,C,24,PHI,82,40,2233,376,811,.464,31,87,.356,345,724,.477,.483,122,157,.777,173,417,590,183,24,113,131,233,905,2013
Chuck Hayes,C,29,SAC,74,1,1209,84,190,.442,0,1,.000,84,189,.444,.442,30,48,.625,113,186,299,112,31,18,44,114,198,2013
Gordon Hayward,SF,22,UTA,72,27,2104,336,773,.435,102,246,.415,234,527,.444,.501,243,294,.827,51,174,225,213,58,38,120,125,1017,2013
Lazar Hayward,SF,26,MIN,4,0,31,2,10,.200,0,4,.000,2,6,.333,.200,6,6,1.000,0,4,4,3,2,0,0,3,10,2013
Brendan Haywood,C,33,CHA,61,17,1162,93,216,.431,0,1,.000,93,215,.433,.431,30,66,.455,125,165,290,29,16,49,50,125,216,2013
Gerald Henderson,SG,25,CHA,68,58,2133,382,855,.447,33,100,.330,349,755,.462,.466,258,313,.824,55,195,250,177,68,34,108,149,1055,2013
Xavier Henry,SF,21,NOH,50,2,625,66,161,.410,4,11,.364,62,150,.413,.422,58,92,.630,21,69,90,13,16,5,31,72,194,2013
John Henson,PF,22,MIL,63,9,827,162,336,.482,0,3,.000,162,333,.486,.482,56,105,.533,116,181,297,31,19,42,47,83,380,2013
Roy Hibbert,C,26,IND,79,79,2269,385,859,.448,1,4,.250,384,855,.449,.449,166,224,.741,296,360,656,113,39,206,162,279,937,2013
J.J. Hickson,C,24,POR,80,80,2323,418,744,.562,0,2,.000,418,742,.563,.562,182,268,.679,266,562,828,88,48,51,145,160,1018,2013
Cory Higgins,SG,23,CHA,6,0,32,6,19,.316,1,5,.200,5,14,.357,.342,1,2,.500,1,2,3,5,3,0,0,5,14,2013
Nene Hilario,PF,30,WAS,61,49,1659,285,594,.480,0,1,.000,285,593,.481,.480,196,269,.729,101,306,407,177,55,37,139,171,766,2013
George Hill,PG,26,IND,76,76,2620,386,871,.443,130,353,.368,256,518,.494,.518,174,213,.817,47,237,284,355,81,26,116,134,1076,2013
Grant Hill,SF,40,LAC,29,0,437,38,98,.388,3,11,.273,35,87,.402,.403,14,24,.583,6,43,49,26,11,7,25,39,93,2013
Jordan Hill,PF,25,LAL,29,1,458,77,155,.497,0,2,.000,77,153,.503,.497,40,61,.656,82,84,166,13,8,19,26,55,194,2013
Kirk Hinrich,PG,32,CHI,60,60,1764,159,422,.377,71,182,.390,88,240,.367,.461,70,98,.714,16,142,158,314,63,25,99,192,459,2013
Jrue Holiday,PG,22,PHI,78,78,2926,555,1288,.431,91,247,.368,464,1041,.446,.466,182,242,.752,89,240,329,625,123,32,292,170,1383,2013
Justin Holiday,SG,23,PHI,9,0,142,16,48,.333,4,16,.250,12,32,.375,.375,6,8,.750,0,14,14,15,3,6,9,7,42,2013
Ryan Hollins,C,28,LAC,60,0,663,70,114,.614,0,0,.000,70,114,.614,.614,66,88,.750,50,89,139,11,6,34,44,133,206,2013
Tyler Honeycutt,SF,22,SAC,9,0,32,3,11,.273,0,2,.000,3,9,.333,.273,2,2,1.000,3,7,10,2,0,1,5,2,8,2013
Al Horford,C,26,ATL,74,74,2756,576,1060,.543,3,6,.500,573,1054,.544,.545,134,208,.644,195,562,757,240,78,78,147,163,1289,2013
Dwight Howard,C,27,LAL,76,76,2722,470,813,.578,1,6,.167,469,807,.581,.579,355,721,.492,251,694,945,108,84,186,225,291,1296,2013
Josh Howard,SF,32,MIN,11,4,207,31,77,.403,5,16,.313,26,61,.426,.435,7,12,.583,9,27,36,4,10,3,10,18,74,2013
Juwan Howard,PF,39,MIA,7,2,51,10,19,.526,0,0,.000,10,19,.526,.526,1,1,1.000,0,8,8,6,0,0,4,9,21,2013
Kris Humphries,PF,27,BRK,65,21,1191,139,310,.448,0,2,.000,139,308,.451,.448,97,123,.789,126,239,365,32,16,33,57,127,375,2013
Serge Ibaka,PF,23,OKC,80,80,2486,446,778,.573,20,57,.351,426,721,.591,.586,143,191,.749,222,395,617,43,28,242,125,213,1055,2013
Andre Iguodala,SG,29,DEN,80,80,2779,396,879,.451,91,287,.317,305,592,.515,.502,155,270,.574,82,341,423,433,139,52,206,127,1038,2013
Ersan Ilyasova,PF,25,MIL,73,54,2012,371,803,.462,95,214,.444,276,589,.469,.521,125,157,.796,154,366,520,117,68,36,75,185,962,2013
Kyrie Irving,PG,20,CLE,59,59,2048,484,1070,.452,109,279,.391,375,791,.474,.503,248,290,.855,34,182,216,350,89,21,191,146,1325,2013
Royal Ivey,SG,31,PHI,53,5,698,62,144,.431,37,88,.420,25,56,.446,.559,9,16,.563,16,41,57,32,23,3,20,73,170,2013
Jarrett Jack,SG,29,GSW,79,4,2349,387,857,.452,82,203,.404,305,654,.466,.499,167,198,.843,21,222,243,439,60,11,157,134,1023,2013
Reggie Jackson,PG,22,OKC,70,0,993,149,325,.458,24,104,.231,125,221,.566,.495,52,62,.839,21,145,166,122,29,13,53,84,374,2013
Stephen Jackson,SF,34,SAS,55,6,1075,123,330,.373,46,170,.271,77,160,.481,.442,49,70,.700,22,133,155,80,37,14,77,89,341,2013
Bernard James,C,27,DAL,46,11,457,53,103,.515,0,2,.000,53,101,.525,.515,25,41,.610,52,79,131,6,12,38,18,64,131,2013
Damion James,SF,25,BRK,2,0,0,0,0,.000,0,0,.000,0,0,.000,.000,0,0,.000,0,1,1,0,0,0,0,0,0,2013
LeBron James,PF,28,MIA,76,76,2877,765,1354,.565,103,254,.406,662,1100,.602,.603,403,535,.753,97,513,610,551,129,67,226,110,2036,2013
Mike James,PG,37,DAL,45,23,862,101,271,.373,48,125,.384,53,146,.363,.461,23,29,.793,9,63,72,139,26,3,55,95,273,2013
Antawn Jamison,PF,36,LAL,76,6,1636,267,575,.464,84,233,.361,183,342,.535,.537,94,136,.691,109,253,362,50,30,22,53,124,712,2013
Al Jefferson,C,28,UTA,78,78,2578,611,1236,.494,2,17,.118,609,1219,.500,.495,167,217,.770,156,564,720,164,80,89,105,170,1391,2013
Richard Jefferson,SF,32,GSW,56,1,568,62,136,.456,14,45,.311,48,91,.527,.507,38,53,.717,5,79,84,31,14,7,23,45,176,2013
Jared Jeffries,PF,31,POR,38,0,350,16,54,.296,0,2,.000,16,52,.308,.296,12,23,.522,26,34,60,14,6,6,17,58,44,2013
Charles Jenkins,SG-PG,23,TOT,59,1,441,49,121,.405,1,2,.500,48,119,.403,.409,12,22,.545,8,24,32,44,15,2,21,22,111,2013
Charles Jenkins,SG,23,GSW,47,0,291,35,83,.422,1,2,.500,34,81,.420,.428,10,18,.556,5,16,21,28,9,1,19,18,81,2013
Charles Jenkins,PG,23,PHI,12,1,150,14,38,.368,0,0,.000,14,38,.368,.368,2,4,.500,3,8,11,16,6,1,2,4,30,2013
John Jenkins,SG,21,ATL,61,2,902,131,294,.446,53,138,.384,78,156,.500,.536,59,70,.843,17,77,94,56,12,10,40,37,374,2013
Brandon Jennings,PG,23,MIL,80,80,2897,497,1247,.399,173,461,.375,324,786,.412,.468,230,281,.819,59,187,246,521,125,10,203,155,1397,2013
Jonas Jerebko,PF,25,DET,49,2,892,142,316,.449,25,83,.301,117,233,.502,.489,68,88,.773,68,117,185,43,38,8,42,90,377,2013
Amir Johnson,PF,25,TOR,81,38,2325,336,606,.554,5,13,.385,331,593,.558,.559,136,187,.727,227,384,611,122,81,110,117,301,813,2013
Chris Johnson,C,27,MIN,30,0,284,48,75,.640,0,0,.000,48,75,.640,.640,21,34,.618,20,40,60,8,7,28,13,49,117,2013
Chris Johnson,SF,22,MEM,8,0,102,11,25,.440,6,18,.333,5,7,.714,.560,1,2,.500,5,6,11,2,4,0,3,5,29,2013
Ivan Johnson,PF,28,ATL,69,5,1035,185,356,.520,1,13,.077,184,343,.536,.521,81,131,.618,76,190,266,46,56,14,71,131,452,2013
James Johnson,SF,25,SAC,54,11,878,117,283,.413,2,21,.095,115,262,.439,.417,40,67,.597,49,96,145,58,41,50,68,99,276,2013
Joe Johnson,SG,31,BRK,72,72,2642,445,1052,.423,148,395,.375,297,657,.452,.493,132,161,.820,53,165,218,253,49,14,123,99,1170,2013
Orlando Johnson,SG,23,IND,51,0,619,72,180,.400,36,94,.383,36,86,.419,.500,23,32,.719,20,90,110,47,11,9,29,51,203,2013
Wesley Johnson,SF,25,PHO,50,21,953,161,396,.407,50,155,.323,111,241,.461,.470,27,35,.771,21,102,123,34,22,18,48,56,399,2013
Darius Johnson-Odom,SG,23,LAL,4,0,6,0,4,.000,0,1,.000,0,3,.000,.000,0,0,.000,1,3,4,1,0,0,0,0,0,2013
Dahntay Jones,SF,32,TOT,78,19,1016,82,222,.369,11,49,.224,71,173,.410,.394,87,113,.770,24,77,101,48,22,6,38,119,262,2013
Dahntay Jones,SF,32,DAL,50,15,635,50,140,.357,8,37,.216,42,103,.408,.386,66,82,.805,13,57,70,28,10,5,22,73,174,2013
Dahntay Jones,SF,32,ATL,28,4,381,32,82,.390,3,12,.250,29,70,.414,.409,21,31,.677,11,20,31,20,12,1,16,46,88,2013
DeQuan Jones,SF,22,ORL,63,17,803,95,218,.436,9,35,.257,86,183,.470,.456,34,51,.667,17,88,105,16,19,22,30,55,233,2013
Dominique Jones,PG,24,DAL,29,3,338,40,109,.367,1,9,.111,39,100,.390,.372,35,53,.660,18,27,45,83,14,2,38,29,116,2013
James Jones,SF,32,MIA,38,0,221,21,61,.344,16,53,.302,5,8,.625,.475,2,4,.500,0,22,22,13,2,6,3,16,60,2013
Kevin Jones,PF,23,CLE,32,0,334,43,107,.402,0,0,.000,43,107,.402,.402,9,15,.600,38,40,78,10,9,5,8,25,95,2013
Perry Jones,SF,21,OKC,38,1,280,39,99,.394,0,2,.000,39,97,.402,.394,10,15,.667,12,50,62,10,5,6,15,23,88,2013
Solomon Jones,PF,28,NYK,2,1,26,0,1,.000,0,0,.000,0,1,.000,.000,0,0,.000,1,2,3,0,0,1,3,3,0,2013
Terrence Jones,PF,21,HOU,19,0,276,43,94,.457,5,19,.263,38,75,.507,.484,13,17,.765,28,37,65,15,12,19,13,21,104,2013
DeAndre Jordan,C,24,LAC,82,82,2010,314,488,.643,0,0,.000,314,488,.643,.643,96,249,.386,210,384,594,28,48,112,100,192,724,2013
Cory Joseph,PG,21,SAS,28,9,388,51,110,.464,6,21,.286,45,89,.506,.491,18,21,.857,12,40,52,53,15,4,21,25,126,2013
Kris Joseph,SF,24,TOT,10,0,54,2,14,.143,0,3,.000,2,11,.182,.143,5,8,.625,1,6,7,1,3,0,2,3,9,2013
Kris Joseph,SF,24,BOS,6,0,24,2,11,.182,0,2,.000,2,9,.222,.182,3,4,.750,1,4,5,1,0,0,2,2,7,2013
Kris Joseph,SF,24,BRK,4,0,30,0,3,.000,0,1,.000,0,2,.000,.000,2,4,.500,0,2,2,0,3,0,0,1,2,2013
Chris Kaman,C,30,DAL,66,52,1363,313,617,.507,0,1,.000,313,616,.508,.507,67,85,.788,97,275,372,51,29,52,103,141,693,2013
Enes Kanter,C,20,UTA,70,2,1078,206,379,.544,1,1,1.000,205,378,.542,.545,93,117,.795,135,169,304,31,28,32,101,116,506,2013
Jason Kidd,SG,39,NYK,76,48,2043,152,409,.372,114,325,.351,38,84,.452,.511,40,48,.833,50,273,323,249,125,25,76,125,458,2013
Michael Kidd-Gilchrist,SF,19,CHA,78,77,2025,281,613,.458,2,9,.222,279,604,.462,.460,140,187,.749,131,324,455,117,54,70,101,164,704,2013
Andrei Kirilenko,SF,31,MIN,64,64,2034,284,560,.507,35,120,.292,249,440,.566,.538,188,250,.752,102,260,362,177,96,62,119,82,791,2013
Linas Kleiza,SF,28,TOR,20,3,376,48,144,.333,20,66,.303,28,78,.359,.403,32,38,.842,10,42,52,16,4,2,14,45,148,2013
Brandon Knight,PG,21,DET,75,75,2365,357,878,.407,120,327,.367,237,551,.430,.475,165,225,.733,54,193,247,303,58,8,205,157,999,2013
Kyle Korver,SF,31,ATL,74,60,2259,277,601,.461,189,414,.457,88,187,.471,.618,67,78,.859,23,270,293,146,70,37,70,170,810,2013
Kosta Koufos,C,23,DEN,81,81,1817,295,508,.581,0,1,.000,295,507,.582,.581,58,104,.558,211,351,562,32,44,103,53,246,648,2013
Viacheslav Kravtsov,C,25,DET,25,0,224,33,46,.717,0,0,.000,33,46,.717,.717,11,37,.297,24,21,45,9,5,9,14,32,77,2013
Doron Lamb,SG,21,TOT,47,0,577,60,163,.368,14,37,.378,46,126,.365,.411,20,34,.588,8,38,46,32,13,0,26,52,154,2013
Doron Lamb,SG,21,MIL,23,0,280,33,95,.347,4,16,.250,29,79,.367,.368,8,15,.533,3,14,17,20,7,0,16,27,78,2013
Doron Lamb,SG,21,ORL,24,0,297,27,68,.397,10,21,.476,17,47,.362,.471,12,19,.632,5,24,29,12,6,0,10,25,76,2013
Jeremy Lamb,SF,20,OKC,23,0,147,24,68,.353,9,30,.300,15,38,.395,.419,14,14,1.000,5,13,18,5,2,2,6,13,71,2013
Carl Landry,PF,29,GSW,81,2,1876,325,602,.540,1,3,.333,324,599,.541,.541,223,273,.817,180,303,483,65,35,31,115,190,874,2013
Ty Lawson,PG,25,DEN,73,71,2513,448,971,.461,85,232,.366,363,739,.491,.505,235,311,.756,36,162,198,501,107,8,182,135,1216,2013
Courtney Lee,SG,27,BOS,78,39,1941,246,530,.464,58,156,.372,188,374,.503,.519,62,72,.861,31,159,190,143,89,21,84,139,612,2013
David Lee,PF,29,GSW,79,79,2907,602,1160,.519,0,4,.000,602,1156,.521,.519,255,320,.797,218,668,886,279,67,22,207,246,1459,2013
Malcolm Lee,SG,22,MIN,16,12,289,29,76,.382,8,24,.333,21,52,.404,.434,12,20,.600,15,24,39,20,12,6,10,30,78,2013
Kawhi Leonard,SF,21,SAS,58,57,1810,260,526,.494,65,174,.374,195,352,.554,.556,104,126,.825,63,283,346,93,97,32,62,99,689,2013
Meyers Leonard,C,20,POR,69,9,1206,151,277,.545,3,7,.429,148,270,.548,.551,72,89,.809,80,175,255,33,11,38,49,168,377,2013
Jon Leuer,PF-C,23,TOT,28,0,187,25,52,.481,0,3,.000,25,49,.510,.481,6,13,.462,13,24,37,8,6,0,8,21,56,2013
Jon Leuer,C,23,CLE,9,0,91,10,28,.357,0,3,.000,10,25,.400,.357,2,6,.333,5,8,13,5,2,0,5,11,22,2013
Jon Leuer,PF,23,MEM,19,0,96,15,24,.625,0,0,.000,15,24,.625,.625,4,7,.571,8,16,24,3,4,0,3,10,34,2013
Rashard Lewis,PF,33,MIA,55,9,792,103,249,.414,51,131,.389,52,118,.441,.516,28,45,.622,19,102,121,30,21,14,33,67,285,2013
DeAndre Liggins,SG,24,OKC,39,1,290,21,47,.447,7,19,.368,14,28,.500,.521,9,18,.500,13,40,53,15,18,3,14,33,58,2013
Damian Lillard,PG,22,POR,82,82,3167,553,1288,.429,185,503,.368,368,785,.469,.501,271,321,.844,42,215,257,531,74,19,243,172,1562,2013
Jeremy Lin,PG,24,HOU,82,82,2640,396,897,.441,87,257,.339,309,640,.483,.490,216,275,.785,32,215,247,497,134,29,236,205,1095,2013
Shaun Livingston,PG,27,TOT,66,16,1455,166,346,.480,0,4,.000,166,342,.485,.480,85,98,.867,31,127,158,215,48,31,76,127,417,2013
Shaun Livingston,PG,27,WAS,17,4,320,24,66,.364,0,3,.000,24,63,.381,.364,15,15,1.000,2,35,37,38,11,2,17,22,63,2013
Shaun Livingston,PG,27,CLE,49,12,1135,142,280,.507,0,1,.000,142,279,.509,.507,70,83,.843,29,92,121,177,37,29,59,105,354,2013
Brook Lopez,C,24,BRK,74,74,2253,570,1094,.521,0,1,.000,570,1093,.522,.521,297,392,.758,208,304,512,70,33,154,131,152,1437,2013
Robin Lopez,C,24,NOH,82,82,2136,384,719,.534,0,0,.000,384,719,.534,.534,161,207,.778,226,236,462,64,32,128,110,167,929,2013
Kevin Love,PF,24,MIN,18,18,618,105,298,.352,20,92,.217,85,206,.413,.386,100,142,.704,64,188,252,42,13,9,39,34,330,2013
Kyle Lowry,PG,26,TOR,68,52,2020,250,623,.401,101,279,.362,149,344,.433,.482,190,239,.795,56,265,321,435,94,24,157,218,791,2013
John Lucas III,PG,30,TOR,63,0,827,129,334,.386,57,151,.377,72,183,.393,.472,18,25,.720,8,57,65,105,23,1,26,50,333,2013
Scott Machado,PG,22,HOU,6,0,21,3,6,.500,0,1,.000,3,5,.600,.500,2,2,1.000,0,1,1,6,2,0,8,0,8,2013
Shelvin Mack,PG-SG,22,TOT,31,3,416,58,126,.460,18,49,.367,40,77,.519,.532,9,16,.563,3,37,40,68,15,0,34,39,143,2013
Shelvin Mack,PG,22,WAS,7,2,141,16,40,.400,4,13,.308,12,27,.444,.450,1,2,.500,3,13,16,23,6,0,8,10,37,2013
Shelvin Mack,SG,22,PHI,4,0,7,1,2,.500,0,1,.000,1,1,1.000,.500,0,0,.000,0,0,0,1,0,0,2,1,2,2013
Shelvin Mack,PG,22,ATL,20,1,268,41,84,.488,14,35,.400,27,49,.551,.571,8,14,.571,0,24,24,44,9,0,24,28,104,2013
Corey Maggette,SF,33,DET,18,0,257,27,76,.355,5,21,.238,22,55,.400,.388,36,48,.750,5,20,25,19,6,2,17,42,95,2013
Ian Mahinmi,C,26,IND,80,2,1322,149,329,.453,0,2,.000,149,327,.456,.453,104,171,.608,115,196,311,27,39,66,92,201,402,2013
Shawn Marion,PF,34,DAL,67,67,2010,355,690,.514,23,73,.315,332,617,.538,.531,79,101,.782,146,379,525,163,75,47,103,111,812,2013
Kendall Marshall,PG,21,PHO,48,3,702,56,151,.371,23,73,.315,33,78,.423,.447,8,14,.571,4,38,42,143,22,4,57,48,143,2013
Cartier Martin,SF,28,WAS,41,3,694,96,252,.381,58,146,.397,38,106,.358,.496,20,28,.714,11,89,100,20,19,6,32,58,270,2013
Kenyon Martin,C,35,NYK,18,11,431,56,93,.602,0,0,.000,56,93,.602,.602,17,40,.425,34,61,95,8,16,17,16,64,129,2013
Kevin Martin,SG,29,OKC,77,0,2136,350,778,.450,158,371,.426,192,407,.472,.551,219,246,.890,31,147,178,106,72,8,101,138,1077,2013
Roger Mason,SG,32,NOH,69,13,1219,132,305,.433,66,159,.415,66,146,.452,.541,39,43,.907,11,121,132,74,26,11,51,104,369,2013
Wesley Matthews,SG,26,POR,69,69,2403,352,808,.436,169,425,.398,183,383,.478,.540,149,187,.797,35,156,191,174,90,18,109,172,1022,2013
Jason Maxiell,PF,29,DET,72,71,1789,204,457,.446,0,0,.000,204,457,.446,.446,90,145,.621,135,274,409,54,32,95,81,172,498,2013
Eric Maynor,PG-SG,25,TOT,64,0,963,106,281,.377,34,96,.354,72,185,.389,.438,45,62,.726,9,37,46,182,22,1,79,55,291,2013
Eric Maynor,PG,25,OKC,37,0,391,36,115,.313,15,46,.326,21,69,.304,.378,17,21,.810,5,13,18,73,10,0,31,19,104,2013
Eric Maynor,SG,25,POR,27,0,572,70,166,.422,19,50,.380,51,116,.440,.479,28,41,.683,4,24,28,109,12,1,48,36,187,2013
O.J. Mayo,SG,25,DAL,82,82,2913,461,1026,.449,142,349,.407,319,677,.471,.519,191,233,.820,36,255,291,361,93,23,210,195,1255,2013
Luc Mbah a Moute,SF,26,MIL,58,45,1326,151,377,.401,13,37,.351,138,340,.406,.418,72,126,.571,89,167,256,55,42,14,70,82,387,2013
JaVale McGee,C,25,DEN,79,0,1433,303,527,.575,1,1,1.000,302,526,.574,.576,110,186,.591,158,223,381,24,30,157,90,184,717,2013
Dominic McGuire,SF,27,TOT,26,10,387,24,56,.429,0,0,.000,24,56,.429,.429,3,10,.300,19,59,78,20,13,11,12,39,51,2013
Dominic McGuire,SF,27,TOR,15,9,230,15,32,.469,0,0,.000,15,32,.469,.469,2,6,.333,11,37,48,10,5,8,7,26,32,2013
Dominic McGuire,SF,27,NOH,9,0,145,9,21,.429,0,0,.000,9,21,.429,.429,1,2,.500,7,21,28,9,8,3,5,13,19,2013
Dominic McGuire,SF,27,IND,2,1,12,0,3,.000,0,0,.000,0,3,.000,.000,0,2,.000,1,1,2,1,0,0,0,0,0,2013
Josh McRoberts,PF,25,TOT,67,22,1487,156,343,.455,24,84,.286,132,259,.510,.490,65,85,.765,93,232,325,141,32,27,66,131,401,2013
Josh McRoberts,PF,25,ORL,41,3,685,60,153,.392,17,55,.309,43,98,.439,.448,22,30,.733,41,96,137,70,10,12,28,65,159,2013
Josh McRoberts,PF,25,CHA,26,19,802,96,190,.505,7,29,.241,89,161,.553,.524,43,55,.782,52,136,188,71,22,15,38,66,242,2013
Jodie Meeks,SG,25,LAL,78,10,1663,205,530,.387,122,342,.357,83,188,.441,.502,86,96,.896,37,134,171,69,58,5,52,103,618,2013
Fab Melo,C,22,BOS,6,0,36,3,6,.500,0,0,.000,3,6,.500,.500,1,4,.250,0,3,3,0,2,2,1,7,7,2013
Khris Middleton,SG,21,DET,27,0,475,62,141,.440,14,45,.311,48,96,.500,.489,27,32,.844,4,46,50,28,15,4,11,53,165,2013
C.J. Miles,SF,25,CLE,65,13,1364,255,614,.415,126,328,.384,129,286,.451,.518,93,107,.869,24,150,174,63,49,17,69,138,729,2013
Darko Milicic,C,27,BOS,1,0,5,0,1,.000,0,0,.000,0,1,.000,.000,0,0,.000,0,1,1,0,0,0,2,1,0,2013
Andre Miller,PG,36,DEN,82,11,2151,303,632,.479,17,64,.266,286,568,.504,.493,163,194,.840,60,178,238,484,73,11,172,159,786,2013
Darius Miller,SF,22,NOH,52,2,694,44,108,.407,22,56,.393,22,52,.423,.509,8,8,1.000,8,70,78,44,17,12,23,89,118,2013
Mike Miller,SF,32,MIA,59,17,900,100,231,.433,73,175,.417,27,56,.482,.591,8,11,.727,18,139,157,99,21,4,35,63,281,2013
Quincy Miller,PF,20,DEN,7,0,26,4,12,.333,0,1,.000,4,11,.364,.333,1,2,.500,1,1,2,3,1,0,1,3,9,2013
Patty Mills,PG,24,SAS,58,2,656,113,241,.469,52,130,.400,61,111,.550,.577,16,19,.842,9,41,50,62,26,4,39,55,294,2013
Paul Millsap,PF,27,UTA,78,78,2375,429,875,.490,13,39,.333,416,836,.498,.498,264,356,.742,177,377,554,201,102,80,138,232,1135,2013
Nazr Mohammed,C,35,CHI,63,12,693,66,180,.367,0,2,.000,66,178,.371,.367,34,47,.723,73,122,195,26,21,32,24,97,166,2013
Greg Monroe,C,22,DET,81,81,2687,514,1058,.486,0,4,.000,514,1054,.488,.486,270,392,.689,236,541,777,281,105,55,234,190,1298,2013
E'Twaun Moore,SG,23,ORL,75,21,1682,237,598,.396,67,197,.340,170,401,.424,.452,47,59,.797,48,119,167,206,51,23,105,122,588,2013
Darius Morris,PG,22,LAL,48,17,683,73,188,.388,24,66,.364,49,122,.402,.452,24,37,.649,24,33,57,76,21,2,45,58,194,2013
Marcus Morris,PF-SF,23,TOT,77,23,1524,222,526,.422,86,233,.369,136,293,.464,.504,66,117,.564,80,197,277,62,45,20,77,160,596,2013
Marcus Morris,PF,23,HOU,54,17,1154,171,400,.428,74,194,.381,97,206,.471,.520,49,75,.653,63,156,219,47,27,16,53,120,465,2013
Marcus Morris,SF,23,PHO,23,6,370,51,126,.405,12,39,.308,39,87,.448,.452,17,42,.405,17,41,58,15,18,4,24,40,131,2013
Markieff Morris,PF,23,PHO,82,32,1837,266,653,.407,45,134,.336,221,519,.426,.442,93,127,.732,131,265,396,108,77,64,104,209,670,2013
Anthony Morrow,SG,27,TOT,41,1,383,64,145,.441,16,43,.372,48,102,.471,.497,20,22,.909,11,19,30,13,13,1,8,43,164,2013
Anthony Morrow,SG,27,ATL,24,1,301,47,111,.423,15,38,.395,32,73,.438,.491,16,18,.889,10,16,26,9,12,1,4,33,125,2013
Anthony Morrow,SG,27,DAL,17,0,82,17,34,.500,1,5,.200,16,29,.552,.515,4,4,1.000,1,3,4,4,1,0,4,10,39,2013
Donatas Motiejunas,PF,22,HOU,44,14,538,97,213,.455,24,83,.289,73,130,.562,.512,32,51,.627,36,57,93,31,7,10,37,73,250,2013
Arnett Moultrie,PF,22,PHI,47,0,542,78,134,.582,0,0,.000,78,134,.582,.582,18,28,.643,76,69,145,10,17,10,19,43,174,2013
Timofey Mozgov,C,26,DEN,41,1,366,44,87,.506,0,2,.000,44,85,.518,.506,20,26,.769,50,57,107,9,6,18,25,57,108,2013
Byron Mullens,PF,23,CHA,53,41,1428,217,563,.385,66,208,.317,151,355,.425,.444,64,99,.646,71,266,337,81,34,32,74,110,564,2013
Kevin Murphy,SG,22,UTA,17,0,52,7,28,.250,1,5,.200,6,23,.261,.268,0,0,.000,0,4,4,2,1,0,3,4,15,2013
Troy Murphy,PF,32,DAL,14,1,256,22,61,.361,11,35,.314,11,26,.423,.451,10,11,.909,7,42,49,7,10,6,7,29,65,2013
Steve Nash,PG,38,LAL,50,50,1627,236,475,.497,57,130,.438,179,345,.519,.557,107,116,.922,26,116,142,333,30,5,126,70,636,2013
Gary Neal,SG,28,SAS,68,17,1484,246,597,.412,89,251,.355,157,346,.454,.487,64,74,.865,13,130,143,129,30,2,69,93,645,2013
Jameer Nelson,PG,30,ORL,56,56,1977,306,780,.392,121,355,.341,185,425,.435,.470,89,102,.873,23,186,209,413,71,6,154,161,822,2013
Andrew Nicholson,PF,23,ORL,75,28,1249,256,486,.527,0,0,.000,256,486,.527,.527,75,94,.798,69,189,258,44,24,32,79,133,587,2013
Joakim Noah,C,27,CHI,66,64,2426,303,630,.481,0,5,.000,303,625,.485,.481,178,237,.751,260,473,733,262,78,141,176,185,784,2013
Steve Novak,SF,29,NYK,81,1,1641,178,430,.414,149,351,.425,29,79,.367,.587,30,33,.909,17,135,152,35,28,8,12,97,535,2013
Dirk Nowitzki,PF,34,DAL,53,47,1661,343,728,.471,65,157,.414,278,571,.487,.516,166,193,.860,37,326,363,132,38,37,70,93,917,2013
Jermaine O'Neal,C,34,PHO,55,4,1029,179,371,.482,0,0,.000,179,371,.482,.482,96,115,.835,82,211,293,42,19,78,73,126,454,2013
Kyle O'Quinn,C,22,ORL,57,5,638,101,197,.513,0,1,.000,101,196,.515,.513,30,45,.667,65,144,209,52,11,26,37,107,232,2013
Lamar Odom,PF,33,LAC,82,2,1616,146,366,.399,18,90,.200,128,276,.464,.423,20,42,.476,117,363,480,142,69,58,86,214,330,2013
Tim Ohlbrecht,C,24,HOU,3,0,12,1,3,.333,0,0,.000,1,3,.333,.333,1,1,1.000,0,1,1,1,1,0,4,1,3,2013
Emeka Okafor,C,30,WAS,79,77,2052,328,687,.477,0,0,.000,328,687,.477,.477,109,191,.571,199,493,692,93,45,77,107,145,765,2013
Daniel Orton,C,22,OKC,13,0,104,12,26,.462,0,0,.000,12,26,.462,.462,9,17,.529,13,13,26,4,4,3,4,13,33,2013
Travis Outlaw,SF,28,SAC,38,2,444,74,177,.418,14,50,.280,60,127,.472,.458,38,52,.731,17,44,61,21,11,8,19,35,200,2013
Zaza Pachulia,C,28,ATL,52,15,1134,114,241,.473,0,3,.000,114,238,.479,.473,78,103,.757,132,204,336,79,35,12,70,128,306,2013
Jannero Pargo,PG,33,TOT,32,0,507,78,212,.368,39,116,.336,39,96,.406,.460,12,13,.923,10,25,35,67,18,3,41,42,207,2013
Jannero Pargo,PG,33,WAS,7,0,102,8,32,.250,3,20,.150,5,12,.417,.297,2,2,1.000,0,6,6,14,0,1,8,8,21,2013
Jannero Pargo,PG,33,ATL,7,0,113,13,38,.342,7,20,.350,6,18,.333,.434,2,2,1.000,1,6,7,19,3,0,5,8,35,2013
Jannero Pargo,PG,33,CHA,18,0,292,57,142,.401,29,76,.382,28,66,.424,.504,8,9,.889,9,13,22,34,15,2,28,26,151,2013
Jeremy Pargo,PG-SG,26,TOT,39,11,655,99,250,.396,25,74,.338,74,176,.420,.446,42,62,.677,8,41,49,92,13,2,50,46,265,2013
Jeremy Pargo,PG,26,CLE,25,11,447,75,187,.401,18,57,.316,57,130,.438,.449,28,41,.683,7,25,32,64,12,2,37,32,196,2013
Jeremy Pargo,SG,26,PHI,14,0,208,24,63,.381,7,17,.412,17,46,.370,.437,14,21,.667,1,16,17,28,1,0,13,14,69,2013
Tony Parker,PG,30,SAS,66,66,2174,519,995,.522,24,68,.353,495,927,.534,.534,279,330,.845,18,180,198,499,54,6,170,92,1341,2013
Chandler Parsons,SF,24,HOU,76,76,2758,456,939,.486,152,395,.385,304,544,.559,.567,113,155,.729,79,325,404,269,75,32,147,148,1177,2013
Patrick Patterson,PF,23,TOT,71,41,1775,319,623,.512,51,132,.386,268,491,.546,.553,48,63,.762,113,224,337,81,31,40,61,138,737,2013
Patrick Patterson,PF,23,HOU,47,38,1219,236,455,.519,35,96,.365,201,359,.560,.557,37,49,.755,73,148,221,51,18,27,42,90,544,2013
Patrick Patterson,PF,23,SAC,24,3,556,83,168,.494,16,36,.444,67,132,.508,.542,11,14,.786,40,76,116,30,13,13,19,48,193,2013
Chris Paul,PG,27,LAC,70,70,2335,412,856,.481,76,232,.328,336,624,.538,.526,286,323,.885,53,209,262,678,169,10,159,143,1186,2013
Sasha Pavlovic,SG,29,POR,39,1,528,42,119,.353,18,60,.300,24,59,.407,.429,1,6,.167,7,49,56,32,24,5,14,59,103,2013
Nikola Pekovic,C,27,MIN,62,62,1959,385,741,.520,0,0,.000,385,741,.520,.520,241,324,.744,230,315,545,53,43,50,101,143,1011,2013
Kendrick Perkins,C,28,OKC,78,78,1954,143,313,.457,0,1,.000,143,312,.458,.457,44,72,.611,110,356,466,111,43,83,109,227,330,2013
Johan Petro,C,27,ATL,31,8,352,48,110,.436,1,4,.250,47,106,.443,.441,11,12,.917,33,79,112,16,10,9,24,48,108,2013
Paul Pierce,SF,35,BOS,77,77,2575,476,1092,.436,145,382,.380,331,710,.466,.502,333,423,.787,45,442,487,370,84,30,214,210,1430,2013
Mickael Pietrus,SF,30,TOR,19,16,386,34,98,.347,20,64,.313,14,34,.412,.449,12,18,.667,5,31,36,9,12,6,16,33,100,2013
Dexter Pittman,C,24,TOT,11,0,32,4,11,.364,0,0,.000,4,11,.364,.364,0,3,.000,7,5,12,0,0,0,3,8,8,2013
Dexter Pittman,C,24,MIA,4,0,12,3,5,.600,0,0,.000,3,5,.600,.600,0,0,.000,4,3,7,0,0,0,2,4,6,2013
Dexter Pittman,C,24,MEM,7,0,20,1,6,.167,0,0,.000,1,6,.167,.167,0,3,.000,3,2,5,0,0,0,1,4,2,2013
Miles Plumlee,C,24,IND,14,0,55,5,21,.238,0,0,.000,5,21,.238,.238,3,4,.750,12,10,22,2,0,3,3,5,13,2013
Quincy Pondexter,SF,24,MEM,59,1,1243,128,299,.428,60,152,.395,68,147,.463,.528,59,75,.787,43,89,132,61,35,6,42,95,375,2013
A.J. Price,PG,26,WAS,57,22,1278,161,413,.390,70,200,.350,91,213,.427,.475,49,62,.790,20,94,114,205,33,3,64,73,441,2013
Ronnie Price,PG,29,POR,39,0,510,39,120,.325,10,39,.256,29,81,.358,.367,17,24,.708,13,31,44,73,26,3,34,61,105,2013
Pablo Prigioni,PG,35,NYK,78,18,1263,100,220,.455,53,134,.396,47,86,.547,.575,22,25,.880,41,102,143,236,69,2,86,127,275,2013
Tayshaun Prince,SF,32,TOT,82,81,2631,359,820,.438,38,94,.404,321,726,.442,.461,96,130,.738,72,292,364,196,48,25,89,86,852,2013
Tayshaun Prince,SF,32,DET,45,45,1457,215,484,.444,23,53,.434,192,431,.445,.468,74,93,.796,43,166,209,111,21,13,54,45,527,2013
Tayshaun Prince,SF,32,MEM,37,36,1174,144,336,.429,15,41,.366,129,295,.437,.451,22,37,.595,29,126,155,85,27,12,35,41,325,2013
Joel Przybilla,C,33,MIL,12,1,68,1,4,.250,0,0,.000,1,4,.250,.250,0,2,.000,5,16,21,4,1,2,4,10,2,2013
Chris Quinn,SG,29,CLE,7,0,78,4,16,.250,0,5,.000,4,11,.364,.250,2,2,1.000,1,1,2,9,3,0,6,4,10,2013
Vladimir Radmanovic,PF,32,CHI,25,0,144,13,43,.302,5,27,.185,8,16,.500,.360,2,3,.667,10,18,28,8,8,4,7,29,33,2013
Anthony Randolph,PF,23,DEN,39,0,329,56,114,.491,0,8,.000,56,106,.528,.491,31,45,.689,29,66,95,12,19,21,37,41,143,2013
Shavlik Randolph,PF,29,BOS,16,0,198,28,48,.583,0,0,.000,28,48,.583,.583,11,27,.407,28,42,70,4,8,7,10,38,67,2013
Zach Randolph,PF,31,MEM,76,75,2607,471,1024,.460,2,23,.087,469,1001,.469,.461,225,300,.750,310,544,854,108,61,31,150,180,1169,2013
J.J. Redick,SG,28,TOT,78,13,2379,382,880,.434,165,451,.366,217,429,.506,.528,171,190,.900,17,154,171,296,38,9,138,117,1100,2013
J.J. Redick,SG,28,ORL,50,11,1575,262,582,.450,117,300,.390,145,282,.514,.551,115,129,.891,9,110,119,220,29,5,105,70,756,2013
J.J. Redick,SG,28,MIL,28,2,804,120,298,.403,48,151,.318,72,147,.490,.483,56,61,.918,8,44,52,76,9,4,33,47,344,2013
Jason Richardson,SG,32,PHI,33,33,936,135,336,.402,57,167,.341,78,169,.462,.487,20,33,.606,19,108,127,51,40,15,26,57,347,2013
Quentin Richardson,SF,32,NYK,1,0,29,1,11,.091,1,4,.250,0,7,.000,.136,2,2,1.000,5,5,10,1,0,0,2,1,5,2013
Luke Ridnour,SG,31,MIN,82,82,2474,367,811,.453,66,212,.311,301,599,.503,.493,139,164,.848,41,165,206,311,82,15,130,187,939,2013
Austin Rivers,SG,20,NOH,61,26,1418,145,390,.372,28,86,.326,117,304,.385,.408,59,108,.546,16,93,109,127,26,9,74,122,377,2013
Brian Roberts,PG,27,NOH,78,5,1324,213,511,.417,59,153,.386,154,358,.430,.475,70,77,.909,17,80,97,219,37,3,71,108,555,2013
Nate Robinson,PG,28,CHI,82,23,2086,399,921,.433,141,348,.405,258,573,.450,.510,135,169,.799,29,155,184,358,85,10,144,207,1074,2013
Thomas Robinson,PF,21,TOT,70,0,1056,138,321,.430,0,1,.000,138,320,.431,.430,57,109,.523,122,193,315,46,41,26,88,124,333,2013
Thomas Robinson,PF,21,SAC,51,0,809,103,243,.424,0,0,.000,103,243,.424,.424,41,71,.577,92,146,238,36,25,21,65,95,247,2013
Thomas Robinson,PF,21,HOU,19,0,247,35,78,.449,0,1,.000,35,77,.455,.449,16,38,.421,30,47,77,10,16,5,23,29,86,2013
Rajon Rondo,PG,26,BOS,38,38,1423,225,465,.484,12,50,.240,213,415,.513,.497,60,93,.645,43,169,212,420,70,9,148,96,522,2013
Terrence Ross,SG,21,TOR,73,2,1239,186,457,.407,65,196,.332,121,261,.464,.478,30,42,.714,35,109,144,53,43,14,48,122,467,2013
Brandon Roy,SG,28,MIN,5,5,122,11,35,.314,0,9,.000,11,26,.423,.314,7,10,.700,3,11,14,23,3,0,7,5,29,2013
Ricky Rubio,PG,22,MIN,57,47,1691,185,514,.360,27,92,.293,158,422,.374,.386,211,264,.799,44,185,229,418,137,5,172,143,608,2013
Brandon Rush,SF,27,GSW,2,0,25,6,9,.667,0,2,.000,6,7,.857,.667,2,3,.667,0,1,1,2,0,0,3,5,14,2013
Robert Sacre,C,23,LAL,32,3,203,18,48,.375,0,0,.000,18,48,.375,.375,7,11,.636,9,25,34,6,0,10,10,38,43,2013
John Salmons,SF,33,SAC,76,72,2278,244,612,.399,99,267,.371,145,345,.420,.480,85,110,.773,33,174,207,226,51,25,85,143,672,2013
Samardo Samuels,C,24,CLE,18,1,196,22,60,.367,0,1,.000,22,59,.373,.367,14,24,.583,10,18,28,8,3,3,6,30,58,2013
Larry Sanders,C,24,MIL,71,55,1937,306,605,.506,0,2,.000,306,603,.507,.506,84,136,.618,224,448,672,83,53,201,87,233,696,2013
Luis Scola,PF,32,PHO,82,67,2184,432,915,.472,3,16,.188,429,899,.477,.474,181,230,.787,158,383,541,182,67,35,126,257,1048,2013
Mike Scott,PF,24,ATL,40,1,376,70,147,.476,0,1,.000,70,146,.479,.476,43,56,.768,39,71,110,12,4,2,21,32,183,2013
Thabo Sefolosha,SG,28,OKC,81,81,2229,224,466,.481,108,258,.419,116,208,.558,.597,57,69,.826,58,259,317,125,103,44,64,177,613,2013
Josh Selby,PG,21,MEM,10,0,59,6,22,.273,1,6,.167,5,16,.313,.295,7,11,.636,0,5,5,4,2,0,7,7,20,2013
Kevin Seraphin,C,23,WAS,79,8,1721,330,716,.461,0,0,.000,330,716,.461,.461,61,88,.693,107,239,346,57,24,59,130,211,721,2013
Ramon Sessions,SG,26,CHA,61,0,1652,276,676,.408,33,107,.308,243,569,.427,.433,291,347,.839,27,142,169,230,48,7,104,91,876,2013
Tornike Shengelia,SF,21,BRK,19,0,93,10,23,.435,1,2,.500,9,21,.429,.457,9,16,.563,9,14,23,3,3,1,11,11,30,2013
Iman Shumpert,SG,22,NYK,45,45,996,109,275,.396,51,127,.402,58,148,.392,.489,36,47,.766,31,105,136,75,43,7,37,99,305,2013
Alexey Shved,SG,24,MIN,77,16,1840,236,635,.372,85,288,.295,151,347,.435,.439,108,150,.720,41,134,175,286,54,27,147,117,665,2013
Henry Sims,C,22,NOH,2,0,5,2,3,.667,0,0,.000,2,3,.667,.667,0,0,.000,2,0,2,0,0,0,1,1,4,2013
Kyle Singler,SF,24,DET,82,74,2293,275,642,.428,70,200,.350,205,442,.464,.483,100,124,.806,109,221,330,77,57,37,98,217,720,2013
Chris Singleton,PF,23,WAS,57,11,924,92,241,.382,7,36,.194,85,205,.415,.396,40,70,.571,51,133,184,37,38,24,45,124,231,2013
Donald Sloan,SG-PG,25,TOT,23,0,263,27,78,.346,7,19,.368,20,59,.339,.391,20,25,.800,3,25,28,38,5,0,14,17,81,2013
Donald Sloan,SG,25,CLE,20,0,257,27,78,.346,7,19,.368,20,59,.339,.391,20,25,.800,3,25,28,37,5,0,13,17,81,2013
Donald Sloan,PG,25,NOH,3,0,6,0,0,.000,0,0,.000,0,0,.000,.000,0,0,.000,0,0,0,1,0,0,1,0,0,2013
Greg Smith,C,22,HOU,70,10,1110,170,274,.620,0,1,.000,170,273,.623,.620,81,130,.623,111,210,321,25,18,40,41,175,421,2013
Ish Smith,PG,24,TOT,52,3,516,56,159,.352,8,27,.296,48,132,.364,.377,3,7,.429,12,49,61,87,21,9,37,26,123,2013
Ish Smith,PG,24,ORL,36,3,378,39,116,.336,4,17,.235,35,99,.354,.353,3,7,.429,11,35,46,57,13,6,27,14,85,2013
Ish Smith,PG,24,MIL,16,0,138,17,43,.395,4,10,.400,13,33,.394,.442,0,0,.000,1,14,15,30,8,3,10,12,38,2013
J.R. Smith,SG,27,NYK,80,0,2678,527,1249,.422,155,436,.356,372,813,.458,.484,237,311,.762,64,361,425,218,100,24,134,226,1446,2013
Jason Smith,C,26,NOH,51,0,876,167,341,.490,0,4,.000,167,337,.496,.490,86,102,.843,64,122,186,34,15,45,55,123,420,2013
Josh Smith,PF,27,ATL,76,76,2683,550,1182,.465,61,201,.303,489,981,.498,.491,166,321,.517,133,506,639,321,94,136,226,175,1327,2013
Nolan Smith,PG,24,POR,40,0,288,42,114,.368,6,28,.214,36,86,.419,.395,20,28,.714,7,20,27,35,7,1,29,26,110,2013
Marreese Speights,C,25,TOT,79,3,1300,260,584,.445,3,10,.300,257,574,.448,.448,135,175,.771,146,240,386,47,24,53,80,175,658,2013
Marreese Speights,C,25,MEM,40,2,579,106,247,.429,2,5,.400,104,242,.430,.433,48,67,.716,76,113,189,18,10,27,35,86,262,2013
Marreese Speights,C,25,CLE,39,1,721,154,337,.457,1,5,.200,153,332,.461,.458,87,108,.806,70,127,197,29,14,26,45,89,396,2013
Tiago Splitter,PF,28,SAS,81,58,1997,315,563,.560,0,2,.000,315,561,.561,.560,208,285,.730,144,371,515,130,63,64,100,161,838,2013
Jerry Stackhouse,SF,38,BRK,37,0,544,66,172,.384,30,89,.337,36,83,.434,.471,20,23,.870,5,28,33,35,7,4,24,31,182,2013
Lance Stephenson,SG,22,IND,78,72,2278,275,598,.460,62,188,.330,213,410,.520,.512,75,115,.652,47,257,304,223,81,16,109,162,687,2013
DeShawn Stevenson,SG,31,ATL,56,31,1158,98,262,.374,76,209,.364,22,53,.415,.519,12,23,.522,18,104,122,52,29,6,23,69,284,2013
Greg Stiemsma,C,27,MIN,76,19,1209,127,278,.457,0,0,.000,127,278,.457,.457,53,69,.768,61,200,261,30,44,90,59,184,307,2013
Julyan Stone,PG,24,DEN,4,0,28,2,2,1.000,0,0,.000,2,2,1.000,1.000,3,4,.750,2,1,3,2,1,0,2,4,7,2013
Amar'e Stoudemire,PF,30,NYK,29,0,682,154,267,.577,0,0,.000,154,267,.577,.577,105,130,.808,60,85,145,13,10,21,50,89,413,2013
Rodney Stuckey,SG,26,DET,76,24,2171,304,748,.406,55,182,.302,249,566,.440,.443,213,272,.783,43,169,212,270,51,17,134,127,876,2013
Jared Sullinger,PF,20,BOS,45,5,892,111,225,.493,1,5,.200,110,220,.500,.496,47,63,.746,92,172,264,35,22,22,29,154,270,2013
DaJuan Summers,PF,25,LAC,2,0,7,1,4,.250,0,0,.000,1,4,.250,.250,0,0,.000,0,2,2,1,0,0,0,0,2,2013
Jeffery Taylor,SF,23,CHA,77,29,1507,172,399,.431,53,154,.344,119,245,.486,.497,75,103,.728,51,99,150,63,47,15,48,136,472,2013
Tyshawn Taylor,PG,22,BRK,38,0,221,32,87,.368,6,13,.462,26,74,.351,.402,15,27,.556,2,16,18,21,13,0,25,25,85,2013
Jeff Teague,PG,24,ATL,80,78,2628,439,974,.451,89,248,.359,350,726,.482,.496,199,226,.881,25,155,180,579,117,28,230,181,1166,2013
Marquis Teague,PG,19,CHI,48,0,392,43,113,.381,4,23,.174,39,90,.433,.398,9,16,.563,3,41,44,63,9,7,35,47,99,2013
Mirza Teletovic,PF,27,BRK,53,0,499,71,185,.384,37,108,.343,34,77,.442,.484,9,11,.818,33,62,95,23,13,8,20,53,188,2013
Sebastian Telfair,PG,27,TOT,59,2,980,112,309,.362,53,150,.353,59,159,.371,.448,54,69,.783,13,71,84,153,37,11,64,104,331,2013
Sebastian Telfair,PG,27,PHO,46,2,795,94,247,.381,43,113,.381,51,134,.381,.468,44,57,.772,12,56,68,114,28,10,53,84,275,2013
Sebastian Telfair,PG,27,TOR,13,0,185,18,62,.290,10,37,.270,8,25,.320,.371,10,12,.833,1,15,16,39,9,1,11,20,56,2013
Garrett Temple,SG,26,WAS,51,36,1156,105,258,.407,26,80,.325,79,178,.444,.457,26,37,.703,29,94,123,115,50,17,61,94,262,2013
Jason Terry,SG,35,BOS,79,24,2124,281,648,.434,123,331,.372,158,317,.498,.529,114,131,.870,19,140,159,198,66,11,102,110,799,2013
Hasheem Thabeet,C,25,OKC,66,4,770,64,106,.604,0,0,.000,64,106,.604,.604,32,53,.604,69,126,195,11,30,60,41,148,160,2013
Isaiah Thomas,PG,23,SAC,79,62,2122,366,832,.440,115,321,.358,251,511,.491,.509,253,287,.882,29,132,161,316,67,3,140,167,1100,2013
Kurt Thomas,PF,40,NYK,39,17,392,45,83,.542,1,1,1.000,44,82,.537,.548,6,13,.462,24,65,89,21,10,16,8,52,97,2013
Lance Thomas,SF,24,NOH,59,9,646,53,106,.500,0,0,.000,53,106,.500,.500,43,59,.729,44,71,115,17,11,7,14,78,149,2013
Malcolm Thomas,PF,24,TOT,12,0,57,5,10,.500,0,0,.000,5,10,.500,.500,5,8,.625,5,11,16,4,2,2,3,8,15,2013
Malcolm Thomas,PF,24,GSW,5,0,21,0,1,.000,0,0,.000,0,1,.000,.000,3,4,.750,0,5,5,2,0,1,1,1,3,2013
Malcolm Thomas,PF,24,CHI,7,0,36,5,9,.556,0,0,.000,5,9,.556,.556,2,4,.500,5,6,11,2,2,1,2,7,12,2013
Tyrus Thomas,PF,26,CHA,26,2,360,48,136,.353,3,8,.375,45,128,.352,.364,26,31,.839,16,44,60,19,14,15,17,51,125,2013
Jason Thompson,PF,26,SAC,82,81,2285,374,745,.502,0,3,.000,374,742,.504,.502,143,206,.694,172,377,549,84,48,61,101,227,891,2013
Klay Thompson,SG,22,GSW,82,82,2936,508,1205,.422,211,526,.401,297,679,.437,.509,132,157,.841,32,274,306,183,86,45,157,237,1359,2013
Tristan Thompson,PF,21,CLE,82,82,2564,390,799,.488,0,3,.000,390,796,.490,.488,177,291,.608,306,467,773,108,60,71,123,234,957,2013
Marcus Thornton,SG,25,SAC,72,8,1726,332,774,.429,141,379,.372,191,395,.484,.520,111,126,.881,50,131,181,91,61,4,68,105,916,2013
Jamaal Tinsley,PG,34,UTA,66,32,1221,86,234,.368,39,127,.307,47,107,.439,.451,18,26,.692,17,98,115,290,64,14,106,106,229,2013
Anthony Tolliver,SF,27,ATL,62,11,963,82,216,.380,45,133,.338,37,83,.446,.484,44,51,.863,31,124,155,32,15,12,36,66,253,2013
P.J. Tucker,SG,27,PHO,79,45,1910,210,444,.473,22,70,.314,188,374,.503,.498,64,86,.744,132,218,350,109,62,19,67,145,506,2013
Ronny Turiaf,C,30,LAC,65,0,701,49,97,.505,0,0,.000,49,97,.505,.505,23,63,.365,45,107,152,35,19,35,29,80,121,2013
Hedo Turkoglu,SF,33,ORL,11,1,189,14,53,.264,1,24,.042,13,29,.448,.274,3,6,.500,4,22,26,23,7,1,12,11,32,2013
Evan Turner,SF,24,PHI,82,82,2892,441,1053,.419,58,159,.365,383,894,.428,.446,154,208,.740,56,461,517,354,71,17,187,197,1094,2013
Jeremy Tyler,C,21,TOT,21,0,68,9,24,.375,0,0,.000,9,24,.375,.375,4,6,.667,6,14,20,1,1,2,6,10,22,2013
Jeremy Tyler,C,21,GSW,20,0,63,9,24,.375,0,0,.000,9,24,.375,.375,4,6,.667,6,11,17,1,1,2,6,10,22,2013
Jeremy Tyler,C,21,ATL,1,0,5,0,0,.000,0,0,.000,0,0,.000,.000,0,0,.000,0,3,3,0,0,0,0,0,0,2013
Ekpe Udoh,C,25,MIL,76,9,1312,117,269,.435,0,1,.000,117,268,.437,.435,89,119,.748,113,138,251,43,39,85,43,139,323,2013
Beno Udrih,SG-PG,30,TOT,66,9,1457,210,476,.441,34,102,.333,176,374,.471,.477,84,103,.816,34,107,141,302,41,3,108,90,538,2013
Beno Udrih,SG,30,MIL,39,0,719,113,238,.475,13,49,.265,100,189,.529,.502,24,33,.727,17,61,78,138,16,2,53,39,263,2013
Beno Udrih,PG,30,ORL,27,9,738,97,238,.408,21,53,.396,76,185,.411,.452,60,70,.857,17,46,63,164,25,1,55,51,275,2013
Jonas Valanciunas,C,20,TOR,62,57,1482,204,366,.557,0,0,.000,204,366,.557,.557,146,185,.789,121,251,372,45,17,78,94,188,554,2013
Anderson Varejao,C,30,CLE,25,25,901,138,289,.478,0,5,.000,138,284,.486,.478,77,102,.755,138,223,361,84,37,14,44,68,353,2013
Jarvis Varnado,PF,24,TOT,13,0,58,3,7,.429,0,0,.000,3,7,.429,.429,2,4,.500,2,7,9,3,1,2,6,10,8,2013
Jarvis Varnado,PF,24,BOS,5,0,18,2,4,.500,0,0,.000,2,4,.500,.500,2,4,.500,1,2,3,1,1,0,1,1,6,2013
Jarvis Varnado,PF,24,MIA,8,0,40,1,3,.333,0,0,.000,1,3,.333,.333,0,0,.000,1,5,6,2,0,2,5,9,2,2013
Greivis Vasquez,PG,26,NOH,78,78,2685,438,1012,.433,83,243,.342,355,769,.462,.474,124,154,.805,43,294,337,704,66,6,247,190,1083,2013
Jan Vesely,PF,22,WAS,51,4,601,57,114,.500,0,1,.000,57,113,.504,.500,12,39,.308,43,79,122,28,15,17,27,107,126,2013
Charlie Villanueva,PF,28,DET,69,0,1092,175,464,.377,90,259,.347,85,205,.415,.474,27,49,.551,49,192,241,54,31,39,39,96,467,2013
Nikola Vucevic,C,22,ORL,77,77,2559,461,889,.519,0,3,.000,461,886,.520,.519,86,126,.683,273,644,917,143,61,79,141,218,1008,2013
Dwyane Wade,SG,31,MIA,69,69,2391,569,1093,.521,17,66,.258,552,1027,.537,.528,308,425,.725,86,258,344,352,128,56,194,140,1463,2013
Dion Waiters,SG,21,CLE,61,48,1756,336,815,.412,63,203,.310,273,612,.446,.451,159,213,.746,22,127,149,183,59,16,121,113,894,2013
Kemba Walker,PG,22,CHA,82,82,2859,526,1244,.423,107,332,.322,419,912,.459,.466,296,371,.798,60,223,283,471,160,31,200,153,1455,2013
John Wall,PG,22,WAS,49,42,1602,324,735,.441,12,45,.267,312,690,.452,.449,246,306,.804,35,161,196,373,65,37,157,117,906,2013
Gerald Wallace,SF,30,BRK,69,68,2076,182,458,.397,46,163,.282,136,295,.461,.448,121,190,.637,69,250,319,181,97,46,110,118,531,2013
Rasheed Wallace,C,38,NYK,21,0,296,55,142,.387,22,69,.319,33,73,.452,.465,14,20,.700,11,72,83,6,13,15,10,40,146,2013
Luke Walton,PF,32,CLE,50,0,857,71,181,.392,20,67,.299,51,114,.447,.448,10,20,.500,38,107,145,166,42,13,60,98,172,2013
Hakim Warrick,PF,30,TOT,28,14,489,67,165,.406,0,3,.000,67,162,.414,.406,60,88,.682,21,68,89,25,13,6,29,37,194,2013
Hakim Warrick,PF,30,NOH,1,0,7,1,2,.500,0,0,.000,1,2,.500,.500,2,2,1.000,0,0,0,0,1,0,0,0,4,2013
Hakim Warrick,PF,30,CHA,27,14,482,66,163,.405,0,3,.000,66,160,.413,.405,58,86,.674,21,68,89,25,12,6,29,37,190,2013
C.J. Watson,PG,28,BRK,80,8,1521,192,459,.418,88,214,.411,104,245,.424,.514,71,91,.780,38,107,145,161,66,12,69,123,543,2013
Earl Watson,PG,33,UTA,48,4,829,37,120,.308,5,28,.179,32,92,.348,.329,17,25,.680,23,64,87,190,40,8,69,94,96,2013
Maalik Wayns,PG,21,TOT,27,1,202,26,88,.295,7,31,.226,19,57,.333,.335,17,19,.895,1,6,7,27,6,0,15,26,76,2013
Maalik Wayns,PG,21,PHI,21,1,165,19,72,.264,5,25,.200,14,47,.298,.299,13,15,.867,1,4,5,20,3,0,13,18,56,2013
Maalik Wayns,PG,21,LAC,6,0,37,7,16,.438,2,6,.333,5,10,.500,.500,4,4,1.000,0,2,2,7,3,0,2,8,20,2013
Martell Webster,SF,26,WAS,76,62,2200,281,636,.442,139,329,.422,142,307,.463,.551,168,198,.848,53,241,294,143,49,17,90,166,869,2013
David West,PF,32,IND,73,73,2435,502,1009,.498,4,19,.211,498,990,.503,.500,242,315,.768,145,418,563,213,74,69,157,149,1250,2013
Russell Westbrook,PG,24,OKC,82,82,2861,673,1535,.438,97,300,.323,576,1235,.466,.470,460,575,.800,111,317,428,607,145,24,273,189,1903,2013
D.J. White,PF,26,BOS,12,0,86,12,23,.522,0,0,.000,12,23,.522,.522,5,9,.556,4,9,13,4,1,6,2,5,29,2013
James White,SF,30,NYK,57,16,435,50,116,.431,14,41,.341,36,75,.480,.491,11,19,.579,5,43,48,29,13,4,17,44,125,2013
Chris Wilcox,C,30,BOS,61,7,830,110,153,.719,0,1,.000,110,152,.724,.719,39,58,.672,55,125,180,22,32,28,34,125,259,2013
Damien Wilkins,SG,33,PHI,61,21,1095,145,316,.459,17,51,.333,128,265,.483,.486,81,109,.743,32,73,105,91,37,18,49,98,388,2013
Deron Williams,PG,28,BRK,78,78,2842,495,1124,.440,169,447,.378,326,677,.482,.516,317,369,.859,29,203,232,604,75,30,218,194,1476,2013
Derrick Williams,PF,21,MIN,78,56,1916,338,786,.430,65,196,.332,273,590,.463,.471,192,272,.706,96,334,430,46,44,37,101,127,933,2013
Lou Williams,SG,26,ATL,39,9,1119,187,443,.422,72,196,.367,115,247,.466,.503,105,121,.868,8,72,80,139,44,10,74,55,551,2013
Marvin Williams,SF,26,UTA,73,51,1727,199,470,.423,54,166,.325,145,304,.477,.481,77,99,.778,55,208,263,77,37,38,60,98,529,2013
Mo Williams,PG,30,UTA,46,46,1418,229,533,.430,59,154,.383,170,379,.449,.485,75,85,.882,24,86,110,285,46,9,125,105,592,2013
Reggie Williams,SF,26,CHA,40,0,380,57,132,.432,22,72,.306,35,60,.583,.515,10,21,.476,8,43,51,39,12,1,19,19,146,2013
Terrence Williams,SF,25,BOS,24,0,318,48,97,.495,5,15,.333,43,82,.524,.521,9,21,.429,4,40,44,38,11,2,22,13,110,2013
Metta World Peace,SF,33,LAL,75,66,2530,332,824,.403,141,412,.342,191,412,.464,.488,124,169,.734,101,271,372,112,122,42,98,198,929,2013
Brandan Wright,C,25,DAL,64,16,1149,241,404,.597,0,3,.000,241,401,.601,.597,59,96,.615,85,175,260,38,26,76,34,78,541,2013
Chris Wright,SG,23,DAL,3,0,4,1,2,.500,0,0,.000,1,2,.500,.500,0,0,.000,0,0,0,0,0,0,1,0,2,2013
Dorell Wright,SF,27,PHI,79,8,1783,237,599,.396,135,361,.374,102,238,.429,.508,120,141,.851,42,260,302,150,62,35,64,98,729,2013
Tony Wroten,SG,19,MEM,35,0,272,33,86,.384,4,16,.250,29,70,.414,.407,21,29,.724,13,15,28,43,8,4,29,34,91,2013
Nick Young,SG,27,PHI,59,17,1411,224,542,.413,75,210,.357,149,332,.449,.482,105,128,.820,24,106,130,84,36,14,50,84,628,2013
Sam Young,SG,27,IND,56,3,693,58,148,.392,16,52,.308,42,96,.438,.446,23,43,.535,26,97,123,42,15,8,33,62,155,2013
Thaddeus Young,PF,24,PHI,76,76,2629,509,958,.531,1,8,.125,508,950,.535,.532,108,188,.574,182,389,571,125,133,55,90,191,1127,2013
Luke Zeller,C,25,PHO,16,0,58,9,26,.346,1,5,.200,8,21,.381,.365,0,0,.000,1,9,10,3,0,0,0,5,19,2013
Tyler Zeller,C,23,CLE,77,55,2033,245,559,.438,0,4,.000,245,555,.441,.438,120,157,.764,159,279,438,96,35,70,95,251,610,2013
Jeff Adrien,PF,25,HOU,8,0,63,7,16,.438,0,0,.000,7,16,.438,.438,7,12,.583,5,17,22,1,0,2,2,13,21,2012
Arron Afflalo,SG,26,DEN,62,62,2086,329,699,.471,88,221,.398,241,478,.504,.534,197,247,.798,40,157,197,149,36,13,85,134,943,2012
Blake Ahearn,PG,27,UTA,4,0,30,4,14,.286,2,9,.222,2,5,.400,.357,0,0,.000,0,2,2,1,0,0,5,4,10,2012
Solomon Alabi,C,23,TOR,14,0,122,13,36,.361,0,0,.000,13,36,.361,.361,7,8,.875,15,32,47,3,2,9,5,11,33,2012
Cole Aldrich,C,23,OKC,26,0,173,22,42,.524,0,0,.000,22,42,.524,.524,13,14,.929,13,35,48,3,8,16,9,22,57,2012
LaMarcus Aldridge,PF,26,POR,55,55,1994,483,943,.512,2,11,.182,481,932,.516,.513,223,274,.814,150,292,442,134,51,45,111,153,1191,2012
Lavoy Allen,PF,22,PHI,41,15,624,79,167,.473,0,0,.000,79,167,.473,.473,11,14,.786,47,124,171,34,13,18,20,73,169,2012
Ray Allen,SG,36,BOS,46,42,1565,226,493,.458,106,234,.453,120,259,.463,.566,97,106,.915,14,128,142,109,49,8,68,83,655,2012
Tony Allen,SG,30,MEM,58,57,1525,210,448,.469,8,26,.308,202,422,.479,.478,140,175,.800,98,135,233,79,104,33,94,142,568,2012
Morris Almond,SG,26,WAS,4,0,67,6,17,.353,1,3,.333,5,14,.357,.382,1,3,.333,1,7,8,2,7,0,1,6,14,2012
Al-Farouq Aminu,SF,21,NOH,66,21,1477,150,365,.411,13,47,.277,137,318,.431,.429,86,114,.754,95,213,308,66,59,34,91,136,399,2012
Lou Amundson,PF,29,IND,60,0,753,89,207,.430,0,0,.000,89,207,.430,.430,35,82,.427,94,128,222,14,27,44,45,125,213,2012
Chris Andersen,C,33,DEN,32,1,486,59,108,.546,0,0,.000,59,108,.546,.546,50,82,.610,48,100,148,6,19,46,17,52,168,2012
Alan Anderson,SF,29,TOR,17,12,461,55,142,.387,24,61,.393,31,81,.383,.472,29,34,.853,8,26,34,26,5,3,25,35,163,2012
James Anderson,SG,22,SAS,51,2,603,66,174,.379,19,68,.279,47,106,.443,.434,39,52,.750,16,63,79,41,8,2,30,35,190,2012
Ryan Anderson,PF,23,ORL,61,61,1964,332,757,.439,166,422,.393,166,335,.496,.548,150,171,.877,224,247,471,54,50,26,57,146,980,2012
Carmelo Anthony,SF,27,NYK,55,55,1876,441,1025,.430,68,203,.335,373,822,.454,.463,295,367,.804,88,256,344,200,62,24,144,156,1245,2012
Joel Anthony,C,29,MIA,64,51,1349,85,152,.559,0,0,.000,85,152,.559,.559,49,71,.690,100,150,250,9,36,84,45,126,219,2012
Gilbert Arenas,PG,30,MEM,17,0,211,26,64,.406,13,39,.333,13,25,.520,.508,7,10,.700,2,16,18,18,11,1,12,35,72,2012
Trevor Ariza,SF,26,NOH,41,41,1350,168,403,.417,29,87,.333,139,316,.440,.453,79,102,.775,41,174,215,135,69,25,76,73,444,2012
Omer Asik,C,25,CHI,66,2,971,79,156,.506,0,0,.000,79,156,.506,.506,47,103,.456,127,223,350,32,30,68,68,121,205,2012
D.J. Augustin,PG,24,CHA,48,46,1408,183,487,.376,61,179,.341,122,308,.396,.438,105,120,.875,24,85,109,307,36,1,110,65,532,2012
Gustavo Ayon,PF,26,NOH,54,24,1088,140,261,.536,0,1,.000,140,260,.538,.536,39,63,.619,86,179,265,74,53,46,46,118,319,2012
Jeff Ayres,C,24,IND,20,1,106,15,36,.417,0,0,.000,15,36,.417,.417,4,7,.571,12,21,33,4,3,2,2,16,34,2012
Kelenna Azubuike,SG,28,DAL,3,0,18,3,8,.375,1,3,.333,2,5,.400,.438,0,0,.000,0,0,0,0,1,0,4,1,7,2012
Luke Babbitt,SF,22,POR,40,4,537,71,173,.410,43,100,.430,28,73,.384,.535,17,20,.850,16,79,95,16,10,4,27,46,202,2012
Renaldo Balkman,SF,27,NYK,14,0,115,16,32,.500,2,9,.222,14,23,.609,.531,8,11,.727,6,20,26,5,4,3,6,14,42,2012
Leandro Barbosa,SG,29,TOT,64,0,1382,271,637,.425,65,170,.382,206,467,.441,.476,101,124,.815,33,95,128,96,56,7,94,135,708,2012
Leandro Barbosa,SG,29,TOR,42,0,946,198,454,.436,40,111,.360,158,343,.461,.480,76,91,.835,21,58,79,63,36,7,68,101,512,2012
Leandro Barbosa,SG,29,IND,22,0,436,73,183,.399,25,59,.424,48,124,.387,.467,25,33,.758,12,37,49,33,20,0,26,34,196,2012
J.J. Barea,PG,27,MIN,41,11,1032,167,418,.400,53,143,.371,114,275,.415,.463,76,98,.776,14,100,114,232,21,0,103,61,463,2012
Andrea Bargnani,C,26,TOR,31,31,1032,209,484,.432,34,115,.296,175,369,.474,.467,151,173,.873,24,148,172,61,18,15,69,52,603,2012
Matt Barnes,SF,31,LAL,63,16,1440,175,387,.452,46,138,.333,129,249,.518,.512,95,128,.742,97,247,344,126,35,48,73,152,491,2012
Earl Barron,C,30,GSW,2,0,9,2,4,.500,0,0,.000,2,4,.500,.500,0,0,.000,1,0,1,0,0,0,0,5,4,2012
Brandon Bass,PF,26,BOS,59,39,1868,303,632,.479,0,0,.000,303,632,.479,.479,132,163,.810,95,270,365,55,34,54,65,135,738,2012
Tony Battie,C,35,PHI,27,11,295,19,51,.373,0,1,.000,19,50,.380,.373,4,4,1.000,8,59,67,16,4,6,4,26,42,2012
Shane Battier,SF,33,MIA,65,10,1499,113,292,.387,62,183,.339,51,109,.468,.493,23,37,.622,56,100,156,82,64,33,37,105,311,2012
Nicolas Batum,SF,23,POR,59,34,1791,289,641,.451,107,274,.391,182,367,.496,.534,133,159,.836,81,190,271,84,57,60,90,105,818,2012
Jerryd Bayless,PG,23,TOR,31,11,705,117,276,.424,44,104,.423,73,172,.424,.504,75,88,.852,8,58,66,118,24,4,53,70,353,2012
Michael Beasley,SF,23,MIN,47,7,1087,221,497,.445,38,101,.376,183,396,.462,.483,61,95,.642,39,168,207,45,18,19,80,83,541,2012
Rodrigue Beaubois,PG,23,DAL,53,12,1151,188,445,.422,38,132,.288,150,313,.479,.465,58,69,.841,19,132,151,152,56,28,70,98,472,2012
Marco Belinelli,SG,25,NOH,66,55,1966,286,686,.417,107,284,.377,179,402,.445,.495,101,129,.783,19,153,172,101,48,5,69,115,780,2012
Raja Bell,SG,35,UTA,34,33,796,81,174,.466,34,87,.391,47,87,.540,.563,21,25,.840,6,43,49,38,13,2,21,78,217,2012
Keith Benson,C,23,GSW,3,0,9,0,1,.000,0,0,.000,0,1,.000,.000,0,0,.000,2,1,3,0,0,0,0,0,0,2012
Mike Bibby,PG,33,NYK,39,4,557,35,124,.282,27,85,.318,8,39,.205,.391,6,8,.750,5,54,59,80,21,3,20,45,103,2012
Andris Biedrins,C,25,GSW,47,35,739,39,64,.609,0,0,.000,39,64,.609,.609,1,9,.111,45,131,176,16,23,45,14,125,79,2012
Chauncey Billups,SG,35,LAC,20,20,607,83,228,.364,48,125,.384,35,103,.340,.469,85,95,.895,4,46,50,80,9,3,38,40,299,2012
Bismack Biyombo,C,19,CHA,63,41,1455,129,278,.464,0,0,.000,129,278,.464,.464,69,143,.483,113,255,368,27,20,115,71,145,327,2012
DeJuan Blair,PF,22,SAS,64,62,1363,269,504,.534,0,1,.000,269,503,.535,.534,73,119,.613,154,197,351,78,59,12,92,168,611,2012
Steve Blake,PG,31,LAL,53,5,1237,101,268,.377,53,158,.335,48,110,.436,.476,21,27,.778,9,76,85,175,39,2,72,75,276,2012
Andray Blatche,PF,25,WAS,26,13,626,93,245,.380,2,7,.286,91,238,.382,.384,33,49,.673,42,108,150,28,20,17,37,54,221,2012
Eric Bledsoe,PG,22,LAC,40,1,464,49,126,.389,6,30,.200,43,96,.448,.413,28,44,.636,22,43,65,66,31,14,47,58,132,2012
Keith Bogans,SF,31,NJN,5,1,94,8,21,.381,3,12,.250,5,9,.556,.452,2,5,.400,5,6,11,3,2,0,3,15,21,2012
Andrew Bogut,C,27,MIL,12,12,364,61,136,.449,0,1,.000,61,135,.452,.449,14,23,.609,22,78,100,31,12,24,24,36,136,2012
Matt Bonner,PF,31,SAS,65,2,1326,154,350,.440,105,250,.420,49,100,.490,.590,16,21,.762,29,185,214,61,15,21,14,68,429,2012
Trevor Booker,PF,24,WAS,50,32,1261,181,341,.531,1,2,.500,180,339,.531,.532,56,93,.602,119,206,325,40,48,43,58,138,419,2012
Carlos Boozer,PF,30,CHI,66,66,1948,448,842,.532,0,1,.000,448,841,.533,.532,95,137,.693,114,450,564,125,63,24,115,168,991,2012
Chris Bosh,PF,27,MIA,57,57,2007,393,807,.487,10,35,.286,383,772,.496,.493,229,279,.821,94,358,452,103,51,45,117,128,1025,2012
Earl Boykins,PG,35,HOU,8,0,111,12,36,.333,2,9,.222,10,27,.370,.361,13,15,.867,0,11,11,17,1,0,7,5,39,2012
Craig Brackins,PF,24,PHI,14,1,88,9,33,.273,3,9,.333,6,24,.250,.318,1,2,.500,5,10,15,8,0,1,4,6,22,2012
Avery Bradley,PG,21,BOS,64,28,1368,200,402,.498,22,54,.407,178,348,.511,.525,62,78,.795,34,81,115,87,43,12,75,109,484,2012
Elton Brand,C,32,PHI,60,60,1732,287,581,.494,0,1,.000,287,580,.495,.494,85,116,.733,145,284,429,97,58,97,65,176,659,2012
Corey Brewer,SF,25,DEN,59,17,1287,201,463,.434,33,127,.260,168,336,.500,.470,90,130,.692,43,107,150,88,72,17,56,113,525,2012
Ronnie Brewer,SG,26,CHI,66,43,1635,190,445,.427,19,69,.275,171,376,.455,.448,56,100,.560,72,159,231,137,72,21,59,64,455,2012
Jon Brockman,PF,24,MIL,35,0,239,15,45,.333,0,1,.000,15,44,.341,.333,7,15,.467,33,42,75,9,4,1,10,33,37,2012
MarShon Brooks,SG,23,NJN,56,47,1648,274,640,.428,47,150,.313,227,490,.463,.465,113,148,.764,70,130,200,131,52,15,118,116,708,2012
Derrick Brown,SF,24,CHA,65,17,1443,212,409,.518,6,24,.250,206,385,.535,.526,94,141,.667,95,141,236,67,48,12,55,96,524,2012
Kwame Brown,C,29,GSW,9,3,187,21,40,.525,0,0,.000,21,40,.525,.525,15,34,.441,16,41,57,4,8,0,14,21,57,2012
Shannon Brown,SG,26,PHO,59,19,1400,251,598,.420,68,188,.362,183,410,.446,.477,80,99,.808,38,119,157,69,44,15,64,66,650,2012
Kobe Bryant,SG,33,LAL,58,58,2232,574,1336,.430,87,287,.303,487,1049,.464,.462,381,451,.845,66,247,313,264,69,18,204,105,1616,2012
Chase Budinger,SF,23,HOU,58,9,1298,208,471,.442,88,219,.402,120,252,.476,.535,54,70,.771,38,179,217,74,29,7,55,65,558,2012
Alec Burks,SG,20,UTA,59,0,939,153,357,.429,15,45,.333,138,312,.442,.450,104,143,.727,57,75,132,55,27,5,51,84,425,2012
Caron Butler,SF,31,LAC,63,63,1871,287,705,.407,92,257,.358,195,448,.435,.472,87,107,.813,44,186,230,78,52,9,77,123,753,2012
Jimmy Butler,SG,22,CHI,42,0,359,32,79,.405,2,11,.182,30,68,.441,.418,43,56,.768,23,33,56,14,11,5,14,20,109,2012
Rasual Butler,SF,32,TOR,34,14,453,41,133,.308,21,77,.273,20,56,.357,.387,7,12,.583,6,60,66,19,7,5,15,39,110,2012
Derrick Byars,PF,27,SAS,2,0,37,3,11,.273,0,6,.000,3,5,.600,.273,4,4,1.000,6,5,11,1,2,0,0,2,10,2012
Andrew Bynum,C,24,LAL,60,60,2112,444,796,.558,1,5,.200,443,791,.560,.558,234,338,.692,192,517,709,85,27,116,152,104,1123,2012
Will Bynum,PG,29,DET,36,0,514,74,194,.381,7,29,.241,67,165,.406,.399,49,64,.766,10,46,56,66,23,3,54,61,204,2012
Jose Calderon,PG,30,TOR,53,53,1799,218,477,.457,59,159,.371,159,318,.500,.519,60,68,.882,19,141,160,468,47,3,104,94,555,2012
Marcus Camby,C,37,TOT,59,53,1352,128,287,.446,2,5,.400,126,282,.447,.449,29,64,.453,157,373,530,107,50,85,57,126,287,2012
Marcus Camby,C,37,POR,40,40,894,67,161,.416,0,0,.000,67,161,.416,.416,18,38,.474,105,249,354,75,33,56,47,88,152,2012
Marcus Camby,C,37,HOU,19,13,458,61,126,.484,2,5,.400,59,121,.488,.492,11,26,.423,52,124,176,32,17,29,10,38,135,2012
Brian Cardinal,SF,34,DAL,44,0,277,14,55,.255,10,49,.204,4,6,.667,.345,5,6,.833,4,30,34,16,8,2,8,38,43,2012
DeMarre Carroll,SF-PF,25,TOT,24,9,348,43,105,.410,7,19,.368,36,86,.419,.443,14,16,.875,28,25,53,18,12,1,11,37,107,2012
DeMarre Carroll,PF,25,DEN,4,0,21,6,6,1.000,0,0,.000,6,6,1.000,1.000,0,0,.000,0,3,3,3,0,0,2,1,12,2012
DeMarre Carroll,SF,25,UTA,20,9,327,37,99,.374,7,19,.368,30,80,.375,.409,14,16,.875,28,22,50,15,12,1,9,36,95,2012
Matt Carroll,SG,31,CHA,53,2,596,52,157,.331,8,43,.186,44,114,.386,.357,30,38,.789,8,50,58,38,16,7,24,52,142,2012
Anthony Carter,PG,36,TOR,24,0,209,17,53,.321,5,17,.294,12,36,.333,.368,8,10,.800,5,28,33,34,8,4,17,20,47,2012
Vince Carter,SG,35,DAL,61,40,1542,223,542,.411,74,205,.361,149,337,.442,.480,95,115,.826,32,173,205,139,56,25,84,134,615,2012
Omri Casspi,SF,23,CLE,65,35,1341,166,412,.403,53,168,.315,113,244,.463,.467,74,108,.685,63,165,228,66,37,21,64,115,459,2012
Mario Chalmers,PG,25,MIA,64,64,1825,223,498,.448,101,260,.388,122,238,.513,.549,80,101,.792,16,155,171,222,97,11,142,166,627,2012
Tyson Chandler,C,29,NYK,62,62,2061,241,355,.679,0,2,.000,241,353,.683,.679,217,315,.689,212,400,612,56,56,89,102,186,699,2012
Wilson Chandler,SF,24,DEN,8,6,215,31,79,.392,3,12,.250,28,67,.418,.411,10,12,.833,6,35,41,17,6,6,18,18,75,2012
Josh Childress,SF,28,PHO,34,0,491,48,99,.485,4,24,.167,44,75,.587,.505,0,2,.000,31,64,95,34,14,6,9,38,100,2012
Earl Clark,PF,24,ORL,45,1,559,51,139,.367,0,0,.000,51,139,.367,.367,21,29,.724,35,89,124,18,12,32,25,72,123,2012
Norris Cole,PG,23,MIA,65,2,1260,177,450,.393,21,76,.276,156,374,.417,.417,66,85,.776,21,70,91,133,44,2,105,124,441,2012
Jason Collins,C,33,ATL,30,10,308,16,40,.400,0,0,.000,16,40,.400,.400,7,15,.467,12,36,48,10,4,3,10,34,39,2012
Darren Collison,PG,24,IND,60,56,1878,230,523,.440,34,94,.362,196,429,.457,.472,127,153,.830,30,157,187,287,49,14,114,101,621,2012
Nick Collison,PF,31,OKC,63,0,1307,120,201,.597,0,1,.000,120,200,.600,.597,44,62,.710,119,155,274,82,33,28,61,153,284,2012
Mike Conley,PG,24,MEM,62,61,2174,296,684,.433,60,159,.377,236,525,.450,.477,136,158,.861,22,134,156,404,136,11,125,133,788,2012
Brian Cook,PF,31,TOT,32,0,276,31,98,.316,10,50,.200,21,48,.438,.367,9,10,.900,10,53,63,10,6,5,11,48,81,2012
Brian Cook,PF,31,LAC,16,0,121,11,49,.224,5,27,.185,6,22,.273,.276,4,4,1.000,4,19,23,2,2,4,4,26,31,2012
Brian Cook,PF,31,WAS,16,0,155,20,49,.408,5,23,.217,15,26,.577,.459,5,6,.833,6,34,40,8,4,1,7,22,50,2012
Daequan Cook,SG,24,OKC,57,22,989,109,296,.368,79,228,.346,30,68,.441,.502,14,22,.636,12,110,122,15,22,11,16,69,311,2012
DeMarcus Cousins,C,21,SAC,64,62,1950,448,999,.448,2,14,.143,446,985,.453,.449,262,373,.702,265,438,703,102,93,75,170,257,1160,2012
Jamal Crawford,PG,31,POR,60,6,1613,283,737,.384,80,260,.308,203,477,.426,.438,191,206,.927,16,102,118,191,55,14,111,74,837,2012
Jordan Crawford,SG,23,WAS,64,32,1753,349,872,.400,79,273,.289,270,599,.451,.446,161,203,.793,44,124,168,190,59,5,141,111,938,2012
Dante Cunningham,PF,24,MEM,64,5,1124,144,279,.516,0,2,.000,144,277,.520,.516,45,69,.652,91,155,246,37,42,34,29,98,333,2012
Eddy Curry,C,29,MIA,14,1,83,12,26,.462,0,0,.000,12,26,.462,.462,6,8,.750,4,8,12,1,0,2,10,17,30,2012
Stephen Curry,PG,23,GSW,26,23,732,145,296,.490,55,121,.455,90,175,.514,.583,38,47,.809,15,73,88,138,39,8,65,62,383,2012
Samuel Dalembert,C,30,HOU,65,45,1446,200,395,.506,0,1,.000,200,394,.508,.506,90,113,.796,158,298,456,33,37,111,82,162,490,2012
Erick Dampier,C,36,ATL,15,0,83,1,8,.125,0,0,.000,1,8,.125,.125,0,0,.000,10,15,25,4,1,4,3,9,2,2012
Marquis Daniels,SG,31,BOS,38,0,484,52,143,.364,0,10,.000,52,133,.391,.364,17,23,.739,16,50,66,47,21,9,28,36,121,2012
Baron Davis,PG,32,NYK,29,14,595,68,184,.370,26,85,.306,42,99,.424,.440,16,24,.667,13,43,56,135,34,3,76,61,178,2012
Ed Davis,PF,22,TOR,66,9,1534,172,335,.513,0,1,.000,172,334,.515,.513,71,106,.670,134,304,438,60,40,63,67,156,415,2012
Glen Davis,PF,26,ORL,61,13,1427,225,534,.421,2,14,.143,223,520,.429,.423,114,167,.683,107,224,331,47,43,19,75,106,566,2012
Josh Davis,PF,31,MEM,15,0,130,10,27,.370,4,13,.308,6,14,.429,.444,4,8,.500,16,11,27,6,7,1,3,19,28,2012
Eric Dawson,C,27,SAS,4,0,39,7,12,.583,0,0,.000,7,12,.583,.583,1,2,.500,5,5,10,0,1,2,3,6,15,2012
Austin Daye,SF,23,DET,41,4,603,73,227,.322,13,62,.210,60,165,.364,.350,35,43,.814,14,77,91,33,22,21,40,62,194,2012
Carlos Delfino,SF,29,MIL,54,53,1537,182,453,.402,86,239,.360,96,214,.449,.497,38,48,.792,20,188,208,123,79,10,66,99,488,2012
Luol Deng,SF,26,CHI,54,54,2129,311,755,.412,79,215,.367,232,540,.430,.464,127,165,.770,77,273,350,157,56,36,96,81,828,2012
Justin Dentmon,PG,26,TOT,6,0,91,10,28,.357,2,14,.143,8,14,.571,.393,4,6,.667,0,8,8,10,2,0,7,10,26,2012
Justin Dentmon,PG,26,SAS,2,0,19,2,6,.333,0,4,.000,2,2,1.000,.333,0,0,.000,0,1,1,1,1,0,1,2,4,2012
Justin Dentmon,PG,26,TOR,4,0,72,8,22,.364,2,10,.200,6,12,.500,.409,4,6,.667,0,7,7,9,1,0,6,8,22,2012
DeMar DeRozan,SG,22,TOR,63,63,2206,381,903,.422,24,92,.261,357,811,.440,.435,268,331,.810,40,171,211,128,48,17,123,162,1054,2012
Boris Diaw,PF,29,TOT,57,35,1424,156,351,.444,31,99,.313,125,252,.496,.489,22,35,.629,70,210,280,205,34,25,112,125,365,2012
Boris Diaw,PF,29,CHA,37,28,1018,116,283,.410,23,86,.267,93,197,.472,.451,17,27,.630,47,148,195,158,20,19,84,71,272,2012
Boris Diaw,PF,29,SAS,20,7,406,40,68,.588,8,13,.615,32,55,.582,.647,5,8,.625,23,62,85,47,14,6,28,54,93,2012
Ike Diogu,PF,28,SAS,2,0,14,0,2,.000,0,0,.000,0,2,.000,.000,2,2,1.000,0,1,1,0,0,0,1,1,2,2012
DeSagana Diop,C,30,CHA,27,9,325,15,42,.357,0,0,.000,15,42,.357,.357,1,6,.167,33,52,85,23,6,13,19,36,31,2012
Keyon Dooling,SG,31,BOS,46,2,662,66,163,.405,27,81,.333,39,82,.476,.488,23,31,.742,3,36,39,51,13,2,34,57,182,2012
Toney Douglas,PG,25,NYK,38,9,656,94,290,.324,27,117,.231,67,173,.387,.371,22,26,.846,16,56,72,77,29,1,56,55,237,2012
Goran Dragic,PG,25,HOU,66,28,1752,277,600,.462,68,202,.337,209,398,.525,.518,153,190,.805,53,115,168,351,85,10,157,166,775,2012
Jared Dudley,SG,26,PHO,65,60,2020,312,643,.485,80,209,.383,232,434,.535,.547,119,164,.726,95,206,301,112,49,19,72,107,823,2012
Chris Duhon,PG,29,ORL,63,9,1226,85,203,.419,50,119,.420,35,84,.417,.542,17,21,.810,14,88,102,151,35,9,81,71,237,2012
Tim Duncan,C,35,SAS,58,58,1634,361,733,.492,0,4,.000,361,729,.495,.492,173,249,.695,110,410,520,132,38,88,97,98,895,2012
Mike Dunleavy,SF,31,MIL,55,3,1445,239,504,.474,83,208,.399,156,296,.527,.557,116,143,.811,29,175,204,117,28,8,58,87,677,2012
Kevin Durant,SF,23,OKC,66,66,2546,643,1297,.496,133,344,.387,510,953,.535,.547,431,501,.860,40,487,527,231,88,77,248,133,1850,2012
Jerome Dyson,PG,24,NOH,9,1,180,19,48,.396,1,8,.125,18,40,.450,.406,28,36,.778,2,17,19,18,11,2,20,19,67,2012
Devin Ebanks,SG,22,LAL,24,12,396,37,89,.416,0,9,.000,37,80,.463,.416,23,35,.657,26,28,54,12,11,6,18,26,97,2012
Wayne Ellington,SG,24,MIN,51,4,973,122,302,.404,35,108,.324,87,194,.448,.462,32,40,.800,14,85,99,33,26,10,26,56,311,2012
Monta Ellis,SG,26,TOT,58,58,2120,450,1040,.433,62,201,.308,388,839,.462,.463,219,275,.796,20,180,200,346,85,18,177,136,1181,2012
Monta Ellis,SG,26,GSW,37,37,1365,305,704,.433,50,156,.321,255,548,.465,.469,151,186,.812,16,111,127,223,56,12,123,84,811,2012
Monta Ellis,SG,26,MIL,21,21,755,145,336,.432,12,45,.267,133,291,.457,.449,68,89,.764,4,69,73,123,29,6,54,52,370,2012
Francisco Elson,C,35,PHI,5,0,16,1,3,.333,0,0,.000,1,3,.333,.333,0,0,.000,0,1,1,1,1,1,1,0,2,2012
Andre Emmett,SF,29,NJN,6,0,45,4,7,.571,0,1,.000,4,6,.667,.571,5,8,.625,2,4,6,1,2,1,2,2,13,2012
Semih Erden,C,25,CLE,28,9,333,39,74,.527,0,0,.000,39,74,.527,.527,21,41,.512,20,52,72,9,10,5,16,60,99,2012
Jeremy Evans,SF,24,UTA,29,0,217,27,42,.643,0,1,.000,27,41,.659,.643,8,16,.500,19,31,50,13,6,24,5,23,62,2012
Maurice Evans,SF,33,WAS,24,0,343,45,112,.402,17,45,.378,28,67,.418,.478,10,13,.769,8,16,24,9,14,0,10,36,117,2012
Reggie Evans,PF,31,LAC,56,0,771,34,72,.472,0,0,.000,34,72,.472,.472,36,71,.507,100,171,271,17,31,6,44,118,104,2012
Tyreke Evans,SG,22,SAC,63,61,2162,408,900,.453,20,99,.202,388,801,.484,.464,201,258,.779,64,225,289,283,84,29,171,136,1037,2012
Christian Eyenga,SF,22,TOT,7,0,102,6,25,.240,1,3,.333,5,22,.227,.260,4,8,.500,4,10,14,5,3,5,3,7,17,2012
Christian Eyenga,SF,22,CLE,6,0,83,3,19,.158,1,2,.500,2,17,.118,.184,2,6,.333,3,9,12,4,3,4,2,7,9,2012
Christian Eyenga,SF,22,LAL,1,0,19,3,6,.500,0,1,.000,3,5,.600,.500,2,2,1.000,1,1,2,1,0,1,1,0,8,2012
Kenneth Faried,PF,22,DEN,46,39,1037,181,309,.586,0,0,.000,181,309,.586,.586,109,164,.665,142,210,352,36,34,47,54,116,471,2012
Jordan Farmar,PG,25,NJN,39,5,831,147,315,.467,55,125,.440,92,190,.484,.554,57,63,.905,7,54,61,129,24,2,68,49,406,2012
Derrick Favors,PF,20,UTA,65,9,1376,222,445,.499,0,0,.000,222,445,.499,.499,126,194,.649,158,267,425,43,38,65,103,145,570,2012
Raymond Felton,PG,27,POR,60,56,1906,261,642,.407,62,203,.305,199,439,.453,.455,100,124,.806,27,122,149,390,78,10,170,122,684,2012
Rudy Fernandez,SG,26,DEN,31,1,710,99,225,.440,40,122,.328,59,103,.573,.529,30,43,.698,9,56,65,75,31,3,40,37,268,2012
Kyrylo Fesenko,C,25,IND,3,0,17,2,5,.400,0,0,.000,2,5,.400,.400,4,6,.667,2,7,9,1,2,0,0,2,8,2012
Landry Fields,SG,23,NYK,66,62,1894,236,513,.460,31,121,.256,205,392,.523,.490,77,137,.562,59,219,278,169,79,17,102,99,580,2012
Derek Fisher,PG,37,TOT,63,43,1508,129,348,.371,35,109,.321,94,239,.393,.421,57,67,.851,12,109,121,170,51,4,73,117,350,2012
Derek Fisher,PG,37,LAL,43,43,1101,92,240,.383,24,74,.324,68,166,.410,.433,44,53,.830,10,82,92,142,40,3,58,85,252,2012
Derek Fisher,PG,37,OKC,20,0,407,37,108,.343,11,35,.314,26,73,.356,.394,13,14,.929,2,27,29,28,11,1,15,32,98,2012
Jonny Flynn,PG,22,TOT,29,1,416,46,131,.351,10,34,.294,36,97,.371,.389,29,39,.744,8,31,39,96,6,2,36,23,131,2012
Jonny Flynn,PG,22,HOU,11,0,135,12,41,.293,2,9,.222,10,32,.313,.317,11,14,.786,1,7,8,28,3,1,9,8,37,2012
Jonny Flynn,PG,22,POR,18,1,281,34,90,.378,8,25,.320,26,65,.400,.422,18,25,.720,7,24,31,68,3,1,27,15,94,2012
Jeff Foote,C,24,NOH,4,0,39,2,6,.333,0,0,.000,2,6,.333,.333,0,0,.000,1,5,6,0,0,1,2,5,4,2012
Gary Forbes,SG,26,TOR,48,2,713,112,271,.413,29,83,.349,83,188,.441,.467,66,91,.725,27,75,102,54,24,4,54,56,319,2012
T.J. Ford,PG,28,SAS,14,0,191,19,43,.442,2,8,.250,17,35,.486,.465,11,14,.786,3,15,18,45,9,2,23,23,51,2012
Courtney Fortson,PG,23,TOT,10,0,95,11,32,.344,3,13,.231,8,19,.421,.391,10,15,.667,6,9,15,10,3,0,10,5,35,2012
Courtney Fortson,PG,23,LAC,4,0,46,5,12,.417,1,4,.250,4,8,.500,.458,6,9,.667,4,4,8,5,0,0,5,3,17,2012
Courtney Fortson,PG,23,HOU,6,0,49,6,20,.300,2,9,.222,4,11,.364,.350,4,6,.667,2,5,7,5,3,0,5,2,18,2012
Jeff Foster,C,35,IND,11,0,141,9,18,.500,1,1,1.000,8,17,.471,.528,6,9,.667,18,24,42,4,8,1,7,26,25,2012
Randy Foye,SG,28,LAC,65,48,1682,256,644,.398,127,329,.386,129,315,.410,.496,73,85,.859,25,113,138,146,46,24,73,130,712,2012
Jimmer Fredette,PG,22,SAC,61,7,1135,172,446,.386,78,216,.361,94,230,.409,.473,40,48,.833,17,56,73,108,30,3,67,73,462,2012
Channing Frye,PF,28,PHO,64,59,1669,255,613,.416,91,263,.346,164,350,.469,.490,73,82,.890,71,308,379,88,42,70,63,176,674,2012
Dan Gadzuric,C,33,NYK,2,0,13,0,2,.000,0,0,.000,0,2,.000,.000,0,2,.000,1,4,5,0,1,1,1,4,0,2012
Sundiata Gaines,SG,25,NJN,57,12,793,102,271,.376,28,82,.341,74,189,.392,.428,59,96,.615,27,81,108,126,55,2,52,58,291,2012
Danilo Gallinari,SF,23,DEN,43,40,1351,193,466,.414,60,183,.328,133,283,.470,.479,182,209,.871,28,174,202,116,42,23,68,86,628,2012
Francisco Garcia,SF,30,SAC,49,3,798,86,229,.376,38,131,.290,48,98,.490,.459,24,30,.800,11,88,99,31,36,37,22,73,234,2012
Kevin Garnett,C,35,BOS,60,60,1864,391,777,.503,3,9,.333,388,768,.505,.505,162,189,.857,66,428,494,175,56,61,107,141,947,2012
Marc Gasol,C,27,MEM,65,65,2370,357,740,.482,1,12,.083,356,728,.489,.483,237,317,.748,120,459,579,204,62,121,121,201,952,2012
Pau Gasol,PF,31,LAL,65,65,2430,459,917,.501,7,27,.259,452,890,.508,.504,204,261,.782,183,495,678,237,37,88,142,127,1129,2012
Rudy Gay,SF,25,MEM,65,65,2422,485,1067,.455,54,173,.312,431,894,.482,.480,208,263,.791,130,287,417,147,95,55,161,138,1232,2012
Alonzo Gee,SG,24,CLE,63,31,1827,227,551,.412,44,137,.321,183,414,.442,.452,167,212,.788,101,221,322,113,83,17,114,149,665,2012
Paul George,SG,21,IND,66,66,1958,281,639,.440,90,234,.385,191,405,.472,.510,146,182,.802,56,314,370,158,108,38,117,191,798,2012
Daniel Gibson,SG,25,CLE,35,7,916,87,248,.351,55,139,.396,32,109,.294,.462,34,43,.791,11,90,101,76,26,16,45,69,263,2012
Taj Gibson,PF,26,CHI,63,0,1284,200,404,.495,0,0,.000,200,404,.495,.495,84,135,.622,135,197,332,47,27,81,60,131,484,2012
Manu Ginobili,SG,34,SAS,34,7,792,150,285,.526,52,126,.413,98,159,.616,.618,88,101,.871,18,98,116,151,24,12,64,56,440,2012
Mickell Gladness,PF,25,TOT,26,7,252,25,59,.424,0,0,.000,25,59,.424,.424,6,12,.500,14,44,58,5,4,20,7,32,56,2012
Mickell Gladness,PF,25,MIA,8,0,28,1,3,.333,0,0,.000,1,3,.333,.333,0,0,.000,1,10,11,2,1,1,3,8,2,2012
Mickell Gladness,PF,25,GSW,18,7,224,24,56,.429,0,0,.000,24,56,.429,.429,6,12,.500,13,34,47,3,3,19,4,24,54,2012
Ryan Gomes,SF,29,LAC,32,2,425,31,95,.326,4,29,.138,27,66,.409,.347,8,11,.727,14,47,61,12,16,0,15,34,74,2012
Drew Gooden,C,30,MIL,56,46,1469,287,657,.437,16,55,.291,271,602,.450,.449,176,208,.846,130,233,363,144,46,34,109,112,766,2012
Ben Gordon,SG,28,DET,52,21,1398,234,530,.442,63,147,.429,171,383,.446,.501,117,136,.860,14,107,121,127,34,11,115,114,648,2012
Eric Gordon,PG,23,NOH,9,9,310,63,140,.450,10,40,.250,53,100,.530,.486,49,65,.754,2,23,25,31,13,4,24,20,185,2012
Marcin Gortat,C,27,PHO,66,66,2114,427,769,.555,0,2,.000,427,767,.557,.555,163,251,.649,185,474,659,59,48,99,90,142,1017,2012
Andrew Goudelock,SG,23,LAL,40,0,419,68,174,.391,28,75,.373,40,99,.404,.471,11,12,.917,5,26,31,20,4,0,21,32,175,2012
Danny Granger,SF,28,IND,62,62,2062,391,941,.416,123,323,.381,268,618,.434,.481,254,291,.873,79,228,307,109,62,40,110,144,1159,2012
Aaron Gray,C,27,TOR,49,40,813,83,161,.516,0,0,.000,83,161,.516,.516,25,47,.532,83,198,281,27,22,17,51,127,191,2012
Danny Green,SG,24,SAS,66,38,1522,211,477,.442,102,234,.436,109,243,.449,.549,79,100,.790,54,174,228,86,58,46,67,107,603,2012
Gerald Green,SF,26,NJN,31,2,781,154,320,.481,43,110,.391,111,210,.529,.548,49,65,.754,15,93,108,34,28,17,55,80,400,2012
Willie Green,SG,30,ATL,53,2,922,153,325,.471,50,113,.442,103,212,.486,.548,48,56,.857,15,65,80,40,23,6,33,74,404,2012
Donte Greene,PF,23,SAC,53,7,777,108,266,.406,25,105,.238,83,161,.516,.453,44,55,.800,19,114,133,34,18,29,32,67,285,2012
Blake Griffin,PF,22,LAC,66,66,2392,561,1022,.549,2,16,.125,559,1006,.556,.550,244,468,.521,218,499,717,210,54,48,150,216,1368,2012
Hamed Haddadi,C,26,MEM,35,0,206,26,48,.542,0,1,.000,26,47,.553,.542,18,26,.692,28,43,71,8,1,26,21,43,70,2012
Jordan Hamilton,SF,21,DEN,26,2,258,48,111,.432,17,47,.362,31,64,.484,.509,2,5,.400,11,51,62,20,4,3,16,15,115,2012
Richard Hamilton,SG,33,CHI,28,28,697,140,310,.452,17,46,.370,123,264,.466,.479,29,37,.784,20,46,66,84,12,1,49,56,326,2012
Tyler Hansbrough,PF,26,IND,66,0,1442,194,479,.405,0,1,.000,194,478,.406,.405,226,278,.813,113,177,290,30,54,9,65,159,614,2012
Luke Harangody,PF,24,CLE,21,1,231,23,65,.354,5,21,.238,18,44,.409,.392,9,12,.750,20,33,53,6,6,3,4,17,60,2012
James Harden,SG,22,OKC,62,2,1946,309,629,.491,114,292,.390,195,337,.579,.582,312,369,.846,30,222,252,229,62,15,137,150,1044,2012
Justin Harper,PF,22,ORL,14,0,84,9,31,.290,2,13,.154,7,18,.389,.323,0,1,.000,3,9,12,2,2,3,6,5,20,2012
Josh Harrellson,PF,22,NYK,37,4,540,63,149,.423,20,59,.339,43,90,.478,.490,16,26,.615,47,97,144,11,23,20,20,48,162,2012
Al Harrington,PF,31,DEN,64,1,1761,345,773,.446,101,303,.333,244,470,.519,.512,119,176,.676,72,318,390,88,58,12,112,181,910,2012
Devin Harris,PG,28,UTA,63,63,1741,241,542,.445,77,213,.362,164,329,.498,.516,156,209,.746,12,100,112,316,64,13,122,136,715,2012
Manny Harris,SG,22,CLE,26,5,456,60,150,.400,12,36,.333,48,114,.421,.440,41,59,.695,11,59,70,31,13,6,27,28,173,2012
Terrel Harris,SG,24,MIA,22,1,318,29,83,.349,8,39,.205,21,44,.477,.398,14,21,.667,18,33,51,26,9,2,25,34,80,2012
Tobias Harris,SF,19,MIL,42,9,479,79,169,.467,6,23,.261,73,146,.500,.485,44,54,.815,30,71,101,22,13,7,31,45,208,2012
Udonis Haslem,PF,31,MIA,64,10,1589,151,357,.423,0,0,.000,151,357,.423,.423,83,102,.814,117,353,470,42,35,24,60,142,385,2012
Spencer Hawes,C,23,PHI,37,29,920,156,319,.489,3,12,.250,153,307,.498,.494,40,55,.727,78,192,270,98,16,48,55,100,355,2012
Chuck Hayes,C,28,SAC,54,9,1039,73,170,.429,0,2,.000,73,168,.435,.429,26,39,.667,72,162,234,77,36,17,50,111,172,2012
Gordon Hayward,SF,21,UTA,66,58,2015,267,586,.456,55,159,.346,212,427,.496,.503,193,232,.832,59,171,230,207,53,41,109,106,782,2012
Lazar Hayward,SF,25,OKC,26,0,141,13,38,.342,4,14,.286,9,24,.375,.395,7,12,.583,2,14,16,4,3,1,9,18,37,2012
Brendan Haywood,C,32,DAL,54,54,1146,118,228,.518,0,0,.000,118,228,.518,.518,45,96,.469,139,185,324,19,24,54,46,121,281,2012
Gerald Henderson,SG,24,CHA,55,55,1831,332,723,.459,11,47,.234,321,676,.475,.467,155,204,.760,64,161,225,126,49,20,100,128,830,2012
Xavier Henry,SG,20,NOH,45,0,759,90,228,.395,7,17,.412,83,211,.393,.410,52,85,.612,24,82,106,35,26,8,35,59,239,2012
Roy Hibbert,C,25,IND,65,65,1937,332,668,.497,0,1,.000,332,667,.498,.497,170,239,.711,213,359,572,108,32,128,128,195,834,2012
J.J. Hickson,PF,23,TOT,54,19,1244,183,392,.467,0,2,.000,183,390,.469,.467,86,134,.642,133,202,335,45,30,35,70,85,452,2012
J.J. Hickson,PF,23,SAC,35,9,644,64,173,.370,0,1,.000,64,172,.372,.370,37,58,.638,67,110,177,22,18,17,39,44,165,2012
J.J. Hickson,PF,23,POR,19,10,600,119,219,.543,0,1,.000,119,218,.546,.543,49,76,.645,66,92,158,23,12,18,31,41,287,2012
Cory Higgins,PG,22,CHA,38,0,423,52,160,.325,4,20,.200,48,140,.343,.338,42,60,.700,7,28,35,36,5,6,39,40,150,2012
Nene Hilario,C,29,TOT,39,33,1110,211,393,.537,0,4,.000,211,389,.542,.537,113,168,.673,63,228,291,80,42,38,96,95,535,2012
Nene Hilario,C,29,DEN,28,27,826,143,281,.509,0,2,.000,143,279,.513,.509,90,133,.677,43,165,208,61,36,25,77,69,376,2012
Nene Hilario,C,29,WAS,11,6,284,68,112,.607,0,2,.000,68,110,.618,.607,23,35,.657,20,63,83,19,6,13,19,26,159,2012
George Hill,PG,25,IND,50,9,1274,168,380,.442,54,147,.367,114,233,.489,.513,91,117,.778,31,120,151,145,42,17,52,98,481,2012
Grant Hill,SF,39,PHO,49,46,1378,201,451,.446,14,53,.264,187,398,.470,.461,83,109,.761,29,142,171,107,41,29,65,88,499,2012
Jordan Hill,C,24,TOT,39,8,551,82,165,.497,0,3,.000,82,162,.506,.497,30,47,.638,61,125,186,16,14,27,31,71,194,2012
Jordan Hill,C,24,HOU,32,7,469,68,135,.504,0,3,.000,68,132,.515,.504,25,39,.641,47,108,155,14,9,21,24,60,161,2012
Jordan Hill,C,24,LAL,7,1,82,14,30,.467,0,0,.000,14,30,.467,.467,5,8,.625,14,17,31,2,5,6,7,11,33,2012
Kirk Hinrich,SG,31,ATL,48,31,1237,122,295,.414,47,136,.346,75,159,.472,.493,25,32,.781,11,90,101,132,38,11,58,100,316,2012
Darington Hobson,SG,24,MIL,5,0,39,2,13,.154,0,6,.000,2,7,.286,.154,0,0,.000,0,3,3,6,0,0,2,1,4,2012
Jrue Holiday,PG,21,PHI,65,65,2196,360,834,.432,65,171,.380,295,663,.445,.471,94,120,.783,57,155,212,290,103,18,135,137,879,2012
Ryan Hollins,C,27,TOT,39,8,522,46,84,.548,0,0,.000,46,84,.548,.548,39,75,.520,34,48,82,9,5,17,35,78,131,2012
Ryan Hollins,C,27,CLE,24,7,362,28,56,.500,0,0,.000,28,56,.500,.500,33,55,.600,25,31,56,6,4,12,24,55,89,2012
Ryan Hollins,C,27,BOS,15,1,160,18,28,.643,0,0,.000,18,28,.643,.643,6,20,.300,9,17,26,3,1,5,11,23,42,2012
Tyler Honeycutt,SF,21,SAC,15,0,88,8,24,.333,1,3,.333,7,21,.333,.354,3,5,.600,3,11,14,7,4,3,2,3,20,2012
Al Horford,C,25,ATL,11,11,348,57,103,.553,0,1,.000,57,102,.559,.553,22,30,.733,26,51,77,24,10,14,16,21,136,2012
Dennis Horner,PF,23,NJN,8,0,22,1,4,.250,0,1,.000,1,3,.333,.250,3,4,.750,2,3,5,0,0,0,1,1,5,2012
Dwight Howard,C,26,ORL,54,54,2070,416,726,.573,0,7,.000,416,719,.579,.573,281,572,.491,200,585,785,104,81,116,175,159,1113,2012
Josh Howard,SF,31,UTA,43,18,991,144,361,.399,9,37,.243,135,324,.417,.411,75,97,.773,39,119,158,50,32,10,53,91,372,2012
Juwan Howard,PF,38,MIA,28,0,190,17,55,.309,0,0,.000,17,55,.309,.309,8,10,.800,18,29,47,10,4,1,20,18,42,2012
Lester Hudson,PG,27,TOT,16,0,334,62,162,.383,16,64,.250,46,98,.469,.432,34,41,.829,7,39,46,36,14,3,32,26,174,2012
Lester Hudson,PG,27,CLE,13,0,314,59,151,.391,15,61,.246,44,90,.489,.440,32,38,.842,7,39,46,35,14,3,30,26,165,2012
Lester Hudson,PG,27,MEM,3,0,20,3,11,.273,1,3,.333,2,8,.250,.318,2,3,.667,0,0,0,1,0,0,2,0,9,2012
Larry Hughes,PG,33,ORL,9,0,114,5,22,.227,1,7,.143,4,15,.267,.250,1,2,.500,1,4,5,7,2,0,12,10,12,2012
Kris Humphries,PF,26,NJN,62,62,2162,323,671,.481,0,0,.000,323,671,.481,.481,209,278,.752,233,448,681,90,50,74,119,173,855,2012
Serge Ibaka,PF,22,OKC,66,66,1792,262,490,.535,1,3,.333,261,487,.536,.536,78,118,.661,193,305,498,28,33,241,79,179,603,2012
Andre Iguodala,SF,28,PHI,62,62,2209,287,632,.454,76,193,.394,211,439,.481,.514,121,196,.617,56,325,381,339,107,30,115,92,771,2012
Ersan Ilyasova,PF,24,MIL,60,41,1655,294,597,.492,51,112,.455,243,485,.501,.535,143,183,.781,196,333,529,71,42,44,76,133,782,2012
Kyrie Irving,PG,19,CLE,51,51,1558,350,747,.469,73,183,.399,277,564,.491,.517,171,196,.872,44,147,191,275,54,20,160,110,944,2012
Royal Ivey,SG,30,OKC,34,0,354,26,73,.356,18,53,.340,8,20,.400,.479,1,8,.125,1,23,24,10,14,0,9,36,71,2012
Jarrett Jack,PG,28,NOH,45,39,1530,266,583,.456,39,112,.348,227,471,.482,.490,129,148,.872,23,153,176,285,31,9,106,93,700,2012
Reggie Jackson,PG,21,OKC,45,0,501,51,159,.321,13,62,.210,38,97,.392,.362,25,29,.862,14,39,53,71,25,1,36,31,140,2012
Stephen Jackson,SF,33,TOT,47,14,1212,159,425,.374,49,170,.288,110,255,.431,.432,94,114,.825,22,141,163,118,54,13,103,99,461,2012
Stephen Jackson,SF,33,MIL,26,13,712,97,272,.357,30,108,.278,67,164,.409,.412,50,60,.833,16,66,82,77,26,6,66,61,274,2012
Stephen Jackson,SF,33,SAS,21,1,500,62,153,.405,19,62,.306,43,91,.473,.467,44,54,.815,6,75,81,41,28,7,37,38,187,2012
Damion James,SF,24,NJN,7,7,170,13,35,.371,0,1,.000,13,34,.382,.371,8,12,.667,7,26,33,3,7,7,12,17,34,2012
LeBron James,SF,27,MIA,62,62,2326,621,1169,.531,54,149,.362,567,1020,.556,.554,387,502,.771,94,398,492,387,115,50,213,96,1683,2012
Mike James,PG,36,CHI,11,0,120,20,49,.408,6,10,.600,14,39,.359,.469,7,8,.875,2,8,10,29,4,2,14,20,53,2012
Antawn Jamison,PF,35,CLE,65,65,2151,421,1044,.403,91,267,.341,330,777,.425,.447,185,271,.683,123,285,408,131,51,43,90,164,1118,2012
Al Jefferson,C,27,UTA,61,61,2075,516,1048,.492,1,4,.250,515,1044,.493,.493,137,177,.774,133,452,585,134,47,101,62,155,1170,2012
Richard Jefferson,SF,31,TOT,63,44,1748,203,488,.416,113,269,.420,90,219,.411,.532,59,85,.694,26,193,219,88,37,19,50,121,578,2012
Richard Jefferson,SF,31,SAS,41,41,1168,132,319,.414,80,190,.421,52,129,.403,.539,35,50,.700,18,125,143,55,25,12,32,83,379,2012
Richard Jefferson,SF,31,GSW,22,3,580,71,169,.420,33,79,.418,38,90,.422,.518,24,35,.686,8,68,76,33,12,7,18,38,199,2012
Jared Jeffries,PF,30,NYK,39,4,729,59,144,.410,3,16,.188,56,128,.438,.420,49,72,.681,69,83,152,26,29,25,29,89,170,2012
Charles Jenkins,PG,22,GSW,51,28,893,130,291,.447,3,20,.150,127,271,.469,.452,34,39,.872,8,60,68,170,33,6,60,85,297,2012
Brandon Jennings,PG,22,MIL,66,66,2331,469,1121,.418,129,388,.332,340,733,.464,.476,193,239,.808,49,177,226,365,104,22,146,114,1260,2012
Jonas Jerebko,PF,24,DET,64,13,1468,212,453,.468,32,106,.302,180,347,.519,.503,100,124,.806,96,212,308,43,41,21,66,162,556,2012
Yi Jianlian,PF,24,DAL,30,0,203,31,82,.378,3,10,.300,28,72,.389,.396,14,21,.667,12,37,49,5,7,8,14,23,79,2012
Amir Johnson,PF,24,TOR,64,43,1553,196,340,.576,2,5,.400,194,335,.579,.579,58,84,.690,149,259,408,79,33,69,94,209,452,2012
Armon Johnson,PG,22,TOT,9,0,124,20,43,.465,1,3,.333,19,40,.475,.477,6,6,1.000,1,12,13,11,5,0,6,9,47,2012
Armon Johnson,PG,22,POR,1,0,5,1,1,1.000,0,0,.000,1,1,1.000,1.000,0,0,.000,0,1,1,0,1,0,1,0,2,2012
Armon Johnson,PG,22,NJN,8,0,119,19,42,.452,1,3,.333,18,39,.462,.464,6,6,1.000,1,11,12,11,4,0,5,9,45,2012
Carldell Johnson,PG,29,NOH,15,0,119,11,35,.314,4,15,.267,7,20,.350,.371,1,3,.333,1,8,9,22,8,0,7,11,27,2012
Chris Johnson,C,26,TOT,27,0,175,20,41,.488,0,0,.000,20,41,.488,.488,15,19,.789,15,25,40,2,6,9,15,33,55,2012
Chris Johnson,C,26,POR,20,0,93,11,23,.478,0,0,.000,11,23,.478,.478,10,12,.833,8,10,18,1,1,8,7,20,32,2012
Chris Johnson,C,26,NOH,7,0,82,9,18,.500,0,0,.000,9,18,.500,.500,5,7,.714,7,15,22,1,5,1,8,13,23,2012
Ivan Johnson,PF,27,ATL,56,0,934,141,275,.513,2,6,.333,139,269,.517,.516,72,100,.720,65,161,226,32,43,18,69,116,356,2012
JaJuan Johnson,PF,22,BOS,36,0,298,54,121,.446,0,0,.000,54,121,.446,.446,6,9,.667,20,38,58,6,5,14,14,25,114,2012
James Johnson,SF,24,TOR,62,40,1561,233,518,.450,19,60,.317,214,458,.467,.468,81,115,.704,74,218,292,122,71,84,101,177,566,2012
Joe Johnson,SG,30,ATL,60,60,2127,423,931,.454,125,322,.388,298,609,.489,.521,158,186,.849,53,168,221,232,48,13,116,75,1129,2012
Trey Johnson,SG,27,NOH,11,0,61,8,14,.571,0,0,.000,8,14,.571,.571,5,5,1.000,3,9,12,4,1,0,5,10,21,2012
Wesley Johnson,SF,24,MIN,65,64,1469,158,397,.398,53,169,.314,105,228,.461,.465,24,34,.706,24,153,177,59,35,48,60,115,393,2012
Dahntay Jones,SF,31,IND,65,3,1052,115,281,.409,33,77,.429,82,204,.402,.468,83,99,.838,23,94,117,63,23,11,46,119,346,2012
Dominique Jones,SG,23,DAL,33,1,268,29,73,.397,1,8,.125,28,65,.431,.404,29,37,.784,9,35,44,42,10,5,28,28,88,2012
James Jones,SG,31,MIA,51,10,666,57,150,.380,46,114,.404,11,36,.306,.533,25,30,.833,6,43,49,19,17,9,10,45,185,2012
Solomon Jones,C-PF,27,TOT,21,1,292,24,61,.393,0,0,.000,24,61,.393,.393,19,23,.826,32,26,58,9,9,11,18,43,67,2012
Solomon Jones,PF,27,LAC,10,0,96,1,8,.125,0,0,.000,1,8,.125,.125,4,5,.800,11,6,17,2,4,5,5,12,6,2012
Solomon Jones,C,27,NOH,11,1,196,23,53,.434,0,0,.000,23,53,.434,.434,15,18,.833,21,20,41,7,5,6,13,31,61,2012
DeAndre Jordan,C,23,LAC,66,66,1798,206,326,.632,0,1,.000,206,325,.634,.632,74,141,.525,202,344,546,17,30,134,74,189,486,2012
Jerome Jordan,C,25,NYK,21,0,108,17,33,.515,0,0,.000,17,33,.515,.515,8,10,.800,14,13,27,4,1,6,2,15,42,2012
Cory Joseph,PG,20,SAS,29,1,266,22,70,.314,3,15,.200,19,55,.345,.336,11,17,.647,5,20,25,34,7,3,12,16,58,2012
Chris Kaman,C,29,NOH,47,33,1372,266,597,.446,0,0,.000,266,597,.446,.446,84,107,.785,89,275,364,101,25,77,129,106,616,2012
Enes Kanter,C,19,UTA,66,0,874,117,236,.496,0,1,.000,117,235,.498,.496,70,105,.667,107,171,278,8,18,23,54,87,304,2012
Jason Kapono,SG,30,LAL,27,0,269,21,55,.382,8,27,.296,13,28,.464,.455,4,4,1.000,2,12,14,11,3,0,6,21,54,2012
D.J. Kennedy,SF,22,CLE,2,0,59,5,12,.417,2,4,.500,3,8,.375,.500,0,2,.000,1,6,7,3,2,0,3,7,12,2012
Jason Kidd,PG,38,DAL,48,48,1379,99,273,.363,79,223,.354,20,50,.400,.507,22,28,.786,15,183,198,264,82,10,91,83,299,2012
Linas Kleiza,SF,27,TOR,49,3,1057,165,410,.402,62,179,.346,103,231,.446,.478,81,100,.810,42,157,199,46,23,4,64,119,473,2012
Brandon Knight,PG,20,DET,66,60,2129,319,769,.415,105,276,.380,214,493,.434,.483,104,137,.759,33,178,211,251,49,10,171,154,847,2012
Kyle Korver,SG,30,CHI,65,7,1469,178,412,.432,118,271,.435,60,141,.426,.575,55,66,.833,26,133,159,112,36,15,53,110,529,2012
Kosta Koufos,C,22,DEN,48,24,792,115,192,.599,0,0,.000,115,192,.599,.599,33,55,.600,95,163,258,15,24,41,33,96,263,2012
Carl Landry,PF,28,NOH,41,8,999,182,362,.503,0,3,.000,182,359,.507,.503,147,184,.799,78,136,214,38,13,12,64,89,511,2012
Ty Lawson,PG,24,DEN,61,61,2124,374,767,.488,73,200,.365,301,567,.531,.535,178,216,.824,54,173,227,401,82,6,149,94,999,2012
Courtney Lee,SG,26,HOU,58,26,1757,251,580,.433,87,217,.401,164,363,.452,.508,71,86,.826,26,133,159,88,68,22,64,106,660,2012
David Lee,PF,28,GSW,57,57,2121,464,922,.503,0,5,.000,464,917,.506,.503,219,280,.782,171,374,545,162,54,22,149,179,1147,2012
Malcolm Lee,SG,21,MIN,19,0,243,23,59,.390,2,10,.200,21,49,.429,.407,14,17,.824,9,17,26,31,8,4,17,22,62,2012
Kawhi Leonard,SF,20,SAS,64,39,1534,199,404,.493,41,109,.376,158,295,.536,.543,68,88,.773,104,223,327,70,85,24,44,88,507,2012
Travis Leslie,SG,21,LAC,10,0,45,5,14,.357,0,0,.000,5,14,.357,.357,4,9,.444,6,3,9,5,2,2,2,4,14,2012
Jon Leuer,PF,22,MIL,46,12,555,97,191,.508,3,9,.333,94,182,.516,.516,21,28,.750,45,75,120,25,14,17,18,67,218,2012
Rashard Lewis,SF,32,WAS,28,15,729,85,221,.385,16,67,.239,69,154,.448,.421,31,37,.838,34,75,109,27,23,10,32,49,217,2012
DeAndre Liggins,SF,23,ORL,17,0,115,12,25,.480,0,4,.000,12,21,.571,.480,9,19,.474,6,9,15,5,6,0,10,6,33,2012
Jeremy Lin,PG,23,NYK,35,25,940,171,383,.446,24,75,.320,147,308,.477,.478,146,183,.798,18,89,107,216,55,9,126,78,512,2012
Shaun Livingston,SG,26,MIL,58,27,1092,127,271,.469,2,3,.667,125,268,.466,.472,62,79,.785,39,84,123,122,27,20,66,79,318,2012
Brook Lopez,C,23,NJN,5,5,136,38,77,.494,0,0,.000,38,77,.494,.494,20,32,.625,8,10,18,6,1,4,6,8,96,2012
Robin Lopez,C,23,PHO,64,0,895,124,269,.461,0,0,.000,124,269,.461,.461,100,140,.714,90,119,209,20,18,60,43,128,348,2012
Kevin Love,PF,23,MIN,55,55,2145,474,1059,.448,105,282,.372,369,777,.475,.497,379,460,.824,226,508,734,111,47,28,128,152,1432,2012
Kyle Lowry,PG,25,HOU,47,38,1510,210,513,.409,79,211,.374,131,302,.434,.486,171,198,.864,37,176,213,310,73,14,130,133,670,2012
John Lucas III,PG,29,CHI,49,2,726,143,358,.399,55,140,.393,88,218,.404,.476,28,32,.875,22,54,76,108,19,1,42,42,369,2012
Shelvin Mack,PG,21,WAS,64,0,779,88,220,.400,12,42,.286,76,178,.427,.427,42,59,.712,12,80,92,131,28,2,48,50,230,2012
Vernon Macklin,C,25,DET,23,0,135,19,35,.543,0,0,.000,19,35,.543,.543,8,14,.571,14,20,34,5,4,4,3,9,46,2012
Corey Maggette,SF,32,CHA,32,28,881,139,373,.373,24,66,.364,115,307,.375,.405,178,208,.856,21,104,125,39,23,1,59,83,480,2012
Jamaal Magloire,C,33,TOR,34,1,374,17,45,.378,0,0,.000,17,45,.378,.378,7,27,.259,25,88,113,6,4,10,22,66,41,2012
Ian Mahinmi,C,25,DAL,61,12,1139,130,238,.546,0,1,.000,130,237,.549,.546,94,147,.639,108,181,289,12,38,31,50,176,354,2012
Shawn Marion,SF,33,DAL,63,63,1919,288,646,.446,20,68,.294,268,578,.464,.461,74,93,.796,145,320,465,132,67,36,98,87,670,2012
Cartier Martin,SF,27,WAS,17,2,391,59,134,.440,29,75,.387,30,59,.508,.549,11,19,.579,12,46,58,10,11,2,13,35,158,2012
Kenyon Martin,PF,34,LAC,42,0,940,97,220,.441,3,13,.231,94,207,.454,.448,20,54,.370,49,132,181,18,44,43,32,103,217,2012
Kevin Martin,SG,28,HOU,40,40,1264,222,537,.413,78,225,.347,144,312,.462,.486,160,179,.894,13,93,106,110,28,3,70,70,682,2012
Roger Mason,SG,31,WAS,52,0,697,103,258,.399,59,154,.383,44,104,.423,.514,21,27,.778,7,62,69,47,13,5,32,33,286,2012
Wesley Matthews,SG,25,POR,66,53,2228,314,763,.412,129,337,.383,185,426,.434,.496,147,171,.860,56,168,224,113,96,15,73,148,904,2012
Jason Maxiell,PF,28,DET,65,42,1466,183,383,.478,0,2,.000,183,381,.480,.478,58,106,.547,126,207,333,41,32,50,71,151,424,2012
Eric Maynor,PG,24,OKC,9,0,137,14,39,.359,6,17,.353,8,22,.364,.436,4,4,1.000,3,10,13,22,5,0,11,13,38,2012
O.J. Mayo,SG,24,MEM,66,0,1771,300,736,.408,100,275,.364,200,461,.434,.476,133,172,.773,30,180,210,169,71,23,124,137,833,2012
Luc Mbah a Moute,PF,25,MIL,43,22,1009,133,261,.510,1,4,.250,132,257,.514,.511,66,103,.641,77,150,227,29,40,22,39,93,333,2012
JaVale McGee,C,24,TOT,61,45,1535,307,552,.556,0,0,.000,307,552,.556,.556,77,167,.461,163,314,477,31,35,132,87,166,691,2012
JaVale McGee,C,24,WAS,41,40,1124,214,400,.535,0,0,.000,214,400,.535,.535,58,116,.500,127,235,362,25,25,101,68,118,486,2012
JaVale McGee,C,24,DEN,20,5,411,93,152,.612,0,0,.000,93,152,.612,.612,19,51,.373,36,79,115,6,10,31,19,48,205,2012
Tracy McGrady,SF,32,ATL,52,0,837,101,231,.437,15,33,.455,86,198,.434,.470,56,83,.675,23,131,154,110,16,15,53,35,273,2012
Dominic McGuire,PF,26,GSW,64,6,1127,94,210,.448,0,4,.000,94,206,.456,.448,39,53,.736,73,173,246,110,44,36,56,104,227,2012
Josh McRoberts,PF,24,LAL,50,6,718,56,118,.475,3,7,.429,53,111,.477,.487,23,36,.639,61,110,171,51,15,18,31,74,138,2012
Jodie Meeks,SG,24,PHI,66,50,1644,191,467,.409,97,266,.365,94,201,.468,.513,77,85,.906,17,144,161,54,40,3,29,82,556,2012
C.J. Miles,SG,24,UTA,56,14,1145,177,465,.381,46,150,.307,131,315,.416,.430,108,136,.794,27,89,116,69,46,18,53,122,508,2012
Darko Milicic,C,26,MIN,29,23,472,59,130,.454,0,0,.000,59,130,.454,.454,16,37,.432,35,62,97,17,9,25,32,59,134,2012
Andre Miller,SG,35,DEN,66,7,1809,242,552,.438,18,83,.217,224,469,.478,.455,137,169,.811,53,168,221,441,63,9,177,133,639,2012
Brad Miller,C,35,MIN,15,1,146,9,27,.333,7,15,.467,2,12,.167,.463,10,12,.833,4,15,19,24,4,2,12,10,35,2012
Mike Miller,SG,31,MIA,39,2,752,91,209,.435,53,117,.453,38,92,.413,.562,2,5,.400,22,106,128,42,14,6,30,58,237,2012
Patty Mills,PG,23,SAS,16,3,261,63,130,.485,24,56,.429,39,74,.527,.577,15,15,1.000,4,24,28,39,10,1,26,14,165,2012
Paul Millsap,PF,26,UTA,64,62,2100,426,861,.495,7,31,.226,419,830,.505,.499,202,255,.792,180,383,563,150,118,52,112,222,1061,2012
Nazr Mohammed,C,34,OKC,63,1,692,79,169,.467,0,1,.000,79,168,.470,.467,13,23,.565,59,111,170,14,20,37,26,101,171,2012
Greg Monroe,C,21,DET,66,66,2082,407,781,.521,0,1,.000,407,780,.522,.521,201,272,.739,239,398,637,152,83,46,161,180,1015,2012
Jamario Moon,SF,31,CHA,8,0,123,7,24,.292,2,10,.200,5,14,.357,.333,2,2,1.000,2,20,22,5,1,5,8,5,18,2012
E'Twaun Moore,PG,22,BOS,38,0,331,43,113,.381,17,45,.378,26,68,.382,.456,7,7,1.000,4,29,33,34,11,3,21,33,110,2012
Mikki Moore,C,36,GSW,7,0,118,9,20,.450,0,0,.000,9,20,.450,.450,6,7,.857,7,15,22,5,3,3,7,24,24,2012
Darius Morris,PG,21,LAL,19,0,169,18,42,.429,4,9,.444,14,33,.424,.476,6,9,.667,2,14,16,21,2,0,19,16,46,2012
Marcus Morris,PF,22,HOU,17,0,126,16,54,.296,2,17,.118,14,37,.378,.315,6,8,.750,5,11,16,3,2,2,4,12,40,2012
Markieff Morris,PF,22,PHO,63,7,1227,174,436,.399,43,124,.347,131,312,.420,.448,76,106,.717,69,210,279,65,41,42,70,179,467,2012
Anthony Morrow,SG,26,NJN,62,18,1636,272,658,.413,106,286,.371,166,372,.446,.494,97,104,.933,31,96,127,61,46,9,70,86,747,2012
Timofey Mozgov,C,25,DEN,44,35,687,100,190,.526,0,0,.000,100,190,.526,.526,39,57,.684,53,126,179,22,15,42,53,86,239,2012
Byron Mullens,C,22,CHA,65,25,1465,251,591,.425,12,51,.235,239,540,.443,.435,92,112,.821,96,231,327,57,21,52,74,137,606,2012
Troy Murphy,PF,31,LAL,59,0,956,77,171,.450,28,67,.418,49,104,.471,.532,6,9,.667,40,151,191,51,15,16,26,98,188,2012
Hamady N'Diaye,C,25,WAS,3,0,3,0,1,.000,0,0,.000,0,1,.000,.000,0,0,.000,0,0,0,0,0,0,0,0,0,2012
Eduardo Najera,PF,35,CHA,22,0,270,24,64,.375,8,29,.276,16,35,.457,.438,2,4,.500,11,39,50,12,19,4,7,40,58,2012
Steve Nash,PG,37,PHO,62,62,1961,295,555,.532,55,141,.390,240,414,.580,.581,127,142,.894,26,160,186,664,38,8,229,53,772,2012
Gary Neal,SG,27,SAS,56,7,1206,212,486,.436,83,198,.419,129,288,.448,.522,50,64,.781,12,106,118,117,27,2,60,75,557,2012
Jameer Nelson,PG,29,ORL,57,57,1706,259,606,.427,87,231,.377,172,375,.459,.499,71,88,.807,29,152,181,325,38,5,135,130,676,2012
Joakim Noah,C,26,CHI,64,64,1945,249,490,.508,0,1,.000,249,489,.509,.508,154,206,.748,242,387,629,160,41,92,92,162,652,2012
Andres Nocioni,SF,32,PHI,11,1,56,5,20,.250,1,6,.167,4,14,.286,.275,6,11,.545,1,13,14,1,1,1,5,4,17,2012
Steve Novak,PF,28,NYK,54,0,1020,161,337,.478,133,282,.472,28,55,.509,.675,22,26,.846,9,95,104,12,16,9,21,59,477,2012
Dirk Nowitzki,PF,33,DAL,62,62,2079,473,1034,.457,78,212,.368,395,822,.481,.495,318,355,.896,46,372,418,136,42,30,117,129,1342,2012
Jermaine O'Neal,C,33,BOS,25,24,570,52,120,.433,0,0,.000,52,120,.433,.433,21,31,.677,37,98,135,10,8,43,21,80,125,2012
Lamar Odom,SF,32,DAL,50,4,1027,123,349,.352,28,111,.252,95,238,.399,.393,58,98,.592,36,172,208,83,20,18,52,97,332,2012
Emeka Okafor,C,29,NOH,27,27,781,114,214,.533,0,0,.000,114,214,.533,.533,38,74,.514,70,143,213,24,16,26,37,73,266,2012
Mehmet Okur,C,32,NJN,17,14,454,52,139,.374,23,72,.319,29,67,.433,.457,3,5,.600,22,59,81,30,9,5,25,45,130,2012
Daniel Orton,PF,21,ORL,16,2,187,17,30,.567,0,1,.000,17,29,.586,.567,11,25,.440,19,20,39,5,8,9,7,30,45,2012
Travis Outlaw,SF,27,SAC,39,5,500,60,175,.343,16,60,.267,44,115,.383,.389,31,46,.674,19,42,61,16,19,21,20,34,167,2012
Larry Owens,SF,29,NJN,7,0,75,4,11,.364,2,5,.400,2,6,.333,.455,3,4,.750,2,11,13,4,0,1,2,10,13,2012
Zaza Pachulia,C,27,ATL,58,44,1640,169,339,.499,0,0,.000,169,339,.499,.499,117,158,.741,154,303,457,79,55,29,81,172,455,2012
Jannero Pargo,PG,32,ATL,50,0,671,105,253,.415,53,138,.384,52,115,.452,.520,19,20,.950,9,64,73,96,20,2,49,64,282,2012
Jeremy Pargo,PG,25,MEM,44,5,424,50,150,.333,10,38,.263,40,112,.357,.367,16,27,.593,12,25,37,55,15,0,46,46,126,2012
Anthony Parker,SF,36,CLE,51,51,1280,141,326,.433,50,138,.362,91,188,.484,.509,35,56,.625,10,128,138,120,38,7,50,65,367,2012
Tony Parker,PG,29,SAS,60,60,1923,427,890,.480,14,61,.230,413,829,.498,.488,227,284,.799,22,149,171,463,57,5,153,75,1095,2012
Chandler Parsons,SF,23,HOU,63,57,1804,248,549,.452,60,178,.337,188,371,.507,.506,43,78,.551,90,210,300,134,73,29,81,142,599,2012
Patrick Patterson,PF,22,HOU,64,1,1483,225,511,.440,0,3,.000,225,508,.443,.440,40,57,.702,112,174,286,53,27,36,49,113,490,2012
Chris Paul,PG,26,LAC,60,60,2181,425,890,.478,79,213,.371,346,677,.511,.522,260,302,.861,42,171,213,543,152,4,124,138,1189,2012
Sasha Pavlovic,SF,28,BOS,45,7,527,50,128,.391,17,58,.293,33,70,.471,.457,3,8,.375,4,68,72,18,20,15,20,54,120,2012
Nikola Pekovic,C,26,MIN,47,35,1264,256,454,.564,0,0,.000,256,454,.564,.564,139,187,.743,181,165,346,31,29,31,87,98,651,2012
Kendrick Perkins,C,27,OKC,65,65,1744,128,262,.489,0,0,.000,128,262,.489,.489,73,112,.652,120,306,426,78,25,73,118,189,329,2012
Johan Petro,C,26,NJN,59,10,920,109,260,.419,1,1,1.000,108,259,.417,.421,31,37,.838,68,156,224,45,21,23,38,122,250,2012
Paul Pierce,SF,34,BOS,61,61,2075,394,890,.443,100,273,.366,294,617,.476,.499,293,344,.852,37,280,317,274,70,26,173,147,1181,2012
Mickael Pietrus,SG,29,BOS,42,6,921,104,270,.385,61,182,.335,43,88,.489,.498,20,31,.645,18,112,130,25,21,10,33,81,289,2012
Dexter Pittman,C,23,MIA,35,6,301,44,94,.468,0,0,.000,44,94,.468,.468,18,28,.643,27,44,71,9,8,8,17,73,106,2012
Quincy Pondexter,SF,23,MEM,64,8,1002,108,239,.452,22,73,.301,86,166,.518,.498,33,53,.623,55,71,126,27,27,5,30,90,271,2012
A.J. Price,PG,25,IND,44,1,568,59,174,.339,26,88,.295,33,86,.384,.414,28,35,.800,13,48,61,86,20,2,32,30,172,2012
Ronnie Price,PG,28,PHO,36,8,517,49,130,.377,13,44,.295,36,86,.419,.427,20,25,.800,18,38,56,67,34,3,46,72,131,2012
Tayshaun Prince,SF,31,DET,63,63,2087,336,798,.421,37,104,.356,299,694,.431,.444,89,115,.774,72,209,281,153,27,32,74,77,798,2012
Joel Przybilla,C,32,POR,27,19,449,22,48,.458,0,0,.000,22,48,.458,.458,11,18,.611,29,109,138,6,4,16,22,66,55,2012
Vladimir Radmanovic,SF,31,ATL,49,3,755,74,197,.376,50,135,.370,24,62,.387,.503,22,29,.759,34,109,143,54,21,15,35,62,220,2012
Anthony Randolph,PF,22,MIN,34,5,517,94,200,.470,0,1,.000,94,199,.472,.470,64,84,.762,42,81,123,19,13,35,40,56,252,2012
Zach Randolph,PF,30,MEM,28,8,735,132,285,.463,2,8,.250,130,277,.469,.467,58,88,.659,78,147,225,48,21,4,40,57,324,2012
Michael Redd,SG,32,PHO,51,2,770,144,360,.400,42,132,.318,102,228,.447,.458,88,111,.793,14,63,77,33,13,0,37,29,418,2012
J.J. Redick,SG,27,ORL,65,22,1765,248,584,.425,112,268,.418,136,316,.430,.521,143,157,.911,18,132,150,164,27,6,68,92,751,2012
Ryan Reid,PF,25,OKC,5,0,17,4,5,.800,0,0,.000,4,5,.800,.800,0,0,.000,1,1,2,0,0,0,1,1,8,2012
Jason Richardson,SG,31,ORL,54,54,1591,243,596,.408,102,277,.368,141,319,.442,.493,41,69,.594,36,158,194,107,53,22,60,91,629,2012
Quentin Richardson,SF,31,ORL,48,3,866,74,197,.376,42,121,.347,32,76,.421,.482,25,30,.833,15,108,123,38,28,6,29,74,215,2012
Luke Ridnour,SG,30,MIN,53,53,1750,242,550,.440,49,152,.322,193,398,.485,.485,106,119,.891,19,122,141,252,56,16,96,136,639,2012
Nate Robinson,PG,27,GSW,51,9,1192,205,484,.424,66,181,.365,139,303,.459,.492,94,113,.832,15,85,100,231,59,2,75,118,570,2012
Rajon Rondo,PG,25,BOS,53,53,1957,256,572,.448,10,42,.238,246,530,.464,.456,108,181,.597,62,195,257,620,95,3,193,99,630,2012
Derrick Rose,PG,23,CHI,39,39,1375,302,695,.435,54,173,.312,248,522,.475,.473,194,239,.812,26,105,131,307,35,28,119,52,852,2012
Ricky Rubio,PG,21,MIN,41,31,1404,139,389,.357,32,94,.340,107,295,.363,.398,126,157,.803,21,150,171,336,91,8,131,97,436,2012
Brandon Rush,SF,26,GSW,65,1,1717,235,469,.501,99,219,.452,136,250,.544,.607,65,82,.793,33,218,251,88,35,58,68,64,634,2012
Walker Russell,PG,29,DET,28,0,357,33,95,.347,4,13,.308,29,82,.354,.368,14,22,.636,7,19,26,58,18,1,33,29,84,2012
John Salmons,SF,32,SAC,46,32,1250,141,345,.409,33,112,.295,108,233,.464,.457,29,45,.644,20,114,134,93,37,7,45,77,344,2012
Samardo Samuels,C,23,CLE,54,0,825,105,231,.455,0,0,.000,105,231,.455,.455,82,117,.701,63,117,180,20,20,20,56,113,292,2012
Larry Sanders,PF,23,MIL,52,0,643,84,184,.457,0,2,.000,84,182,.462,.457,18,38,.474,62,98,160,33,32,76,43,133,186,2012
Brian Scalabrine,PF,33,CHI,28,0,122,14,30,.467,1,7,.143,13,23,.565,.483,3,6,.500,8,13,21,15,5,6,9,9,32,2012
Luis Scola,PF,31,HOU,66,66,2067,436,888,.491,0,3,.000,436,885,.493,.491,153,198,.773,122,306,428,140,35,24,153,214,1025,2012
Thabo Sefolosha,SG,27,OKC,42,42,914,67,155,.432,31,71,.437,36,84,.429,.532,38,43,.884,21,107,128,47,37,17,40,78,203,2012
Josh Selby,PG,20,MEM,28,0,237,25,72,.347,2,15,.133,23,57,.404,.361,11,14,.786,2,13,15,30,7,0,29,17,63,2012
Kevin Seraphin,C,22,WAS,57,21,1176,203,382,.531,0,1,.000,203,381,.533,.531,47,70,.671,103,177,280,33,19,76,66,133,453,2012
Ramon Sessions,PG,25,TOT,64,23,1707,242,565,.428,43,97,.443,199,468,.425,.466,194,248,.782,33,181,214,354,44,3,141,100,721,2012
Ramon Sessions,PG,25,CLE,41,4,1006,141,354,.398,26,62,.419,115,292,.394,.435,122,147,.830,19,108,127,212,27,1,82,63,430,2012
Ramon Sessions,PG,25,LAL,23,19,701,101,211,.479,17,35,.486,84,176,.477,.519,72,101,.713,14,73,87,142,17,2,59,37,291,2012
Iman Shumpert,PG,21,NYK,59,35,1705,214,534,.401,48,157,.306,166,377,.440,.446,87,109,.798,42,144,186,164,101,8,111,173,563,2012
Xavier Silas,SG,24,PHI,2,0,39,4,15,.267,1,6,.167,3,9,.333,.300,2,3,.667,2,2,4,3,0,0,3,5,11,2012
Bobby Simmons,SF,31,LAC,28,0,418,28,90,.311,20,60,.333,8,30,.267,.422,4,7,.571,17,38,55,11,15,3,10,41,80,2012
Chris Singleton,SF,22,WAS,66,51,1431,116,312,.372,44,127,.346,72,185,.389,.442,30,44,.682,43,190,233,49,70,30,38,176,306,2012
James Singleton,PF,30,WAS,12,0,262,41,75,.547,2,9,.222,39,66,.591,.560,14,15,.933,25,56,81,15,9,8,10,27,98,2012
Brian Skinner,C,35,MEM,1,0,4,0,1,.000,0,0,.000,0,1,.000,.000,0,0,.000,0,0,0,0,0,0,0,1,0,2012
Donald Sloan,PG,24,TOT,33,11,669,79,198,.399,2,25,.080,77,173,.445,.404,23,30,.767,18,49,67,105,13,3,49,37,183,2012
Donald Sloan,PG,24,ATL,5,0,20,3,8,.375,0,1,.000,3,7,.429,.375,0,0,.000,1,4,5,5,1,0,2,3,6,2012
Donald Sloan,PG,24,NOH,3,0,41,5,14,.357,0,2,.000,5,12,.417,.357,2,4,.500,2,1,3,8,2,0,5,2,12,2012
Donald Sloan,PG,24,CLE,25,11,608,71,176,.403,2,22,.091,69,154,.448,.409,21,26,.808,15,44,59,92,10,3,42,32,165,2012
Craig Smith,PF,28,POR,47,0,464,59,117,.504,0,1,.000,59,116,.509,.504,38,53,.717,33,77,110,19,16,5,24,55,156,2012
Greg Smith,C,21,HOU,8,0,69,7,11,.636,0,0,.000,7,11,.636,.636,0,0,.000,5,15,20,1,2,5,1,17,14,2012
Ish Smith,PG,23,TOT,26,1,234,31,81,.383,3,9,.333,28,72,.389,.401,7,10,.700,7,28,35,41,15,2,13,15,72,2012
Ish Smith,PG,23,GSW,6,1,63,12,30,.400,2,5,.400,10,25,.400,.433,1,2,.500,2,7,9,9,4,0,1,4,27,2012
Ish Smith,PG,23,ORL,20,0,171,19,51,.373,1,4,.250,18,47,.383,.382,6,8,.750,5,21,26,32,11,2,12,11,45,2012
J.R. Smith,SG,26,NYK,35,1,967,165,405,.407,67,193,.347,98,212,.462,.490,39,55,.709,29,107,136,84,54,6,46,87,436,2012
Jason Smith,PF,25,NOH,40,29,947,181,348,.520,1,9,.111,180,339,.531,.522,33,47,.702,72,124,196,34,21,41,40,102,396,2012
Jerry Smith,PG,24,NJN,5,0,46,3,14,.214,1,6,.167,2,8,.250,.250,0,0,.000,2,5,7,4,5,0,0,5,7,2012
Josh Smith,PF,26,ATL,66,66,2329,504,1101,.458,28,109,.257,476,992,.480,.470,203,322,.630,136,496,632,257,93,115,164,172,1239,2012
Nolan Smith,PG,23,POR,44,4,541,67,180,.372,13,45,.289,54,135,.400,.408,20,28,.714,17,39,56,62,18,3,42,55,167,2012
Marreese Speights,PF,24,MEM,60,54,1345,221,488,.453,0,3,.000,221,485,.456,.453,84,109,.771,133,241,374,48,21,29,74,147,526,2012
Tiago Splitter,C,27,SAS,59,2,1121,212,343,.618,0,0,.000,212,343,.618,.618,125,181,.691,93,213,306,65,21,47,87,134,549,2012
Jerry Stackhouse,SF,37,ATL,30,0,273,37,100,.370,13,38,.342,24,62,.387,.435,21,23,.913,6,17,23,14,10,3,13,12,108,2012
Lance Stephenson,SG,21,IND,42,1,442,47,125,.376,4,30,.133,43,95,.453,.392,8,17,.471,12,41,53,46,21,5,36,30,106,2012
DeShawn Stevenson,SF,30,NJN,51,30,960,49,172,.285,41,145,.283,8,27,.296,.404,9,16,.563,7,94,101,41,19,4,19,59,148,2012
Greg Stiemsma,C,26,BOS,55,3,766,66,121,.545,0,0,.000,66,121,.545,.545,29,41,.707,48,129,177,28,37,85,33,144,161,2012
Julyan Stone,SG,23,DEN,22,2,179,13,31,.419,2,11,.182,11,20,.550,.452,8,11,.727,5,20,25,37,8,6,11,18,36,2012
Amar'e Stoudemire,PF,29,NYK,47,47,1543,316,654,.483,5,21,.238,311,633,.491,.487,186,243,.765,106,261,367,52,38,45,112,138,823,2012
Rodney Stuckey,SG,25,DET,55,48,1644,256,597,.429,33,104,.317,223,493,.452,.456,267,320,.834,38,104,142,210,44,10,106,124,812,2012
DaJuan Summers,SF,24,NOH,15,6,209,28,65,.431,5,16,.313,23,49,.469,.469,7,9,.778,8,15,23,10,7,0,8,31,68,2012
Jeff Teague,PG,23,ATL,66,66,2183,320,672,.476,51,149,.342,269,523,.514,.514,140,185,.757,21,138,159,321,106,37,134,145,831,2012
Sebastian Telfair,PG,26,PHO,60,1,895,141,342,.412,33,105,.314,108,237,.456,.461,53,67,.791,20,71,91,138,41,12,68,120,368,2012
Jason Terry,SG,34,DAL,63,1,2000,357,830,.430,138,365,.378,219,465,.471,.513,98,111,.883,16,133,149,226,73,11,127,69,950,2012
Hasheem Thabeet,C,24,TOT,20,3,139,11,21,.524,0,0,.000,11,21,.524,.524,13,20,.650,16,26,42,0,1,10,8,20,35,2012
Hasheem Thabeet,C,24,HOU,5,0,23,3,3,1.000,0,0,.000,3,3,1.000,1.000,0,0,.000,1,6,7,0,0,2,0,5,6,2012
Hasheem Thabeet,C,24,POR,15,3,116,8,18,.444,0,0,.000,8,18,.444,.444,13,20,.650,15,20,35,0,1,8,8,15,29,2012
Isaiah Thomas,PG,22,SAC,65,37,1656,256,571,.448,83,219,.379,173,352,.491,.521,154,185,.832,48,120,168,266,53,8,105,121,749,2012
Kurt Thomas,C,39,POR,53,3,803,73,157,.465,0,0,.000,73,157,.465,.465,14,20,.700,39,149,188,46,24,31,31,123,160,2012
Lance Thomas,PF,23,NOH,42,10,630,57,126,.452,0,1,.000,57,125,.456,.452,52,62,.839,49,77,126,12,10,7,24,78,166,2012
Malcolm Thomas,PF,23,SAS,3,0,15,0,3,.000,0,0,.000,0,3,.000,.000,1,2,.500,1,2,3,1,1,1,0,0,1,2012
Tyrus Thomas,PF,25,CHA,54,30,1013,120,327,.367,1,3,.333,119,324,.367,.369,63,83,.759,49,151,200,35,36,60,53,144,304,2012
Trey Thompkins,C,21,LAC,24,0,119,24,61,.393,4,13,.308,20,48,.417,.426,5,7,.714,4,20,24,3,3,3,6,10,57,2012
Jason Thompson,PF,25,SAC,64,47,1657,237,443,.535,0,2,.000,237,441,.537,.535,109,181,.602,166,277,443,79,43,44,68,149,583,2012
Klay Thompson,SG,21,GSW,66,29,1608,318,718,.443,111,268,.414,207,450,.460,.520,79,91,.868,24,137,161,133,49,20,103,155,826,2012
Mychel Thompson,SG,23,CLE,5,3,95,7,24,.292,4,11,.364,3,13,.231,.375,0,0,.000,0,5,5,7,2,1,5,8,18,2012
Tristan Thompson,PF,20,CLE,60,25,1424,194,442,.439,0,2,.000,194,440,.441,.439,106,192,.552,187,202,389,27,27,62,81,134,494,2012
Marcus Thornton,SG,24,SAC,51,51,1780,352,803,.438,107,310,.345,245,493,.497,.505,141,163,.865,84,104,188,98,71,12,84,111,952,2012
Jamaal Tinsley,PG,33,UTA,37,1,507,57,141,.404,10,37,.270,47,104,.452,.440,13,17,.765,6,39,45,123,17,8,52,47,137,2012
Anthony Tolliver,SF,26,MIN,51,0,882,71,182,.390,25,101,.248,46,81,.568,.459,41,55,.745,50,103,153,22,18,19,35,86,208,2012
Ronny Turiaf,C,29,TOT,17,5,279,19,33,.576,0,1,.000,19,32,.594,.576,13,22,.591,20,50,70,10,14,17,14,39,51,2012
Ronny Turiaf,C,29,WAS,4,0,58,3,3,1.000,0,0,.000,3,3,1.000,1.000,0,0,.000,1,11,12,5,6,3,6,7,6,2012
Ronny Turiaf,C,29,MIA,13,5,221,16,30,.533,0,1,.000,16,29,.552,.533,13,22,.591,19,39,58,5,8,14,8,32,45,2012
Hedo Turkoglu,SF,32,ORL,53,53,1653,209,504,.415,91,258,.353,118,246,.480,.505,67,95,.705,24,175,199,233,45,17,142,139,576,2012
Evan Turner,SF,23,PHI,65,20,1713,263,590,.446,11,49,.224,252,541,.466,.455,73,108,.676,27,349,376,180,40,20,105,117,610,2012
Jeremy Tyler,C,20,GSW,42,23,568,88,209,.421,0,1,.000,88,208,.423,.421,29,52,.558,54,86,140,16,16,20,36,84,205,2012
Edwin Ubiles,SF,25,WAS,4,0,52,5,18,.278,1,5,.200,4,13,.308,.306,3,3,1.000,2,8,10,1,1,1,1,1,14,2012
Ekpe Udoh,C,24,TOT,61,11,1290,127,295,.431,0,2,.000,127,293,.433,.431,86,114,.754,100,154,254,57,40,102,53,174,340,2012
Ekpe Udoh,C,24,GSW,38,6,827,82,185,.443,0,0,.000,82,185,.443,.443,46,64,.719,58,89,147,31,25,65,35,115,210,2012
Ekpe Udoh,C,24,MIL,23,5,463,45,110,.409,0,2,.000,45,108,.417,.409,40,50,.800,42,65,107,26,15,37,18,59,130,2012
Beno Udrih,SG,29,MIL,59,0,1080,146,332,.440,17,59,.288,129,273,.473,.465,39,55,.709,26,76,102,227,37,1,77,69,348,2012
Ben Uzoh,PG,23,TOT,18,8,370,35,99,.354,0,1,.000,35,98,.357,.354,11,19,.579,19,48,67,61,17,3,19,31,81,2012
Ben Uzoh,PG,23,CLE,2,0,13,2,5,.400,0,0,.000,2,5,.400,.400,0,0,.000,2,2,4,2,1,0,0,1,4,2012
Ben Uzoh,PG,23,TOR,16,8,357,33,94,.351,0,1,.000,33,93,.355,.351,11,19,.579,17,46,63,59,16,3,19,30,77,2012
Anderson Varejao,C,29,CLE,25,25,785,114,222,.514,0,4,.000,114,218,.523,.514,43,64,.672,109,178,287,43,35,17,45,62,271,2012
Greivis Vasquez,SG,25,NOH,66,26,1706,225,523,.430,43,135,.319,182,388,.469,.471,96,117,.821,23,150,173,359,60,8,148,126,589,2012
Jan Vesely,PF,21,WAS,57,20,1078,117,218,.537,0,1,.000,117,217,.539,.537,33,62,.532,101,148,249,47,39,32,60,156,267,2012
Charlie Villanueva,PF,27,DET,13,0,180,35,91,.385,15,45,.333,20,46,.435,.467,6,7,.857,9,39,48,6,7,5,7,25,91,2012
Nikola Vucevic,C,21,PHI,51,15,812,131,291,.450,3,8,.375,128,283,.452,.455,18,34,.529,88,158,246,31,20,34,33,111,283,2012
Dwyane Wade,SG,30,MIA,49,49,1625,416,837,.497,15,56,.268,401,781,.513,.506,235,297,.791,73,164,237,225,82,63,129,110,1082,2012
Von Wafer,SG,26,ORL,33,1,469,71,157,.452,14,39,.359,57,118,.483,.497,38,54,.704,6,39,45,29,10,3,35,26,194,2012
Henry Walker,SG,24,NYK,32,8,620,68,171,.398,36,113,.319,32,58,.552,.503,17,20,.850,9,71,80,37,19,7,35,84,189,2012
Kemba Walker,PG,21,CHA,66,25,1792,281,767,.366,69,226,.305,212,541,.392,.411,168,213,.789,30,204,234,289,60,20,119,79,799,2012
John Wall,PG,21,WAS,66,66,2386,378,894,.423,3,42,.071,375,852,.440,.424,317,402,.789,48,252,300,530,95,57,255,137,1076,2012
Ben Wallace,C,37,DET,62,11,980,34,86,.395,1,4,.250,33,82,.402,.401,16,47,.340,81,188,269,43,47,51,34,60,85,2012
Gerald Wallace,SF,29,TOT,58,58,2076,287,632,.454,46,150,.307,241,482,.500,.491,180,225,.800,87,299,386,164,85,36,111,145,800,2012
Gerald Wallace,SF,29,POR,42,42,1503,203,430,.472,26,98,.265,177,332,.533,.502,125,161,.776,63,214,277,115,62,25,84,107,557,2012
Gerald Wallace,SF,29,NJN,16,16,573,84,202,.416,20,52,.385,64,150,.427,.465,55,64,.859,24,85,109,49,23,11,27,38,243,2012
Luke Walton,PF-SF,31,TOT,30,0,364,24,65,.369,7,20,.350,17,45,.378,.423,0,0,.000,13,36,49,35,5,1,27,41,55,2012
Luke Walton,SF,31,LAL,9,0,65,6,14,.429,0,4,.000,6,10,.600,.429,0,0,.000,6,8,14,5,2,0,2,9,12,2012
Luke Walton,PF,31,CLE,21,0,299,18,51,.353,7,16,.438,11,35,.314,.422,0,0,.000,7,28,35,30,3,1,25,32,43,2012
Hakim Warrick,PF,29,PHO,35,0,503,74,180,.411,1,10,.100,73,170,.429,.414,76,99,.768,31,61,92,30,8,3,36,35,225,2012
Darryl Watkins,C,27,NOH,5,0,98,7,14,.500,0,0,.000,7,14,.500,.500,9,18,.500,8,19,27,3,5,4,8,14,23,2012
C.J. Watson,PG,27,CHI,49,25,1159,161,437,.368,68,173,.393,93,264,.352,.446,84,104,.808,21,84,105,200,45,8,97,103,474,2012
Earl Watson,PG,32,UTA,50,2,1033,54,160,.338,10,52,.192,44,108,.407,.369,31,46,.674,30,91,121,217,54,22,85,105,149,2012
Martell Webster,SF,25,MIN,47,26,1140,115,272,.423,37,109,.339,78,163,.479,.491,57,72,.792,42,126,168,40,31,17,46,86,324,2012
David West,PF,31,IND,66,66,1925,349,716,.487,2,9,.222,347,707,.491,.489,142,176,.807,118,315,433,140,52,46,93,160,842,2012
Delonte West,PG,28,DAL,44,33,1060,166,360,.461,27,76,.355,139,284,.489,.499,62,70,.886,13,88,101,139,58,11,76,67,421,2012
Russell Westbrook,PG,23,OKC,66,66,2331,578,1266,.457,62,196,.316,516,1070,.482,.481,340,413,.823,96,205,301,362,112,21,239,147,1558,2012
D.J. White,PF,25,CHA,58,11,1098,174,353,.493,1,1,1.000,173,352,.491,.494,43,61,.705,50,159,209,47,17,23,43,94,392,2012
Hassan Whiteside,C,22,SAC,18,0,109,12,27,.444,0,0,.000,12,27,.444,.444,5,12,.417,16,23,39,0,3,15,5,12,29,2012
Chris Wilcox,C,29,BOS,28,4,481,64,107,.598,0,0,.000,64,107,.598,.598,24,39,.615,38,84,122,12,11,9,30,64,152,2012
Damien Wilkins,SF,32,DET,60,2,922,76,193,.394,7,23,.304,69,170,.406,.412,34,54,.630,22,78,100,44,29,13,30,85,193,2012
Deron Williams,PG,27,NJN,55,55,1999,391,961,.407,115,342,.336,276,619,.446,.467,257,305,.843,23,160,183,481,67,20,219,121,1154,2012
Derrick Williams,PF,20,MIN,66,15,1418,205,498,.412,37,138,.268,168,360,.467,.449,136,195,.697,77,234,311,38,30,31,77,95,583,2012
Elliot Williams,SG,22,POR,24,0,149,37,74,.500,8,27,.296,29,47,.617,.554,6,18,.333,7,12,19,6,6,3,5,18,88,2012
Jordan Williams,C,21,NJN,43,5,635,77,152,.507,0,0,.000,77,152,.507,.507,43,66,.652,66,90,156,11,21,15,23,61,197,2012
Lou Williams,PG,25,PHI,64,0,1682,318,782,.407,83,229,.362,235,553,.425,.460,237,292,.812,30,125,155,221,53,18,71,90,956,2012
Marvin Williams,SF,25,ATL,57,37,1500,203,470,.432,58,149,.389,145,321,.452,.494,115,146,.788,76,218,294,71,47,18,39,84,579,2012
Mo Williams,SG,29,LAC,52,1,1472,260,611,.426,93,239,.389,167,372,.449,.502,72,80,.900,23,76,99,160,51,7,86,103,685,2012
Reggie Williams,SF,25,CHA,33,13,747,106,255,.416,33,107,.308,73,148,.493,.480,29,40,.725,27,66,93,60,20,3,33,34,274,2012
Sean Williams,C,25,TOT,11,0,107,14,22,.636,0,0,.000,14,22,.636,.636,12,13,.923,13,12,25,5,4,8,10,18,40,2012
Sean Williams,C,25,DAL,8,0,65,12,16,.750,0,0,.000,12,16,.750,.750,5,6,.833,9,4,13,2,1,5,7,14,29,2012
Sean Williams,C,25,BOS,3,0,42,2,6,.333,0,0,.000,2,6,.333,.333,7,7,1.000,4,8,12,3,3,3,3,4,11,2012
Shawne Williams,SF,25,NJN,25,6,514,42,147,.286,21,87,.241,21,60,.350,.357,8,11,.727,20,48,68,16,10,11,13,44,113,2012
Shelden Williams,C,28,NJN,58,35,1276,96,201,.478,0,0,.000,96,201,.478,.478,76,104,.731,141,209,350,35,47,39,66,149,268,2012
Terrence Williams,SG,24,TOT,30,0,550,85,198,.429,16,46,.348,69,152,.454,.470,27,46,.587,13,89,102,65,20,7,43,35,213,2012
Terrence Williams,SG,24,HOU,12,0,181,20,57,.351,8,19,.421,12,38,.316,.421,6,12,.500,2,26,28,10,4,1,10,16,54,2012
Terrence Williams,SG,24,SAC,18,0,369,65,141,.461,8,27,.296,57,114,.500,.489,21,34,.618,11,63,74,55,16,6,33,19,159,2012
Metta World Peace,SF,32,LAL,64,45,1720,183,465,.394,56,189,.296,127,276,.460,.454,71,115,.617,71,147,218,140,69,27,69,137,493,2012
Brandan Wright,C,24,DAL,49,0,791,144,233,.618,0,1,.000,144,232,.621,.618,52,82,.634,62,112,174,13,22,63,21,61,340,2012
Chris Wright,SF,23,GSW,24,1,186,23,45,.511,0,0,.000,23,45,.511,.511,24,31,.774,19,26,45,4,7,13,8,22,70,2012
Dorell Wright,SF,26,GSW,61,61,1650,222,526,.422,105,292,.360,117,234,.500,.522,80,98,.816,60,218,278,94,58,26,51,97,629,2012
Nick Young,SG,26,TOT,62,35,1729,316,784,.403,103,282,.365,213,502,.424,.469,144,169,.852,31,102,133,56,44,17,83,141,879,2012
Nick Young,SG,26,WAS,40,32,1211,240,591,.406,73,197,.371,167,394,.424,.468,112,130,.862,20,77,97,46,30,11,59,90,665,2012
Nick Young,SG,26,LAC,22,3,518,76,193,.394,30,85,.353,46,108,.426,.472,32,39,.821,11,25,36,10,14,6,24,51,214,2012
Sam Young,SF,26,TOT,35,2,375,45,127,.354,5,17,.294,40,110,.364,.374,19,26,.731,20,42,62,15,17,6,16,23,114,2012
Sam Young,SF,26,MEM,21,2,240,32,83,.386,0,9,.000,32,74,.432,.386,10,12,.833,14,27,41,9,11,2,9,12,74,2012
Sam Young,SF,26,PHI,14,0,135,13,44,.295,5,8,.625,8,36,.222,.352,9,14,.643,6,15,21,6,6,4,7,11,40,2012
Thaddeus Young,PF,23,PHI,63,1,1755,348,687,.507,1,4,.250,347,683,.508,.507,111,144,.771,137,188,325,74,64,41,55,127,808,2012
Jeff Adrien,PF,24,GSW,23,0,196,23,54,.426,0,0,.000,23,54,.426,.426,11,19,.579,23,35,58,10,4,5,9,28,57,2011
Arron Afflalo,SG,25,DEN,69,69,2324,312,627,.498,105,248,.423,207,379,.546,.581,138,163,.847,45,206,251,168,34,31,71,153,867,2011
Maurice Ager,SG,26,MIN,4,0,29,6,11,.545,3,4,.750,3,7,.429,.682,0,0,.000,0,2,2,1,1,0,4,4,15,2011
Alexis Ajinca,C,22,TOT,34,2,340,59,133,.444,12,34,.353,47,99,.475,.489,13,18,.722,17,61,78,10,11,19,18,73,143,2011
Alexis Ajinca,C,22,DAL,10,2,75,12,32,.375,3,7,.429,9,25,.360,.422,2,3,.667,5,12,17,2,3,5,1,13,29,2011
Alexis Ajinca,C,22,TOR,24,0,265,47,101,.465,9,27,.333,38,74,.514,.510,11,15,.733,12,49,61,8,8,14,17,60,114,2011
Solomon Alabi,C,22,TOR,12,0,59,3,15,.200,0,0,.000,3,15,.200,.200,0,2,.000,7,7,14,2,2,2,3,5,6,2011
Cole Aldrich,C,22,OKC,18,0,142,8,15,.533,0,0,.000,8,15,.533,.533,2,4,.500,13,22,35,4,5,7,8,30,18,2011
LaMarcus Aldridge,PF,25,POR,81,81,3211,707,1415,.500,4,23,.174,703,1392,.505,.501,351,444,.791,278,431,709,170,82,94,153,220,1769,2011
Malik Allen,PF,32,ORL,18,0,178,11,31,.355,0,0,.000,11,31,.355,.355,1,2,.500,12,20,32,4,1,4,3,30,23,2011
Ray Allen,SG,35,BOS,80,80,2890,480,978,.491,168,378,.444,312,600,.520,.577,193,219,.881,51,223,274,219,77,16,117,147,1321,2011
Tony Allen,SG,29,MEM,72,31,1494,251,492,.510,4,23,.174,247,469,.527,.514,137,182,.753,70,123,193,104,129,44,86,161,643,2011
Al-Farouq Aminu,SF,20,LAC,81,14,1452,160,406,.394,45,143,.315,115,263,.437,.450,92,119,.773,75,192,267,60,59,25,103,121,457,2011
Lou Amundson,PF,28,GSW,46,7,691,83,183,.454,0,0,.000,83,183,.454,.454,34,87,.391,81,104,185,17,14,33,24,87,200,2011
Chris Andersen,C,32,DEN,45,0,732,82,137,.599,0,1,.000,82,136,.603,.599,86,135,.637,75,144,219,20,23,58,25,79,250,2011
David Andersen,PF,30,TOT,40,0,373,56,121,.463,8,23,.348,48,98,.490,.496,14,22,.636,20,64,84,13,5,9,22,40,134,2011
David Andersen,PF,30,TOR,11,0,150,23,47,.489,3,10,.300,20,37,.541,.521,7,7,1.000,8,26,34,7,3,3,8,11,56,2011
David Andersen,PF,30,NOH,29,0,223,33,74,.446,5,13,.385,28,61,.459,.480,7,15,.467,12,38,50,6,2,6,14,29,78,2011
James Anderson,SF,21,SAS,26,2,286,31,81,.383,18,46,.391,13,35,.371,.494,14,18,.778,2,21,23,18,3,6,13,24,94,2011
Ryan Anderson,PF,22,ORL,64,14,1424,226,525,.430,134,341,.393,92,184,.500,.558,95,117,.812,129,226,355,52,30,38,49,137,681,2011
Carmelo Anthony,SF,26,TOT,77,77,2751,684,1503,.455,95,251,.378,589,1252,.470,.487,507,605,.838,118,445,563,221,68,46,206,224,1970,2011
Carmelo Anthony,SF,26,DEN,50,50,1774,437,967,.452,42,126,.333,395,841,.470,.474,343,417,.823,77,305,382,140,43,31,142,134,1259,2011
Carmelo Anthony,SF,26,NYK,27,27,977,247,536,.461,53,125,.424,194,411,.472,.510,164,188,.872,41,140,181,81,25,15,64,90,711,2011
Joel Anthony,C,28,MIA,75,11,1463,53,99,.535,0,0,.000,53,99,.535,.535,47,73,.644,104,162,266,24,10,93,36,194,153,2011
Gilbert Arenas,PG,29,TOT,70,16,1796,269,734,.366,97,327,.297,172,407,.423,.433,120,153,.784,22,167,189,274,74,21,177,188,755,2011
Gilbert Arenas,PG,29,WAS,21,14,726,130,330,.394,47,145,.324,83,185,.449,.465,56,67,.836,6,64,70,117,30,12,71,76,363,2011
Gilbert Arenas,PG,29,ORL,49,2,1070,139,404,.344,50,182,.275,89,222,.401,.406,64,86,.744,16,103,119,157,44,9,106,112,392,2011
Trevor Ariza,SF,25,NOH,75,75,2600,303,762,.398,82,271,.303,221,491,.450,.451,138,197,.701,61,347,408,162,120,31,118,180,826,2011
Hilton Armstrong,C,26,TOT,53,2,488,37,76,.487,2,4,.500,35,72,.486,.500,16,33,.485,42,89,131,14,18,21,28,84,92,2011
Hilton Armstrong,C,26,WAS,41,2,412,31,64,.484,1,3,.333,30,61,.492,.492,14,23,.609,39,75,114,10,15,16,25,75,77,2011
Hilton Armstrong,C,26,ATL,12,0,76,6,12,.500,1,1,1.000,5,11,.455,.542,2,10,.200,3,14,17,4,3,5,3,9,15,2011
Carlos Arroyo,PG,31,TOT,64,43,1185,120,273,.440,31,69,.449,89,204,.436,.496,39,47,.830,20,83,103,125,21,1,60,71,310,2011
Carlos Arroyo,PG,31,MIA,49,42,995,109,238,.458,28,64,.438,81,174,.466,.517,28,35,.800,13,67,80,100,14,1,43,60,274,2011
Carlos Arroyo,PG,31,BOS,15,1,190,11,35,.314,3,5,.600,8,30,.267,.357,11,12,.917,7,16,23,25,7,0,17,11,36,2011
Darrell Arthur,PF,22,MEM,80,9,1609,310,624,.497,0,6,.000,310,618,.502,.497,109,134,.813,115,227,342,53,52,63,88,228,729,2011
Omer Asik,C,24,CHI,82,0,989,78,141,.553,0,0,.000,78,141,.553,.553,73,145,.503,112,194,306,32,20,56,64,153,229,2011
D.J. Augustin,PG,23,CHA,82,82,2757,399,958,.416,111,333,.333,288,625,.461,.474,269,297,.906,38,187,225,498,54,3,155,152,1178,2011
Luke Babbitt,SF,21,POR,24,0,137,15,55,.273,3,16,.188,12,39,.308,.300,3,9,.333,6,24,30,6,2,2,8,15,36,2011
Renaldo Balkman,SF,26,TOT,8,0,62,6,13,.462,1,2,.500,5,11,.455,.500,3,4,.750,2,5,7,2,4,2,1,15,16,2011
Renaldo Balkman,SF,26,DEN,5,0,44,5,9,.556,0,0,.000,5,9,.556,.556,3,4,.750,1,3,4,2,3,2,0,11,13,2011
Renaldo Balkman,SF,26,NYK,3,0,18,1,4,.250,1,2,.500,0,2,.000,.375,0,0,.000,1,2,3,0,1,0,1,4,3,2011
Marcus Banks,PG,29,TOR,3,0,22,0,2,.000,0,0,.000,0,2,.000,.000,6,8,.750,0,1,1,3,1,0,2,4,6,2011
Leandro Barbosa,SG,28,TOR,58,0,1395,294,653,.450,72,213,.338,222,440,.505,.505,109,137,.796,14,85,99,119,50,6,84,112,769,2011
J.J. Barea,PG,26,DAL,81,2,1669,285,649,.439,66,189,.349,219,460,.476,.490,133,157,.847,29,130,159,317,30,1,136,136,769,2011
Andrea Bargnani,C,25,TOR,66,66,2353,525,1173,.448,77,223,.345,448,950,.472,.480,287,350,.820,74,269,343,119,34,46,152,160,1414,2011
Matt Barnes,SF,30,LAL,53,0,1020,131,279,.470,34,107,.318,97,172,.564,.530,60,77,.779,73,155,228,71,39,22,58,127,356,2011
Earl Barron,C,29,TOT,21,7,305,32,99,.323,0,0,.000,32,99,.323,.323,15,24,.625,32,44,76,11,8,6,16,46,79,2011
Earl Barron,C,29,PHO,12,6,183,12,51,.235,0,0,.000,12,51,.235,.235,12,20,.600,16,24,40,4,6,4,11,32,36,2011
Earl Barron,C,29,MIL,7,0,85,17,37,.459,0,0,.000,17,37,.459,.459,2,2,1.000,12,10,22,4,2,2,2,10,36,2011
Earl Barron,C,29,POR,2,1,37,3,11,.273,0,0,.000,3,11,.273,.273,1,2,.500,4,10,14,3,0,0,3,4,7,2011
Brandon Bass,PF,25,ORL,76,51,1980,332,645,.515,0,2,.000,332,643,.516,.515,190,233,.815,134,290,424,57,27,52,97,159,854,2011
Tony Battie,C,34,PHI,38,0,377,45,96,.469,2,3,.667,43,93,.462,.479,8,14,.571,17,82,99,12,5,15,12,59,100,2011
Shane Battier,SF,32,TOT,82,59,2375,229,509,.450,102,267,.382,127,242,.525,.550,64,93,.688,90,283,373,185,69,81,79,158,624,2011
Shane Battier,SF,32,HOU,59,59,1818,186,408,.456,88,225,.391,98,183,.536,.564,49,76,.645,58,223,281,153,53,71,63,127,509,2011
Shane Battier,SF,32,MEM,23,0,557,43,101,.426,14,42,.333,29,59,.492,.495,15,17,.882,32,60,92,32,16,10,16,31,115,2011
Nicolas Batum,SF,22,POR,80,67,2522,367,807,.455,118,342,.345,249,465,.535,.528,138,164,.841,109,252,361,123,68,49,83,194,990,2011
Jerryd Bayless,PG,22,TOT,71,14,1496,218,517,.422,49,146,.336,169,371,.456,.469,166,206,.806,26,139,165,266,38,5,127,149,651,2011
Jerryd Bayless,PG,22,NOH,11,0,149,17,49,.347,3,14,.214,14,35,.400,.378,13,17,.765,2,13,15,28,2,1,17,16,50,2011
Jerryd Bayless,PG,22,TOR,60,14,1347,201,468,.429,46,132,.348,155,336,.461,.479,153,189,.810,24,126,150,238,36,4,110,133,601,2011
Michael Beasley,SF,22,MIN,73,73,2361,561,1246,.450,60,164,.366,501,1082,.463,.474,219,291,.753,118,291,409,158,54,52,195,222,1401,2011
Rodrigue Beaubois,PG,22,DAL,28,26,496,94,223,.422,25,83,.301,69,140,.493,.478,23,30,.767,7,45,52,64,20,8,47,76,236,2011
Marco Belinelli,SG,24,NOH,80,69,1957,302,691,.437,134,324,.414,168,367,.458,.534,98,125,.784,17,134,151,92,38,6,77,146,836,2011
Charlie Bell,SG,31,GSW,19,0,171,12,43,.279,6,21,.286,6,22,.273,.349,2,4,.500,6,12,18,13,6,1,6,13,32,2011
Raja Bell,SG,34,UTA,68,63,2097,191,467,.409,68,193,.352,123,274,.449,.482,91,102,.892,31,145,176,118,56,14,63,169,541,2011
Mike Bibby,PG,32,TOT,80,68,2285,248,576,.431,153,348,.440,95,228,.417,.563,39,62,.629,17,178,195,265,50,9,101,175,688,2011
Mike Bibby,PG,32,ATL,56,56,1674,192,441,.435,113,256,.441,79,185,.427,.563,29,46,.630,15,128,143,202,38,6,68,125,526,2011
Mike Bibby,PG,32,WAS,2,0,29,1,9,.111,0,4,.000,1,5,.200,.111,0,0,.000,0,3,3,8,1,0,1,3,2,2011
Mike Bibby,PG,32,MIA,22,12,582,55,126,.437,40,88,.455,15,38,.395,.595,10,16,.625,2,47,49,55,11,3,32,47,160,2011
Andris Biedrins,C,24,GSW,59,55,1397,142,266,.534,0,0,.000,142,266,.534,.534,10,31,.323,145,281,426,60,52,52,57,198,294,2011
Chauncey Billups,PG,34,TOT,72,72,2310,339,794,.427,146,363,.402,193,431,.448,.519,384,419,.916,25,165,190,387,71,14,177,146,1208,2011
Chauncey Billups,PG,34,DEN,51,51,1646,235,536,.438,105,238,.441,130,298,.436,.536,265,287,.923,12,113,125,271,52,12,129,94,840,2011
Chauncey Billups,PG,34,NYK,21,21,664,104,258,.403,41,125,.328,63,133,.474,.483,119,132,.902,13,52,65,116,19,2,48,52,368,2011
DeJuan Blair,PF,21,SAS,81,65,1734,292,583,.501,0,2,.000,292,581,.503,.501,90,137,.657,215,350,565,77,95,42,113,213,674,2011
Steve Blake,PG,30,LAL,79,0,1581,110,306,.359,73,193,.378,37,113,.327,.479,26,30,.867,19,137,156,170,40,3,73,99,319,2011
Andray Blatche,PF,24,WAS,64,63,2172,426,957,.445,4,18,.222,422,939,.449,.447,220,283,.777,183,343,526,144,98,51,172,182,1076,2011
Eric Bledsoe,PG,21,LAC,81,25,1841,206,486,.424,32,116,.276,174,370,.470,.457,99,133,.744,68,155,223,289,92,26,194,130,543,2011
Keith Bogans,SG,30,CHI,82,82,1461,124,307,.404,90,237,.380,34,70,.486,.550,21,32,.656,19,129,148,101,38,9,41,113,359,2011
Andrew Bogut,C,26,MIL,65,65,2297,367,742,.495,0,4,.000,367,738,.497,.495,96,217,.442,199,521,720,131,47,168,125,217,830,2011
Matt Bonner,PF,30,SAS,66,1,1432,172,371,.464,105,230,.457,67,141,.475,.605,32,43,.744,60,179,239,60,26,21,27,110,481,2011
Trevor Booker,PF,23,WAS,65,14,1063,139,253,.549,0,1,.000,139,252,.552,.549,68,101,.673,98,153,251,35,29,42,38,115,346,2011
Carlos Boozer,C,29,CHI,59,59,1882,431,845,.510,0,0,.000,431,845,.510,.510,171,244,.701,130,435,565,145,45,18,149,186,1033,2011
Chris Bosh,PF,26,MIA,77,77,2795,524,1056,.496,6,25,.240,518,1031,.502,.499,384,471,.815,141,500,641,144,59,49,138,172,1438,2011
Earl Boykins,PG,34,MIL,57,0,862,156,352,.443,27,71,.380,129,281,.459,.482,69,82,.841,15,40,55,141,38,3,52,43,408,2011
Craig Brackins,PF,23,PHI,3,0,33,4,16,.250,0,5,.000,4,11,.364,.250,0,0,.000,2,2,4,1,1,0,0,3,8,2011
Avery Bradley,PG,20,BOS,31,0,162,23,67,.343,0,5,.000,23,62,.371,.343,6,12,.500,4,13,17,12,9,0,16,20,52,2011
Elton Brand,PF,31,PHI,81,81,2809,502,981,.512,0,1,.000,502,980,.512,.512,213,273,.780,237,439,676,120,92,106,101,244,1217,2011
Corey Brewer,SF-SG,24,TOT,69,24,1510,193,488,.395,30,112,.268,163,376,.434,.426,136,192,.708,57,118,175,89,100,16,87,159,552,2011
Corey Brewer,SF,24,MIN,56,22,1362,168,437,.384,26,99,.263,142,338,.420,.414,121,171,.708,45,107,152,77,89,14,77,134,483,2011
Corey Brewer,SG,24,DAL,13,2,148,25,51,.490,4,13,.308,21,38,.553,.529,15,21,.714,12,11,23,12,11,2,10,25,69,2011
Ronnie Brewer,SG,25,CHI,81,1,1781,205,427,.480,6,27,.222,199,400,.498,.487,87,133,.654,55,207,262,140,106,22,55,82,503,2011
Jon Brockman,C,23,MIL,63,6,677,48,94,.511,0,0,.000,48,94,.511,.511,40,59,.678,74,110,184,18,14,3,24,119,136,2011
Aaron Brooks,PG,26,TOT,59,12,1284,220,587,.375,70,236,.297,150,351,.427,.434,124,140,.886,20,58,78,233,34,3,99,115,634,2011
Aaron Brooks,PG,26,HOU,34,7,811,134,387,.346,48,169,.284,86,218,.394,.408,78,83,.940,11,40,51,129,21,2,55,69,394,2011
Aaron Brooks,PG,26,PHO,25,5,473,86,200,.430,22,67,.328,64,133,.481,.485,46,57,.807,9,18,27,104,13,1,44,46,240,2011
Derrick Brown,SF,23,TOT,49,1,576,74,131,.565,5,10,.500,69,121,.570,.584,32,60,.533,41,58,99,33,20,10,35,59,185,2011
Derrick Brown,SF,23,CHA,41,1,488,62,113,.549,2,6,.333,60,107,.561,.558,25,47,.532,32,52,84,29,16,8,28,48,151,2011
Derrick Brown,SF,23,NYK,8,0,88,12,18,.667,3,4,.750,9,14,.643,.750,7,13,.538,9,6,15,4,4,2,7,11,34,2011
Kwame Brown,C,28,CHA,66,50,1714,194,375,.517,0,0,.000,194,375,.517,.517,136,231,.589,147,303,450,43,26,39,69,174,524,2011
Shannon Brown,SG,25,LAL,82,0,1568,273,643,.425,74,212,.349,199,431,.462,.482,92,101,.911,35,122,157,96,67,16,75,124,712,2011
Kobe Bryant,SG,32,LAL,82,82,2779,740,1639,.451,115,356,.323,625,1283,.487,.487,483,583,.828,83,336,419,388,99,12,243,172,2078,2011
Chase Budinger,SF,22,HOU,78,22,1738,279,656,.425,89,274,.325,190,382,.497,.493,118,138,.855,52,229,281,127,41,18,67,114,765,2011
Caron Butler,SF,30,DAL,29,29,867,170,378,.450,28,65,.431,142,313,.454,.487,68,88,.773,22,96,118,46,28,8,49,59,436,2011
Rasual Butler,SG,31,TOT,47,2,770,79,237,.333,46,136,.338,33,101,.327,.430,18,27,.667,10,67,77,27,8,15,24,37,222,2011
Rasual Butler,SG,31,LAC,41,2,744,73,226,.323,42,129,.326,31,97,.320,.416,18,27,.667,10,66,76,27,8,15,22,34,206,2011
Rasual Butler,SG,31,CHI,6,0,26,6,11,.545,4,7,.571,2,4,.500,.727,0,0,.000,0,1,1,0,0,0,2,3,16,2011
Andrew Bynum,C,23,LAL,54,47,1500,237,413,.574,0,0,.000,237,413,.574,.574,138,209,.660,170,338,508,73,19,106,74,140,612,2011
Will Bynum,PG,28,DET,61,5,1125,182,406,.448,16,50,.320,166,356,.466,.468,102,122,.836,15,59,74,195,52,4,83,113,482,2011
Jose Calderon,PG,29,TOR,68,55,2102,262,596,.440,57,156,.365,205,440,.466,.487,88,103,.854,30,172,202,605,81,7,148,143,669,2011
Marcus Camby,C,36,POR,59,51,1540,117,294,.398,0,1,.000,117,293,.399,.398,43,70,.614,182,424,606,121,40,92,62,140,277,2011
Derrick Caracter,C,22,LAL,41,0,215,32,66,.485,0,0,.000,32,66,.485,.485,17,23,.739,19,24,43,7,4,10,19,47,81,2011
Brian Cardinal,SF,33,DAL,56,4,618,43,100,.430,42,87,.483,1,13,.077,.640,17,18,.944,10,49,59,40,24,7,17,82,145,2011
Rodney Carney,SF,26,TOT,27,1,336,46,110,.418,17,38,.447,29,72,.403,.495,18,27,.667,13,35,48,11,12,5,16,33,127,2011
Rodney Carney,SF,26,GSW,25,1,331,45,107,.421,17,37,.459,28,70,.400,.500,18,27,.667,12,35,47,11,11,5,16,33,125,2011
Rodney Carney,SF,26,MEM,2,0,5,1,3,.333,0,1,.000,1,2,.500,.333,0,0,.000,1,0,1,0,1,0,0,0,2,2011
DeMarre Carroll,PF,24,TOT,12,0,50,4,12,.333,0,0,.000,4,12,.333,.333,2,2,1.000,2,6,8,4,1,1,0,5,10,2011
DeMarre Carroll,PF,24,MEM,7,0,39,4,9,.444,0,0,.000,4,9,.444,.444,2,2,1.000,2,6,8,2,1,1,0,5,10,2011
DeMarre Carroll,PF,24,HOU,5,0,11,0,3,.000,0,0,.000,0,3,.000,.000,0,0,.000,0,0,0,2,0,0,0,0,0,2011
Matt Carroll,SG,30,CHA,54,1,582,89,199,.447,17,46,.370,72,153,.471,.490,40,52,.769,12,56,68,23,17,6,23,43,235,2011
Anthony Carter,PG,35,TOT,33,0,463,45,106,.425,12,40,.300,33,66,.500,.481,8,8,1.000,7,44,51,69,27,6,39,49,110,2011
Anthony Carter,PG,35,DEN,14,0,153,10,30,.333,4,12,.333,6,18,.333,.400,2,2,1.000,0,12,12,26,9,1,14,19,26,2011
Anthony Carter,PG,35,NYK,19,0,310,35,76,.461,8,28,.286,27,48,.563,.513,6,6,1.000,7,32,39,43,18,5,25,30,84,2011
Vince Carter,SG,34,TOT,73,63,2051,389,891,.437,116,321,.361,273,570,.479,.502,128,173,.740,54,221,275,146,67,20,90,193,1022,2011
Vince Carter,SG,34,ORL,22,22,664,125,266,.470,27,78,.346,98,188,.521,.521,56,75,.747,11,79,90,64,20,3,36,70,333,2011
Vince Carter,SG,34,PHO,51,41,1387,264,625,.422,89,243,.366,175,382,.458,.494,72,98,.735,43,142,185,82,47,17,54,123,689,2011
Omri Casspi,SF,22,SAC,71,27,1702,225,546,.412,92,247,.372,133,299,.445,.496,68,101,.673,74,233,307,74,54,13,68,115,610,2011
Mario Chalmers,PG,24,MIA,70,28,1579,155,388,.399,83,231,.359,72,157,.459,.506,54,62,.871,12,134,146,177,76,7,91,158,447,2011
Tyson Chandler,C,28,DAL,74,74,2059,266,407,.654,0,0,.000,266,407,.654,.654,216,295,.732,206,486,692,32,36,80,88,240,748,2011
Wilson Chandler,SF,23,TOT,72,49,2401,429,953,.450,112,320,.350,317,633,.501,.509,130,161,.807,75,333,408,120,48,94,104,199,1100,2011
Wilson Chandler,SF,23,NYK,51,30,1759,328,712,.461,86,245,.351,242,467,.518,.521,96,119,.807,62,241,303,86,34,70,67,152,838,2011
Wilson Chandler,SF,23,DEN,21,19,642,101,241,.419,26,75,.347,75,166,.452,.473,34,42,.810,13,92,105,34,14,24,37,47,262,2011
Josh Childress,SG,27,PHO,54,3,894,121,214,.565,1,16,.063,120,198,.606,.568,29,59,.492,69,86,155,42,33,23,44,68,272,2011
Earl Clark,SF,23,TOT,42,0,464,68,158,.430,0,5,.000,68,153,.444,.430,27,47,.574,37,64,101,9,8,18,28,45,163,2011
Earl Clark,SF,23,PHO,9,0,72,12,31,.387,0,0,.000,12,31,.387,.387,5,10,.500,4,13,17,4,1,3,2,6,29,2011
Earl Clark,SF,23,ORL,33,0,392,56,127,.441,0,5,.000,56,122,.459,.441,22,37,.595,33,51,84,5,7,15,26,39,134,2011
Jarron Collins,C,32,TOT,28,0,181,6,21,.286,0,0,.000,6,21,.286,.286,7,10,.700,14,10,24,2,4,1,7,29,19,2011
Jarron Collins,C,32,LAC,23,0,157,5,15,.333,0,0,.000,5,15,.333,.333,7,10,.700,7,10,17,1,4,1,5,24,17,2011
Jarron Collins,C,32,POR,5,0,24,1,6,.167,0,0,.000,1,6,.167,.167,0,0,.000,7,0,7,1,0,0,2,5,2,2011
Jason Collins,C,32,ATL,49,28,593,34,71,.479,1,1,1.000,33,70,.471,.486,27,41,.659,30,72,102,22,9,9,26,97,96,2011
Sherron Collins,PG,23,CHA,20,0,66,7,25,.280,2,10,.200,5,15,.333,.320,1,1,1.000,0,5,5,8,2,0,4,2,17,2011
Darren Collison,PG,23,IND,79,79,2360,398,870,.457,41,124,.331,357,746,.479,.481,202,232,.871,40,185,225,403,87,14,194,109,1039,2011
Nick Collison,C,30,OKC,71,2,1524,137,242,.566,0,0,.000,137,242,.566,.566,55,73,.753,119,197,316,69,42,31,55,210,329,2011
Mike Conley,PG,23,MEM,81,81,2872,423,953,.444,80,217,.369,343,736,.466,.486,181,247,.733,32,215,247,528,144,18,176,182,1107,2011
Brian Cook,PF,30,LAC,40,0,447,72,170,.424,34,79,.430,38,91,.418,.524,15,24,.625,19,77,96,15,12,11,25,75,193,2011
Daequan Cook,SG,23,OKC,43,0,598,79,181,.436,65,154,.422,14,27,.519,.616,16,20,.800,8,64,72,20,14,1,17,51,239,2011
Marcus Cousin,C,24,UTA,4,0,18,2,3,.667,0,0,.000,2,3,.667,.667,0,0,.000,0,3,3,0,0,1,1,1,4,2011
DeMarcus Cousins,C,20,SAC,81,62,2309,432,1004,.430,3,18,.167,429,986,.435,.432,276,402,.687,217,482,699,204,85,68,268,332,1143,2011
Jamal Crawford,SG,30,ATL,76,0,2297,368,874,.421,119,349,.341,249,525,.474,.489,222,260,.854,22,108,130,241,57,14,145,97,1077,2011
Jordan Crawford,SG,22,TOT,42,18,1027,192,500,.384,33,128,.258,159,372,.427,.417,73,84,.869,31,74,105,117,39,3,83,63,490,2011
Jordan Crawford,SG,22,ATL,16,0,160,27,77,.351,9,27,.333,18,50,.360,.409,4,6,.667,9,19,28,15,3,0,15,13,67,2011
Jordan Crawford,SG,22,WAS,26,18,867,165,423,.390,24,101,.238,141,322,.438,.418,69,78,.885,22,55,77,102,36,3,68,50,423,2011
Dante Cunningham,PF,23,TOT,78,18,1637,218,472,.462,1,13,.077,217,459,.473,.463,45,62,.726,96,181,277,43,54,43,51,177,482,2011
Dante Cunningham,PF,23,POR,56,9,1108,126,291,.433,0,4,.000,126,287,.439,.433,32,45,.711,73,116,189,30,39,32,33,139,284,2011
Dante Cunningham,PF,23,CHA,22,9,529,92,181,.508,1,9,.111,91,172,.529,.511,13,17,.765,23,65,88,13,15,11,18,38,198,2011
Stephen Curry,PG,22,GSW,74,74,2489,505,1053,.480,151,342,.442,354,711,.498,.551,212,227,.934,52,234,286,432,109,20,226,233,1373,2011
Samuel Dalembert,C,29,SAC,80,46,1938,268,567,.473,0,2,.000,268,565,.474,.473,108,148,.730,212,445,657,67,36,116,132,225,644,2011
Erick Dampier,C,35,MIA,51,22,815,52,89,.584,0,1,.000,52,88,.591,.584,24,44,.545,53,124,177,22,14,47,32,82,128,2011
Antonio Daniels,PG,35,PHI,4,0,35,2,5,.400,0,2,.000,2,3,.667,.400,2,2,1.000,0,5,5,2,0,0,1,0,6,2011
Marquis Daniels,SF,30,BOS,49,0,938,114,232,.491,4,21,.190,110,211,.521,.500,39,57,.684,24,89,113,64,39,22,38,63,271,2011
Baron Davis,PG,31,TOT,58,44,1649,289,693,.417,81,239,.339,208,454,.458,.475,101,131,.771,35,121,156,391,78,28,146,143,760,2011
Baron Davis,PG,31,LAC,43,35,1269,214,515,.416,45,152,.296,169,363,.466,.459,79,104,.760,29,91,120,299,62,22,107,114,552,2011
Baron Davis,PG,31,CLE,15,9,380,75,178,.421,36,87,.414,39,91,.429,.522,22,27,.815,6,30,36,92,16,6,39,29,208,2011
Ed Davis,PF,21,TOR,65,17,1602,215,373,.576,0,0,.000,215,373,.576,.576,71,128,.555,168,294,462,40,39,67,48,183,501,2011
Glen Davis,C,25,BOS,78,13,2298,359,801,.448,2,15,.133,357,786,.454,.449,195,265,.736,101,324,425,92,78,30,85,231,915,2011
Austin Daye,SF,22,DET,72,16,1446,193,471,.410,69,172,.401,124,299,.415,.483,82,108,.759,64,210,274,78,39,39,59,165,537,2011
Carlos Delfino,SF,28,MIL,49,40,1590,200,513,.390,105,284,.370,95,229,.415,.492,60,75,.800,24,176,200,112,76,8,57,72,565,2011
Luol Deng,SF,25,CHI,82,82,3208,531,1155,.460,115,333,.345,416,822,.506,.510,253,336,.753,116,360,476,230,78,48,156,162,1430,2011
DeMar DeRozan,SG,21,TOR,82,82,2851,539,1154,.467,5,52,.096,534,1102,.485,.469,327,402,.813,75,240,315,148,85,31,144,217,1410,2011
Boris Diaw,PF,28,CHA,82,82,2778,381,774,.492,78,226,.345,303,548,.553,.543,84,123,.683,105,309,414,337,74,46,166,190,924,2011
Ike Diogu,PF,27,LAC,36,0,470,83,148,.561,0,0,.000,83,148,.561,.561,41,62,.661,41,74,115,2,3,3,22,72,207,2011
DeSagana Diop,C,29,CHA,16,0,181,8,24,.333,0,0,.000,8,24,.333,.333,4,11,.364,12,28,40,7,4,15,11,26,20,2011
Keyon Dooling,PG,30,MIL,80,22,1757,206,519,.397,81,234,.346,125,285,.439,.475,78,94,.830,12,105,117,243,54,4,91,119,571,2011
Joey Dorsey,C,27,TOR,43,9,522,52,99,.525,0,0,.000,52,99,.525,.525,31,65,.477,79,111,190,27,24,17,39,78,135,2011
Toney Douglas,SG,24,NYK,81,9,1971,314,755,.416,143,383,.373,171,372,.460,.511,85,107,.794,65,179,244,244,89,4,89,177,856,2011
Chris Douglas-Roberts,SF,24,MIL,44,12,884,117,273,.429,15,46,.326,102,227,.449,.456,74,89,.831,7,81,88,50,29,13,35,73,323,2011
Zabian Dowdell,PG,26,PHO,24,0,292,51,125,.408,3,10,.300,48,115,.417,.420,16,17,.941,5,15,20,51,20,2,29,30,121,2011
Goran Dragic,PG,24,TOT,70,5,1234,192,441,.435,56,155,.361,136,286,.476,.499,83,133,.624,36,106,142,204,50,10,117,125,523,2011
Goran Dragic,PG,24,PHO,48,2,856,133,316,.421,28,101,.277,105,215,.488,.465,59,97,.608,24,62,86,149,36,6,96,90,353,2011
Goran Dragic,PG,24,HOU,22,3,378,59,125,.472,28,54,.519,31,71,.437,.584,24,36,.667,12,44,56,55,14,4,21,35,170,2011
Jared Dudley,SF,25,PHO,82,15,2140,300,629,.477,105,253,.415,195,376,.519,.560,162,218,.743,111,207,318,108,87,20,77,139,867,2011
Chris Duhon,PG,28,ORL,51,5,774,49,129,.380,13,52,.250,36,77,.468,.430,14,25,.560,9,43,52,118,16,2,61,30,125,2011
Tim Duncan,C,34,SAS,76,76,2156,419,838,.500,0,4,.000,419,834,.502,.500,184,257,.716,169,509,678,203,50,146,122,119,1022,2011
Mike Dunleavy,SG,30,IND,61,44,1683,240,520,.462,102,254,.402,138,266,.519,.560,100,125,.800,28,248,276,105,40,30,69,107,682,2011
Ronald Dupree,SF,30,TOR,3,0,13,1,4,.250,0,1,.000,1,3,.333,.250,0,0,.000,0,3,3,1,0,0,0,2,2,2011
Kevin Durant,SF,22,OKC,78,78,3038,711,1538,.462,145,414,.350,566,1124,.504,.509,594,675,.880,57,476,533,214,88,76,218,159,2161,2011
Devin Ebanks,SG,21,LAL,20,0,118,21,51,.412,2,5,.400,19,46,.413,.431,18,23,.783,15,12,27,2,4,5,6,7,62,2011
Wayne Ellington,SG,23,MIN,62,8,1181,160,397,.403,48,121,.397,112,276,.406,.463,42,53,.792,26,82,108,72,28,3,53,85,410,2011
Monta Ellis,SG,25,GSW,80,80,3227,726,1611,.451,137,379,.361,589,1232,.478,.493,340,431,.789,44,237,281,450,168,23,252,203,1929,2011
Francisco Elson,C,34,UTA,62,1,610,54,113,.478,0,0,.000,54,113,.478,.478,26,31,.839,35,80,115,33,21,14,32,84,134,2011
Melvin Ely,C,32,DEN,30,2,366,28,51,.549,0,0,.000,28,51,.549,.549,13,21,.619,27,47,74,14,4,11,14,50,69,2011
Semih Erden,C,24,TOT,41,8,595,62,111,.559,0,0,.000,62,111,.559,.559,39,60,.650,37,81,118,20,15,24,34,104,163,2011
Semih Erden,C,24,BOS,37,7,531,58,97,.598,0,0,.000,58,97,.598,.598,34,54,.630,31,76,107,19,13,21,32,92,150,2011
Semih Erden,C,24,CLE,4,1,64,4,14,.286,0,0,.000,4,14,.286,.286,5,6,.833,6,5,11,1,2,3,2,12,13,2011
Jeremy Evans,SF,23,UTA,49,3,463,76,115,.661,0,1,.000,76,114,.667,.661,26,37,.703,36,61,97,24,17,17,19,50,178,2011
Maurice Evans,SF,32,TOT,73,24,1549,177,424,.417,55,167,.329,122,257,.475,.482,52,58,.897,52,104,156,45,34,14,33,129,461,2011
Maurice Evans,SF,32,ATL,47,12,837,79,201,.393,28,89,.315,51,112,.455,.463,24,28,.857,23,61,84,30,16,5,15,74,210,2011
Maurice Evans,SF,32,WAS,26,12,712,98,223,.439,27,78,.346,71,145,.490,.500,28,30,.933,29,43,72,15,18,9,18,55,251,2011
Reggie Evans,PF,30,TOR,30,18,798,42,103,.408,0,1,.000,42,102,.412,.408,48,88,.545,119,226,345,38,29,6,39,89,132,2011
Tyreke Evans,SG,21,SAC,57,53,2107,382,933,.409,43,148,.291,339,785,.432,.432,205,266,.771,46,229,275,319,85,30,184,143,1012,2011
Patrick Ewing,SF,26,NOH,7,0,19,0,5,.000,0,2,.000,0,3,.000,.000,3,4,.750,1,1,2,2,0,1,1,1,3,2011
Christian Eyenga,SF,21,CLE,44,18,947,130,306,.425,25,91,.275,105,215,.488,.466,18,28,.643,27,96,123,35,34,28,47,78,303,2011
Jordan Farmar,PG,24,NJN,73,18,1796,255,651,.392,109,304,.359,146,347,.421,.475,82,100,.820,24,149,173,368,62,6,139,128,701,2011
Derrick Favors,PF,19,TOT,78,27,1535,215,416,.517,0,0,.000,215,416,.517,.517,103,173,.595,171,241,412,39,29,68,77,246,533,2011
Derrick Favors,PF,19,NJN,56,23,1091,141,276,.511,0,0,.000,141,276,.511,.511,71,116,.612,126,171,297,21,18,41,56,183,353,2011
Derrick Favors,PF,19,UTA,22,4,444,74,140,.529,0,0,.000,74,140,.529,.529,32,57,.561,45,70,115,18,11,27,21,63,180,2011
Raymond Felton,PG-SG,26,TOT,75,54,2737,427,1005,.425,116,329,.353,311,676,.460,.483,194,241,.805,48,221,269,625,125,11,221,150,1164,2011
Raymond Felton,PG,26,NYK,54,54,2074,339,801,.423,88,268,.328,251,533,.471,.478,157,181,.867,40,154,194,488,97,11,176,113,923,2011
Raymond Felton,SG,26,DEN,21,0,663,88,204,.431,28,61,.459,60,143,.420,.500,37,60,.617,8,67,75,137,28,0,45,37,241,2011
Rudy Fernandez,SG,25,POR,78,3,1821,213,575,.370,116,361,.321,97,214,.453,.471,126,146,.863,37,135,172,193,87,14,88,134,668,2011
Kyrylo Fesenko,C,24,UTA,53,1,456,44,100,.440,0,1,.000,44,99,.444,.440,18,46,.391,34,74,108,18,4,16,25,90,106,2011
Landry Fields,SG,22,NYK,82,81,2541,299,602,.497,86,219,.393,213,383,.556,.568,113,147,.769,105,416,521,155,80,17,107,114,797,2011
Derek Fisher,PG,36,LAL,82,82,2297,206,529,.389,63,159,.396,143,370,.386,.449,83,103,.806,14,138,152,224,99,8,70,192,558,2011
Jonny Flynn,PG,21,MIN,53,8,983,108,296,.365,31,100,.310,77,196,.393,.417,32,42,.762,12,65,77,182,34,3,113,58,279,2011
Gary Forbes,SF,25,DEN,63,11,791,124,273,.454,19,58,.328,105,215,.488,.489,59,87,.678,28,88,116,49,23,6,46,77,326,2011
T.J. Ford,PG,27,IND,41,3,773,91,236,.386,6,32,.188,85,204,.417,.398,35,48,.729,17,64,81,141,35,8,63,69,223,2011
Jeff Foster,C,34,IND,56,3,940,80,167,.479,0,3,.000,80,164,.488,.479,27,48,.563,160,190,350,46,24,31,26,127,187,2011
Randy Foye,SG,27,LAC,63,24,1551,206,531,.388,71,217,.327,135,314,.430,.455,133,149,.893,13,90,103,170,47,21,95,122,616,2011
Channing Frye,PF,27,PHO,77,64,2541,358,829,.432,171,439,.390,187,390,.479,.535,89,107,.832,65,448,513,96,46,79,73,272,976,2011
Dan Gadzuric,C-PF,32,TOT,42,9,463,54,129,.419,0,1,.000,54,128,.422,.419,10,27,.370,71,64,135,14,13,29,29,91,118,2011
Dan Gadzuric,C,32,GSW,28,4,297,37,88,.420,0,1,.000,37,87,.425,.420,5,14,.357,53,33,86,11,10,18,21,63,79,2011
Dan Gadzuric,PF,32,NJN,14,5,166,17,41,.415,0,0,.000,17,41,.415,.415,5,13,.385,18,31,49,3,3,11,8,28,39,2011
Sundiata Gaines,PG,24,TOT,24,0,301,42,105,.400,9,38,.237,33,67,.493,.443,18,36,.500,13,25,38,42,16,1,27,25,111,2011
Sundiata Gaines,PG,24,MIN,8,0,65,7,22,.318,2,6,.333,5,16,.313,.364,5,10,.500,1,5,6,6,3,0,6,4,21,2011
Sundiata Gaines,PG,24,TOR,6,0,90,15,35,.429,3,15,.200,12,20,.600,.471,2,6,.333,2,6,8,11,4,1,8,10,35,2011
Sundiata Gaines,PG,24,NJN,10,0,146,20,48,.417,4,17,.235,16,31,.516,.458,11,20,.550,10,14,24,25,9,0,13,11,55,2011
Danilo Gallinari,PF-SF,22,TOT,62,60,2104,265,640,.414,103,293,.352,162,347,.467,.495,337,391,.862,59,246,305,104,51,27,83,144,970,2011
Danilo Gallinari,PF,22,NYK,48,48,1671,211,509,.415,83,239,.347,128,270,.474,.496,259,290,.893,48,181,229,82,38,18,58,117,764,2011
Danilo Gallinari,SF,22,DEN,14,12,433,54,131,.412,20,54,.370,34,77,.442,.489,78,101,.772,11,65,76,22,13,9,25,27,206,2011
Francisco Garcia,SF,29,SAC,58,34,1386,207,475,.436,81,224,.362,126,251,.502,.521,65,76,.855,24,109,133,71,51,49,45,126,560,2011
Kevin Garnett,PF,34,BOS,71,71,2220,434,822,.528,1,5,.200,433,817,.530,.529,187,217,.862,83,548,631,171,95,57,115,148,1056,2011
Marc Gasol,C,26,MEM,81,81,2586,364,691,.527,3,7,.429,361,684,.528,.529,220,294,.748,154,415,569,200,74,136,146,265,951,2011
Pau Gasol,C,30,LAL,82,82,3037,593,1120,.529,1,3,.333,592,1117,.530,.530,354,430,.823,268,568,836,273,48,130,142,203,1541,2011
Rudy Gay,SF,24,MEM,54,54,2152,409,869,.471,57,144,.396,352,725,.486,.503,194,241,.805,82,254,336,153,91,58,135,131,1069,2011
Alonzo Gee,SG,23,TOT,56,34,1118,121,264,.458,17,51,.333,104,213,.488,.491,72,92,.783,62,120,182,38,40,18,55,94,331,2011
Alonzo Gee,SG,23,SAS,5,0,18,1,3,.333,0,0,.000,1,3,.333,.333,0,0,.000,2,1,3,0,0,2,3,3,2,2011
Alonzo Gee,SG,23,WAS,11,5,127,12,27,.444,0,2,.000,12,25,.480,.444,8,12,.667,11,11,22,5,7,0,8,10,32,2011
Alonzo Gee,SG,23,CLE,40,29,973,108,234,.462,17,49,.347,91,185,.492,.498,64,80,.800,49,108,157,33,33,16,44,81,297,2011
Paul George,SG,20,IND,61,19,1265,179,395,.453,41,138,.297,138,257,.537,.505,77,101,.762,37,187,224,65,62,26,70,127,476,2011
Daniel Gibson,SG,24,CLE,67,15,1865,264,660,.400,118,293,.403,146,367,.398,.489,134,163,.822,24,153,177,201,48,21,80,154,780,2011
Taj Gibson,PF,25,CHI,80,19,1742,234,502,.466,1,8,.125,233,494,.472,.467,100,148,.676,162,296,458,58,39,106,71,203,569,2011
Manu Ginobili,SG,33,SAS,80,79,2426,441,1018,.433,154,441,.349,287,577,.497,.509,357,410,.871,42,253,295,393,123,28,174,163,1393,2011
Ryan Gomes,SF,28,LAC,76,62,2095,207,505,.410,72,211,.341,135,294,.459,.481,61,85,.718,61,193,254,118,62,12,55,159,547,2011
Drew Gooden,PF,29,MIL,35,18,860,156,362,.431,3,20,.150,153,342,.447,.435,81,102,.794,73,165,238,47,21,18,46,98,396,2011
Ben Gordon,SG,27,DET,82,27,2131,339,770,.440,107,266,.402,232,504,.460,.510,136,160,.850,41,154,195,171,48,16,141,178,921,2011
Eric Gordon,SG,22,LAC,56,56,2112,427,949,.450,106,291,.364,321,658,.488,.506,287,348,.825,45,119,164,244,71,18,151,115,1247,2011
Marcin Gortat,C,26,TOT,80,14,2032,338,603,.561,1,4,.250,337,599,.563,.561,140,193,.725,148,483,631,70,36,91,81,188,817,2011
Marcin Gortat,C,26,ORL,25,2,396,44,81,.543,0,0,.000,44,81,.543,.543,12,18,.667,38,80,118,17,7,21,17,52,100,2011
Marcin Gortat,C,26,PHO,55,12,1636,294,522,.563,1,4,.250,293,518,.566,.564,128,175,.731,110,403,513,53,29,70,64,136,717,2011
Joey Graham,SF,28,CLE,39,8,586,82,179,.458,9,30,.300,73,149,.490,.483,29,36,.806,8,76,84,18,6,7,28,73,202,2011
Stephen Graham,SG,28,NJN,59,28,959,81,200,.405,5,21,.238,76,179,.425,.418,31,38,.816,17,106,123,40,14,1,38,106,198,2011
Danny Granger,SF,27,IND,79,79,2763,535,1260,.425,157,407,.386,378,853,.443,.487,395,466,.848,87,338,425,203,89,62,206,213,1622,2011
Aaron Gray,C,26,NOH,41,6,531,56,99,.566,0,0,.000,56,99,.566,.566,17,34,.500,59,112,171,16,11,12,32,96,129,2011
Danny Green,SG,23,SAS,8,0,92,17,35,.486,7,19,.368,10,16,.625,.586,0,0,.000,3,12,15,2,2,1,5,7,41,2011
Jeff Green,PF-SF,24,TOT,75,51,2427,368,820,.449,64,211,.303,304,609,.499,.488,198,244,.811,73,287,360,108,53,37,99,210,998,2011
Jeff Green,PF,24,OKC,49,49,1815,270,618,.437,56,184,.304,214,434,.493,.482,148,181,.818,57,217,274,89,40,21,76,142,744,2011
Jeff Green,SF,24,BOS,26,2,612,98,202,.485,8,27,.296,90,175,.514,.505,50,63,.794,16,70,86,19,13,16,23,68,254,2011
Willie Green,SG,29,NOH,77,13,1674,270,609,.443,54,155,.348,216,454,.476,.488,78,100,.780,22,139,161,74,36,13,67,143,672,2011
Donte Greene,SF,22,SAC,69,21,1127,156,386,.404,45,154,.292,111,232,.478,.462,43,65,.662,49,98,147,48,36,20,60,88,400,2011
Orien Greene,SG,28,NJN,3,0,5,1,2,.500,0,0,.000,1,2,.500,.500,1,2,.500,0,0,0,1,1,0,0,0,3,2011
Blake Griffin,PF,21,LAC,82,82,3112,696,1376,.506,7,24,.292,689,1352,.510,.508,446,695,.642,270,719,989,312,63,45,223,252,1845,2011
Hamed Haddadi,C,25,MEM,31,0,168,30,58,.517,0,1,.000,30,57,.526,.517,15,23,.652,24,44,68,5,2,13,11,29,75,2011
Richard Hamilton,SG,32,DET,55,39,1498,288,671,.429,55,144,.382,233,527,.442,.470,146,172,.849,24,102,126,171,39,4,88,95,777,2011
Tyler Hansbrough,PF,25,IND,70,29,1535,285,613,.465,0,2,.000,285,611,.466,.465,197,253,.779,145,221,366,41,37,15,76,160,767,2011
Luke Harangody,PF,23,TOT,49,0,640,79,206,.383,16,66,.242,63,140,.450,.422,19,26,.731,40,103,143,30,15,17,16,80,193,2011
Luke Harangody,PF,23,BOS,28,0,241,28,71,.394,2,10,.200,26,61,.426,.408,5,8,.625,17,38,55,10,4,7,5,36,63,2011
Luke Harangody,PF,23,CLE,21,0,399,51,135,.378,14,56,.250,37,79,.468,.430,14,18,.778,23,65,88,20,11,10,11,44,130,2011
James Harden,SG,21,OKC,82,5,2189,298,684,.436,113,324,.349,185,360,.514,.518,289,343,.843,42,213,255,176,92,24,106,207,998,2011
Al Harrington,PF,30,DEN,73,3,1665,281,675,.416,117,328,.357,164,347,.473,.503,86,117,.735,76,256,332,101,39,10,106,202,765,2011
Devin Harris,PG,27,TOT,71,70,2254,343,813,.422,58,180,.322,285,633,.450,.458,335,402,.833,17,152,169,503,70,7,207,163,1079,2011
Devin Harris,PG,27,NJN,54,54,1724,260,612,.425,33,110,.300,227,502,.452,.452,258,307,.840,11,118,129,411,57,5,158,130,811,2011
Devin Harris,PG,27,UTA,17,16,530,83,201,.413,25,70,.357,58,131,.443,.475,77,95,.811,6,34,40,92,13,2,49,33,268,2011
Manny Harris,SG,21,CLE,54,15,933,108,289,.374,34,92,.370,74,197,.376,.433,71,93,.763,36,104,140,85,31,7,63,65,321,2011
Mike Harris,PF,27,HOU,4,0,16,3,6,.500,0,0,.000,3,6,.500,.500,2,4,.500,2,3,5,1,0,1,1,2,8,2011
Udonis Haslem,PF,30,MIA,13,0,345,44,86,.512,0,0,.000,44,86,.512,.512,16,20,.800,29,77,106,6,7,3,14,39,104,2011
Spencer Hawes,C,22,PHI,81,81,1718,264,568,.465,9,37,.243,255,531,.480,.473,47,88,.534,129,336,465,121,29,71,97,201,584,2011
Chuck Hayes,C,27,HOU,74,63,2079,244,463,.527,0,2,.000,244,461,.529,.527,94,142,.662,219,380,599,202,79,49,86,200,582,2011
Gordon Hayward,SF,20,UTA,72,17,1218,142,293,.485,35,74,.473,107,219,.489,.544,69,97,.711,41,98,139,81,30,19,70,106,388,2011
Lazar Hayward,SF,24,MIN,42,0,419,55,154,.357,17,60,.283,38,94,.404,.412,33,42,.786,23,47,70,28,12,7,19,44,160,2011
Brendan Haywood,C,31,DAL,72,8,1331,128,223,.574,0,1,.000,128,222,.577,.574,64,177,.362,129,247,376,19,16,74,51,146,320,2011
Luther Head,PG,28,SAC,36,14,586,68,164,.415,25,64,.391,43,100,.430,.491,39,50,.780,16,44,60,70,10,9,32,43,200,2011
Gerald Henderson,SG,23,CHA,68,30,1661,259,570,.454,7,36,.194,252,534,.472,.461,128,163,.785,49,158,207,101,50,32,64,118,653,2011
Xavier Henry,SG,19,MEM,38,16,527,65,160,.406,2,17,.118,63,143,.441,.413,33,52,.635,9,28,37,18,11,3,13,48,165,2011
Roy Hibbert,C,24,IND,81,80,2244,410,890,.461,0,4,.000,410,886,.463,.461,205,275,.745,182,428,610,166,33,142,185,256,1025,2011
J.J. Hickson,C,22,CLE,80,66,2256,429,936,.458,0,5,.000,429,931,.461,.458,247,367,.673,217,478,695,91,48,54,173,215,1105,2011
Nene Hilario,C,28,DEN,75,75,2291,402,654,.615,1,5,.200,401,649,.618,.615,286,402,.711,145,426,571,149,84,73,134,238,1091,2011
George Hill,PG,24,SAS,76,5,2148,287,633,.453,77,204,.377,210,429,.490,.514,233,270,.863,24,175,199,193,66,21,99,153,884,2011
Grant Hill,SF,38,PHO,80,80,2409,399,825,.484,45,114,.395,354,711,.498,.511,213,257,.829,77,261,338,200,64,35,134,184,1056,2011
Jordan Hill,C,23,HOU,72,11,1125,173,352,.491,0,2,.000,173,350,.494,.491,60,85,.706,128,178,306,29,14,52,62,157,406,2011
Kirk Hinrich,SG-PG,30,TOT,72,51,2157,278,623,.446,75,188,.399,203,435,.467,.506,106,126,.841,21,161,182,288,75,17,121,185,737,2011
Kirk Hinrich,SG,30,WAS,48,29,1471,198,438,.452,43,112,.384,155,326,.475,.501,92,105,.876,14,115,129,210,56,10,84,119,531,2011
Kirk Hinrich,PG,30,ATL,24,22,686,80,185,.432,32,76,.421,48,109,.440,.519,14,21,.667,7,46,53,78,19,7,37,66,206,2011
Jrue Holiday,PG,20,PHI,82,82,2901,446,999,.446,81,222,.365,365,777,.470,.487,172,209,.823,68,264,332,531,120,29,218,203,1145,2011
Ryan Hollins,C,26,CLE,70,16,1182,131,219,.598,0,0,.000,131,219,.598,.598,111,163,.681,70,116,186,26,22,42,67,199,373,2011
Al Horford,C,24,ATL,77,77,2704,513,921,.557,2,4,.500,511,917,.557,.558,150,188,.798,182,536,718,266,59,80,119,193,1178,2011
Eddie House,SG,32,MIA,56,1,978,128,321,.399,68,175,.389,60,146,.411,.505,38,40,.950,9,83,92,62,32,3,29,68,362,2011
Dwight Howard,C,25,ORL,78,78,2935,619,1044,.593,0,7,.000,619,1037,.597,.593,546,916,.596,309,789,1098,107,107,186,279,258,1784,2011
Josh Howard,SF,30,WAS,18,10,409,58,162,.358,7,29,.241,51,133,.383,.380,29,47,.617,18,56,74,24,13,5,20,34,152,2011
Juwan Howard,PF,37,MIA,57,0,592,55,125,.440,0,0,.000,55,125,.440,.440,29,35,.829,36,86,122,23,10,4,25,61,139,2011
Lester Hudson,PG,26,WAS,11,0,73,6,24,.250,4,15,.267,2,9,.222,.333,2,4,.500,1,4,5,17,4,1,7,10,18,2011
Kris Humphries,PF,25,NJN,74,44,2061,307,583,.527,0,1,.000,307,582,.527,.527,127,191,.665,225,546,771,84,33,80,103,168,741,2011
Serge Ibaka,PF,21,OKC,82,44,2216,335,617,.543,0,1,.000,335,616,.544,.543,138,184,.750,214,408,622,22,31,198,71,267,808,2011
Andre Iguodala,SF,27,PHI,67,67,2469,338,759,.445,61,181,.337,277,578,.479,.486,208,300,.693,61,326,387,422,101,38,138,109,945,2011
Zydrunas Ilgauskas,C,35,MIA,72,51,1145,162,319,.508,0,1,.000,162,318,.509,.508,36,46,.783,108,179,287,26,23,58,52,185,360,2011
Didier Ilunga-Mbenga,C,30,NOH,41,0,330,23,49,.469,0,0,.000,23,49,.469,.469,13,18,.722,35,51,86,6,6,27,21,52,59,2011
Ersan Ilyasova,PF,23,MIL,60,34,1505,221,507,.436,36,121,.298,185,386,.479,.471,93,104,.894,105,260,365,56,51,24,63,159,571,2011
Royal Ivey,SG,29,OKC,25,0,155,16,38,.421,7,16,.438,9,22,.409,.513,2,2,1.000,2,14,16,7,6,1,5,17,41,2011
Jarrett Jack,SG-PG,27,TOT,83,15,1722,260,637,.408,33,108,.306,227,529,.429,.434,182,214,.850,20,153,173,242,54,6,110,102,735,2011
Jarrett Jack,PG,27,TOR,13,13,347,48,122,.393,4,24,.167,44,98,.449,.410,40,46,.870,6,36,42,59,14,0,34,25,140,2011
Jarrett Jack,SG,27,NOH,70,2,1375,212,515,.412,29,84,.345,183,431,.425,.440,142,168,.845,14,117,131,183,40,6,76,77,595,2011
Darnell Jackson,PF,25,SAC,59,2,486,77,158,.487,3,11,.273,74,147,.503,.497,30,49,.612,49,45,94,14,12,3,23,61,187,2011
Stephen Jackson,SG,32,CHA,67,67,2405,435,1059,.411,121,359,.337,314,700,.449,.468,249,305,.816,53,251,304,241,80,28,209,161,1240,2011
Damion James,SF,23,NJN,25,9,403,46,103,.447,0,3,.000,46,100,.460,.447,18,28,.643,17,68,85,20,16,12,25,36,110,2011
LeBron James,SF,26,MIA,79,79,3063,758,1485,.510,92,279,.330,666,1206,.552,.541,503,663,.759,80,510,590,554,124,50,284,163,2111,2011
Antawn Jamison,PF,34,CLE,56,38,1842,374,876,.427,91,263,.346,283,613,.462,.479,171,234,.731,86,289,375,93,50,30,77,137,1010,2011
Othyus Jeffers,SG,25,TOT,17,1,322,31,65,.477,1,4,.250,30,61,.492,.485,30,46,.652,25,42,67,20,17,0,14,32,93,2011
Othyus Jeffers,SG,25,SAS,1,0,8,1,3,.333,0,0,.000,1,3,.333,.333,0,0,.000,0,2,2,1,0,0,1,1,2,2011
Othyus Jeffers,SG,25,WAS,16,1,314,30,62,.484,1,4,.250,29,58,.500,.492,30,46,.652,25,40,65,19,17,0,13,31,91,2011
Al Jefferson,C,26,UTA,82,82,2940,654,1319,.496,0,0,.000,654,1319,.496,.496,220,289,.761,235,559,794,149,46,153,105,238,1528,2011
Richard Jefferson,SF,30,SAS,81,81,2459,304,642,.474,135,307,.440,169,335,.504,.579,148,195,.759,54,256,310,107,38,34,93,164,891,2011
Jared Jeffries,PF,29,TOT,42,9,601,30,86,.349,2,9,.222,28,77,.364,.360,12,29,.414,62,54,116,36,31,17,21,75,74,2011
Jared Jeffries,PF,29,HOU,18,0,138,11,36,.306,1,6,.167,10,30,.333,.319,4,10,.400,20,15,35,11,7,3,4,21,27,2011
Jared Jeffries,PF,29,NYK,24,9,463,19,50,.380,1,3,.333,18,47,.383,.390,8,19,.421,42,39,81,25,24,14,17,54,47,2011
Brandon Jennings,PG,21,MIL,63,61,2169,361,926,.390,98,303,.323,263,623,.422,.443,199,246,.809,42,192,234,305,95,21,146,131,1019,2011
Eugene Jeter,PG,27,SAC,62,1,858,106,259,.409,6,30,.200,100,229,.437,.421,37,41,.902,9,61,70,162,29,2,51,54,255,2011
Yi Jianlian,PF,23,WAS,63,11,1112,145,347,.418,3,13,.231,142,334,.425,.422,62,91,.681,79,169,248,25,27,32,51,115,355,2011
Amir Johnson,PF,23,TOR,72,54,1853,281,495,.568,0,1,.000,281,494,.569,.568,126,160,.788,189,272,461,81,53,88,69,263,688,2011
Armon Johnson,PG,21,POR,38,0,277,46,101,.455,5,12,.417,41,89,.461,.480,13,22,.591,11,25,36,45,5,1,38,31,110,2011
Chris Johnson,C,25,TOT,14,1,138,9,21,.429,0,0,.000,9,21,.429,.429,15,20,.750,12,20,32,3,3,9,10,21,33,2011
Chris Johnson,C,25,POR,10,1,106,7,18,.389,0,0,.000,7,18,.389,.389,13,18,.722,11,16,27,2,3,6,8,18,27,2011
Chris Johnson,C,25,BOS,4,0,32,2,3,.667,0,0,.000,2,3,.667,.667,2,2,1.000,1,4,5,1,0,3,2,3,6,2011
James Johnson,SF,23,TOT,38,25,822,108,237,.456,8,34,.235,100,203,.493,.473,47,71,.662,37,105,142,89,33,37,64,95,271,2011
James Johnson,SF,23,CHI,13,0,123,17,41,.415,2,9,.222,15,32,.469,.439,6,13,.462,6,18,24,14,8,9,18,25,42,2011
James Johnson,SF,23,TOR,25,25,699,91,196,.464,6,25,.240,85,171,.497,.480,41,58,.707,31,87,118,75,25,28,46,70,229,2011
Joe Johnson,SG,29,ATL,72,72,2554,514,1161,.443,89,300,.297,425,861,.494,.481,195,243,.802,59,232,291,338,47,7,146,131,1312,2011
Trey Johnson,SG,26,TOT,8,0,94,12,33,.364,1,3,.333,11,30,.367,.379,9,10,.900,2,5,7,11,1,1,5,12,34,2011
Trey Johnson,SG,26,TOR,7,0,81,10,30,.333,1,3,.333,9,27,.333,.350,7,8,.875,2,5,7,11,1,1,5,11,28,2011
Trey Johnson,SG,26,LAL,1,0,13,2,3,.667,0,0,.000,2,3,.667,.667,2,2,1.000,0,0,0,0,0,0,0,1,6,2011
Wesley Johnson,SG,23,MIN,79,63,2069,271,682,.397,103,289,.356,168,393,.427,.473,64,92,.696,51,189,240,148,58,54,95,163,709,2011
Dahntay Jones,SG,30,IND,45,2,589,100,214,.467,14,39,.359,86,175,.491,.500,69,90,.767,4,61,65,33,20,7,31,70,283,2011
Dominique Jones,SG,22,DAL,18,0,135,14,45,.311,0,4,.000,14,41,.341,.311,14,17,.824,6,19,25,19,5,3,10,7,42,2011
James Jones,SF,30,MIA,81,8,1549,146,346,.422,123,287,.429,23,59,.390,.600,60,72,.833,23,137,160,43,29,19,21,129,475,2011
Solomon Jones,C,26,IND,39,0,528,49,121,.405,0,1,.000,49,120,.408,.405,41,62,.661,45,68,113,30,12,22,35,94,139,2011
DeAndre Jordan,C,22,LAC,80,66,2047,234,341,.686,0,1,.000,234,340,.688,.686,98,217,.452,207,368,575,42,41,142,101,255,566,2011
Chris Kaman,C,28,LAC,32,15,838,177,376,.471,0,0,.000,177,376,.471,.471,43,57,.754,51,174,225,46,16,48,58,75,397,2011
Jason Kapono,SF,29,PHI,24,2,112,7,28,.250,1,8,.125,6,20,.300,.268,1,2,.500,3,8,11,4,2,1,2,4,16,2011
Jason Kidd,PG,37,DAL,80,80,2653,215,596,.361,133,391,.340,82,205,.400,.472,67,77,.870,35,316,351,655,134,29,179,119,630,2011
Andrei Kirilenko,SF,29,UTA,64,62,1999,253,542,.467,36,98,.367,217,444,.489,.500,208,270,.770,100,227,327,192,81,74,117,113,750,2011
Linas Kleiza,SF,26,TOR,39,23,1032,178,406,.438,39,131,.298,139,275,.505,.486,41,65,.631,37,140,177,40,19,7,65,99,436,2011
Kyle Korver,SG,29,CHI,82,0,1649,242,557,.434,120,289,.415,122,268,.455,.542,77,87,.885,12,138,150,124,35,20,60,156,681,2011
Kosta Koufos,C,21,TOT,50,2,434,68,150,.453,0,2,.000,68,148,.459,.453,24,43,.558,57,73,130,7,10,25,31,59,160,2011
Kosta Koufos,C,21,MIN,39,1,336,47,108,.435,0,2,.000,47,106,.443,.435,12,24,.500,42,55,97,7,8,20,25,50,106,2011
Kosta Koufos,C,21,DEN,11,1,98,21,42,.500,0,0,.000,21,42,.500,.500,12,19,.632,15,18,33,0,2,5,6,9,54,2011
Nenad Krstic,C,27,TOT,71,67,1571,231,452,.511,0,0,.000,231,452,.511,.511,113,146,.774,124,211,335,27,26,25,56,184,575,2011
Nenad Krstic,C,27,OKC,47,47,1018,152,305,.498,0,0,.000,152,305,.498,.498,53,66,.803,77,130,207,19,18,17,33,107,357,2011
Nenad Krstic,C,27,BOS,24,20,553,79,147,.537,0,0,.000,79,147,.537,.537,60,80,.750,47,81,128,8,8,8,23,77,218,2011
Carl Landry,PF,27,TOT,76,26,2008,345,687,.502,0,4,.000,345,683,.505,.502,213,288,.740,165,182,347,63,40,32,109,196,903,2011
Carl Landry,PF,27,SAC,53,16,1406,238,484,.492,0,3,.000,238,481,.495,.492,155,215,.721,127,126,253,50,30,20,82,125,631,2011
Carl Landry,PF,27,NOH,23,10,602,107,203,.527,0,1,.000,107,202,.530,.527,58,73,.795,38,56,94,13,10,12,27,71,272,2011
Acie Law,PG,26,TOT,51,0,726,81,186,.435,6,36,.167,75,150,.500,.452,47,64,.734,12,51,63,84,32,0,43,61,215,2011
Acie Law,PG,26,MEM,11,0,94,3,19,.158,0,6,.000,3,13,.231,.158,6,10,.600,3,8,11,14,4,0,10,10,12,2011
Acie Law,PG,26,GSW,40,0,632,78,167,.467,6,30,.200,72,137,.526,.485,41,54,.759,9,43,52,70,28,0,33,51,203,2011
Gani Lawal,PF,22,PHO,1,0,2,0,0,.000,0,0,.000,0,0,.000,.000,0,0,.000,0,0,0,0,0,0,0,1,0,2011
Ty Lawson,PG,23,DEN,80,31,2103,346,688,.503,69,171,.404,277,517,.536,.553,172,225,.764,67,142,209,377,80,4,137,133,933,2011
Courtney Lee,SG,25,HOU,81,1,1723,253,576,.439,71,174,.408,182,402,.453,.501,95,120,.792,51,158,209,100,58,18,68,102,672,2011
David Lee,PF,27,GSW,73,73,2634,496,978,.507,1,3,.333,495,975,.508,.508,210,267,.787,217,497,714,233,74,31,170,211,1203,2011
Rashard Lewis,SF-PF,31,TOT,57,52,1824,252,582,.433,87,244,.357,165,338,.488,.508,77,96,.802,71,219,290,92,52,30,87,159,668,2011
Rashard Lewis,PF,31,ORL,25,25,810,113,270,.419,44,120,.367,69,150,.460,.500,34,45,.756,23,83,106,29,22,10,35,63,304,2011
Rashard Lewis,SF,31,WAS,32,27,1014,139,312,.446,43,124,.347,96,188,.511,.514,43,51,.843,48,136,184,63,30,20,52,96,364,2011
Jeremy Lin,PG,22,GSW,29,0,285,28,72,.389,1,5,.200,27,67,.403,.396,19,25,.760,12,22,34,42,33,9,18,31,76,2011
Shaun Livingston,PG,25,CHA,73,0,1261,185,397,.466,1,4,.250,184,393,.468,.467,108,125,.864,29,120,149,164,47,29,88,109,479,2011
Brook Lopez,C,22,NJN,82,82,2889,644,1309,.492,0,1,.000,644,1308,.492,.492,385,489,.787,197,291,488,129,47,120,176,240,1673,2011
Robin Lopez,C,22,PHO,67,56,991,179,357,.501,0,0,.000,179,357,.501,.501,74,100,.740,82,134,216,8,18,45,48,143,432,2011
Kevin Love,PF,22,MIN,73,73,2611,482,1026,.470,88,211,.417,394,815,.483,.513,424,499,.850,330,782,1112,184,45,28,155,148,1476,2011
Kyle Lowry,PG,24,HOU,75,71,2563,345,809,.426,129,343,.376,216,466,.464,.506,192,251,.765,89,220,309,500,102,23,158,207,1011,2011
John Lucas III,PG,28,CHI,2,0,10,1,3,.333,0,1,.000,1,2,.500,.333,0,2,.000,0,0,0,1,0,0,0,0,2,2011
Corey Maggette,SF,31,MIL,67,18,1401,253,559,.453,28,78,.359,225,481,.468,.478,271,325,.834,44,197,241,84,21,5,127,175,805,2011
Jamaal Magloire,C,32,MIA,18,0,158,13,22,.591,0,0,.000,13,22,.591,.591,9,18,.500,17,44,61,3,4,2,5,26,35,2011
Ian Mahinmi,C,24,DAL,56,0,488,55,98,.561,0,2,.000,55,96,.573,.561,63,82,.768,43,77,120,8,14,15,25,105,173,2011
Shawn Marion,SF,32,DAL,80,27,2253,434,834,.520,5,33,.152,429,801,.536,.523,126,164,.768,168,383,551,110,68,50,130,144,999,2011
Sean Marks,C,35,POR,29,0,208,19,44,.432,2,2,1.000,17,42,.405,.455,5,8,.625,16,24,40,4,3,5,11,44,45,2011
Cartier Martin,SF,26,WAS,52,1,542,71,182,.390,39,99,.394,32,83,.386,.497,28,40,.700,20,54,74,18,18,6,16,52,209,2011
Kenyon Martin,PF,33,DEN,48,48,1233,185,362,.511,2,9,.222,183,353,.518,.514,42,72,.583,67,230,297,109,43,35,59,136,414,2011
Kevin Martin,SG,27,HOU,80,80,2603,553,1267,.436,176,459,.383,377,808,.467,.506,594,669,.888,28,230,258,198,80,15,184,155,1876,2011
Roger Mason,SG,30,NYK,26,0,319,26,77,.338,16,44,.364,10,33,.303,.442,7,10,.700,5,38,43,20,6,2,6,25,75,2011
Wesley Matthews,SG,24,POR,82,69,2758,440,979,.449,154,378,.407,286,601,.476,.528,266,315,.844,48,210,258,164,102,9,138,195,1300,2011
Jason Maxiell,PF,27,DET,57,14,930,93,189,.492,0,0,.000,93,189,.492,.492,51,99,.515,66,107,173,17,24,21,44,92,237,2011
Eric Maynor,PG,23,OKC,82,0,1200,134,333,.402,37,96,.385,97,237,.409,.458,43,59,.729,25,96,121,238,35,6,77,96,348,2011
O.J. Mayo,SG,23,MEM,71,17,1869,304,747,.407,96,264,.364,208,483,.431,.471,99,131,.756,35,135,170,145,73,26,99,127,803,2011
Luc Mbah a Moute,PF,24,MIL,79,52,2093,198,428,.463,0,7,.000,198,421,.470,.463,133,188,.707,169,251,420,68,72,28,77,180,529,2011
Antonio McDyess,PF,36,SAS,73,16,1387,169,344,.491,0,1,.000,169,343,.493,.491,52,77,.675,122,273,395,84,36,39,72,163,390,2011
JaVale McGee,C,23,WAS,79,75,2193,332,604,.550,0,3,.000,332,601,.552,.550,134,230,.583,223,411,634,38,41,193,102,232,798,2011
Tracy McGrady,SG,31,DET,72,39,1686,227,514,.442,30,88,.341,197,426,.462,.471,90,129,.698,49,202,251,252,66,34,102,101,574,2011
Dominic McGuire,SF,25,CHA,52,8,760,72,182,.396,0,2,.000,72,180,.400,.396,30,39,.769,63,136,199,43,10,33,25,94,174,2011
Josh McRoberts,PF,23,IND,72,51,1597,211,386,.547,23,60,.383,188,326,.577,.576,88,119,.739,109,273,382,150,47,57,93,165,533,2011
Jodie Meeks,SG,23,PHI,74,64,2062,242,570,.425,138,348,.397,104,222,.468,.546,152,170,.894,21,150,171,78,63,4,60,97,774,2011
Pops Mensah-Bonsu,PF,27,NOH,7,0,35,1,3,.333,0,0,.000,1,3,.333,.333,0,0,.000,3,8,11,2,0,0,2,11,2,2011
C.J. Miles,SF,23,UTA,78,19,1969,366,899,.407,109,339,.322,257,560,.459,.468,159,196,.811,54,201,255,135,74,38,93,221,1000,2011
Darko Milicic,C,25,MIN,69,69,1686,271,578,.469,0,0,.000,271,578,.469,.469,64,115,.557,133,227,360,104,54,140,151,229,606,2011
Andre Miller,PG,34,POR,81,81,2650,388,844,.460,4,37,.108,384,807,.476,.462,249,292,.853,97,205,302,566,114,12,197,171,1029,2011
Brad Miller,C,34,HOU,60,5,1015,132,296,.446,40,107,.374,92,189,.487,.514,78,94,.830,44,178,222,145,28,21,54,98,382,2011
Mike Miller,SG,30,MIA,41,2,838,81,202,.401,43,118,.364,38,84,.452,.507,23,34,.676,38,146,184,51,20,2,41,88,228,2011
Patty Mills,PG,22,POR,64,0,783,135,328,.412,47,133,.353,88,195,.451,.483,36,47,.766,19,32,51,109,27,1,62,63,353,2011
Paul Millsap,PF,25,UTA,76,76,2605,525,988,.531,9,23,.391,516,965,.535,.536,256,338,.757,164,415,579,187,103,69,145,272,1315,2011
Yao Ming,C,30,HOU,5,5,91,18,37,.486,0,0,.000,18,37,.486,.486,15,16,.938,7,20,27,4,0,8,7,13,51,2011
Nazr Mohammed,C,33,TOT,75,37,1280,234,448,.522,0,1,.000,234,447,.523,.522,67,112,.598,140,228,368,23,30,56,70,184,535,2011
Nazr Mohammed,C,33,CHA,51,30,851,159,317,.502,0,1,.000,159,316,.503,.502,52,88,.591,94,158,252,17,14,46,51,121,370,2011
Nazr Mohammed,C,33,OKC,24,7,429,75,131,.573,0,0,.000,75,131,.573,.573,15,24,.625,46,70,116,6,16,10,19,63,165,2011
Greg Monroe,C,20,DET,80,48,2222,303,550,.551,0,1,.000,303,549,.552,.551,145,233,.622,248,353,601,105,93,45,81,196,751,2011
Jamario Moon,SF,30,TOT,59,20,1042,101,248,.407,38,123,.309,63,125,.504,.484,15,17,.882,23,142,165,52,28,33,22,65,255,2011
Jamario Moon,SF,30,CLE,40,13,764,76,189,.402,27,95,.284,49,94,.521,.474,10,11,.909,14,104,118,45,25,27,17,39,189,2011
Jamario Moon,SF,30,LAC,19,7,278,25,59,.424,11,28,.393,14,31,.452,.517,5,6,.833,9,38,47,7,3,6,5,26,66,2011
Anthony Morrow,SG,25,NJN,58,47,1856,279,620,.450,110,260,.423,169,360,.469,.539,96,107,.897,37,135,172,68,19,7,54,135,764,2011
Timofey Mozgov,C,24,TOT,45,14,524,63,133,.474,0,0,.000,63,133,.474,.474,37,52,.712,46,75,121,15,15,25,35,84,163,2011
Timofey Mozgov,C,24,NYK,34,14,458,52,112,.464,0,0,.000,52,112,.464,.464,31,44,.705,41,63,104,15,14,23,32,76,135,2011
Timofey Mozgov,C,24,DEN,11,0,66,11,21,.524,0,0,.000,11,21,.524,.524,6,8,.750,5,12,17,0,1,2,3,8,28,2011
Byron Mullens,PF,21,OKC,13,0,85,9,28,.321,0,0,.000,9,28,.321,.321,7,14,.500,6,18,24,0,2,3,8,11,25,2011
Troy Murphy,PF,30,TOT,35,4,466,42,114,.368,5,33,.152,37,81,.457,.390,20,30,.667,22,91,113,23,15,3,20,47,109,2011
Troy Murphy,PF,30,NJN,18,4,288,26,76,.342,4,23,.174,22,53,.415,.368,9,17,.529,11,64,75,17,7,2,13,28,65,2011
Troy Murphy,PF,30,BOS,17,0,178,16,38,.421,1,10,.100,15,28,.536,.434,11,13,.846,11,27,38,6,8,1,7,19,44,2011
Hamady N'Diaye,C,24,WAS,16,0,80,4,5,.800,0,0,.000,4,5,.800,.800,6,12,.500,2,5,7,0,2,5,3,18,14,2011
Eduardo Najera,PF,34,CHA,31,0,372,26,72,.361,11,34,.324,15,38,.395,.438,6,11,.545,14,30,44,20,11,6,13,52,69,2011
Steve Nash,PG,36,PHO,75,75,2497,399,811,.492,81,205,.395,318,606,.525,.542,227,249,.912,40,220,260,855,48,4,265,87,1106,2011
Gary Neal,SG,26,SAS,80,1,1685,285,632,.451,129,308,.419,156,324,.481,.553,84,104,.808,21,175,196,96,27,4,78,148,783,2011
Jameer Nelson,PG,28,ORL,76,76,2319,374,838,.446,119,297,.401,255,541,.471,.517,130,162,.802,37,189,226,456,75,3,194,209,997,2011
Joakim Noah,C,25,CHI,48,48,1576,211,402,.525,0,1,.000,211,401,.526,.525,139,188,.739,182,316,498,107,48,72,90,156,561,2011
Andres Nocioni,SF,31,PHI,54,17,931,118,277,.426,42,118,.356,76,159,.478,.502,49,61,.803,19,150,169,45,14,15,47,100,327,2011
Steve Novak,SF,27,TOT,30,0,215,35,67,.522,26,46,.565,9,21,.429,.716,8,8,1.000,4,24,28,3,1,5,4,14,104,2011
Steve Novak,SF,27,DAL,7,0,18,4,8,.500,3,4,.750,1,4,.250,.688,0,0,.000,0,5,5,0,0,0,0,3,11,2011
Steve Novak,SF,27,SAS,23,0,197,31,59,.525,23,42,.548,8,17,.471,.720,8,8,1.000,4,19,23,3,1,5,4,11,93,2011
Dirk Nowitzki,PF,32,DAL,73,73,2504,610,1179,.517,66,168,.393,544,1011,.538,.545,395,443,.892,50,463,513,190,38,47,137,172,1681,2011
Jermaine O'Neal,C,32,BOS,24,10,431,50,109,.459,0,1,.000,50,108,.463,.459,29,43,.674,25,63,88,12,2,30,27,65,129,2011
Shaquille O'Neal,C,38,BOS,37,36,752,134,201,.667,0,0,.000,134,201,.667,.667,73,131,.557,48,130,178,26,16,42,56,120,341,2011
Fabricio Oberto,C,35,POR,5,0,45,3,5,.600,0,0,.000,3,5,.600,.600,1,2,.500,3,4,7,0,0,0,3,10,7,2011
Lamar Odom,PF,31,LAL,82,35,2639,473,893,.530,68,178,.382,405,715,.566,.568,166,246,.675,175,535,710,249,47,61,139,200,1180,2011
Emeka Okafor,C,28,NOH,72,72,2287,300,524,.573,0,1,.000,300,523,.574,.573,145,258,.562,230,454,684,42,40,127,119,230,745,2011
Mehmet Okur,C,31,UTA,13,0,168,22,62,.355,5,16,.313,17,46,.370,.395,15,20,.750,9,21,30,19,4,4,7,18,64,2011
Travis Outlaw,SF,26,NJN,82,55,2358,274,731,.375,76,252,.302,198,479,.413,.427,132,171,.772,54,271,325,84,34,36,71,148,756,2011
Larry Owens,SF,28,TOT,12,0,143,15,32,.469,6,13,.462,9,19,.474,.563,4,9,.444,1,14,15,8,9,5,5,18,40,2011
Larry Owens,SF,28,SAS,7,0,31,3,6,.500,1,3,.333,2,3,.667,.583,2,4,.500,0,4,4,1,2,0,0,4,9,2011
Larry Owens,SF,28,WAS,5,0,112,12,26,.462,5,10,.500,7,16,.438,.558,2,5,.400,1,10,11,7,7,5,5,14,31,2011
Zaza Pachulia,C,26,ATL,79,7,1244,107,232,.461,0,0,.000,107,232,.461,.461,135,179,.754,119,214,333,58,34,22,69,184,349,2011
Anthony Parker,SF,35,CLE,72,65,2091,220,552,.399,86,227,.379,134,325,.412,.476,74,95,.779,33,185,218,218,67,10,80,109,600,2011
Tony Parker,PG,28,SAS,78,78,2528,555,1069,.519,25,70,.357,530,999,.531,.531,233,303,.769,30,208,238,513,90,3,200,135,1368,2011
Patrick Patterson,PF,21,HOU,52,6,868,149,267,.558,0,2,.000,149,265,.562,.558,30,42,.714,86,114,200,41,17,37,31,77,328,2011
Chris Paul,PG,25,NOH,80,80,2880,430,928,.463,71,183,.388,359,745,.482,.502,337,384,.878,38,289,327,782,188,5,177,196,1268,2011
Sasha Pavlovic,SF-SG,27,TOT,31,7,362,29,72,.403,12,31,.387,17,41,.415,.486,6,10,.600,1,31,32,16,10,7,12,34,76,2011
Sasha Pavlovic,SF,27,DAL,10,6,163,15,35,.429,7,16,.438,8,19,.421,.529,4,5,.800,0,12,12,7,5,3,5,15,41,2011
Sasha Pavlovic,SG,27,NOH,4,1,50,2,11,.182,0,5,.000,2,6,.333,.182,0,0,.000,0,6,6,6,0,4,1,4,4,2011
Sasha Pavlovic,SG,27,BOS,17,0,149,12,26,.462,5,10,.500,7,16,.438,.558,2,5,.400,1,13,14,3,5,0,6,15,31,2011
Nikola Pekovic,C,25,MIN,65,11,887,136,263,.517,0,0,.000,136,263,.517,.517,87,114,.763,90,103,193,27,18,35,91,181,359,2011
Kendrick Perkins,C,26,TOT,29,24,742,67,130,.515,0,0,.000,67,130,.515,.515,40,72,.556,62,170,232,26,9,26,56,91,174,2011
Kendrick Perkins,C,26,BOS,12,7,313,32,59,.542,0,0,.000,32,59,.542,.542,23,40,.575,23,74,97,10,2,10,25,37,87,2011
Kendrick Perkins,C,26,OKC,17,17,429,35,71,.493,0,0,.000,35,71,.493,.493,17,32,.531,39,96,135,16,7,16,31,54,87,2011
Morris Peterson,SG,33,OKC,4,0,23,2,5,.400,0,1,.000,2,4,.500,.400,0,0,.000,0,3,3,1,0,0,0,5,4,2011
Johan Petro,C,25,NJN,77,1,893,129,290,.445,0,4,.000,129,286,.451,.445,15,28,.536,62,150,212,44,34,34,46,178,273,2011
Paul Pierce,SF,33,BOS,80,80,2774,507,1021,.497,111,297,.374,396,724,.547,.551,386,449,.860,34,396,430,260,80,51,171,231,1511,2011
Mickael Pietrus,SG-SF,28,TOT,57,4,1107,143,365,.392,85,236,.360,58,129,.450,.508,39,57,.684,15,111,126,33,29,21,39,101,410,2011
Mickael Pietrus,SF,28,ORL,19,0,418,45,115,.391,34,87,.391,11,28,.393,.539,3,6,.500,6,44,50,10,10,3,14,35,127,2011
Mickael Pietrus,SG,28,PHO,38,4,689,98,250,.392,51,149,.342,47,101,.465,.494,36,51,.706,9,67,76,23,19,18,25,66,283,2011
Dexter Pittman,C,22,MIA,2,0,11,1,3,.333,0,0,.000,1,3,.333,.333,0,0,.000,1,2,3,0,0,0,2,2,2,2011
Quincy Pondexter,SF,22,NOH,66,6,734,73,180,.406,18,50,.360,55,130,.423,.456,24,34,.706,23,65,88,28,17,10,16,63,188,2011
James Posey,SF,34,IND,49,0,839,81,241,.336,67,212,.316,14,29,.483,.475,11,15,.733,10,137,147,34,24,6,24,103,240,2011
Leon Powe,C-PF,27,TOT,30,3,328,59,119,.496,0,2,.000,59,117,.504,.496,40,72,.556,24,39,63,7,10,4,12,44,158,2011
Leon Powe,PF,27,CLE,14,3,187,29,59,.492,0,0,.000,29,59,.492,.492,12,26,.462,16,22,38,2,7,3,5,20,70,2011
Leon Powe,C,27,MEM,16,0,141,30,60,.500,0,2,.000,30,58,.517,.500,28,46,.609,8,17,25,5,3,1,7,24,88,2011
Josh Powell,PF,28,ATL,54,0,653,94,208,.452,0,1,.000,94,207,.454,.452,36,45,.800,49,86,135,22,5,5,53,78,224,2011
A.J. Price,PG,24,IND,50,0,795,114,320,.356,41,149,.275,73,171,.427,.420,54,81,.667,16,56,72,111,29,1,53,61,323,2011
Ronnie Price,SG,27,UTA,59,0,717,74,210,.352,20,69,.290,54,141,.383,.400,29,39,.744,22,39,61,56,42,5,55,106,197,2011
Tayshaun Prince,SF,30,DET,78,78,2562,473,1001,.473,34,98,.347,439,903,.486,.490,118,168,.702,78,251,329,215,30,41,82,90,1098,2011
Joel Przybilla,C,31,TOT,36,9,519,25,44,.568,0,0,.000,25,44,.568,.568,14,27,.519,37,108,145,13,5,15,29,79,64,2011
Joel Przybilla,C,31,POR,31,9,445,21,34,.618,0,0,.000,21,34,.618,.618,13,23,.565,28,93,121,13,5,14,22,63,55,2011
Joel Przybilla,C,31,CHA,5,0,74,4,10,.400,0,0,.000,4,10,.400,.400,1,4,.250,9,15,24,0,0,1,7,16,9,2011
Chris Quinn,PG,27,SAS,41,0,292,33,91,.363,11,37,.297,22,54,.407,.423,4,8,.500,3,22,25,42,5,1,12,29,81,2011
Vladimir Radmanovic,PF,30,GSW,74,6,1169,137,318,.431,70,173,.405,67,145,.462,.541,30,34,.882,64,148,212,79,44,44,57,157,374,2011
Anthony Randolph,C-PF,21,TOT,40,3,590,123,264,.466,1,4,.250,122,260,.469,.468,58,86,.674,43,117,160,33,22,24,53,62,305,2011
Anthony Randolph,PF,21,NYK,17,0,127,14,45,.311,1,4,.250,13,41,.317,.322,6,12,.500,11,29,40,7,4,8,10,15,35,2011
Anthony Randolph,C,21,MIN,23,3,463,109,219,.498,0,0,.000,109,219,.498,.498,52,74,.703,32,88,120,26,18,16,43,47,270,2011
Zach Randolph,PF,29,MEM,75,74,2724,598,1188,.503,8,43,.186,590,1145,.515,.507,300,396,.758,326,588,914,163,63,25,151,175,1504,2011
Theo Ratliff,C,37,LAL,10,0,71,1,6,.167,0,0,.000,1,6,.167,.167,0,2,.000,6,7,13,3,2,5,3,7,2,2011
Andy Rautins,SG,24,NYK,5,0,24,3,7,.429,1,4,.250,2,3,.667,.500,1,2,.500,0,1,1,3,1,0,7,0,8,2011
Michael Redd,SG,31,MIL,10,0,134,18,45,.400,4,17,.235,14,28,.500,.444,4,4,1.000,0,8,8,12,2,1,4,4,44,2011
J.J. Redick,SG,26,ORL,59,5,1513,197,447,.441,87,219,.397,110,228,.482,.538,112,128,.875,6,107,113,102,29,3,53,80,593,2011
Jason Richardson,SG,30,TOT,80,80,2715,472,1056,.447,189,479,.395,283,577,.490,.536,116,159,.730,67,264,331,147,93,13,95,162,1249,2011
Jason Richardson,SG,30,PHO,25,25,796,183,389,.470,62,148,.419,121,241,.502,.550,55,72,.764,33,78,111,36,27,3,30,46,483,2011
Jason Richardson,SG,30,ORL,55,55,1919,289,667,.433,127,331,.384,162,336,.482,.528,61,87,.701,34,186,220,111,66,10,65,116,766,2011
Quentin Richardson,SF,30,ORL,57,19,955,87,255,.341,42,146,.288,45,109,.413,.424,33,44,.750,39,139,178,38,25,5,33,74,249,2011
Luke Ridnour,PG,29,MIN,71,66,2159,319,681,.468,81,184,.440,238,497,.479,.528,121,137,.883,37,162,199,384,89,10,158,146,840,2011
Nate Robinson,PG,26,TOT,59,11,1013,150,376,.399,65,200,.325,85,176,.483,.485,36,44,.818,15,75,90,111,29,4,68,115,401,2011
Nate Robinson,PG,26,BOS,55,11,983,146,361,.404,63,192,.328,83,169,.491,.492,33,40,.825,15,74,89,105,29,4,66,107,388,2011
Nate Robinson,PG,26,OKC,4,0,30,4,15,.267,2,8,.250,2,7,.286,.333,3,4,.750,0,1,1,6,0,0,2,8,13,2011
Rajon Rondo,PG,24,BOS,68,68,2527,318,670,.475,10,43,.233,308,627,.491,.482,75,132,.568,87,210,297,760,153,11,234,120,721,2011
Derrick Rose,PG,22,CHI,81,81,3026,711,1597,.445,128,385,.332,583,1212,.481,.485,476,555,.858,81,249,330,623,85,51,278,136,2026,2011
Quinton Ross,SF,29,NJN,36,4,353,26,59,.441,0,3,.000,26,56,.464,.441,5,14,.357,10,20,30,10,3,6,7,40,57,2011
Brandon Roy,SG,26,POR,47,23,1310,209,523,.400,38,114,.333,171,409,.418,.436,117,138,.848,28,93,121,129,37,12,55,76,573,2011
Brandon Rush,SG,25,IND,67,21,1754,217,515,.421,93,223,.417,124,292,.425,.512,80,106,.755,33,184,217,62,41,35,69,107,607,2011
John Salmons,SG,31,MIL,73,70,2554,373,898,.415,83,219,.379,290,679,.427,.462,195,240,.813,27,239,266,252,72,28,137,157,1024,2011
Samardo Samuels,PF,22,CLE,37,10,701,110,241,.456,0,3,.000,110,238,.462,.456,68,110,.618,75,83,158,17,15,18,53,88,288,2011
Larry Sanders,C,22,MIL,60,12,872,116,268,.433,0,0,.000,116,268,.433,.433,28,50,.560,59,119,178,16,22,72,38,117,260,2011
Brian Scalabrine,PF,32,CHI,18,0,88,10,19,.526,0,5,.000,10,14,.714,.526,0,0,.000,1,7,8,6,3,4,5,18,20,2011
Luis Scola,PF,30,HOU,74,74,2412,569,1129,.504,0,3,.000,569,1126,.505,.504,214,290,.738,147,459,606,185,48,44,147,227,1352,2011
Thabo Sefolosha,SG,26,OKC,79,79,2049,157,333,.471,28,102,.275,129,231,.558,.514,59,79,.747,65,281,346,111,97,38,55,171,401,2011
Kevin Seraphin,PF,21,WAS,58,1,635,66,147,.449,0,0,.000,66,147,.449,.449,22,31,.710,80,72,152,10,17,28,42,126,154,2011
Ramon Sessions,PG,24,CLE,81,38,2133,362,776,.466,3,15,.200,359,761,.472,.468,348,423,.823,46,209,255,419,60,8,178,93,1075,2011
Mustafa Shakur,PG,26,WAS,22,0,159,21,59,.356,1,10,.100,20,49,.408,.364,8,15,.533,7,15,22,25,5,3,18,15,51,2011
Garret Siler,C,24,PHO,21,0,101,17,31,.548,0,0,.000,17,31,.548,.548,11,22,.500,16,12,28,3,1,4,10,20,45,2011
Bobby Simmons,SF,30,SAS,2,0,16,0,3,.000,0,3,.000,0,0,.000,.000,0,0,.000,0,0,0,2,0,0,0,2,0,2011
Brian Skinner,C,34,MIL,2,0,6,0,0,.000,0,0,.000,0,0,.000,.000,0,0,.000,0,0,0,0,0,0,0,0,0,2011
Craig Smith,PF,27,LAC,48,0,586,104,188,.553,0,5,.000,104,183,.568,.553,50,68,.735,43,74,117,31,16,7,33,84,258,2011
Ish Smith,PG,22,TOT,43,3,442,43,115,.374,3,10,.300,40,105,.381,.387,12,21,.571,7,40,47,79,18,2,34,37,101,2011
Ish Smith,PG,22,HOU,28,3,329,32,83,.386,3,8,.375,29,75,.387,.404,7,10,.700,6,36,42,64,13,2,26,26,74,2011
Ish Smith,PG,22,MEM,15,0,113,11,32,.344,0,2,.000,11,30,.367,.344,5,11,.455,1,4,5,15,5,0,8,11,27,2011
J.R. Smith,SF,25,DEN,79,6,1968,341,784,.435,124,318,.390,217,466,.466,.514,163,221,.738,45,277,322,175,92,16,100,173,969,2011
Jason Smith,C,24,NOH,77,6,1102,136,307,.443,0,2,.000,136,305,.446,.443,59,70,.843,89,152,241,36,26,32,53,150,331,2011
Joe Smith,PF,35,TOT,16,3,69,3,16,.188,0,0,.000,3,16,.188,.188,2,2,1.000,3,18,21,4,0,4,5,13,8,2011
Joe Smith,PF,35,NJN,4,3,25,1,4,.250,0,0,.000,1,4,.250,.250,0,0,.000,1,2,3,1,0,0,2,3,2,2011
Joe Smith,PF,35,LAL,12,0,44,2,12,.167,0,0,.000,2,12,.167,.167,2,2,1.000,2,16,18,3,0,4,3,10,6,2011
Josh Smith,PF,25,ATL,77,77,2645,497,1041,.477,51,154,.331,446,887,.503,.502,229,316,.725,134,523,657,255,99,120,197,217,1274,2011
Darius Songaila,C,32,PHI,10,0,71,7,15,.467,0,0,.000,7,15,.467,.467,2,4,.500,2,8,10,2,0,0,4,16,16,2011
Marreese Speights,C,23,PHI,64,1,734,144,291,.495,1,4,.250,143,287,.498,.497,55,73,.753,64,146,210,30,8,19,40,120,344,2011
Tiago Splitter,C,26,SAS,60,6,738,101,191,.529,0,1,.000,101,190,.532,.529,76,140,.543,72,129,201,26,29,17,32,91,278,2011
Jerry Stackhouse,SG,36,MIA,7,1,50,3,12,.250,1,4,.250,2,8,.250,.292,5,7,.714,1,6,7,3,0,2,2,3,12,2011
Lance Stephenson,SG,20,IND,12,0,115,13,39,.333,0,5,.000,13,34,.382,.333,11,14,.786,1,17,18,21,4,0,16,14,37,2011
DeShawn Stevenson,SG,29,DAL,72,54,1158,128,330,.388,94,249,.378,34,81,.420,.530,33,43,.767,20,86,106,77,21,5,44,71,383,2011
Peja Stojakovic,SF,33,TOT,33,13,617,100,227,.441,57,136,.419,43,91,.473,.566,23,25,.920,14,61,75,29,13,2,17,24,280,2011
Peja Stojakovic,SF,33,NOH,6,0,89,14,33,.424,11,25,.440,3,8,.375,.591,6,7,.857,0,6,6,6,2,0,4,2,45,2011
Peja Stojakovic,SF,33,TOR,2,0,22,7,10,.700,4,6,.667,3,4,.750,.900,2,2,1.000,0,3,3,1,0,0,2,0,20,2011
Peja Stojakovic,SF,33,DAL,25,13,506,79,184,.429,42,105,.400,37,79,.468,.543,15,16,.938,14,52,66,22,11,2,11,22,215,2011
Amar'e Stoudemire,C,28,NYK,78,78,2870,744,1482,.502,10,23,.435,734,1459,.503,.505,473,597,.792,198,438,636,202,71,150,250,274,1971,2011
Rodney Stuckey,PG,24,DET,70,54,2183,363,827,.439,26,90,.289,337,737,.457,.455,330,381,.866,70,146,216,361,76,10,155,177,1082,2011
DaJuan Summers,SF,23,DET,22,1,199,28,69,.406,9,21,.429,19,48,.396,.471,9,20,.450,2,10,12,2,3,1,13,21,74,2011
Pape Sy,SF,22,ATL,3,0,21,2,6,.333,0,1,.000,2,5,.400,.333,3,3,1.000,2,1,3,2,1,0,3,1,7,2011
Jermaine Taylor,SG,24,TOT,34,8,483,94,196,.480,14,45,.311,80,151,.530,.515,21,28,.750,26,36,62,32,14,5,46,39,223,2011
Jermaine Taylor,SG,24,HOU,8,0,77,16,32,.500,2,5,.400,14,27,.519,.531,5,6,.833,1,8,9,2,2,2,6,4,39,2011
Jermaine Taylor,SG,24,SAC,26,8,406,78,164,.476,12,40,.300,66,124,.532,.512,16,22,.727,25,28,53,30,12,3,40,35,184,2011
Jeff Teague,PG,22,ATL,70,7,963,133,304,.438,18,48,.375,115,256,.449,.467,77,97,.794,11,91,102,138,45,25,64,82,361,2011
Sebastian Telfair,PG,25,MIN,37,8,711,97,241,.402,28,78,.359,69,163,.423,.461,44,60,.733,17,37,54,111,25,3,64,64,266,2011
Garrett Temple,PG-SG,24,TOT,24,0,230,20,68,.294,10,37,.270,10,31,.323,.368,7,17,.412,1,22,23,32,11,6,23,24,57,2011
Garrett Temple,SG,24,SAS,3,0,21,1,5,.200,0,1,.000,1,4,.250,.200,0,2,.000,1,1,2,2,1,1,1,2,2,2011
Garrett Temple,SG,24,MIL,9,0,83,7,21,.333,3,10,.300,4,11,.364,.405,0,4,.000,0,6,6,6,1,1,2,8,17,2011
Garrett Temple,PG,24,CHA,12,0,126,12,42,.286,7,26,.269,5,16,.313,.369,7,11,.636,0,15,15,24,9,4,20,14,38,2011
Jason Terry,SG,33,DAL,82,10,2564,492,1091,.451,127,351,.362,365,740,.493,.509,182,214,.850,24,129,153,334,93,13,167,140,1293,2011
Hasheem Thabeet,C,23,TOT,47,0,373,17,40,.425,0,0,.000,17,40,.425,.425,19,35,.543,24,51,75,4,9,16,17,76,53,2011
Hasheem Thabeet,C,23,MEM,45,0,369,17,39,.436,0,0,.000,17,39,.436,.436,19,35,.543,24,51,75,4,9,15,17,73,53,2011
Hasheem Thabeet,C,23,HOU,2,0,4,0,1,.000,0,0,.000,0,1,.000,.000,0,0,.000,0,0,0,0,0,1,0,3,0,2011
Etan Thomas,C,32,ATL,13,0,82,10,21,.476,0,0,.000,10,21,.476,.476,12,15,.800,6,17,23,2,1,4,5,11,32,2011
Kurt Thomas,PF,38,CHI,52,37,1178,95,186,.511,1,1,1.000,94,185,.508,.513,20,32,.625,75,226,301,60,32,42,42,164,211,2011
Tyrus Thomas,C,24,CHA,41,2,861,156,331,.471,0,3,.000,156,328,.476,.471,107,136,.787,65,159,224,29,30,66,65,113,419,2011
Jason Thompson,PF,24,SAC,75,39,1748,271,534,.507,0,3,.000,271,531,.510,.507,121,200,.605,144,310,454,88,28,44,99,212,663,2011
Al Thornton,SF-PF,27,TOT,71,23,1383,205,431,.476,4,26,.154,201,405,.496,.480,110,142,.775,56,157,213,62,35,12,64,143,524,2011
Al Thornton,SF,27,WAS,49,23,1069,154,327,.471,4,25,.160,150,302,.497,.477,81,107,.757,46,110,156,51,28,9,44,103,393,2011
Al Thornton,PF,27,GSW,22,0,314,51,104,.490,0,1,.000,51,103,.495,.490,29,35,.829,10,47,57,11,7,3,20,40,131,2011
Marcus Thornton,SG,23,TOT,73,23,1775,350,807,.434,88,240,.367,262,567,.462,.488,145,184,.788,61,197,258,135,64,9,93,110,933,2011
Marcus Thornton,SG,23,NOH,46,0,745,137,334,.410,35,93,.376,102,241,.423,.463,50,66,.758,25,106,131,43,19,4,37,50,359,2011
Marcus Thornton,SG,23,SAC,27,23,1030,213,473,.450,53,147,.361,160,326,.491,.506,95,118,.805,36,91,127,92,45,5,56,60,574,2011
Anthony Tolliver,SF,25,MIN,65,4,1362,141,313,.450,47,115,.409,94,198,.475,.526,105,131,.802,92,203,295,82,28,28,49,145,434,2011
Ronny Turiaf,C,28,NYK,64,21,1141,103,163,.632,0,0,.000,103,163,.632,.632,61,98,.622,64,143,207,92,35,73,41,160,267,2011
Hedo Turkoglu,SF-PF,31,TOT,81,72,2540,322,722,.446,127,310,.410,195,412,.473,.534,106,156,.679,45,311,356,343,72,34,132,247,877,2011
Hedo Turkoglu,PF,31,PHO,25,16,630,85,193,.440,41,97,.423,44,96,.458,.547,26,36,.722,20,80,100,58,18,14,31,77,237,2011
Hedo Turkoglu,SF,31,ORL,56,56,1910,237,529,.448,86,213,.404,151,316,.478,.529,80,120,.667,25,231,256,285,54,20,101,170,640,2011
Evan Turner,SG,22,PHI,78,14,1797,225,529,.425,14,44,.318,211,485,.435,.439,101,125,.808,42,264,306,159,49,14,80,138,565,2011
Ekpe Udoh,C,23,GSW,58,18,1030,97,222,.437,0,0,.000,97,222,.437,.437,42,64,.656,80,101,181,40,22,86,48,144,236,2011
Ime Udoka,SF,33,SAS,20,0,130,5,21,.238,0,8,.000,5,13,.385,.238,4,8,.500,5,14,19,13,8,1,5,14,14,2011
Beno Udrih,PG,28,SAC,79,64,2734,412,824,.500,65,182,.357,347,642,.540,.539,197,228,.864,41,224,265,386,94,9,141,181,1086,2011
Ben Uzoh,PG,22,NJN,42,0,438,61,144,.424,3,8,.375,58,136,.426,.434,33,56,.589,30,31,61,69,13,8,25,29,158,2011
Anderson Varejao,C,28,CLE,31,31,994,114,216,.528,0,2,.000,114,214,.533,.528,54,81,.667,98,203,301,45,27,38,40,87,282,2011
Greivis Vasquez,SG,24,MEM,70,1,860,95,233,.408,25,86,.291,70,147,.476,.461,34,44,.773,12,61,73,151,22,4,70,83,249,2011
Charlie Villanueva,PF,26,DET,76,11,1666,313,708,.442,125,323,.387,188,385,.488,.530,89,116,.767,50,245,295,48,42,42,66,175,840,2011
Sasha Vujacic,SG,26,TOT,67,17,1648,239,595,.402,97,262,.370,142,333,.426,.483,81,96,.844,30,156,186,132,54,5,66,136,656,2011
Sasha Vujacic,SG,26,LAL,11,0,54,8,23,.348,3,7,.429,5,16,.313,.413,1,2,.500,1,3,4,5,1,0,5,7,20,2011
Sasha Vujacic,SG,26,NJN,56,17,1594,231,572,.404,94,255,.369,137,317,.432,.486,80,94,.851,29,153,182,127,53,5,61,129,636,2011
Dwyane Wade,SG,29,MIA,76,76,2823,692,1384,.500,63,206,.306,629,1178,.534,.523,494,652,.758,123,362,485,346,111,87,237,197,1941,2011
Von Wafer,SG,25,BOS,58,2,553,67,159,.421,18,67,.269,49,92,.533,.478,32,38,.842,7,42,49,35,18,5,20,39,184,2011
Henry Walker,SG,23,NYK,61,1,784,104,236,.441,59,153,.386,45,83,.542,.566,31,44,.705,16,106,122,34,21,6,37,81,298,2011
John Wall,PG,20,WAS,69,64,2606,398,972,.409,34,115,.296,364,857,.425,.427,301,393,.766,35,282,317,574,121,35,261,175,1131,2011
Ben Wallace,C,36,DET,54,49,1238,67,149,.450,1,2,.500,66,147,.449,.453,19,57,.333,129,221,350,72,54,54,44,81,154,2011
Gerald Wallace,SF-PF,28,TOT,71,63,2693,386,851,.454,62,186,.333,324,665,.487,.490,279,374,.746,111,458,569,173,105,63,152,183,1113,2011
Gerald Wallace,SF,28,CHA,48,48,1872,252,582,.433,35,106,.330,217,476,.456,.463,210,284,.739,72,322,394,116,59,48,100,120,749,2011
Gerald Wallace,PF,28,POR,23,15,821,134,269,.498,27,80,.338,107,189,.566,.548,69,90,.767,39,136,175,57,46,15,52,63,364,2011
Luke Walton,SF,30,LAL,54,0,484,38,116,.328,8,34,.235,30,82,.366,.362,7,10,.700,9,58,67,62,9,4,31,38,91,2011
Willie Warren,PG,21,LAC,19,0,134,13,35,.371,5,15,.333,8,20,.400,.443,6,8,.750,1,11,12,27,6,0,8,16,37,2011
Hakim Warrick,PF,28,PHO,80,6,1416,228,446,.511,1,11,.091,227,435,.522,.512,212,294,.721,88,208,296,69,32,9,79,100,669,2011
C.J. Watson,PG,26,CHI,82,1,1091,146,394,.371,44,112,.393,102,282,.362,.426,69,93,.742,16,78,94,186,55,11,73,82,405,2011
Earl Watson,PG,31,UTA,80,13,1567,126,307,.410,36,107,.336,90,200,.450,.469,55,82,.671,52,130,182,278,61,17,116,146,343,2011
Kyle Weaver,SG,24,UTA,5,0,69,9,25,.360,3,7,.429,6,18,.333,.420,7,8,.875,2,8,10,7,2,2,7,3,28,2011
Martell Webster,SF,24,MIN,46,1,1094,152,340,.447,55,132,.417,97,208,.466,.528,94,122,.770,36,111,147,53,28,9,58,101,453,2011
Sonny Weems,SF,24,TOR,59,28,1413,228,513,.444,17,61,.279,211,452,.467,.461,72,94,.766,39,114,153,104,34,2,86,87,545,2011
David West,PF,30,NOH,70,70,2451,528,1040,.508,2,9,.222,526,1031,.510,.509,264,327,.807,155,374,529,164,67,62,142,202,1322,2011
Delonte West,PG,27,BOS,24,2,453,55,120,.458,12,33,.364,43,87,.494,.508,13,15,.867,6,31,37,64,20,10,30,29,135,2011
Mario West,SG,26,NJN,6,3,116,9,21,.429,1,4,.250,8,17,.471,.452,3,5,.600,2,9,11,10,7,0,2,13,22,2011
Russell Westbrook,PG,22,OKC,82,82,2847,614,1390,.442,34,103,.330,580,1287,.451,.454,531,631,.842,121,258,379,670,155,30,316,207,1793,2011
D.J. White,C-PF,24,TOT,47,0,685,111,219,.507,0,2,.000,111,217,.512,.507,46,64,.719,43,115,158,19,12,20,14,77,268,2011
D.J. White,PF,24,OKC,23,0,219,30,65,.462,0,0,.000,30,65,.462,.462,5,10,.500,12,40,52,4,6,8,7,31,65,2011
D.J. White,C,24,CHA,24,0,466,81,154,.526,0,2,.000,81,152,.533,.526,41,54,.759,31,75,106,15,6,12,7,46,203,2011
Hassan Whiteside,C,21,SAC,1,0,2,0,0,.000,0,0,.000,0,0,.000,.000,0,0,.000,0,0,0,0,0,0,0,2,0,2011
Chris Wilcox,PF,28,DET,57,29,995,187,322,.581,0,1,.000,187,321,.583,.581,50,89,.562,95,176,271,43,29,17,43,145,424,2011
Damien Wilkins,SF,31,ATL,52,0,676,69,137,.504,2,10,.200,67,127,.528,.511,40,56,.714,23,67,90,41,27,9,21,72,180,2011
Deron Williams,PG,26,TOT,65,65,2465,428,975,.439,105,317,.331,323,658,.491,.493,348,412,.845,40,220,260,667,79,15,230,190,1309,2011
Deron Williams,PG,26,UTA,53,53,2009,369,806,.458,89,258,.345,280,548,.511,.513,302,354,.853,32,173,205,514,64,12,187,152,1129,2011
Deron Williams,PG,26,NJN,12,12,456,59,169,.349,16,59,.271,43,110,.391,.396,46,58,.793,8,47,55,153,15,3,43,38,180,2011
Jason Williams,PG,35,TOT,27,0,295,22,67,.328,10,38,.263,12,29,.414,.403,0,0,.000,3,27,30,52,11,1,18,8,54,2011
Jason Williams,PG,35,ORL,16,0,171,13,38,.342,7,23,.304,6,15,.400,.434,0,0,.000,3,19,22,24,8,0,11,6,33,2011
Jason Williams,PG,35,MEM,11,0,124,9,29,.310,3,15,.200,6,14,.429,.362,0,0,.000,0,8,8,28,3,1,7,2,21,2011
Jawad Williams,SF,27,CLE,26,1,391,41,126,.325,13,45,.289,28,81,.346,.377,9,12,.750,7,41,48,22,9,3,16,34,104,2011
Lou Williams,SG,24,PHI,75,0,1747,323,795,.406,88,253,.348,235,542,.434,.462,293,356,.823,32,117,149,252,47,17,102,128,1027,2011
Marvin Williams,SF,24,ATL,65,52,1865,246,537,.458,37,110,.336,209,427,.489,.493,147,174,.845,68,245,313,88,34,23,62,104,676,2011
Mo Williams,PG,28,TOT,58,56,1788,291,730,.399,79,244,.324,212,486,.436,.453,151,177,.853,21,132,153,380,53,10,171,150,812,2011
Mo Williams,PG,28,CLE,36,34,1065,178,462,.385,36,136,.265,142,326,.436,.424,85,102,.833,15,82,97,257,33,10,105,91,477,2011
Mo Williams,PG,28,LAC,22,22,723,113,268,.422,43,108,.398,70,160,.438,.502,66,75,.880,6,50,56,123,20,0,66,59,335,2011
Reggie Williams,SF,24,GSW,80,9,1626,268,572,.469,102,241,.423,166,331,.502,.558,100,134,.746,45,171,216,121,28,3,57,124,738,2011
Shawne Williams,PF,24,NYK,64,11,1323,164,385,.426,85,212,.401,79,173,.457,.536,41,49,.837,60,179,239,47,39,51,46,164,454,2011
Shelden Williams,PF,27,TOT,59,38,911,103,220,.468,0,0,.000,103,220,.468,.468,58,75,.773,93,180,273,32,23,26,43,126,264,2011
Shelden Williams,PF,27,DEN,42,32,713,82,181,.453,0,0,.000,82,181,.453,.453,34,46,.739,74,149,223,19,18,22,37,92,198,2011
Shelden Williams,PF,27,NYK,17,6,198,21,39,.538,0,0,.000,21,39,.538,.538,24,29,.828,19,31,50,13,5,4,6,34,66,2011
Terrence Williams,SG,23,TOT,21,0,290,43,115,.374,6,22,.273,37,93,.398,.400,14,21,.667,4,47,51,38,9,0,33,25,106,2011
Terrence Williams,SG,23,NJN,10,0,206,29,73,.397,4,12,.333,25,61,.410,.425,5,10,.500,3,33,36,31,5,0,25,21,67,2011
Terrence Williams,SG,23,HOU,11,0,84,14,42,.333,2,10,.200,12,32,.375,.357,9,11,.818,1,14,15,7,4,0,8,4,39,2011
Metta World Peace,SF,31,LAL,82,82,2410,261,658,.397,83,233,.356,178,425,.419,.460,92,136,.676,100,167,267,175,124,36,90,181,697,2011
Antoine Wright,SG,26,SAC,7,0,31,1,8,.125,0,4,.000,1,4,.250,.125,0,0,.000,2,1,3,0,1,0,1,3,2,2011
Brandan Wright,PF,23,TOT,37,2,379,60,117,.513,0,0,.000,60,117,.513,.513,21,31,.677,31,58,89,12,11,17,14,34,141,2011
Brandan Wright,PF,23,GSW,21,1,195,38,63,.603,0,0,.000,38,63,.603,.603,7,14,.500,14,27,41,5,3,10,10,19,83,2011
Brandan Wright,PF,23,NJN,16,1,184,22,54,.407,0,0,.000,22,54,.407,.407,14,17,.824,17,31,48,7,8,7,4,15,58,2011
Dorell Wright,SF,25,GSW,82,82,3147,485,1146,.423,194,516,.376,291,630,.462,.508,180,228,.789,88,343,431,242,124,63,133,171,1344,2011
Julian Wright,SF,23,TOR,52,6,766,82,160,.513,2,10,.200,80,150,.533,.519,22,43,.512,47,71,118,58,39,20,43,45,188,2011
Nick Young,SG,25,WAS,64,40,2034,412,935,.441,105,271,.387,307,664,.462,.497,186,228,.816,26,148,174,75,45,17,90,144,1115,2011
Sam Young,SF,25,MEM,78,46,1577,233,494,.472,17,50,.340,216,444,.486,.489,89,116,.767,40,147,187,71,68,23,61,120,572,2011
Thaddeus Young,PF,22,PHI,82,1,2135,458,847,.541,6,22,.273,452,825,.548,.544,123,174,.707,153,281,434,82,90,26,99,170,1045,2011
Arron Afflalo,SG,24,DEN,82,75,2221,272,585,.465,108,249,.434,164,336,.488,.557,72,98,.735,59,193,252,138,46,30,74,225,724,2010
Alexis Ajinca,C,21,CHA,6,0,30,5,10,.500,0,0,.000,5,10,.500,.500,0,1,.000,1,3,4,0,1,1,2,5,10,2010
LaMarcus Aldridge,PF,24,POR,78,78,2922,579,1169,.495,5,16,.313,574,1153,.498,.497,230,304,.757,192,435,627,160,67,48,104,231,1393,2010
Joe Alexander,SF,23,CHI,8,0,29,1,6,.167,0,1,.000,1,5,.200,.167,2,3,.667,2,3,5,2,1,1,0,9,4,2010
Malik Allen,PF,31,DEN,51,3,456,46,116,.397,1,6,.167,45,110,.409,.401,12,13,.923,36,46,82,16,11,5,22,68,105,2010
Ray Allen,SG,34,BOS,80,80,2819,464,973,.477,145,399,.363,319,574,.556,.551,231,253,.913,45,208,253,210,64,25,129,182,1304,2010
Tony Allen,SG,28,BOS,54,8,889,129,253,.510,0,5,.000,129,248,.520,.510,72,119,.605,52,93,145,72,59,19,66,109,330,2010
Rafer Alston,PG,33,TOT,52,38,1421,155,446,.348,58,168,.345,97,278,.349,.413,59,81,.728,13,116,129,176,50,10,95,103,427,2010
Rafer Alston,PG,33,NJN,27,13,766,95,277,.343,28,87,.322,67,190,.353,.394,44,54,.815,9,66,75,104,27,5,61,50,262,2010
Rafer Alston,PG,33,MIA,25,25,655,60,169,.355,30,81,.370,30,88,.341,.444,15,27,.556,4,50,54,72,23,5,34,53,165,2010
Lou Amundson,PF,27,PHO,79,0,1168,152,276,.551,0,1,.000,152,275,.553,.551,67,123,.545,128,218,346,31,24,73,57,169,371,2010
Chris Andersen,PF,31,DEN,76,0,1695,142,251,.566,0,3,.000,142,248,.573,.566,164,236,.695,147,336,483,33,42,143,59,171,448,2010
David Andersen,C,29,HOU,63,0,891,147,340,.432,27,78,.346,120,262,.458,.472,46,67,.687,54,154,208,44,15,12,37,119,367,2010
Antonio Anderson,SF,24,OKC,1,0,15,1,3,.333,0,0,.000,1,3,.333,.333,0,0,.000,1,0,1,0,0,0,1,1,2,2010
Ryan Anderson,PF,21,ORL,63,6,911,169,388,.436,78,211,.370,91,177,.514,.536,71,82,.866,70,132,202,37,25,14,56,81,487,2010
Carmelo Anthony,SF,25,DEN,69,69,2634,688,1502,.458,59,187,.316,629,1315,.478,.478,508,612,.830,152,302,454,222,88,30,209,225,1943,2010
Joel Anthony,C,27,MIA,80,16,1322,76,159,.478,0,0,.000,76,159,.478,.478,66,92,.717,123,126,249,12,20,109,45,158,218,2010
Gilbert Arenas,PG,28,WAS,32,32,1169,253,616,.411,63,181,.348,190,435,.437,.462,153,207,.739,17,116,133,230,41,9,117,95,722,2010
Trevor Ariza,SF,24,HOU,72,71,2629,394,999,.394,136,407,.334,258,592,.436,.462,148,228,.649,78,325,403,276,126,40,161,162,1072,2010
Hilton Armstrong,PF-C,25,TOT,33,0,335,28,79,.354,0,1,.000,28,78,.359,.354,15,32,.469,27,54,81,21,15,12,22,59,71,2010
Hilton Armstrong,PF,25,NOH,18,0,239,19,50,.380,0,0,.000,19,50,.380,.380,13,28,.464,17,44,61,16,8,8,13,44,51,2010
Hilton Armstrong,C,25,SAC,6,0,56,4,12,.333,0,0,.000,4,12,.333,.333,2,2,1.000,5,9,14,2,2,4,4,5,10,2010
Hilton Armstrong,C,25,HOU,9,0,40,5,17,.294,0,1,.000,5,16,.313,.294,0,2,.000,5,1,6,3,5,0,5,10,10,2010
Carlos Arroyo,PG,30,MIA,72,35,1585,178,375,.475,7,25,.280,171,350,.489,.484,76,90,.844,26,104,130,225,36,6,54,102,439,2010
Darrell Arthur,PF,21,MEM,32,1,457,63,146,.432,0,1,.000,63,145,.434,.432,17,30,.567,37,73,110,15,14,14,22,60,143,2010
Chucky Atkins,PG,35,DET,40,11,644,57,157,.363,22,73,.301,35,84,.417,.433,25,27,.926,5,24,29,91,17,0,32,53,161,2010
D.J. Augustin,PG,22,CHA,80,2,1472,168,435,.386,70,178,.393,98,257,.381,.467,102,131,.779,11,86,97,193,45,5,74,127,508,2010
Jeff Ayres,C,22,POR,39,4,405,43,65,.662,0,0,.000,43,65,.662,.662,18,20,.900,25,73,98,1,7,16,12,76,104,2010
Kelenna Azubuike,SF,26,GSW,9,7,231,48,88,.545,10,27,.370,38,61,.623,.602,19,28,.679,12,29,41,10,5,9,7,16,125,2010
Renaldo Balkman,SF,25,DEN,13,1,91,6,18,.333,0,7,.000,6,11,.545,.333,2,6,.333,4,19,23,7,8,2,6,16,14,2010
Marcus Banks,PG,28,TOR,22,0,244,39,73,.534,7,24,.292,32,49,.653,.582,24,29,.828,3,20,23,26,12,2,20,30,109,2010
Leandro Barbosa,PG,27,PHO,44,5,786,155,365,.425,44,136,.324,111,229,.485,.485,64,73,.877,11,58,69,64,23,12,46,71,418,2010
J.J. Barea,PG,25,DAL,78,18,1546,232,527,.440,56,157,.357,176,370,.476,.493,76,90,.844,17,129,146,258,35,6,102,119,596,2010
Andrea Bargnani,PF,24,TOR,80,80,2799,537,1143,.470,121,325,.372,416,818,.509,.523,181,234,.774,105,388,493,93,25,111,120,215,1376,2010
Matt Barnes,SF,29,ORL,81,58,2097,271,557,.487,66,207,.319,205,350,.586,.546,108,146,.740,106,339,445,134,59,30,112,185,716,2010
Earl Barron,C,28,NYK,7,6,232,30,68,.441,0,0,.000,30,68,.441,.441,22,29,.759,31,46,77,8,4,4,11,24,82,2010
Brandon Bass,PF,24,ORL,50,3,648,119,233,.511,0,0,.000,119,233,.511,.511,52,63,.825,54,73,127,19,12,27,31,69,290,2010
Tony Battie,C,33,NJN,15,0,134,14,40,.350,1,4,.250,13,36,.361,.363,7,10,.700,4,19,23,3,4,2,3,19,36,2010
Shane Battier,SG,31,HOU,67,62,2168,178,447,.398,101,279,.362,77,168,.458,.511,77,106,.726,74,238,312,164,53,76,64,139,534,2010
Nicolas Batum,SF,21,POR,37,25,918,139,268,.519,54,132,.409,85,136,.625,.619,43,51,.843,32,109,141,44,24,25,27,83,375,2010
Jerryd Bayless,SG,21,POR,74,11,1304,200,483,.414,29,92,.315,171,391,.437,.444,201,242,.831,18,102,120,172,26,5,94,152,630,2010
Michael Beasley,PF,21,MIA,78,78,2328,468,1040,.450,28,102,.275,440,938,.469,.463,192,240,.800,123,375,498,100,80,49,131,221,1156,2010
Rodrigue Beaubois,PG,21,DAL,56,16,700,155,299,.518,45,110,.409,110,189,.582,.594,42,52,.808,12,66,78,74,29,12,54,84,397,2010
Marco Belinelli,SG,23,TOR,66,1,1121,154,379,.406,60,158,.380,94,221,.425,.485,101,121,.835,14,81,95,89,42,5,60,80,469,2010
Charlie Bell,SG,30,MIL,71,39,1611,169,443,.381,73,200,.365,96,243,.395,.464,48,67,.716,31,101,132,104,39,12,54,136,459,2010
Raja Bell,SG,33,TOT,6,5,180,28,61,.459,12,27,.444,16,34,.471,.557,3,3,1.000,5,18,23,13,4,2,5,15,71,2010
Raja Bell,SG,33,CHA,5,5,157,24,55,.436,9,24,.375,15,31,.484,.518,3,3,1.000,5,16,21,10,4,2,5,13,60,2010
Raja Bell,SG,33,GSW,1,0,23,4,6,.667,3,3,1.000,1,3,.333,.917,0,0,.000,0,2,2,3,0,0,0,2,11,2010
Jonathan Bender,SF,29,NYK,25,1,292,40,100,.400,14,39,.359,26,61,.426,.470,24,26,.923,15,37,52,16,2,17,28,33,118,2010
Mike Bibby,PG,31,ATL,80,80,2195,268,644,.416,126,324,.389,142,320,.444,.514,68,79,.861,20,164,184,310,67,3,90,157,730,2010
Andris Biedrins,C,23,GSW,33,29,763,81,137,.591,0,0,.000,81,137,.591,.591,4,25,.160,63,196,259,57,20,44,32,117,166,2010
Chauncey Billups,PG,33,DEN,73,73,2490,402,962,.418,157,407,.386,245,555,.441,.499,466,512,.910,25,203,228,409,82,9,177,153,1427,2010
DeJuan Blair,PF,20,SAS,82,23,1494,275,495,.556,0,2,.000,275,493,.558,.556,88,161,.547,200,326,526,65,50,39,112,224,638,2010
Steve Blake,PG,29,TOT,80,38,2159,217,522,.416,116,294,.395,101,228,.443,.527,36,48,.750,21,166,187,380,58,6,128,123,586,2010
Steve Blake,PG,29,POR,51,28,1397,143,355,.403,78,207,.377,65,148,.439,.513,24,32,.750,15,103,118,203,37,2,65,84,388,2010
Steve Blake,PG,29,LAC,29,10,762,74,167,.443,38,87,.437,36,80,.450,.557,12,16,.750,6,63,69,177,21,4,63,39,198,2010
Andray Blatche,PF,23,WAS,81,36,2256,478,999,.478,13,44,.295,465,955,.487,.485,174,234,.744,158,351,509,170,85,71,182,218,1143,2010
Keith Bogans,SF,29,SAS,79,50,1559,120,298,.403,70,196,.357,50,102,.490,.520,37,50,.740,25,151,176,95,45,12,53,156,347,2010
Andrew Bogut,C,25,MIL,69,69,2229,473,910,.520,0,2,.000,473,908,.521,.520,149,237,.629,208,493,701,127,39,175,131,222,1095,2010
Matt Bonner,PF,29,SAS,65,8,1161,166,372,.446,90,231,.390,76,141,.539,.567,35,48,.729,52,162,214,68,30,24,39,109,457,2010
Josh Boone,PF,25,NJN,63,28,1045,117,223,.525,0,0,.000,117,223,.525,.525,19,58,.328,124,191,315,29,30,48,37,111,253,2010
Carlos Boozer,PF,28,UTA,78,78,2673,617,1098,.562,0,0,.000,617,1098,.562,.562,285,384,.742,181,693,874,247,84,36,212,270,1519,2010
Chris Bosh,C,25,TOR,70,70,2526,600,1158,.518,8,22,.364,592,1136,.521,.522,470,590,.797,205,554,759,166,43,68,169,170,1678,2010
Ryan Bowen,SF,34,OKC,1,0,8,1,1,1.000,0,0,.000,1,1,1.000,1.000,2,2,1.000,1,1,2,0,1,0,0,2,4,2010
Earl Boykins,PG,33,WAS,67,1,1117,172,403,.427,19,60,.317,153,343,.446,.450,77,89,.865,17,58,75,171,24,3,69,48,440,2010
Elton Brand,PF,30,PHI,76,57,2297,412,858,.480,0,1,.000,412,857,.481,.480,172,233,.738,179,282,461,109,82,80,131,232,996,2010
Corey Brewer,SG,23,MIN,82,82,2482,409,949,.431,82,237,.346,327,712,.459,.474,166,256,.648,70,209,279,193,117,29,164,224,1066,2010
Ronnie Brewer,SG,24,TOT,58,53,1742,209,429,.487,8,31,.258,201,398,.505,.497,85,133,.639,45,142,187,154,91,15,53,80,511,2010
Ronnie Brewer,SG,24,UTA,53,53,1662,206,416,.495,8,31,.258,198,385,.514,.505,81,128,.633,44,136,180,151,85,15,51,80,501,2010
Ronnie Brewer,SG,24,MEM,5,0,80,3,13,.231,0,0,.000,3,13,.231,.231,4,5,.800,1,6,7,3,6,0,2,0,10,2010
Primoz Brezec,C,30,TOT,21,0,95,9,26,.346,0,0,.000,9,26,.346,.346,1,6,.167,12,13,25,1,1,3,2,19,19,2010
Primoz Brezec,C,30,PHI,7,0,36,2,13,.154,0,0,.000,2,13,.154,.154,1,2,.500,6,6,12,0,1,1,0,9,5,2010
Primoz Brezec,C,30,MIL,14,0,59,7,13,.538,0,0,.000,7,13,.538,.538,0,4,.000,6,7,13,1,0,2,2,10,14,2010
Jon Brockman,PF,22,SAC,52,4,654,55,103,.534,0,0,.000,55,103,.534,.534,37,62,.597,105,108,213,22,15,5,23,115,147,2010
Aaron Brooks,PG,25,HOU,82,82,2919,575,1331,.432,209,525,.398,366,806,.454,.511,245,298,.822,54,161,215,434,69,14,232,199,1604,2010
Bobby Brown,PG,25,TOT,45,0,519,88,237,.371,26,98,.265,62,139,.446,.426,13,15,.867,9,29,38,88,15,1,46,42,215,2010
Bobby Brown,PG,25,NOH,22,0,328,60,152,.395,17,66,.258,43,86,.500,.451,8,8,1.000,1,17,18,46,9,1,24,28,145,2010
Bobby Brown,PG,25,LAC,23,0,191,28,85,.329,9,32,.281,19,53,.358,.382,5,7,.714,8,12,20,42,6,0,22,14,70,2010
Derrick Brown,SF,22,CHA,57,0,535,68,147,.463,2,7,.286,66,140,.471,.469,48,72,.667,31,47,78,19,21,10,19,53,186,2010
Devin Brown,SG,31,TOT,50,37,1060,136,361,.377,58,164,.354,78,197,.396,.457,69,86,.802,29,95,124,65,33,6,62,72,399,2010
Devin Brown,SG,31,NOH,39,37,967,128,325,.394,54,147,.367,74,178,.416,.477,69,86,.802,27,82,109,58,30,5,57,62,379,2010
Devin Brown,SG,31,CHI,11,0,93,8,36,.222,4,17,.235,4,19,.211,.278,0,0,.000,2,13,15,7,3,1,5,10,20,2010
Kwame Brown,C,27,DET,48,1,660,62,124,.500,0,1,.000,62,123,.504,.500,33,98,.337,53,124,177,22,15,12,43,93,157,2010
Shannon Brown,SG,24,LAL,82,7,1700,253,592,.427,62,189,.328,191,403,.474,.480,99,121,.818,30,153,183,108,57,31,67,129,667,2010
Kobe Bryant,SG,31,LAL,73,73,2835,716,1569,.456,99,301,.329,617,1268,.487,.488,439,541,.811,78,313,391,365,113,20,233,187,1970,2010
Chase Budinger,SF,21,HOU,74,4,1488,249,565,.441,92,249,.369,157,316,.497,.522,67,87,.770,38,182,220,88,34,11,48,85,657,2010
Caron Butler,SF-SG,29,TOT,74,74,2783,450,1051,.428,42,145,.290,408,906,.450,.448,264,315,.838,104,357,461,156,116,24,160,193,1206,2010
Caron Butler,SF,29,WAS,47,47,1853,293,694,.422,25,95,.263,268,599,.447,.440,185,211,.877,68,248,316,107,68,15,113,126,796,2010
Caron Butler,SG,29,DAL,27,27,930,157,357,.440,17,50,.340,140,307,.456,.464,79,104,.760,36,109,145,49,48,9,47,67,410,2010
Rasual Butler,SF,30,LAC,82,64,2702,356,870,.409,145,432,.336,211,438,.482,.493,122,145,.841,39,201,240,116,36,68,79,121,979,2010
Andrew Bynum,C,22,LAL,65,65,1977,392,688,.570,0,1,.000,392,687,.571,.570,193,261,.739,177,364,541,68,35,94,115,193,977,2010
Will Bynum,PG,27,DET,63,20,1667,237,534,.444,12,55,.218,225,479,.470,.455,142,178,.798,24,118,142,283,55,7,115,143,628,2010
Jose Calderon,PG,28,TOR,68,39,1817,274,568,.482,68,171,.398,206,397,.519,.542,83,104,.798,23,119,142,404,47,7,99,135,699,2010
Marcus Camby,PF-C,35,TOT,74,74,2314,238,501,.475,2,7,.286,236,494,.478,.477,78,122,.639,249,622,871,186,95,146,91,161,556,2010
Marcus Camby,PF,35,LAC,51,51,1596,166,356,.466,2,6,.333,164,350,.469,.469,60,91,.659,166,450,616,151,69,99,64,105,394,2010
Marcus Camby,C,35,POR,23,23,718,72,145,.497,0,1,.000,72,144,.500,.497,18,31,.581,83,172,255,35,26,47,27,56,162,2010
Brian Cardinal,PF,32,MIN,29,0,267,14,36,.389,3,9,.333,11,27,.407,.431,17,18,.944,7,22,29,24,9,3,7,56,48,2010
Rodney Carney,SG,25,PHI,68,0,857,113,282,.401,41,135,.304,72,147,.490,.473,52,63,.825,26,111,137,37,25,20,21,79,319,2010
DeMarre Carroll,SF,23,MEM,71,1,795,88,222,.396,0,6,.000,88,216,.407,.396,33,53,.623,53,97,150,33,28,9,24,107,209,2010
Matt Carroll,SG,29,DAL,25,0,121,18,50,.360,4,19,.211,14,31,.452,.400,6,6,1.000,4,8,12,6,5,0,7,13,46,2010
Anthony Carter,PG,34,DEN,54,7,859,76,181,.420,17,63,.270,59,118,.500,.467,11,13,.846,17,72,89,160,39,13,58,72,180,2010
Vince Carter,SG,33,ORL,75,74,2310,434,1015,.428,119,324,.367,315,691,.456,.486,257,306,.840,33,260,293,236,53,18,106,189,1244,2010
Omri Casspi,SF,21,SAC,77,31,1931,300,672,.446,75,203,.369,225,469,.480,.502,117,174,.672,75,274,349,95,54,17,98,125,792,2010
Mario Chalmers,PG,23,MIA,73,22,1807,182,454,.401,75,236,.318,107,218,.491,.483,82,110,.745,25,110,135,246,91,12,123,175,521,2010
Tyson Chandler,C,27,CHA,51,27,1163,109,190,.574,0,0,.000,109,190,.574,.574,115,157,.732,114,206,320,16,17,55,91,138,333,2010
Wilson Chandler,SG,22,NYK,65,64,2320,412,860,.479,40,150,.267,372,710,.524,.502,129,160,.806,93,255,348,138,46,49,108,184,993,2010
Earl Clark,PF,22,PHO,51,0,383,56,151,.371,2,5,.400,54,146,.370,.377,26,36,.722,18,44,62,21,7,13,23,25,140,2010
Jarron Collins,C,31,PHO,34,10,261,12,31,.387,0,0,.000,12,31,.387,.387,10,25,.400,22,40,62,6,2,3,10,42,34,2010
Jason Collins,C,31,ATL,24,0,115,8,23,.348,0,1,.000,8,22,.364,.348,0,2,.000,5,9,14,4,3,2,5,21,16,2010
Mardy Collins,SG,25,LAC,43,0,470,47,128,.367,4,17,.235,43,111,.387,.383,13,21,.619,13,37,50,44,23,1,32,45,111,2010
Darren Collison,PG,22,NOH,76,37,2109,376,789,.477,46,115,.400,330,674,.490,.506,148,174,.851,41,151,192,432,78,4,202,92,946,2010
Nick Collison,C,29,OKC,75,5,1557,182,309,.589,1,4,.250,181,305,.593,.591,74,107,.692,152,232,384,38,37,48,63,230,439,2010
Mike Conley,PG,22,MEM,80,80,2569,369,830,.445,82,212,.387,287,618,.464,.494,139,187,.743,30,161,191,425,109,12,170,178,959,2010
Will Conroy,PG,27,HOU,5,0,36,3,10,.300,0,3,.000,3,7,.429,.300,0,2,.000,0,3,3,7,0,0,4,5,6,2010
Brian Cook,PF,29,HOU,15,0,44,7,23,.304,2,9,.222,5,14,.357,.348,5,7,.714,1,8,9,1,0,2,6,5,21,2010
Daequan Cook,SG,22,MIA,45,3,691,81,253,.320,40,126,.317,41,127,.323,.399,21,25,.840,9,73,82,43,14,10,24,50,223,2010
Jamal Crawford,SG,29,ATL,79,0,2460,496,1105,.449,163,427,.382,333,678,.491,.523,270,315,.857,34,167,201,238,61,12,137,132,1425,2010
Dante Cunningham,PF,22,POR,63,2,707,106,214,.495,0,2,.000,106,212,.500,.495,31,48,.646,54,106,160,14,24,22,15,97,243,2010
Eddy Curry,C,27,NYK,7,0,62,8,21,.381,0,0,.000,8,21,.381,.381,10,17,.588,4,9,13,0,0,1,13,13,26,2010
JamesOn Curry,PG,24,LAC,1,0,0,0,0,.000,0,0,.000,0,0,.000,.000,0,0,.000,0,0,0,0,0,0,0,0,0,2010
Stephen Curry,PG,21,GSW,80,77,2896,528,1143,.462,166,380,.437,362,763,.474,.535,177,200,.885,48,308,356,472,152,19,243,252,1399,2010
Samuel Dalembert,C,28,PHI,82,80,2124,285,523,.545,0,0,.000,285,523,.545,.545,97,133,.729,239,545,784,64,42,151,123,252,667,2010
Erick Dampier,C,34,DAL,55,47,1280,133,213,.624,1,3,.333,132,210,.629,.627,61,101,.604,128,272,400,31,15,77,61,153,328,2010
Marquis Daniels,SF,29,BOS,51,4,937,124,249,.498,6,28,.214,118,221,.534,.510,34,56,.607,27,68,95,66,27,6,42,91,288,2010
Baron Davis,PG,30,LAC,75,73,2523,412,1015,.406,82,296,.277,330,719,.459,.446,239,291,.821,52,214,266,598,126,43,211,210,1145,2010
Glen Davis,PF,24,BOS,54,1,933,122,279,.437,0,4,.000,122,275,.444,.437,96,138,.696,101,104,205,35,21,14,53,132,340,2010
Paul Davis,PF,25,WAS,2,0,8,2,4,.500,0,0,.000,2,4,.500,.500,1,2,.500,0,0,0,3,0,1,0,0,5,2010
Ricky Davis,SF,30,LAC,36,2,499,62,143,.434,16,42,.381,46,101,.455,.490,18,31,.581,10,47,57,39,11,3,29,39,158,2010
Austin Daye,SF,21,DET,69,4,915,137,295,.464,29,95,.305,108,200,.540,.514,46,56,.821,34,140,174,34,25,26,48,114,349,2010
Carlos Delfino,SF,27,MIL,75,66,2279,299,732,.408,134,365,.367,165,367,.450,.500,93,119,.782,51,343,394,202,80,21,119,138,825,2010
Luol Deng,SF,24,CHI,70,69,2651,473,1014,.466,32,83,.386,441,931,.474,.482,252,330,.764,131,381,512,143,66,61,134,129,1230,2010
DeMar DeRozan,SG,20,TOR,77,65,1664,255,512,.498,4,16,.250,251,496,.506,.502,148,194,.763,66,157,223,53,43,18,62,176,662,2010
Boris Diaw,PF,27,CHA,82,82,2906,373,773,.483,66,206,.320,307,567,.541,.525,113,147,.769,131,293,424,325,60,57,178,219,925,2010
Yakhouba Diawara,SG,27,MIA,6,2,44,2,10,.200,1,6,.167,1,4,.250,.250,0,0,.000,1,3,4,3,1,0,3,8,5,2010
Travis Diener,PG,27,TOT,9,0,51,2,10,.200,1,7,.143,1,3,.333,.250,1,4,.250,0,3,3,8,4,0,0,2,6,2010
Travis Diener,PG,27,IND,4,0,25,1,6,.167,1,5,.200,0,1,.000,.250,0,2,.000,0,2,2,4,3,0,0,1,3,2010
Travis Diener,PG,27,POR,5,0,26,1,4,.250,0,2,.000,1,2,.500,.250,1,2,.500,0,1,1,4,1,0,0,1,3,2010
DeSagana Diop,C,28,CHA,27,0,262,15,29,.517,0,0,.000,15,29,.517,.517,2,9,.222,24,41,65,5,5,14,12,31,32,2010
Keyon Dooling,PG,29,NJN,53,8,971,129,324,.398,59,157,.376,70,167,.419,.489,47,61,.770,8,46,54,135,34,0,59,82,364,2010
Joey Dorsey,PF,26,TOT,15,0,106,9,20,.450,0,0,.000,9,20,.450,.450,5,12,.417,16,27,43,2,3,2,6,21,23,2010
Joey Dorsey,PF,26,HOU,7,0,54,5,11,.455,0,0,.000,5,11,.455,.455,1,2,.500,11,14,25,2,2,1,4,12,11,2010
Joey Dorsey,PF,26,SAC,8,0,52,4,9,.444,0,0,.000,4,9,.444,.444,4,10,.400,5,13,18,0,1,1,2,9,12,2010
Toney Douglas,PG,23,NYK,56,12,1087,179,391,.458,68,175,.389,111,216,.514,.545,55,68,.809,40,68,108,112,42,3,55,116,481,2010
Chris Douglas-Roberts,SF,23,NJN,67,38,1730,255,573,.445,14,54,.259,241,519,.464,.457,133,157,.847,45,153,198,93,55,19,97,101,657,2010
Goran Dragic,PG,23,PHO,80,2,1442,222,491,.452,74,188,.394,148,303,.488,.527,117,159,.736,38,133,171,241,48,8,126,131,635,2010
Jared Dudley,SF,24,PHO,82,1,1991,225,490,.459,120,262,.458,105,228,.461,.582,104,138,.754,99,182,281,115,81,16,68,162,674,2010
Chris Duhon,PG,27,NYK,67,59,2072,168,451,.373,90,258,.349,78,193,.404,.472,68,95,.716,28,150,178,378,59,3,110,83,494,2010
Tim Duncan,C,33,SAS,78,77,2438,561,1082,.518,2,11,.182,559,1071,.522,.519,271,374,.725,221,567,788,246,45,117,140,152,1395,2010
Mike Dunleavy,SF,29,IND,67,15,1486,229,558,.410,75,236,.318,154,322,.478,.478,133,158,.842,25,211,236,103,38,15,72,105,666,2010
Kevin Durant,SF,21,OKC,82,82,3239,794,1668,.476,128,351,.365,666,1317,.506,.514,756,840,.900,105,518,623,231,112,84,271,171,2472,2010
Wayne Ellington,SG,22,MIN,76,1,1384,190,448,.424,64,162,.395,126,286,.441,.496,61,70,.871,33,126,159,74,20,5,74,72,505,2010
Monta Ellis,SG,24,GSW,64,64,2647,631,1406,.449,77,228,.338,554,1178,.470,.476,292,388,.753,47,210,257,340,143,25,244,189,1631,2010
Francisco Elson,C,33,TOT,12,0,66,5,15,.333,0,0,.000,5,15,.333,.333,2,5,.400,6,8,14,2,1,0,1,7,12,2010
Francisco Elson,C,33,MIL,11,0,62,4,13,.308,0,0,.000,4,13,.308,.308,2,2,1.000,5,8,13,2,1,0,1,7,10,2010
Francisco Elson,C,33,PHI,1,0,4,1,2,.500,0,0,.000,1,2,.500,.500,0,3,.000,1,0,1,0,0,0,0,0,2,2010
Maurice Evans,SF,31,ATL,79,5,1317,175,393,.445,57,169,.337,118,224,.527,.518,46,61,.754,59,95,154,48,34,17,20,125,453,2010
Reggie Evans,PF,29,TOR,28,1,311,34,69,.493,0,0,.000,34,69,.493,.493,27,60,.450,30,75,105,8,14,4,22,44,95,2010
Tyreke Evans,SG,20,SAC,72,72,2677,533,1165,.458,36,141,.255,497,1024,.485,.473,348,465,.748,66,314,380,414,109,26,216,204,1450,2010
Jordan Farmar,PG,23,LAL,82,0,1474,224,515,.435,86,229,.376,138,286,.483,.518,57,85,.671,14,117,131,127,52,11,72,109,591,2010
Raymond Felton,PG,25,CHA,80,80,2643,388,846,.459,60,156,.385,328,690,.475,.494,132,173,.763,53,235,288,446,123,22,168,172,968,2010
Rudy Fernandez,SG,24,POR,62,2,1441,160,423,.378,98,266,.368,62,157,.395,.494,85,98,.867,35,129,164,127,62,11,72,87,503,2010
Kyrylo Fesenko,C,23,UTA,49,5,408,52,95,.547,0,1,.000,52,94,.553,.547,24,57,.421,33,57,90,15,6,19,24,78,128,2010
Michael Finley,SF,36,TOT,46,7,709,81,184,.440,32,82,.390,49,102,.480,.527,8,15,.533,6,65,71,43,10,6,21,33,202,2010
Michael Finley,SF,36,SAS,25,6,395,37,97,.381,13,41,.317,24,56,.429,.448,6,9,.667,5,33,38,19,6,4,13,12,93,2010
Michael Finley,SF,36,BOS,21,1,314,44,87,.506,19,41,.463,25,46,.543,.615,2,6,.333,1,32,33,24,4,2,8,21,109,2010
Derek Fisher,PG,35,LAL,82,82,2227,212,558,.380,78,224,.348,134,334,.401,.450,113,132,.856,25,145,170,201,90,9,78,202,615,2010
Jonny Flynn,PG,20,MIN,81,81,2339,397,952,.417,77,215,.358,320,737,.434,.457,223,270,.826,24,167,191,356,82,2,233,98,1094,2010
T.J. Ford,PG,26,IND,47,32,1189,186,418,.445,8,50,.160,178,368,.484,.455,104,135,.770,41,108,149,180,44,11,90,102,484,2010
Jeff Foster,C,33,IND,16,3,255,22,46,.478,0,1,.000,22,45,.489,.478,5,9,.556,34,47,81,21,3,4,14,45,49,2010
Randy Foye,PG,26,WAS,70,38,1667,256,619,.414,63,182,.346,193,437,.442,.464,129,145,.890,16,114,130,228,33,10,94,123,704,2010
Channing Frye,C,26,PHO,81,41,2190,317,703,.451,172,392,.439,145,311,.466,.573,98,121,.810,66,361,427,113,64,74,73,263,904,2010
Dan Gadzuric,C,31,MIL,32,6,314,39,89,.438,0,0,.000,39,89,.438,.438,10,25,.400,38,54,92,12,9,13,15,63,88,2010
Sundiata Gaines,PG,23,UTA,32,0,217,38,82,.463,7,26,.269,31,56,.554,.506,23,46,.500,6,23,29,39,12,0,14,17,106,2010
Danilo Gallinari,SF,21,NYK,81,74,2747,392,927,.423,186,488,.381,206,439,.469,.523,251,307,.818,65,333,398,135,75,58,110,191,1221,2010
Francisco Garcia,SG,28,SAC,25,4,575,82,176,.466,23,59,.390,59,117,.504,.531,15,17,.882,11,55,66,45,10,19,21,49,202,2010
Kevin Garnett,PF,33,BOS,69,69,2060,402,772,.521,1,5,.200,401,767,.523,.521,185,221,.837,78,428,506,185,68,57,101,170,990,2010
Marc Gasol,C,25,MEM,69,69,2469,378,651,.581,0,1,.000,378,650,.582,.581,252,376,.670,208,432,640,165,69,109,135,254,1008,2010
Pau Gasol,C,29,LAL,65,65,2403,452,844,.536,0,5,.000,452,839,.539,.536,286,362,.790,243,491,734,218,37,113,143,152,1190,2010
Rudy Gay,SF,23,MEM,80,80,3175,600,1288,.466,66,202,.327,534,1086,.492,.491,301,400,.753,115,357,472,153,118,64,169,201,1567,2010
Alonzo Gee,SG,22,WAS,11,2,182,28,59,.475,7,9,.778,21,50,.420,.534,18,29,.621,15,18,33,7,7,1,10,13,81,2010
Devean George,SF,32,GSW,45,4,761,89,206,.432,48,123,.390,41,83,.494,.549,16,23,.696,21,93,114,32,41,10,15,89,242,2010
Daniel Gibson,PG,23,CLE,56,10,1068,125,268,.466,71,149,.477,54,119,.454,.599,34,49,.694,13,60,73,70,25,7,36,79,355,2010
Taj Gibson,PF,24,CHI,82,70,2204,311,629,.494,0,0,.000,311,629,.494,.494,113,175,.646,226,385,611,70,50,104,114,282,735,2010
J.R. Giddens,SF,24,TOT,32,1,239,28,60,.467,0,10,.000,28,50,.560,.467,13,23,.565,16,35,51,13,9,2,17,29,69,2010
J.R. Giddens,SF,24,BOS,21,1,99,9,21,.429,0,2,.000,9,19,.474,.429,6,12,.500,4,16,20,6,4,1,7,10,24,2010
J.R. Giddens,SF,24,NYK,11,0,140,19,39,.487,0,8,.000,19,31,.613,.487,7,11,.636,12,19,31,7,5,1,10,19,45,2010
Trey Gilder,SF,25,MEM,2,0,5,1,1,1.000,0,0,.000,1,1,1.000,1.000,0,0,.000,0,1,1,0,1,0,0,0,2,2010
Manu Ginobili,SG,32,SAS,75,21,2150,398,903,.441,132,350,.377,266,553,.481,.514,309,355,.870,68,216,284,370,103,24,154,154,1237,2010
Ryan Gomes,SF,27,MIN,76,64,2210,327,732,.447,74,199,.372,253,533,.475,.497,104,126,.825,76,272,348,124,62,16,95,155,832,2010
Drew Gooden,C-PF,28,TOT,70,33,1755,288,602,.478,1,8,.125,287,594,.483,.479,186,216,.861,207,335,542,47,41,58,108,194,763,2010
Drew Gooden,C,28,DAL,46,11,1030,157,336,.467,1,6,.167,156,330,.473,.469,93,115,.809,123,193,316,26,26,50,56,129,408,2010
Drew Gooden,PF,28,LAC,24,22,725,131,266,.492,0,2,.000,131,264,.496,.492,93,101,.921,84,142,226,21,15,8,52,65,355,2010
Ben Gordon,SG,26,DET,62,17,1730,291,699,.416,75,234,.321,216,465,.465,.470,198,230,.861,26,93,119,166,49,6,118,147,855,2010
Eric Gordon,SG,21,LAC,62,60,2229,352,784,.449,119,321,.371,233,463,.503,.525,222,299,.742,25,135,160,186,69,14,144,96,1045,2010
Marcin Gortat,C,25,ORL,81,0,1088,121,227,.533,0,3,.000,121,224,.540,.533,51,75,.680,104,237,341,17,17,70,46,138,293,2010
Joey Graham,SF,27,DEN,63,18,759,105,202,.520,2,13,.154,103,189,.545,.525,54,73,.740,39,84,123,22,23,7,43,104,266,2010
Stephen Graham,SG,27,CHA,70,8,804,119,240,.496,16,50,.320,103,190,.542,.529,42,65,.646,24,111,135,23,20,10,36,94,296,2010
Danny Granger,SF,26,IND,62,62,2278,488,1139,.428,158,438,.361,330,701,.471,.498,363,428,.848,67,275,342,171,94,51,157,183,1497,2010
Aaron Gray,C,25,TOT,32,0,311,42,82,.512,0,0,.000,42,82,.512,.512,20,28,.714,45,61,106,22,9,11,18,54,104,2010
Aaron Gray,C,25,CHI,8,0,50,8,21,.381,0,0,.000,8,21,.381,.381,2,7,.286,5,11,16,2,0,0,1,10,18,2010
Aaron Gray,C,25,NOH,24,0,261,34,61,.557,0,0,.000,34,61,.557,.557,18,21,.857,40,50,90,20,9,11,17,44,86,2010
Danny Green,SG,22,CLE,20,0,115,15,39,.385,6,22,.273,9,17,.529,.462,4,6,.667,8,9,17,5,6,3,5,9,40,2010
Jeff Green,PF,23,OKC,82,82,3043,485,1070,.453,104,312,.333,381,758,.503,.502,165,223,.740,112,378,490,134,104,72,135,221,1239,2010
Willie Green,SG,28,PHI,73,18,1553,248,543,.457,47,136,.346,201,407,.494,.500,95,114,.833,20,109,129,152,32,11,67,135,638,2010
Donte Greene,SF,21,SAC,76,50,1630,244,553,.441,69,183,.377,175,370,.473,.504,90,140,.643,53,181,234,71,41,53,93,150,647,2010
Taylor Griffin,SF,23,PHO,8,0,32,4,10,.400,0,2,.000,4,8,.500,.400,2,4,.500,0,2,2,1,0,2,1,4,10,2010
Hamed Haddadi,C,24,MEM,36,0,240,24,62,.387,0,3,.000,24,59,.407,.387,14,19,.737,26,49,75,10,1,14,20,57,62,2010
Malik Hairston,SG,22,SAS,47,0,317,40,76,.526,2,11,.182,38,65,.585,.539,17,30,.567,13,36,49,16,4,9,11,29,99,2010
Marcus Haislip,SF,29,SAS,10,0,44,10,21,.476,3,5,.600,7,16,.438,.548,2,5,.400,4,6,10,0,0,2,3,5,25,2010
Richard Hamilton,SG,31,DET,46,46,1552,293,717,.409,41,138,.297,252,579,.435,.437,204,241,.846,30,92,122,202,30,3,115,115,831,2010
Tyler Hansbrough,PF,24,IND,29,1,511,81,225,.360,0,4,.000,81,221,.367,.360,84,113,.743,60,78,138,28,17,8,21,70,246,2010
James Harden,SG,20,OKC,76,0,1738,233,578,.403,93,248,.375,140,330,.424,.484,194,240,.808,47,197,244,137,80,20,106,200,753,2010
Al Harrington,PF,29,NYK,72,15,2195,448,1030,.435,140,409,.342,308,621,.496,.503,240,317,.757,88,317,405,110,62,26,132,209,1276,2010
Devin Harris,PG,26,NJN,64,61,2221,356,884,.403,60,217,.276,296,667,.444,.437,308,386,.798,24,179,203,423,79,18,181,178,1080,2010
Mike Harris,PF,26,TOT,13,0,96,11,30,.367,0,1,.000,11,29,.379,.367,7,11,.636,10,14,24,3,5,1,9,14,29,2010
Mike Harris,PF,26,HOU,8,0,82,10,27,.370,0,1,.000,10,26,.385,.370,5,9,.556,9,11,20,3,4,1,9,10,25,2010
Mike Harris,PF,26,WAS,5,0,14,1,3,.333,0,0,.000,1,3,.333,.333,2,2,1.000,1,3,4,0,1,0,0,4,4,2010
Jason Hart,PG,31,TOT,5,0,22,1,2,.500,0,0,.000,1,2,.500,.500,0,0,.000,0,2,2,6,2,1,3,4,2,2010
Jason Hart,PG,31,MIN,1,0,5,0,1,.000,0,0,.000,0,1,.000,.000,0,0,.000,0,0,0,1,1,0,0,0,0,2010
Jason Hart,PG,31,NOH,4,0,17,1,1,1.000,0,0,.000,1,1,1.000,1.000,0,0,.000,0,2,2,5,1,1,3,4,2,2010
Udonis Haslem,PF,29,MIA,78,0,2177,312,632,.494,0,0,.000,312,632,.494,.494,147,193,.762,167,462,629,52,30,23,75,174,771,2010
Trenton Hassell,SF,30,NJN,52,31,1106,90,219,.411,0,5,.000,90,214,.421,.411,52,69,.754,56,96,152,50,17,9,47,91,232,2010
Spencer Hawes,C,21,SAC,72,59,1904,312,666,.468,26,87,.299,286,579,.494,.488,73,106,.689,145,291,436,158,32,83,131,200,723,2010
Chuck Hayes,C,26,HOU,82,82,1773,161,329,.489,0,0,.000,161,329,.489,.489,36,66,.545,151,314,465,139,73,43,74,219,358,2010
Jarvis Hayes,SF,28,NJN,45,19,1033,138,328,.421,60,179,.335,78,149,.523,.512,14,18,.778,9,99,108,40,29,9,28,91,350,2010
Brendan Haywood,C,30,TOT,77,67,2355,276,491,.562,0,1,.000,276,490,.563,.562,152,245,.620,278,437,715,43,26,158,99,209,704,2010
Brendan Haywood,C,30,WAS,49,48,1614,188,335,.561,0,0,.000,188,335,.561,.561,102,158,.646,200,307,507,18,18,101,67,145,478,2010
Brendan Haywood,C,30,DAL,28,19,741,88,156,.564,0,1,.000,88,155,.568,.564,50,87,.575,78,130,208,25,8,57,32,64,226,2010
Luther Head,SG,27,IND,47,10,813,136,311,.437,37,105,.352,99,206,.481,.497,48,58,.828,6,74,80,72,18,9,54,53,357,2010
Gerald Henderson,SG,22,CHA,43,0,355,37,104,.356,4,19,.211,33,85,.388,.375,35,47,.745,15,40,55,13,10,9,14,25,113,2010
Roy Hibbert,C,23,IND,81,69,2035,387,782,.495,3,6,.500,384,776,.495,.497,169,224,.754,177,287,464,158,30,131,145,285,946,2010
J.J. Hickson,PF,21,CLE,81,73,1691,289,522,.554,0,1,.000,289,521,.555,.554,111,163,.681,110,290,400,40,36,39,92,132,689,2010
Nene Hilario,C,27,DEN,82,82,2755,421,717,.587,0,2,.000,421,715,.589,.587,293,416,.704,166,461,627,203,115,82,125,281,1135,2010
George Hill,PG,23,SAS,78,43,2276,353,738,.478,75,188,.399,278,550,.505,.529,183,237,.772,42,163,205,226,69,26,101,222,964,2010
Grant Hill,SF,37,PHO,81,81,2430,336,703,.478,35,80,.438,301,623,.483,.503,205,251,.817,74,371,445,193,60,36,108,165,912,2010
Jordan Hill,PF,22,TOT,47,0,624,99,201,.493,0,2,.000,99,199,.497,.493,46,68,.676,76,99,175,20,14,21,30,92,244,2010
Jordan Hill,PF,22,NYK,24,0,252,41,92,.446,0,2,.000,41,90,.456,.446,15,21,.714,32,29,61,7,10,9,12,37,97,2010
Jordan Hill,PF,22,HOU,23,0,372,58,109,.532,0,0,.000,58,109,.532,.532,31,47,.660,44,70,114,13,4,12,18,55,147,2010
Kirk Hinrich,SG,29,CHI,74,53,2481,308,753,.409,104,280,.371,204,473,.431,.478,85,113,.752,24,236,260,330,85,24,113,204,805,2010
Jrue Holiday,PG,19,PHI,73,51,1767,230,520,.442,62,159,.390,168,361,.465,.502,65,86,.756,56,135,191,280,79,18,156,153,587,2010
Ryan Hollins,C,25,MIN,73,27,1223,169,303,.558,0,1,.000,169,302,.560,.558,109,158,.690,79,128,207,51,19,38,95,199,447,2010
Al Horford,C,23,ATL,81,81,2845,467,847,.551,1,1,1.000,466,846,.551,.552,213,270,.789,236,563,799,189,59,91,122,225,1148,2010
Eddie House,PG-SG,31,TOT,68,0,1217,173,455,.380,79,227,.348,94,228,.412,.467,48,52,.923,13,96,109,85,40,7,47,81,473,2010
Eddie House,PG,31,BOS,50,0,846,129,322,.401,64,167,.383,65,155,.419,.500,36,40,.900,7,62,69,48,28,7,27,61,358,2010
Eddie House,SG,31,NYK,18,0,371,44,133,.331,15,60,.250,29,73,.397,.387,12,12,1.000,6,34,40,37,12,0,20,20,115,2010
Dwight Howard,C,24,ORL,82,82,2843,510,834,.612,0,7,.000,510,827,.617,.612,483,816,.592,284,798,1082,144,75,228,274,287,1503,2010
Josh Howard,SF,29,TOT,35,12,918,157,388,.405,23,86,.267,134,302,.444,.434,109,139,.784,30,95,125,48,26,11,46,91,446,2010
Josh Howard,SF,29,DAL,31,9,827,137,342,.401,20,75,.267,117,267,.438,.430,94,119,.790,26,86,112,44,23,9,43,78,388,2010
Josh Howard,SF,29,WAS,4,3,91,20,46,.435,3,11,.273,17,35,.486,.467,15,20,.750,4,9,13,4,3,2,3,13,58,2010
Juwan Howard,C,36,POR,73,27,1632,191,375,.509,0,1,.000,191,374,.511,.509,55,70,.786,108,227,335,61,27,10,72,191,437,2010
Lester Hudson,PG,25,TOT,25,0,131,21,53,.396,5,16,.313,16,37,.432,.443,11,13,.846,7,11,18,13,8,3,14,12,58,2010
Lester Hudson,PG,25,BOS,16,0,70,7,18,.389,3,5,.600,4,13,.308,.472,5,6,.833,3,5,8,8,3,2,9,7,22,2010
Lester Hudson,PG,25,MEM,9,0,61,14,35,.400,2,11,.182,12,24,.500,.429,6,7,.857,4,6,10,5,5,1,5,5,36,2010
Larry Hughes,SG,31,TOT,45,16,1115,137,386,.355,43,139,.309,94,247,.381,.411,94,113,.832,23,119,142,137,52,15,75,70,411,2010
Larry Hughes,SG,31,NYK,31,14,820,102,279,.366,28,97,.289,74,182,.407,.416,65,79,.823,16,94,110,109,40,11,56,53,297,2010
Larry Hughes,SG,31,CHA,14,2,295,35,107,.327,15,42,.357,20,65,.308,.397,29,34,.853,7,25,32,28,12,4,19,17,114,2010
Kris Humphries,PF,24,TOT,69,0,1221,180,408,.441,0,1,.000,180,407,.442,.441,127,190,.668,120,258,378,32,36,48,66,145,487,2010
Kris Humphries,PF,24,DAL,25,0,315,53,115,.461,0,0,.000,53,115,.461,.461,25,44,.568,38,57,95,7,7,11,13,43,131,2010
Kris Humphries,PF,24,NJN,44,0,906,127,293,.433,0,1,.000,127,292,.435,.433,102,146,.699,82,201,283,25,29,37,53,102,356,2010
Chris Hunter,C,25,GSW,60,9,783,109,217,.502,0,4,.000,109,213,.512,.502,52,69,.754,56,111,167,37,13,35,30,132,270,2010
Lindsey Hunter,PG,39,CHI,13,0,122,5,30,.167,1,13,.077,4,17,.235,.183,2,2,1.000,1,13,14,9,1,0,4,12,13,2010
Othello Hunter,SF,23,ATL,7,0,33,4,12,.333,0,0,.000,4,12,.333,.333,3,4,.750,6,6,12,0,0,1,3,5,11,2010
Steven Hunter,C,28,MEM,21,0,158,17,43,.395,0,0,.000,17,43,.395,.395,19,36,.528,18,24,42,0,1,10,9,10,53,2010
Serge Ibaka,PF,20,OKC,73,0,1323,201,370,.543,1,2,.500,200,368,.543,.545,58,92,.630,138,259,397,10,25,97,68,194,461,2010
Andre Iguodala,SF,26,PHI,82,82,3193,496,1120,.443,94,303,.310,402,817,.492,.485,315,430,.733,82,447,529,472,141,55,218,145,1401,2010
Zydrunas Ilgauskas,C,34,CLE,64,6,1339,194,438,.443,11,23,.478,183,415,.441,.455,75,101,.743,114,231,345,48,14,50,63,183,474,2010
Didier Ilunga-Mbenga,C,29,LAL,49,2,355,48,103,.466,0,0,.000,48,103,.466,.466,9,19,.474,32,55,87,8,5,29,15,54,105,2010
Ersan Ilyasova,PF,22,MIL,81,31,1898,323,729,.443,81,241,.336,242,488,.496,.499,113,158,.715,157,360,517,84,53,23,71,251,840,2010
Allen Iverson,SG-PG,34,TOT,28,24,865,136,316,.430,9,25,.360,127,291,.436,.445,104,131,.794,16,63,79,113,19,2,64,48,385,2010
Allen Iverson,PG,34,MEM,3,0,67,15,26,.577,1,1,1.000,14,25,.560,.596,6,12,.500,1,3,4,11,1,0,7,5,37,2010
Allen Iverson,SG,34,PHI,25,24,798,121,290,.417,8,24,.333,113,266,.425,.431,98,119,.824,15,60,75,102,18,2,57,43,348,2010
Royal Ivey,SG,28,TOT,44,0,326,35,83,.422,14,35,.400,21,48,.438,.506,9,12,.750,6,28,34,27,19,2,11,39,93,2010
Royal Ivey,SG,28,PHI,26,0,236,26,55,.473,12,24,.500,14,31,.452,.582,6,7,.857,5,21,26,17,10,2,5,25,70,2010
Royal Ivey,SG,28,MIL,18,0,90,9,28,.321,2,11,.182,7,17,.412,.357,3,5,.600,1,7,8,10,9,0,6,14,23,2010
Jarrett Jack,PG,26,TOR,82,43,2243,323,671,.481,82,199,.412,241,472,.511,.542,203,241,.842,30,192,222,413,60,6,163,151,931,2010
Cedric Jackson,PG,23,TOT,12,0,74,6,20,.300,1,6,.167,5,14,.357,.325,7,12,.583,2,6,8,14,3,2,11,7,20,2010
Cedric Jackson,PG,23,CLE,5,0,10,0,2,.000,0,1,.000,0,1,.000,.000,1,4,.250,0,1,1,2,0,0,1,0,1,2010
Cedric Jackson,PG,23,SAS,3,0,25,2,7,.286,0,2,.000,2,5,.400,.286,3,4,.750,1,3,4,6,3,2,2,2,7,2010
Cedric Jackson,PG,23,WAS,4,0,39,4,11,.364,1,3,.333,3,8,.375,.409,3,4,.750,1,2,3,6,0,0,8,5,12,2010
Darnell Jackson,PF,24,TOT,28,0,123,9,30,.300,1,4,.250,8,26,.308,.317,4,6,.667,9,13,22,4,2,4,13,21,23,2010
Darnell Jackson,PF,24,CLE,27,0,114,8,25,.320,1,3,.333,7,22,.318,.340,4,6,.667,8,12,20,4,2,4,13,19,21,2010
Darnell Jackson,PF,24,MIL,1,0,9,1,5,.200,0,1,.000,1,4,.250,.200,0,0,.000,1,1,2,0,0,0,0,2,2,2010
Stephen Jackson,SG-PF,31,TOT,81,81,3129,600,1418,.423,129,393,.328,471,1025,.460,.469,338,434,.779,78,323,401,300,132,43,259,197,1667,2010
Stephen Jackson,PF,31,GSW,9,9,300,56,133,.421,11,40,.275,45,93,.484,.462,26,37,.703,6,29,35,42,14,6,26,16,149,2010
Stephen Jackson,SG,31,CHA,72,72,2829,544,1285,.423,118,353,.334,426,932,.457,.469,312,397,.786,72,294,366,258,118,37,233,181,1518,2010
LeBron James,SF,25,CLE,76,76,2966,768,1528,.503,129,387,.333,639,1141,.560,.545,593,773,.767,71,483,554,651,125,77,261,119,2258,2010
Mike James,PG,34,WAS,4,0,46,6,20,.300,2,6,.333,4,14,.286,.350,4,8,.500,1,2,3,5,3,0,5,3,18,2010
Antawn Jamison,PF,33,TOT,66,64,2406,478,1036,.461,85,247,.344,393,789,.498,.502,194,300,.647,136,419,555,84,71,21,91,179,1235,2010
Antawn Jamison,PF,33,WAS,41,41,1595,315,700,.450,58,168,.345,257,532,.483,.491,152,217,.700,99,263,362,52,43,9,61,112,840,2010
Antawn Jamison,PF,33,CLE,25,23,811,163,336,.485,27,79,.342,136,257,.529,.525,42,83,.506,37,156,193,32,28,12,30,67,395,2010
Nathan Jawai,C,23,MIN,39,2,412,49,111,.441,0,1,.000,49,110,.445,.441,26,38,.684,49,55,104,24,10,9,27,58,124,2010
Othyus Jeffers,SG,24,UTA,14,0,73,12,29,.414,0,0,.000,12,29,.414,.414,13,19,.684,8,11,19,1,4,0,6,10,37,2010
Al Jefferson,C,25,MIN,76,76,2463,560,1125,.498,0,4,.000,560,1121,.500,.498,181,266,.680,180,523,703,137,63,98,136,205,1301,2010
Richard Jefferson,SF,29,SAS,81,70,2520,362,775,.467,59,187,.316,303,588,.515,.505,211,287,.735,58,298,356,158,45,40,105,178,994,2010
Jared Jeffries,PF-SF,28,TOT,70,37,1794,138,314,.439,21,71,.296,117,243,.481,.473,75,120,.625,130,158,288,101,62,71,76,203,372,2010
Jared Jeffries,PF,28,NYK,52,37,1462,102,230,.443,20,62,.323,82,168,.488,.487,60,93,.645,99,124,223,83,53,58,62,157,284,2010
Jared Jeffries,SF,28,HOU,18,0,332,36,84,.429,1,9,.111,35,75,.467,.435,15,27,.556,31,34,65,18,9,13,14,46,88,2010
Brandon Jennings,PG,20,MIL,82,82,2671,451,1216,.371,145,388,.374,306,828,.370,.431,223,273,.817,49,233,282,470,105,18,200,191,1270,2010
Jonas Jerebko,PF,22,DET,80,73,2232,290,603,.481,36,115,.313,254,488,.520,.511,125,176,.710,194,284,478,58,79,29,82,230,741,2010
Yi Jianlian,PF,22,NJN,52,51,1655,227,563,.403,15,41,.366,212,522,.406,.417,154,193,.798,115,257,372,47,37,52,77,170,623,2010
Amir Johnson,PF,22,TOR,82,5,1453,208,334,.623,0,4,.000,208,330,.630,.623,95,149,.638,154,241,395,48,44,66,63,255,511,2010
Anthony Johnson,PG,35,ORL,31,0,406,49,111,.441,13,39,.333,36,72,.500,.500,19,20,.950,8,40,48,63,11,1,26,32,130,2010
James Johnson,PF,22,CHI,65,11,757,95,210,.452,15,46,.326,80,164,.488,.488,51,70,.729,34,94,128,48,21,43,62,126,256,2010
Joe Johnson,SG,28,ATL,76,76,2886,635,1386,.458,129,350,.369,506,1036,.488,.505,220,269,.818,74,279,353,369,82,5,145,145,1619,2010
Dahntay Jones,SF,29,IND,76,26,1892,287,623,.461,4,32,.125,283,591,.479,.464,198,257,.770,48,181,229,150,40,39,129,237,776,2010
Dwayne Jones,PF,26,PHO,2,0,7,0,0,.000,0,0,.000,0,0,.000,.000,0,0,.000,0,2,2,0,0,0,0,1,0,2010
James Jones,SF,29,MIA,36,6,503,43,119,.361,37,90,.411,6,29,.207,.517,23,28,.821,4,41,45,17,11,4,11,45,146,2010
Solomon Jones,C,25,IND,52,2,675,78,176,.443,0,3,.000,78,173,.451,.443,51,71,.718,51,93,144,32,14,37,40,125,207,2010
DeAndre Jordan,C,21,LAC,70,12,1137,144,238,.605,0,2,.000,144,236,.610,.605,48,128,.375,122,230,352,21,16,62,75,152,336,2010
Chris Kaman,C,27,LAC,76,76,2608,589,1202,.490,0,6,.000,589,1196,.492,.490,230,307,.749,184,520,704,120,37,94,223,213,1408,2010
Jason Kapono,SF,28,PHI,57,12,976,126,301,.419,63,171,.368,63,130,.485,.523,9,15,.600,14,52,66,39,21,6,34,80,324,2010
Coby Karl,SF-SG,26,TOT,7,1,113,11,32,.344,2,11,.182,9,21,.429,.375,4,6,.667,4,14,18,15,3,1,10,14,28,2010
Coby Karl,SG,26,CLE,3,0,5,0,0,.000,0,0,.000,0,0,.000,.000,0,0,.000,0,2,2,0,0,0,4,0,0,2010
Coby Karl,SF,26,GSW,4,1,108,11,32,.344,2,11,.182,9,21,.429,.375,4,6,.667,4,12,16,15,3,1,6,14,28,2010
Jason Kidd,PG,36,DAL,80,80,2881,284,671,.423,176,414,.425,108,257,.420,.554,80,99,.808,48,397,445,724,145,35,195,142,824,2010
Andrei Kirilenko,SF,28,UTA,58,35,1681,244,482,.506,26,89,.292,218,393,.555,.533,174,234,.744,76,188,264,158,83,71,79,102,688,2010
Kyle Korver,SG,28,UTA,52,0,952,138,280,.493,59,110,.536,79,170,.465,.598,39,49,.796,10,101,111,89,26,12,42,76,374,2010
Kosta Koufos,C,20,UTA,36,0,172,22,47,.468,0,0,.000,22,47,.468,.468,9,15,.600,16,29,45,6,2,4,15,26,53,2010
Nenad Krstic,C,26,OKC,76,76,1741,281,560,.502,1,5,.200,280,555,.505,.503,76,106,.717,134,249,383,52,32,45,58,177,639,2010
Oliver Lafayette,SG,25,BOS,1,0,22,3,6,.500,1,2,.500,2,4,.500,.583,0,0,.000,1,3,4,2,0,0,1,0,7,2010
Carl Landry,PF,26,TOT,80,29,2469,499,931,.536,1,3,.333,498,928,.537,.537,344,427,.806,188,280,468,66,55,63,136,234,1343,2010
Carl Landry,PF,26,HOU,52,1,1415,302,552,.547,0,0,.000,302,552,.547,.547,235,280,.839,122,164,286,40,28,46,86,146,839,2010
Carl Landry,PF,26,SAC,28,28,1054,197,379,.520,1,3,.333,196,376,.521,.521,109,147,.741,66,116,182,26,27,17,50,88,504,2010
Marcus Landry,SF,24,TOT,18,0,111,16,43,.372,9,28,.321,7,15,.467,.477,3,5,.600,5,14,19,0,1,2,6,14,44,2010
Marcus Landry,SF,24,NYK,17,0,108,16,41,.390,9,26,.346,7,15,.467,.500,3,5,.600,5,14,19,0,1,2,6,14,44,2010
Marcus Landry,SF,24,BOS,1,0,3,0,2,.000,0,2,.000,0,0,.000,.000,0,0,.000,0,0,0,0,0,0,0,0,0,2010
Acie Law,PG,25,TOT,26,1,234,35,75,.467,5,16,.313,30,59,.508,.500,38,49,.776,3,14,17,26,11,1,17,16,113,2010
Acie Law,PG,25,GSW,5,0,66,9,14,.643,1,3,.333,8,11,.727,.679,12,15,.800,0,2,2,7,6,0,2,5,31,2010
Acie Law,PG,25,CHA,9,0,33,5,16,.313,0,1,.000,5,15,.333,.313,6,7,.857,0,1,1,3,1,1,3,3,16,2010
Acie Law,PG,25,CHI,12,1,135,21,45,.467,4,12,.333,17,33,.515,.511,20,27,.741,3,11,14,16,4,0,12,8,66,2010
Ty Lawson,PG,22,DEN,65,8,1318,201,390,.515,34,83,.410,167,307,.544,.559,106,140,.757,42,82,124,203,48,2,82,89,542,2010
Courtney Lee,SG,24,NJN,71,66,2375,338,775,.436,76,225,.338,262,550,.476,.485,133,153,.869,60,192,252,121,93,20,76,130,885,2010
David Lee,C,26,NYK,81,81,3019,686,1258,.545,0,8,.000,686,1250,.549,.545,268,330,.812,228,721,949,295,85,40,189,257,1640,2010
Rashard Lewis,PF,30,ORL,72,72,2369,350,805,.435,168,423,.397,182,382,.476,.539,145,180,.806,62,256,318,107,78,28,108,180,1013,2010
Shaun Livingston,PG,24,TOT,36,18,796,104,201,.517,0,6,.000,104,195,.533,.517,42,48,.875,16,62,78,130,17,11,58,61,250,2010
Shaun Livingston,PG,24,OKC,10,0,130,5,16,.313,0,2,.000,5,14,.357,.313,0,0,.000,4,16,20,14,5,2,8,9,10,2010
Shaun Livingston,PG,24,WAS,26,18,666,99,185,.535,0,4,.000,99,181,.547,.535,42,48,.875,12,46,58,116,12,9,50,52,240,2010
Brook Lopez,C,21,NJN,82,82,3027,563,1129,.499,0,2,.000,563,1127,.500,.499,416,509,.817,270,439,709,187,55,139,204,251,1542,2010
Robin Lopez,C,21,PHO,51,31,986,171,291,.588,0,0,.000,171,291,.588,.588,88,125,.704,104,144,248,7,10,53,41,117,430,2010
Kevin Love,PF,21,MIN,60,22,1714,291,646,.450,35,106,.330,256,540,.474,.478,225,276,.815,227,431,658,136,43,23,117,136,842,2010
Kyle Lowry,PG,23,HOU,68,0,1651,184,464,.397,37,136,.272,147,328,.448,.436,215,260,.827,91,156,247,305,60,9,116,173,620,2010
Corey Maggette,PF,30,GSW,70,49,2081,457,886,.516,13,50,.260,444,836,.531,.523,460,551,.835,92,281,373,172,51,4,168,231,1387,2010
Jamaal Magloire,C,31,MIA,36,0,359,28,56,.500,0,0,.000,28,56,.500,.500,21,59,.356,41,80,121,1,9,11,17,59,77,2010
Ian Mahinmi,C,23,SAS,26,0,165,35,55,.636,0,0,.000,35,55,.636,.636,31,47,.660,13,39,52,2,3,8,15,32,101,2010
Shawn Marion,SF,31,DAL,75,75,2385,395,778,.508,3,19,.158,392,759,.516,.510,105,139,.755,158,319,477,107,69,61,99,141,898,2010
Sean Marks,C,34,NOH,14,0,75,4,8,.500,0,0,.000,4,8,.500,.500,2,5,.400,14,9,23,2,0,3,2,17,10,2010
Cartier Martin,SF,25,TOT,18,2,390,50,136,.368,17,49,.347,33,87,.379,.430,24,30,.800,25,43,68,16,11,1,19,48,141,2010
Cartier Martin,SF,25,GSW,10,2,276,32,88,.364,10,31,.323,22,57,.386,.420,16,21,.762,17,30,47,9,8,0,13,36,90,2010
Cartier Martin,SF,25,WAS,8,0,114,18,48,.375,7,18,.389,11,30,.367,.448,8,9,.889,8,13,21,7,3,1,6,12,51,2010
Kenyon Martin,PF,32,DEN,58,58,1986,283,620,.456,8,29,.276,275,591,.465,.463,93,167,.557,142,404,546,109,72,61,91,186,667,2010
Kevin Martin,SG,26,TOT,46,43,1633,289,693,.417,70,210,.333,219,483,.453,.468,298,340,.876,29,135,164,111,46,6,92,96,946,2010
Kevin Martin,SG,26,SAC,22,21,774,135,339,.398,39,110,.355,96,229,.419,.456,127,155,.819,20,74,94,57,23,4,35,51,436,2010
Kevin Martin,SG,26,HOU,24,22,859,154,354,.435,31,100,.310,123,254,.484,.479,171,185,.924,9,61,70,54,23,2,57,45,510,2010
Desmond Mason,SF,32,SAC,5,4,66,5,12,.417,0,0,.000,5,12,.417,.417,3,4,.750,4,9,13,2,1,1,4,5,13,2010
Roger Mason,SG,29,SAS,79,5,1515,193,496,.389,88,264,.333,105,232,.453,.478,27,34,.794,11,151,162,137,30,14,59,99,501,2010
Wesley Matthews,SG,23,UTA,82,48,2025,273,565,.483,63,165,.382,210,400,.525,.539,160,193,.829,50,141,191,124,64,15,93,152,769,2010
Jason Maxiell,C,26,DET,76,29,1550,212,415,.511,0,1,.000,212,414,.512,.511,89,155,.574,161,240,401,39,36,38,68,175,513,2010
Sean May,C,25,SAC,37,4,331,51,111,.459,0,4,.000,51,107,.477,.459,21,32,.656,20,50,70,17,12,7,19,46,123,2010
Eric Maynor,PG,22,TOT,81,2,1269,154,368,.418,22,71,.310,132,297,.444,.448,52,72,.722,21,108,129,266,40,10,85,115,382,2010
Eric Maynor,PG,22,UTA,26,2,363,52,133,.391,5,24,.208,47,109,.431,.410,25,33,.758,10,28,38,81,13,2,28,33,134,2010
Eric Maynor,PG,22,OKC,55,0,906,102,235,.434,17,47,.362,85,188,.452,.470,27,39,.692,11,80,91,185,27,8,57,82,248,2010
O.J. Mayo,SG,22,MEM,82,82,3113,542,1183,.458,136,355,.383,406,828,.490,.516,212,262,.809,61,250,311,242,98,17,176,174,1432,2010
Luc Mbah a Moute,PF,23,MIL,73,62,1866,177,369,.480,6,17,.353,171,352,.486,.488,93,133,.699,171,229,400,81,60,39,70,181,453,2010
Antonio McDyess,PF,35,SAS,77,50,1617,205,428,.479,0,2,.000,205,426,.481,.479,36,57,.632,149,306,455,83,43,32,79,147,446,2010
JaVale McGee,C,22,WAS,60,19,968,156,307,.508,0,1,.000,156,306,.510,.508,74,116,.638,88,155,243,14,16,101,51,122,386,2010
Tracy McGrady,SG,30,TOT,30,24,673,91,235,.387,16,64,.250,75,171,.439,.421,47,63,.746,22,72,94,99,15,14,44,40,245,2010
Tracy McGrady,SG,30,HOU,6,0,46,7,19,.368,1,2,.500,6,17,.353,.395,4,6,.667,0,5,5,6,0,2,1,2,19,2010
Tracy McGrady,SG,30,NYK,24,24,627,84,216,.389,15,62,.242,69,154,.448,.424,43,57,.754,22,67,89,93,15,12,43,38,226,2010
Dominic McGuire,SF,24,TOT,51,2,307,19,52,.365,0,0,.000,19,52,.365,.365,0,7,.000,23,56,79,11,5,4,17,35,38,2010
Dominic McGuire,SF,24,WAS,41,0,240,15,40,.375,0,0,.000,15,40,.375,.375,0,5,.000,17,44,61,8,4,3,10,32,30,2010
Dominic McGuire,SF,24,SAC,10,2,67,4,12,.333,0,0,.000,4,12,.333,.333,0,2,.000,6,12,18,3,1,1,7,3,8,2010
Josh McRoberts,C,22,IND,42,3,524,76,146,.521,8,23,.348,68,123,.553,.548,19,38,.500,40,87,127,44,17,16,19,74,179,2010
Jodie Meeks,SG,22,TOT,60,0,719,104,268,.388,42,132,.318,62,136,.456,.466,31,39,.795,9,90,99,39,18,5,25,52,281,2010
Jodie Meeks,SG,22,MIL,41,0,486,64,177,.362,23,82,.280,41,95,.432,.427,18,21,.857,5,67,72,22,13,4,20,33,169,2010
Jodie Meeks,SG,22,PHI,19,0,233,40,91,.440,19,50,.380,21,41,.512,.544,13,18,.722,4,23,27,17,5,1,5,19,112,2010
Pops Mensah-Bonsu,PF,26,TOT,20,0,120,13,33,.394,0,0,.000,13,33,.394,.394,13,24,.542,16,19,35,3,4,9,10,20,39,2010
Pops Mensah-Bonsu,PF,26,HOU,4,0,13,1,4,.250,0,0,.000,1,4,.250,.250,3,6,.500,1,3,4,1,1,1,0,3,5,2010
Pops Mensah-Bonsu,PF,26,TOR,16,0,107,12,29,.414,0,0,.000,12,29,.414,.414,10,18,.556,15,16,31,2,3,8,10,17,34,2010
C.J. Miles,SF,22,UTA,63,28,1497,241,562,.429,74,217,.341,167,345,.484,.495,66,95,.695,42,126,168,105,58,17,81,190,622,2010
Darko Milicic,C,24,TOT,32,18,685,100,204,.490,0,1,.000,100,203,.493,.490,15,28,.536,47,104,151,47,22,34,35,82,215,2010
Darko Milicic,C,24,NYK,8,0,71,8,17,.471,0,0,.000,8,17,.471,.471,0,0,.000,5,13,18,4,4,1,2,7,16,2010
Darko Milicic,C,24,MIN,24,18,614,92,187,.492,0,1,.000,92,186,.495,.492,15,28,.536,42,91,133,43,18,33,33,75,199,2010
Andre Miller,PG,33,POR,82,66,2500,404,908,.445,16,80,.200,388,828,.469,.454,322,392,.821,81,185,266,445,93,9,173,169,1146,2010
Brad Miller,C,33,CHI,82,37,1950,250,581,.430,37,132,.280,213,449,.474,.462,182,220,.827,83,316,399,154,44,29,107,189,719,2010
Mike Miller,SG,29,WAS,54,50,1805,217,433,.501,82,171,.480,135,262,.515,.596,70,85,.824,55,281,336,212,39,12,115,131,586,2010
Patty Mills,PG,21,POR,10,0,38,10,24,.417,2,4,.500,8,20,.400,.458,4,7,.571,1,1,2,5,0,0,4,6,26,2010
Paul Millsap,PF,24,UTA,82,8,2277,385,716,.538,1,9,.111,384,707,.543,.538,183,264,.693,186,373,559,131,64,99,116,285,954,2010
Nazr Mohammed,C,32,CHA,58,29,984,189,342,.553,0,0,.000,189,342,.553,.553,81,125,.648,114,190,304,28,15,43,53,105,459,2010
Jamario Moon,SF,29,CLE,61,2,1052,114,247,.462,32,100,.320,82,147,.558,.526,36,45,.800,26,165,191,49,34,30,23,69,296,2010
Mikki Moore,C,34,GSW,23,20,406,54,90,.600,0,0,.000,54,90,.600,.600,7,11,.636,26,43,69,36,5,13,21,60,115,2010
Randolph Morris,PF,24,ATL,28,0,124,23,41,.561,0,0,.000,23,41,.561,.561,16,27,.593,10,28,38,2,5,3,12,34,62,2010
Adam Morrison,SF,25,LAL,31,0,241,32,85,.376,5,21,.238,27,64,.422,.406,5,8,.625,10,22,32,18,3,2,10,17,74,2010
Anthony Morrow,SG,24,GSW,69,37,2018,329,703,.468,140,307,.456,189,396,.477,.568,101,114,.886,61,198,259,104,65,16,84,158,899,2010
Byron Mullens,PF,20,OKC,13,0,54,7,19,.368,0,0,.000,7,19,.368,.368,0,0,.000,3,7,10,1,2,0,4,13,14,2010
Troy Murphy,PF,29,IND,72,69,2344,384,813,.472,128,333,.384,256,480,.533,.551,154,193,.798,129,608,737,150,72,34,100,175,1050,2010
Ronald Murray,SG,30,TOT,75,2,1673,268,683,.392,69,221,.312,199,462,.431,.443,141,194,.727,28,155,183,135,46,16,91,126,746,2010
Ronald Murray,SG,30,CHA,46,1,993,160,411,.389,41,131,.313,119,280,.425,.439,93,131,.710,15,83,98,84,28,12,65,77,454,2010
Ronald Murray,SG,30,CHI,29,1,680,108,272,.397,28,90,.311,80,182,.440,.449,48,63,.762,13,72,85,51,18,4,26,49,292,2010
Eduardo Najera,PF,33,TOT,46,5,685,62,146,.425,19,64,.297,43,82,.524,.490,14,24,.583,34,81,115,29,26,14,25,94,157,2010
Eduardo Najera,PF,33,NJN,13,2,204,20,53,.377,3,17,.176,17,36,.472,.406,6,12,.500,12,26,38,15,9,2,12,33,49,2010
Eduardo Najera,PF,33,DAL,33,3,481,42,93,.452,16,47,.340,26,46,.565,.538,8,12,.667,22,55,77,14,17,12,13,61,108,2010
Steve Nash,PG,35,PHO,81,81,2660,499,985,.507,124,291,.426,375,694,.540,.570,211,225,.938,34,234,268,892,42,12,295,108,1333,2010
Jameer Nelson,PG,27,ORL,65,64,1860,317,706,.449,86,226,.381,231,480,.481,.510,98,116,.845,26,168,194,353,48,2,139,147,818,2010
Rasho Nesterovic,C,33,TOR,42,8,413,81,149,.544,0,0,.000,81,149,.544,.544,1,5,.200,37,52,89,25,10,17,16,54,163,2010
Joakim Noah,C,24,CHI,64,54,1925,262,520,.504,0,0,.000,262,520,.504,.504,163,219,.744,220,484,704,132,32,100,117,198,687,2010
Andres Nocioni,SF,30,SAC,75,28,1477,234,587,.399,96,249,.386,138,338,.408,.480,71,99,.717,32,190,222,75,32,26,67,160,635,2010
Steve Novak,SF,26,LAC,54,0,362,42,108,.389,22,71,.310,20,37,.541,.491,7,9,.778,1,32,33,6,7,2,2,21,113,2010
Dirk Nowitzki,PF,31,DAL,81,80,3039,720,1496,.481,51,121,.421,669,1375,.487,.498,536,586,.915,80,540,620,218,70,79,149,208,2027,2010
Patrick O'Bryant,C,23,TOR,11,0,51,8,15,.533,0,1,.000,8,14,.571,.533,3,6,.500,2,9,11,1,2,4,5,12,19,2010
Jermaine O'Neal,C,31,MIA,70,70,1991,394,745,.529,0,2,.000,394,743,.530,.529,162,225,.720,124,362,486,92,25,95,125,212,950,2010
Shaquille O'Neal,C,37,CLE,53,53,1240,262,463,.566,0,1,.000,262,462,.567,.566,112,226,.496,93,262,355,80,15,62,105,169,636,2010
Fabricio Oberto,C,34,WAS,57,20,650,35,56,.625,0,0,.000,35,56,.625,.625,13,17,.765,34,71,105,51,11,9,36,121,83,2010
Greg Oden,C,22,POR,21,21,502,92,152,.605,0,0,.000,92,152,.605,.605,49,64,.766,64,114,178,19,8,48,39,84,233,2010
Lamar Odom,PF,30,LAL,82,38,2585,342,739,.463,58,182,.319,284,557,.510,.502,140,202,.693,184,618,802,267,75,59,150,227,882,2010
Emeka Okafor,C,27,NOH,82,82,2370,348,656,.530,0,0,.000,348,656,.530,.530,154,274,.562,251,491,742,55,54,127,111,218,850,2010
Mehmet Okur,C,30,UTA,73,73,2149,355,775,.458,82,213,.385,273,562,.486,.511,196,239,.820,132,383,515,119,38,81,127,223,988,2010
Kevin Ollie,PG,37,OKC,25,0,263,18,45,.400,0,1,.000,18,44,.409,.400,8,8,1.000,3,22,25,20,9,0,6,16,44,2010
Travis Outlaw,SF,25,TOT,34,6,730,110,281,.391,40,105,.381,70,176,.398,.463,49,59,.831,33,88,121,34,18,17,32,43,309,2010
Travis Outlaw,SF,25,POR,11,0,231,38,101,.376,12,31,.387,26,70,.371,.436,21,24,.875,13,25,38,8,7,8,12,13,109,2010
Travis Outlaw,SF,25,LAC,23,6,499,72,180,.400,28,74,.378,44,106,.415,.478,28,35,.800,20,63,83,26,11,9,20,30,200,2010
Zaza Pachulia,C,25,ATL,78,1,1089,120,246,.488,0,4,.000,120,242,.496,.488,93,143,.650,117,176,293,42,37,31,58,186,333,2010
Jannero Pargo,PG,30,CHI,63,5,829,132,381,.346,38,138,.275,94,243,.387,.396,42,45,.933,9,69,78,89,29,2,50,68,344,2010
Anthony Parker,SG,34,CLE,81,81,2289,206,475,.434,108,261,.414,98,214,.458,.547,75,95,.789,30,201,231,157,63,18,71,151,595,2010
Tony Parker,PG,27,SAS,56,50,1728,349,716,.487,10,34,.294,339,682,.497,.494,186,246,.756,7,128,135,317,29,8,149,96,894,2010
Chris Paul,PG,24,NOH,45,45,1712,314,637,.493,52,127,.409,262,510,.514,.534,161,190,.847,20,171,191,480,96,8,112,118,841,2010
Sasha Pavlovic,SF,26,MIN,71,0,877,109,300,.363,35,118,.297,74,182,.407,.422,10,26,.385,12,105,117,58,23,6,53,84,263,2010
Oleksiy Pecherov,C,24,MIN,44,5,447,77,188,.410,14,52,.269,63,136,.463,.447,29,32,.906,32,92,124,11,9,14,32,55,197,2010
Kendrick Perkins,C,25,BOS,78,78,2154,314,522,.602,0,3,.000,314,519,.605,.602,163,280,.582,155,440,595,80,26,132,165,219,791,2010
Morris Peterson,SG,32,NOH,46,39,973,116,301,.385,62,171,.363,54,130,.415,.488,33,54,.611,17,109,126,41,25,5,27,81,327,2010
Johan Petro,C,24,DEN,36,16,436,54,101,.535,0,1,.000,54,100,.540,.535,14,21,.667,32,97,129,14,10,13,23,80,122,2010
Paul Pierce,SF,32,BOS,71,71,2411,409,867,.472,109,263,.414,300,604,.497,.535,369,433,.852,39,271,310,218,84,31,166,196,1296,2010
Mickael Pietrus,SF,27,ORL,75,24,1687,233,539,.432,116,306,.379,117,233,.502,.540,69,109,.633,39,176,215,49,53,31,69,138,651,2010
James Posey,SF,33,NOH,77,2,1731,126,345,.365,81,242,.335,45,103,.437,.483,66,80,.825,32,297,329,117,42,19,51,204,399,2010
Leon Powe,SF,26,CLE,20,2,236,21,49,.429,0,0,.000,21,49,.429,.429,37,63,.587,19,42,61,0,6,2,11,36,79,2010
Josh Powell,PF,27,LAL,63,0,581,71,194,.366,7,16,.438,64,178,.360,.384,20,31,.645,44,72,116,35,9,6,33,71,169,2010
A.J. Price,PG,23,IND,56,2,865,145,354,.410,60,174,.345,85,180,.472,.494,60,75,.800,12,76,88,106,35,3,59,53,410,2010
Ronnie Price,PG,26,UTA,60,4,806,98,242,.405,18,63,.286,80,179,.447,.442,41,59,.695,28,46,74,123,40,13,56,109,255,2010
Tayshaun Prince,SF,29,DET,49,49,1664,282,580,.486,27,73,.370,255,507,.503,.509,70,98,.714,71,177,248,161,34,22,60,77,661,2010
Joel Przybilla,C,30,POR,30,9,681,45,86,.523,0,0,.000,45,86,.523,.523,33,51,.647,72,166,238,8,8,43,39,95,123,2010
Chris Quinn,PG,26,NJN,25,0,223,20,56,.357,10,32,.313,10,24,.417,.446,6,6,1.000,1,15,16,29,9,1,10,15,56,2010
Vladimir Radmanovic,PF,29,TOT,41,20,891,103,273,.377,30,108,.278,73,165,.442,.432,20,27,.741,51,127,178,45,29,7,44,97,256,2010
Vladimir Radmanovic,PF,29,CHA,8,0,133,14,42,.333,7,22,.318,7,20,.350,.417,4,6,.667,8,21,29,7,3,1,5,18,39,2010
Vladimir Radmanovic,PF,29,GSW,33,20,758,89,231,.385,23,86,.267,66,145,.455,.435,16,21,.762,43,106,149,38,26,6,39,79,217,2010
Anthony Randolph,C,20,GSW,33,8,749,137,309,.443,1,5,.200,136,304,.447,.445,109,136,.801,73,142,215,42,28,51,49,92,384,2010
Shavlik Randolph,PF,26,TOT,6,0,53,6,18,.333,0,0,.000,6,18,.333,.333,2,2,1.000,7,7,14,1,1,1,3,9,14,2010
Shavlik Randolph,PF,26,MIA,3,0,47,5,15,.333,0,0,.000,5,15,.333,.333,0,0,.000,7,6,13,0,1,1,2,9,10,2010
Shavlik Randolph,PF,26,POR,3,0,6,1,3,.333,0,0,.000,1,3,.333,.333,2,2,1.000,0,1,1,1,0,0,1,0,4,2010
Zach Randolph,PF,28,MEM,81,81,3051,652,1336,.488,15,52,.288,637,1284,.496,.494,362,465,.778,330,620,950,149,80,34,174,226,1681,2010
Theo Ratliff,C,36,TOT,49,29,807,70,152,.461,0,0,.000,70,152,.461,.461,38,50,.760,59,98,157,25,12,61,41,87,178,2010
Theo Ratliff,C,36,SAS,21,3,183,16,36,.444,0,0,.000,16,36,.444,.444,2,4,.500,15,25,40,9,3,18,16,27,34,2010
Theo Ratliff,C,36,CHA,28,26,624,54,116,.466,0,0,.000,54,116,.466,.466,36,46,.783,44,73,117,16,9,43,25,60,144,2010
Michael Redd,SG,30,MIL,18,12,492,75,213,.352,18,60,.300,57,153,.373,.394,47,66,.712,11,43,54,39,19,2,15,24,215,2010
J.J. Redick,SG,25,ORL,82,9,1808,243,553,.439,111,274,.405,132,279,.473,.540,191,222,.860,17,138,155,158,28,4,63,118,788,2010
Chris Richard,PF,25,CHI,18,0,224,15,29,.517,0,0,.000,15,29,.517,.517,7,11,.636,19,40,59,7,8,4,14,50,37,2010
Jason Richardson,SG,29,PHO,79,76,2485,473,998,.474,157,400,.393,316,598,.528,.553,136,184,.739,81,323,404,143,66,33,92,169,1239,2010
Quentin Richardson,SF,29,MIA,76,75,2082,242,561,.431,142,358,.397,100,203,.493,.558,52,71,.732,64,310,374,93,70,18,62,169,678,2010
Luke Ridnour,PG,28,MIL,82,0,1759,328,686,.478,69,181,.381,259,505,.513,.528,127,140,.907,24,119,143,324,54,7,106,182,852,2010
Nate Robinson,PG,25,TOT,56,2,1115,215,493,.436,87,223,.390,128,270,.474,.524,50,67,.746,28,82,110,163,49,5,73,116,567,2010
Nate Robinson,PG,25,NYK,30,2,733,152,336,.452,51,136,.375,101,200,.505,.528,42,54,.778,23,49,72,112,27,5,53,66,397,2010
Nate Robinson,PG,25,BOS,26,0,382,63,157,.401,36,87,.414,27,70,.386,.516,8,13,.615,5,33,38,51,22,0,20,50,170,2010
Sergio Rodriguez,PG,23,TOT,66,8,1048,167,351,.476,32,91,.352,135,260,.519,.521,68,93,.731,24,65,89,212,50,5,114,84,434,2010
Sergio Rodriguez,PG,23,SAC,39,0,517,88,190,.463,15,42,.357,73,148,.493,.503,43,62,.694,15,35,50,121,29,3,59,46,234,2010
Sergio Rodriguez,PG,23,NYK,27,8,531,79,161,.491,17,49,.347,62,112,.554,.543,25,31,.806,9,30,39,91,21,2,55,38,200,2010
Rajon Rondo,PG,23,BOS,81,81,2963,459,904,.508,17,80,.213,442,824,.536,.517,175,282,.621,100,260,360,794,189,11,246,198,1110,2010
Derrick Rose,PG,21,CHI,78,78,2871,672,1373,.489,16,60,.267,656,1313,.500,.495,259,338,.766,65,228,293,469,57,27,217,96,1619,2010
Quinton Ross,SF-SG,28,TOT,52,7,562,40,111,.360,4,21,.190,36,90,.400,.378,8,14,.571,17,32,49,12,13,6,11,69,92,2010
Quinton Ross,SF,28,DAL,27,7,301,23,56,.411,3,13,.231,20,43,.465,.438,5,8,.625,11,16,27,7,7,4,3,34,54,2010
Quinton Ross,SG,28,WAS,25,0,261,17,55,.309,1,8,.125,16,47,.340,.318,3,6,.500,6,16,22,5,6,2,8,35,38,2010
Brandon Roy,SG,25,POR,65,65,2419,491,1038,.473,73,221,.330,418,817,.512,.508,343,440,.780,73,212,285,305,61,16,129,136,1398,2010
Brandon Rush,SG,24,IND,82,64,2491,297,702,.423,124,302,.411,173,400,.433,.511,56,89,.629,41,305,346,112,56,65,93,159,774,2010
Kareem Rush,SG,29,LAC,7,0,58,4,11,.364,1,3,.333,3,8,.375,.409,0,0,.000,1,5,6,4,2,3,3,8,9,2010
John Salmons,SG,30,TOT,81,56,2824,437,991,.441,118,309,.382,319,682,.468,.501,253,305,.830,35,235,270,223,99,26,123,166,1245,2010
John Salmons,SG,30,CHI,51,28,1695,230,548,.420,73,192,.380,157,356,.441,.486,116,147,.789,18,156,174,125,65,22,70,101,649,2010
John Salmons,SG,30,MIL,30,28,1129,207,443,.467,45,117,.385,162,326,.497,.518,137,158,.867,17,79,96,98,34,4,53,65,596,2010
Brian Scalabrine,PF,31,BOS,52,3,472,29,85,.341,16,49,.327,13,36,.361,.435,4,6,.667,9,39,48,27,9,4,17,59,78,2010
Luis Scola,PF,29,HOU,82,82,2671,560,1090,.514,1,5,.200,559,1085,.515,.514,208,267,.779,175,530,705,169,63,26,163,246,1329,2010
Thabo Sefolosha,SG,25,OKC,82,82,2348,194,441,.440,41,131,.313,153,310,.494,.486,60,89,.674,76,311,387,145,97,46,90,154,489,2010
Ramon Sessions,PG,23,MIN,82,1,1732,253,555,.456,1,15,.067,252,540,.467,.457,167,233,.717,58,156,214,258,55,5,137,137,674,2010
Bobby Simmons,PF,29,NJN,23,2,395,42,117,.359,20,63,.317,22,54,.407,.444,18,20,.900,11,52,63,15,15,3,19,52,122,2010
James Singleton,PF-SF,28,TOT,57,3,977,97,254,.382,7,37,.189,90,217,.415,.396,53,62,.855,108,168,276,31,28,43,49,113,254,2010
James Singleton,SF,28,DAL,25,0,211,24,64,.375,5,22,.227,19,42,.452,.414,6,6,1.000,17,38,55,9,11,7,12,31,59,2010
James Singleton,PF,28,WAS,32,3,766,73,190,.384,2,15,.133,71,175,.406,.389,47,56,.839,91,130,221,22,17,36,37,82,195,2010
Brian Skinner,PF,33,LAC,16,1,123,10,25,.400,0,0,.000,10,25,.400,.400,6,8,.750,9,18,27,0,3,4,7,20,26,2010
Craig Smith,PF,26,LAC,75,2,1232,226,397,.569,1,5,.200,225,392,.574,.571,132,208,.635,97,190,287,84,33,25,88,194,585,2010
J.R. Smith,SG,24,DEN,75,0,2082,428,1033,.414,158,467,.338,270,566,.477,.491,142,201,.706,28,206,234,183,99,20,139,174,1156,2010
Jason Smith,PF,23,PHI,56,2,658,75,174,.431,10,29,.345,65,145,.448,.460,29,42,.690,54,81,135,33,21,28,35,110,189,2010
Joe Smith,PF,34,ATL,64,1,592,77,193,.399,1,7,.143,76,186,.409,.402,39,48,.813,66,91,157,21,6,19,22,95,194,2010
Josh Smith,PF,24,ATL,81,81,2871,504,999,.505,0,7,.000,504,992,.508,.505,261,422,.618,223,482,705,342,130,172,198,240,1269,2010
Darius Songaila,C,31,NOH,75,1,1410,241,488,.494,1,6,.167,240,482,.498,.495,60,74,.811,59,173,232,70,62,14,81,206,543,2010
Marreese Speights,C,22,PHI,62,1,1016,212,444,.477,0,5,.000,212,439,.483,.477,108,145,.745,85,167,252,36,29,34,51,152,532,2010
Jerry Stackhouse,SG,35,MIL,42,0,855,129,316,.408,45,130,.346,84,186,.452,.479,55,69,.797,19,81,100,70,21,9,66,56,358,2010
DeShawn Stevenson,SG,28,TOT,64,18,883,46,163,.282,19,87,.218,27,76,.355,.340,25,35,.714,11,80,91,56,16,6,30,74,136,2010
DeShawn Stevenson,SG,28,WAS,40,13,616,29,103,.282,11,62,.177,18,41,.439,.335,18,25,.720,7,58,65,44,11,5,24,51,87,2010
DeShawn Stevenson,SG,28,DAL,24,5,267,17,60,.283,8,25,.320,9,35,.257,.350,7,10,.700,4,22,26,12,5,1,6,23,49,2010
Peja Stojakovic,SF,32,NOH,62,55,1947,278,688,.404,132,352,.375,146,336,.435,.500,96,107,.897,39,188,227,92,48,5,56,83,784,2010
Amar'e Stoudemire,PF,27,PHO,82,82,2838,704,1264,.557,1,6,.167,703,1258,.559,.557,487,632,.771,230,502,732,82,52,83,213,281,1896,2010
Rodney Stuckey,PG,23,DET,73,67,2499,449,1109,.405,18,79,.228,431,1030,.418,.413,299,359,.833,67,214,281,348,101,12,163,205,1215,2010
DaJuan Summers,SF,22,DET,44,0,405,46,130,.354,15,42,.357,31,88,.352,.412,27,38,.711,14,31,45,16,8,7,16,52,134,2010
Jermaine Taylor,SG,23,HOU,31,4,303,45,119,.378,5,22,.227,40,97,.412,.399,33,46,.717,21,25,46,16,10,3,19,15,128,2010
Jeff Teague,PG,21,ATL,71,3,719,90,227,.396,7,32,.219,83,195,.426,.412,41,49,.837,5,62,67,122,34,11,50,82,228,2010
Sebastian Telfair,PG,24,TOT,43,1,659,83,201,.413,13,56,.232,70,145,.483,.445,29,37,.784,5,40,45,126,24,5,50,71,208,2010
Sebastian Telfair,PG,24,LAC,39,1,582,67,166,.404,11,47,.234,56,119,.471,.437,24,31,.774,5,36,41,114,22,5,44,65,169,2010
Sebastian Telfair,PG,24,CLE,4,0,77,16,35,.457,2,9,.222,14,26,.538,.486,5,6,.833,0,4,4,12,2,0,6,6,39,2010
Garrett Temple,SG,23,TOT,27,4,334,44,101,.436,13,37,.351,31,64,.484,.500,35,50,.700,6,25,31,21,13,6,27,42,136,2010
Garrett Temple,SG,23,HOU,9,0,118,13,29,.448,3,12,.250,10,17,.588,.500,16,24,.667,2,12,14,7,4,4,14,16,45,2010
Garrett Temple,SG,23,SAC,5,0,23,3,8,.375,0,2,.000,3,6,.500,.375,5,5,1.000,1,2,3,2,1,0,2,1,11,2010
Garrett Temple,SG,23,SAS,13,4,193,28,64,.438,10,23,.435,18,41,.439,.516,14,21,.667,3,11,14,12,8,2,11,25,80,2010
Jason Terry,SG,32,DAL,77,12,2540,456,1041,.438,136,373,.365,320,668,.479,.503,232,268,.866,19,121,140,292,94,17,109,142,1280,2010
Hasheem Thabeet,C,22,MEM,68,13,883,77,131,.588,0,0,.000,77,131,.588,.588,54,93,.581,85,158,243,11,15,89,43,162,208,2010
Etan Thomas,C,31,OKC,23,1,321,31,68,.456,0,0,.000,31,68,.456,.456,13,22,.591,18,46,64,1,4,16,18,39,75,2010
Kenny Thomas,PF,32,SAC,26,2,313,17,35,.486,0,0,.000,17,35,.486,.486,7,12,.583,35,51,86,15,10,10,17,42,41,2010
Kurt Thomas,C,37,MIL,70,9,1049,99,208,.476,0,0,.000,99,208,.476,.476,12,15,.800,84,207,291,47,26,46,48,159,210,2010
Tim Thomas,SF,32,DAL,18,1,285,49,106,.462,16,43,.372,33,63,.524,.538,21,24,.875,13,28,41,14,10,2,14,31,135,2010
Tyrus Thomas,PF-C,23,TOT,54,3,1220,194,420,.462,0,3,.000,194,417,.465,.462,120,175,.686,81,254,335,56,63,85,92,129,508,2010
Tyrus Thomas,PF,23,CHI,29,3,678,99,205,.483,0,1,.000,99,204,.485,.483,58,90,.644,42,141,183,33,40,48,52,64,256,2010
Tyrus Thomas,C,23,CHA,25,0,542,95,215,.442,0,2,.000,95,213,.446,.442,62,85,.729,39,113,152,23,23,37,40,65,252,2010
Jason Thompson,C,23,SAC,75,58,2357,370,784,.472,1,10,.100,369,774,.477,.473,198,277,.715,224,413,637,124,41,73,139,279,939,2010
Al Thornton,SF,26,TOT,75,46,2079,320,676,.473,11,31,.355,309,645,.479,.482,153,211,.725,116,178,294,90,45,35,102,206,804,2010
Al Thornton,SF,26,LAC,51,30,1405,220,460,.478,5,14,.357,215,446,.482,.484,103,139,.741,85,107,192,61,25,22,66,144,548,2010
Al Thornton,SF,26,WAS,24,16,674,100,216,.463,6,17,.353,94,199,.472,.477,50,72,.694,31,71,102,29,20,13,36,62,256,2010
Marcus Thornton,SG,22,NOH,73,17,1872,398,883,.451,117,313,.374,281,570,.493,.517,144,177,.814,72,139,211,114,58,11,76,127,1057,2010
Jamaal Tinsley,PG,31,MEM,38,1,589,52,140,.371,7,39,.179,45,101,.446,.396,22,27,.815,11,55,66,108,33,5,63,67,133,2010
Anthony Tolliver,PF,24,TOT,46,29,1427,193,449,.430,50,152,.329,143,297,.481,.486,103,134,.769,84,236,320,87,32,33,46,128,539,2010
Anthony Tolliver,PF,24,POR,2,0,4,0,1,.000,0,1,.000,0,0,.000,.000,0,0,.000,0,1,1,0,0,0,0,1,0,2010
Anthony Tolliver,PF,24,GSW,44,29,1423,193,448,.431,50,151,.331,143,297,.481,.487,103,134,.769,84,235,319,87,32,33,46,127,539,2010
Alando Tucker,SF,25,TOT,15,0,96,17,39,.436,1,7,.143,16,32,.500,.449,16,21,.762,6,4,10,4,0,0,5,6,51,2010
Alando Tucker,SF,25,PHO,11,0,71,13,30,.433,1,7,.143,12,23,.522,.450,16,21,.762,5,2,7,3,0,0,4,5,43,2010
Alando Tucker,SF,25,MIN,4,0,25,4,9,.444,0,0,.000,4,9,.444,.444,0,0,.000,1,2,3,1,0,0,1,1,8,2010
Ronny Turiaf,C,27,GSW,42,20,872,85,146,.582,0,1,.000,85,145,.586,.582,37,78,.474,54,137,191,90,23,54,49,98,207,2010
Hedo Turkoglu,SF,30,TOR,74,69,2272,276,674,.409,108,289,.374,168,385,.436,.490,175,226,.774,42,301,343,304,55,32,125,220,835,2010
Ime Udoka,SG,32,SAC,69,2,944,91,241,.378,26,91,.286,65,150,.433,.432,42,57,.737,51,140,191,58,34,6,42,83,250,2010
Beno Udrih,PG,27,SAC,79,41,2477,415,841,.493,75,199,.377,340,642,.530,.538,118,141,.837,38,181,219,372,89,10,136,166,1023,2010
Roko Ukic,PG,25,MIL,13,0,97,14,30,.467,3,12,.250,11,18,.611,.517,9,11,.818,0,3,3,12,1,0,6,6,40,2010
Anderson Varejao,PF,27,CLE,76,7,2166,267,467,.572,1,5,.200,266,462,.576,.573,116,175,.663,189,389,578,87,71,67,67,223,651,2010
Charlie Villanueva,PF,25,DET,78,16,1848,363,827,.439,99,282,.351,264,545,.484,.499,106,130,.815,85,280,365,53,48,55,74,223,931,2010
Sasha Vujacic,SG,25,LAL,67,1,575,66,164,.402,25,81,.309,41,83,.494,.479,28,33,.848,25,54,79,41,20,4,17,67,185,2010
Dwyane Wade,SG,28,MIA,77,77,2792,719,1511,.476,73,243,.300,646,1268,.509,.500,534,702,.761,107,266,373,501,142,82,252,181,2045,2010
Henry Walker,SG-SF,22,TOT,35,13,768,120,232,.517,50,116,.431,70,116,.603,.625,39,49,.796,15,73,88,40,23,3,28,83,329,2010
Henry Walker,SF,22,BOS,8,0,29,3,6,.500,0,0,.000,3,6,.500,.500,2,2,1.000,0,5,5,3,0,0,2,4,8,2010
Henry Walker,SG,22,NYK,27,13,739,117,226,.518,50,116,.431,67,110,.609,.628,37,47,.787,15,68,83,37,23,3,26,79,321,2010
Ben Wallace,C,35,DET,69,67,1975,158,292,.541,0,2,.000,158,290,.545,.541,65,160,.406,245,352,597,105,86,84,64,131,381,2010
Gerald Wallace,SF,27,CHA,76,76,3119,456,943,.484,52,140,.371,404,803,.503,.511,422,544,.776,150,612,762,161,117,83,178,194,1386,2010
Rasheed Wallace,C,35,BOS,79,13,1780,266,650,.409,82,290,.283,184,360,.511,.472,96,125,.768,42,283,325,80,80,70,63,222,710,2010
Luke Walton,SF,29,LAL,29,0,272,30,84,.357,7,17,.412,23,67,.343,.399,2,4,.500,12,26,38,40,10,1,12,19,69,2010
Hakim Warrick,PF,27,TOT,76,6,1557,265,550,.482,1,7,.143,264,543,.486,.483,202,274,.737,127,187,314,52,24,18,80,126,733,2010
Hakim Warrick,PF,27,MIL,48,6,1024,182,378,.481,1,6,.167,181,372,.487,.483,125,172,.727,87,125,212,35,17,10,57,83,490,2010
Hakim Warrick,PF,27,CHI,28,0,533,83,172,.483,0,1,.000,83,171,.485,.483,77,102,.755,40,62,102,17,7,8,23,43,243,2010
C.J. Watson,PG,25,GSW,65,15,1788,247,528,.468,45,145,.310,202,383,.527,.510,128,166,.771,28,141,169,180,103,8,69,124,667,2010
Earl Watson,PG,30,IND,79,52,2322,223,524,.426,53,184,.288,170,340,.500,.476,120,169,.710,54,186,240,399,104,16,175,181,619,2010
Kyle Weaver,SG,23,OKC,12,0,144,12,33,.364,7,19,.368,5,14,.357,.470,5,6,.833,1,17,18,11,6,6,4,13,36,2010
Martell Webster,SF,23,POR,82,49,2005,259,639,.405,124,332,.373,135,307,.440,.502,126,155,.813,47,221,268,62,45,40,60,153,768,2010
Sonny Weems,SG,23,TOR,69,19,1368,236,458,.515,2,15,.133,234,443,.528,.517,44,64,.688,42,150,192,101,39,25,65,126,518,2010
David West,PF,29,NOH,81,81,2949,619,1226,.505,7,27,.259,612,1199,.510,.508,296,342,.865,164,441,605,239,76,60,173,233,1541,2010
Delonte West,SG,26,CLE,60,3,1500,194,436,.445,25,77,.325,169,359,.471,.474,115,142,.810,29,140,169,196,55,28,90,86,528,2010
Mario West,SG,25,ATL,39,1,142,12,21,.571,0,1,.000,12,20,.600,.571,6,10,.600,8,19,27,9,8,0,7,25,30,2010
Russell Westbrook,PG,21,OKC,82,82,2813,485,1160,.418,23,104,.221,462,1056,.438,.428,329,422,.780,143,258,401,652,108,34,268,204,1322,2010
D.J. White,PF,23,OKC,12,0,102,25,41,.610,0,0,.000,25,41,.610,.610,9,10,.900,10,13,23,4,5,3,3,12,59,2010
Chris Wilcox,PF,27,DET,34,10,441,63,120,.525,0,0,.000,63,120,.525,.525,26,52,.500,44,73,117,13,13,12,38,64,152,2010
Damien Wilkins,SF,30,MIN,80,31,1585,165,381,.433,18,61,.295,147,320,.459,.457,103,129,.798,72,177,249,135,66,25,76,144,451,2010
Mike Wilks,PG,30,OKC,4,0,59,6,12,.500,2,3,.667,4,9,.444,.583,2,4,.500,1,3,4,4,0,0,4,5,16,2010
Deron Williams,PG,25,UTA,76,76,2802,494,1053,.469,96,259,.371,398,794,.501,.515,335,418,.801,50,253,303,798,96,16,252,208,1419,2010
Jason Williams,PG,34,ORL,82,18,1703,189,426,.444,84,221,.380,105,205,.512,.542,31,41,.756,7,119,126,298,53,3,87,65,493,2010
Jawad Williams,PG,26,CLE,54,6,742,81,206,.393,30,93,.323,51,113,.451,.466,32,45,.711,16,67,83,34,12,5,18,73,224,2010
Lou Williams,PG,23,PHI,64,38,1912,318,677,.470,70,206,.340,248,471,.527,.521,192,233,.824,25,162,187,268,80,15,106,110,898,2010
Marcus Williams,PG,24,MEM,62,1,872,104,271,.384,24,81,.296,80,190,.421,.428,37,55,.673,13,80,93,161,32,1,74,43,269,2010
Marvin Williams,SF,23,ATL,81,81,2468,302,664,.455,40,132,.303,262,532,.492,.485,176,215,.819,106,310,416,93,66,46,72,160,820,2010
Mo Williams,PG,27,CLE,69,68,2359,378,855,.442,159,371,.429,219,484,.452,.535,177,198,.894,28,178,206,368,70,21,173,170,1092,2010
Reggie Williams,SF,23,GSW,24,10,782,140,283,.495,33,92,.359,107,191,.560,.553,52,62,.839,18,92,110,66,23,6,29,49,365,2010
Sean Williams,PF,23,NJN,20,0,227,21,49,.429,0,1,.000,21,48,.438,.429,10,19,.526,21,25,46,1,8,19,20,41,52,2010
Shelden Williams,PF,26,BOS,54,0,597,63,121,.521,0,1,.000,63,120,.525,.521,75,98,.765,47,99,146,21,13,21,30,85,201,2010
Terrence Williams,SF,22,NJN,78,9,1764,261,651,.401,31,100,.310,230,551,.417,.425,103,144,.715,46,302,348,223,43,10,124,126,656,2010
Metta World Peace,SF,30,LAL,77,77,2605,306,740,.414,105,296,.355,201,444,.453,.484,128,186,.688,99,232,331,234,106,21,121,165,845,2010
Antoine Wright,SF,25,TOR,67,10,1392,162,399,.406,58,173,.335,104,226,.460,.479,53,77,.688,38,152,190,71,30,11,58,134,435,2010
Dorell Wright,SF,24,MIA,72,1,1496,194,419,.463,61,157,.389,133,262,.508,.536,61,69,.884,50,185,235,91,52,32,53,94,510,2010
Julian Wright,SF,22,NOH,68,14,871,116,232,.500,2,6,.333,114,226,.504,.504,25,41,.610,58,86,144,41,29,18,44,45,259,2010
Nick Young,SG,24,WAS,74,23,1421,233,558,.418,69,170,.406,164,388,.423,.479,104,130,.800,20,82,102,48,28,8,56,147,639,2010
Sam Young,SF,24,MEM,80,1,1321,224,497,.451,11,56,.196,213,441,.483,.462,136,175,.777,77,124,201,52,34,20,94,106,595,2010
Thaddeus Young,PF,21,PHI,67,45,2145,382,813,.470,48,138,.348,334,675,.495,.499,114,165,.691,130,220,350,97,81,15,126,133,926,2010
Alex Acker,SG,26,TOT,25,0,199,30,76,.395,7,20,.350,23,56,.411,.441,5,10,.500,8,16,24,12,5,4,7,9,72,2009
Alex Acker,SG,26,DET,7,0,20,4,11,.364,0,4,.000,4,7,.571,.364,1,2,.500,0,2,2,1,2,1,0,0,9,2009
Alex Acker,SG,26,LAC,18,0,179,26,65,.400,7,16,.438,19,49,.388,.454,4,8,.500,8,14,22,11,3,3,7,9,63,2009
Hassan Adams,SG,24,TOR,12,0,52,4,13,.308,0,0,.000,4,13,.308,.308,3,6,.500,1,6,7,1,1,1,4,4,11,2009
Arron Afflalo,SG,23,DET,74,8,1234,131,300,.437,43,107,.402,88,193,.456,.508,58,71,.817,30,104,134,44,28,13,43,144,363,2009
Maurice Ager,SG,24,NJN,20,0,97,15,43,.349,0,6,.000,15,37,.405,.349,4,8,.500,3,7,10,3,1,2,4,17,34,2009
Blake Ahearn,PG,24,SAS,3,0,19,2,6,.333,2,4,.500,0,2,.000,.500,2,2,1.000,0,1,1,2,1,0,1,3,8,2009
Alexis Ajinca,PF,20,CHA,31,4,182,25,69,.362,0,2,.000,25,67,.373,.362,20,28,.714,9,21,30,3,7,6,12,34,70,2009
LaMarcus Aldridge,PF,23,POR,81,81,3004,601,1243,.484,7,28,.250,594,1215,.489,.486,261,334,.781,234,371,605,157,77,77,121,207,1470,2009
Joe Alexander,SF,22,MIL,59,0,716,102,245,.416,16,46,.348,86,199,.432,.449,58,83,.699,44,71,115,42,15,29,52,107,278,2009
Malik Allen,PF,30,MIL,49,3,579,73,170,.429,0,1,.000,73,169,.432,.429,10,21,.476,35,68,103,35,7,12,20,89,156,2009
Ray Allen,SG,33,BOS,79,79,2876,499,1040,.480,199,486,.409,300,554,.542,.575,237,249,.952,66,212,278,218,69,13,134,157,1434,2009
Tony Allen,SG,27,BOS,46,2,887,137,284,.482,6,27,.222,131,257,.510,.493,79,109,.725,22,82,104,66,54,23,77,98,359,2009
Morris Almond,SG,23,UTA,25,1,255,33,81,.407,5,17,.294,28,64,.438,.438,21,26,.808,9,27,36,7,4,4,16,31,92,2009
Rafer Alston,PG,32,TOT,77,76,2447,316,820,.385,112,331,.338,204,489,.417,.454,156,208,.750,33,194,227,406,108,10,140,135,900,2009
Rafer Alston,PG,32,HOU,48,48,1591,193,522,.370,80,230,.348,113,292,.387,.446,86,109,.789,25,119,144,258,57,7,88,72,552,2009
Rafer Alston,PG,32,ORL,29,28,856,123,298,.413,32,101,.317,91,197,.462,.466,70,99,.707,8,75,83,148,51,3,52,63,348,2009
Lou Amundson,PF,26,PHO,76,0,1044,134,250,.536,0,1,.000,134,249,.538,.536,53,120,.442,128,142,270,28,32,65,56,154,321,2009
Chris Andersen,C,30,DEN,71,1,1460,160,292,.548,2,10,.200,158,282,.560,.551,130,181,.718,163,279,442,31,41,175,69,174,452,2009
Ryan Anderson,PF,20,NJN,66,30,1312,160,407,.393,69,189,.365,91,218,.417,.478,98,116,.845,104,207,311,52,44,20,63,157,487,2009
Carmelo Anthony,SF,24,DEN,66,66,2277,535,1207,.443,63,170,.371,472,1037,.455,.469,371,468,.793,106,344,450,222,75,24,199,195,1504,2009
Joel Anthony,C,26,MIA,65,28,1048,57,118,.483,0,0,.000,57,118,.483,.483,30,46,.652,89,108,197,27,20,93,41,139,144,2009
Gilbert Arenas,PG,27,WAS,2,2,63,6,23,.261,2,7,.286,4,16,.250,.304,12,16,.750,1,8,9,20,0,1,1,4,26,2009
Trevor Ariza,SF,23,LAL,82,20,1999,274,596,.460,61,191,.319,213,405,.526,.511,120,169,.710,111,241,352,145,137,24,87,166,729,2009
Hilton Armstrong,C,24,NOH,70,29,1092,138,246,.561,0,2,.000,138,244,.566,.561,62,98,.633,81,114,195,29,26,45,80,181,338,2009
Darrell Arthur,PF,20,MEM,76,64,1464,191,436,.438,0,2,.000,191,434,.440,.438,40,60,.667,108,238,346,43,52,52,47,206,422,2009
Chucky Atkins,PG,34,TOT,33,0,412,34,113,.301,15,57,.263,19,56,.339,.367,15,16,.938,5,19,24,59,10,2,23,27,98,2009
Chucky Atkins,PG,34,DEN,14,0,115,9,27,.333,5,17,.294,4,10,.400,.426,4,4,1.000,0,6,6,28,2,1,10,5,27,2009
Chucky Atkins,PG,34,OKC,19,0,297,25,86,.291,10,40,.250,15,46,.326,.349,11,12,.917,5,13,18,31,8,1,13,22,71,2009
D.J. Augustin,PG,21,CHA,72,12,1908,267,621,.430,108,246,.439,159,375,.424,.517,208,233,.893,17,116,133,250,42,2,119,140,850,2009
Kelenna Azubuike,SF,25,GSW,74,51,2375,392,845,.464,94,210,.448,298,635,.469,.520,185,229,.808,112,258,370,117,57,50,95,183,1063,2009
Renaldo Balkman,PF,24,DEN,53,10,780,110,197,.558,2,7,.286,108,190,.568,.563,42,65,.646,86,117,203,34,47,23,35,98,264,2009
Marcus Banks,PG,27,TOT,22,0,206,21,57,.368,3,19,.158,18,38,.474,.395,11,18,.611,1,17,18,28,11,2,14,26,56,2009
Marcus Banks,PG,27,MIA,16,0,166,15,39,.385,2,14,.143,13,25,.520,.410,10,15,.667,0,15,15,22,10,2,11,21,42,2009
Marcus Banks,PG,27,TOR,6,0,40,6,18,.333,1,5,.200,5,13,.385,.361,1,3,.333,1,2,3,6,1,0,3,5,14,2009
Leandro Barbosa,SG,26,PHO,70,11,1705,366,759,.482,90,240,.375,276,519,.532,.542,171,194,.881,34,147,181,162,82,7,93,115,993,2009
J.J. Barea,SG,24,DAL,79,15,1600,246,557,.442,55,154,.357,191,403,.474,.491,70,93,.753,36,141,177,269,37,5,105,121,617,2009
Andrea Bargnani,PF,23,TOR,78,59,2453,431,958,.450,119,291,.409,312,667,.468,.512,221,266,.831,70,346,416,94,34,97,135,242,1202,2009
Matt Barnes,PF,28,PHO,77,40,2082,285,674,.423,117,341,.343,168,333,.505,.510,101,136,.743,79,342,421,212,52,26,130,209,788,2009
Brent Barry,SG,37,HOU,56,1,857,70,172,.407,49,131,.374,21,41,.512,.549,19,20,.950,17,77,94,78,24,3,48,45,208,2009
Brandon Bass,C,23,DAL,81,0,1574,252,508,.496,0,6,.000,252,502,.502,.496,182,210,.867,129,238,367,43,27,55,86,140,686,2009
Maceo Baston,PF,33,IND,27,0,217,25,46,.543,0,1,.000,25,45,.556,.543,17,27,.630,22,30,52,7,6,10,12,39,67,2009
Tony Battie,PF,32,ORL,77,3,1202,158,323,.489,2,9,.222,156,314,.497,.492,54,82,.659,92,186,278,31,26,25,46,112,372,2009
Shane Battier,SG,30,HOU,60,59,2031,145,354,.410,91,237,.384,54,117,.462,.538,55,67,.821,52,233,285,137,48,54,49,114,436,2009
Nicolas Batum,SF,20,POR,79,76,1454,161,361,.446,62,168,.369,99,193,.513,.532,42,52,.808,84,136,220,74,50,40,50,139,426,2009
Jerryd Bayless,PG,20,POR,53,0,655,69,189,.365,7,27,.259,62,162,.383,.384,83,103,.806,8,49,57,78,16,2,56,81,228,2009
Michael Beasley,PF,20,MIA,81,19,2009,452,957,.472,33,81,.407,419,876,.478,.490,186,241,.772,110,329,439,83,41,37,121,184,1123,2009
Marco Belinelli,SG,22,GSW,42,23,882,140,317,.442,52,131,.397,88,186,.473,.524,40,52,.769,10,61,71,88,36,1,59,73,372,2009
Charlie Bell,SG,29,MIL,70,23,1783,217,524,.414,87,240,.363,130,284,.458,.497,66,80,.825,32,102,134,151,50,7,76,138,587,2009
Raja Bell,SG,32,TOT,67,66,2315,299,684,.437,114,271,.421,185,413,.448,.520,87,102,.853,41,202,243,142,50,8,86,166,799,2009
Raja Bell,SG,32,PHO,22,22,712,76,177,.429,44,94,.468,32,83,.386,.554,16,21,.762,8,56,64,29,13,2,18,57,212,2009
Raja Bell,SG,32,CHA,45,44,1603,223,507,.440,70,177,.395,153,330,.464,.509,71,81,.877,33,146,179,113,37,6,68,109,587,2009
Mike Bibby,PG,30,ATL,79,79,2740,437,1005,.435,167,428,.390,270,577,.468,.518,135,171,.789,38,240,278,392,98,11,128,145,1176,2009
Andris Biedrins,C,22,GSW,62,58,1863,308,533,.578,0,1,.000,308,532,.579,.578,119,216,.551,223,470,693,121,63,96,110,236,735,2009
Chauncey Billups,PG,32,TOT,79,79,2789,410,980,.418,162,397,.408,248,583,.425,.501,418,458,.913,32,207,239,506,93,18,177,161,1400,2009
Chauncey Billups,PG,32,DET,2,2,70,7,21,.333,2,7,.286,5,14,.357,.381,9,10,.900,1,9,10,15,3,1,4,3,25,2009
Chauncey Billups,PG,32,DEN,77,77,2719,403,959,.420,160,390,.410,243,569,.427,.504,409,448,.913,31,198,229,491,90,17,173,158,1375,2009
Steve Blake,PG,28,POR,69,69,2188,277,647,.428,140,328,.427,137,319,.429,.536,63,75,.840,28,145,173,348,69,4,108,126,757,2009
Andray Blatche,C,22,WAS,71,36,1703,297,630,.471,5,21,.238,292,609,.479,.475,114,162,.704,126,252,378,118,53,74,117,211,713,2009
Mark Blount,C,33,MIA,20,0,207,30,78,.385,11,27,.407,19,51,.373,.455,8,13,.615,10,31,41,4,1,7,14,17,79,2009
Keith Bogans,SG,28,TOT,65,15,1272,119,324,.367,74,218,.339,45,106,.425,.481,52,57,.912,31,171,202,64,43,4,41,105,364,2009
Keith Bogans,SG,28,ORL,36,15,787,63,175,.360,42,126,.333,21,49,.429,.480,21,24,.875,15,96,111,31,23,2,19,61,189,2009
Keith Bogans,SG,28,MIL,29,0,485,56,149,.376,32,92,.348,24,57,.421,.483,31,33,.939,16,75,91,33,20,2,22,44,175,2009
Andrew Bogut,C,24,MIL,36,33,1124,183,317,.577,0,0,.000,183,317,.577,.577,56,98,.571,117,252,369,72,23,37,86,130,422,2009
Matt Bonner,PF,28,SAS,81,67,1928,266,536,.496,118,268,.440,148,268,.552,.606,17,23,.739,97,289,386,82,47,26,37,190,667,2009
Josh Boone,C,24,NJN,62,7,995,113,214,.528,0,0,.000,113,214,.528,.528,32,85,.376,104,154,258,31,22,48,31,106,258,2009
Calvin Booth,C,32,TOT,8,0,56,5,10,.500,0,0,.000,5,10,.500,.500,6,8,.750,5,6,11,0,1,2,1,10,16,2009
Calvin Booth,C,32,MIN,1,0,1,0,0,.000,0,0,.000,0,0,.000,.000,0,0,.000,1,0,1,0,0,0,0,0,0,2009
Calvin Booth,C,32,SAC,7,0,55,5,10,.500,0,0,.000,5,10,.500,.500,6,8,.750,4,6,10,0,1,2,1,10,16,2009
Carlos Boozer,PF,27,UTA,37,37,1197,251,512,.490,0,0,.000,251,512,.490,.490,97,139,.698,111,274,385,79,39,7,79,132,599,2009
Chris Bosh,C,24,TOR,77,77,2928,615,1263,.487,12,49,.245,603,1214,.497,.492,504,617,.817,215,556,771,191,67,77,174,189,1746,2009
Bruce Bowen,SF,37,SAS,80,10,1506,79,187,.422,42,98,.429,37,89,.416,.535,14,26,.538,16,129,145,40,36,13,25,123,214,2009
Ryan Bowen,SF,33,NOH,21,3,219,22,38,.579,0,0,.000,22,38,.579,.579,3,5,.600,10,14,24,9,14,5,5,37,47,2009
Elton Brand,PF,29,PHI,29,23,920,163,365,.447,0,0,.000,163,365,.447,.447,73,108,.676,77,177,254,37,17,45,68,78,399,2009
Corey Brewer,SF,22,MIN,15,8,307,37,90,.411,5,12,.417,32,78,.410,.439,14,19,.737,18,31,49,25,15,3,13,37,93,2009
Ronnie Brewer,SF,23,UTA,81,80,2605,421,828,.508,22,85,.259,399,743,.537,.522,247,352,.702,101,199,300,179,138,30,110,128,1111,2009
Aaron Brooks,PG,24,HOU,80,35,1998,316,783,.404,113,309,.366,203,474,.428,.476,149,172,.866,33,124,157,238,46,8,125,152,894,2009
Andre Brown,PF,27,CHA,4,0,41,1,7,.143,0,0,.000,1,7,.143,.143,2,2,1.000,7,5,12,1,1,0,5,9,4,2009
Bobby Brown,SG-PG,24,TOT,68,2,931,141,360,.392,45,130,.346,96,230,.417,.454,34,43,.791,14,38,52,117,21,3,63,95,361,2009
Bobby Brown,SG,24,SAC,47,1,675,94,247,.381,31,94,.330,63,153,.412,.443,26,34,.765,8,28,36,87,15,1,47,74,245,2009
Bobby Brown,PG,24,MIN,21,1,256,47,113,.416,14,36,.389,33,77,.429,.478,8,9,.889,6,10,16,30,6,2,16,21,116,2009
Dee Brown,PG,24,TOT,19,11,261,18,49,.367,7,24,.292,11,25,.440,.439,3,5,.600,7,22,29,36,10,0,17,28,46,2009
Dee Brown,PG,24,WAS,17,11,233,17,44,.386,6,20,.300,11,24,.458,.455,1,3,.333,7,21,28,33,10,0,14,22,41,2009
Dee Brown,PG,24,PHO,2,0,28,1,5,.200,1,4,.250,0,1,.000,.300,2,2,1.000,0,1,1,3,0,0,3,6,5,2009
Devin Brown,SG,30,NOH,63,5,869,111,313,.355,28,97,.289,83,216,.384,.399,78,100,.780,31,88,119,54,32,5,54,81,328,2009
Kwame Brown,C,26,DET,58,30,999,90,169,.533,0,0,.000,90,169,.533,.533,63,122,.516,91,199,290,32,24,24,50,138,243,2009
Shannon Brown,SG,23,TOT,48,0,477,78,165,.473,14,37,.378,64,128,.500,.515,32,39,.821,11,33,44,38,22,7,38,42,202,2009
Shannon Brown,SG,23,CHA,30,0,341,56,123,.455,8,28,.286,48,95,.505,.488,24,30,.800,8,16,24,28,18,5,29,33,144,2009
Shannon Brown,SG,23,LAL,18,0,136,22,42,.524,6,9,.667,16,33,.485,.595,8,9,.889,3,17,20,10,4,2,9,9,58,2009
Kobe Bryant,SG,30,LAL,82,82,2960,800,1712,.467,118,336,.351,682,1376,.496,.502,483,564,.856,90,339,429,399,120,37,210,189,2201,2009
Greg Buckner,SF,32,MEM,63,0,878,61,159,.384,13,51,.255,48,108,.444,.425,20,25,.800,32,98,130,57,29,8,38,108,155,2009
Caron Butler,SG,28,WAS,67,67,2585,491,1085,.453,65,210,.310,426,875,.487,.482,345,402,.858,118,296,414,290,106,20,210,165,1392,2009
Rasual Butler,SF,29,NOH,82,74,2614,348,803,.433,140,359,.390,208,444,.468,.521,86,110,.782,49,222,271,75,51,61,59,159,922,2009
Andrew Bynum,C,21,LAL,50,50,1446,281,502,.560,0,0,.000,281,502,.560,.560,152,215,.707,137,261,398,71,18,90,85,157,714,2009
Will Bynum,PG,26,DET,57,1,803,156,342,.456,3,19,.158,153,323,.474,.461,95,119,.798,19,56,75,157,34,2,76,85,410,2009
Jose Calderon,PG,27,TOR,68,68,2333,320,644,.497,82,202,.406,238,442,.538,.561,151,154,.981,16,178,194,607,74,7,143,114,873,2009
Marcus Camby,C,34,LAC,62,55,1925,254,496,.512,1,4,.250,253,492,.514,.513,132,182,.725,161,529,690,127,51,132,93,129,641,2009
Brian Cardinal,PF,31,MIN,64,4,909,65,169,.385,30,92,.326,35,77,.455,.473,30,35,.857,39,103,142,76,37,13,48,135,190,2009
Rodney Carney,SG,24,MIN,67,6,1199,176,423,.416,79,226,.350,97,197,.492,.509,50,66,.758,36,90,126,26,45,29,43,94,481,2009
Matt Carroll,SG,28,TOT,55,10,616,65,171,.380,13,53,.245,52,118,.441,.418,21,25,.840,7,62,69,27,21,6,33,67,164,2009
Matt Carroll,SG,28,CHA,34,10,475,56,138,.406,12,45,.267,44,93,.473,.449,15,19,.789,5,50,55,24,18,5,26,53,139,2009
Matt Carroll,SG,28,DAL,21,0,141,9,33,.273,1,8,.125,8,25,.320,.288,6,6,1.000,2,12,14,3,3,1,7,14,25,2009
Anthony Carter,PG,33,DEN,78,5,1787,167,386,.433,21,88,.239,146,298,.490,.460,57,78,.731,40,165,205,364,96,13,155,142,412,2009
Vince Carter,SG,32,NJN,80,80,2946,588,1345,.437,151,392,.385,437,953,.459,.493,335,410,.817,74,336,410,376,82,38,166,234,1662,2009
Mario Chalmers,PG,22,MIA,82,82,2626,278,662,.420,114,311,.367,164,351,.467,.506,148,193,.767,37,191,228,403,160,8,165,240,818,2009
Tyson Chandler,C,26,NOH,45,45,1445,160,283,.565,0,0,.000,160,283,.565,.565,77,133,.579,163,230,393,22,15,56,70,144,397,2009
Wilson Chandler,SF,21,NYK,82,70,2735,455,1054,.432,103,314,.328,352,740,.476,.481,171,215,.795,91,354,445,170,71,75,139,250,1184,2009
Speedy Claxton,PG,30,ATL,2,0,15,2,7,.286,0,0,.000,2,7,.286,.286,1,2,.500,0,0,0,3,0,0,0,1,5,2009
Jarron Collins,C,30,UTA,26,3,201,16,35,.457,0,0,.000,16,35,.457,.457,8,11,.727,20,17,37,7,2,1,9,35,40,2009
Jason Collins,C,30,MIN,31,22,422,22,70,.314,0,0,.000,22,70,.314,.314,13,28,.464,28,42,70,11,9,13,12,73,57,2009
Mardy Collins,PG-SG,24,TOT,48,14,890,105,247,.425,13,31,.419,92,216,.426,.451,28,46,.609,31,76,107,111,31,10,58,80,251,2009
Mardy Collins,SG,24,NYK,9,0,75,8,23,.348,0,3,.000,8,20,.400,.348,4,9,.444,2,6,8,10,2,0,5,7,20,2009
Mardy Collins,PG,24,LAC,39,14,815,97,224,.433,13,28,.464,84,196,.429,.462,24,37,.649,29,70,99,101,29,10,53,73,231,2009
Nick Collison,C,28,OKC,71,40,1831,243,428,.568,0,2,.000,243,426,.570,.568,98,136,.721,181,308,489,66,51,50,73,239,584,2009
Mike Conley,PG,21,MEM,82,61,2508,323,730,.442,88,217,.406,235,513,.458,.503,161,197,.817,25,251,276,354,90,8,143,146,895,2009
Brian Cook,PF,28,TOT,30,0,171,28,76,.368,13,30,.433,15,46,.326,.454,5,6,.833,7,25,32,5,3,3,13,26,74,2009
Brian Cook,PF,28,ORL,21,0,146,23,60,.383,11,25,.440,12,35,.343,.475,5,6,.833,6,21,27,4,3,0,11,23,62,2009
Brian Cook,PF,28,HOU,9,0,25,5,16,.313,2,5,.400,3,11,.273,.375,0,0,.000,1,4,5,1,0,3,2,3,12,2009
Daequan Cook,SF,21,MIA,75,4,1833,242,645,.375,153,395,.387,89,250,.356,.494,49,56,.875,19,170,189,71,39,10,42,125,686,2009
Jamal Crawford,PG-SG,28,TOT,65,65,2479,419,1022,.410,142,394,.360,277,628,.441,.479,300,344,.872,23,170,193,288,57,13,148,92,1280,2009
Jamal Crawford,SG,28,NYK,11,11,392,73,169,.432,35,77,.455,38,92,.413,.536,35,46,.761,2,15,17,48,9,0,26,13,216,2009
Jamal Crawford,PG,28,GSW,54,54,2087,346,853,.406,107,317,.338,239,536,.446,.468,265,298,.889,21,155,176,240,48,13,122,79,1064,2009
Joe Crawford,SF,22,NYK,2,0,23,3,10,.300,1,4,.250,2,6,.333,.350,2,2,1.000,1,3,4,1,1,0,0,2,9,2009
Javaris Crittenton,PG-SG,21,TOT,63,10,1174,131,285,.460,2,15,.133,129,270,.478,.463,53,92,.576,57,109,166,150,40,6,82,101,317,2009
Javaris Crittenton,SG,21,MEM,7,0,44,7,15,.467,0,1,.000,7,14,.500,.467,5,11,.455,4,2,6,5,1,0,3,5,19,2009
Javaris Crittenton,PG,21,WAS,56,10,1130,124,270,.459,2,14,.143,122,256,.477,.463,48,81,.593,53,107,160,145,39,6,79,96,298,2009
Austin Croshere,PF,33,TOT,14,0,100,14,39,.359,5,15,.333,9,24,.375,.423,7,12,.583,11,23,34,9,1,1,6,5,40,2009
Austin Croshere,PF,33,MIL,11,0,77,12,30,.400,5,11,.455,7,19,.368,.483,7,11,.636,7,17,24,6,1,1,4,4,36,2009
Austin Croshere,PF,33,SAS,3,0,23,2,9,.222,0,4,.000,2,5,.400,.222,0,1,.000,4,6,10,3,0,0,2,1,4,2009
Eddy Curry,C,26,NYK,3,0,12,2,2,1.000,0,0,.000,2,2,1.000,1.000,1,3,.333,0,4,4,0,0,0,2,5,5,2009
Samuel Dalembert,C,27,PHI,82,82,2036,216,434,.498,0,2,.000,216,432,.500,.498,91,124,.734,214,487,701,18,33,146,117,248,523,2009
Erick Dampier,C,33,DAL,80,80,1836,182,280,.650,0,0,.000,182,280,.650,.650,90,141,.638,216,349,565,77,24,95,74,191,454,2009
Antonio Daniels,PG,33,TOT,74,9,1021,99,236,.419,22,60,.367,77,176,.438,.466,80,100,.800,5,72,77,177,26,1,62,55,300,2009
Antonio Daniels,PG,33,WAS,13,5,288,18,45,.400,5,11,.455,13,34,.382,.456,25,33,.758,0,22,22,47,7,0,13,14,66,2009
Antonio Daniels,PG,33,NOH,61,4,733,81,191,.424,17,49,.347,64,142,.451,.469,55,67,.821,5,50,55,130,19,1,49,41,234,2009
Marquis Daniels,SF,28,IND,54,43,1700,311,689,.451,18,90,.200,293,599,.489,.464,93,129,.721,80,168,248,114,62,26,94,120,733,2009
Jermareo Davidson,SF,24,GSW,14,0,111,17,35,.486,0,0,.000,17,35,.486,.486,8,17,.471,10,24,34,1,2,3,5,12,42,2009
Baron Davis,PG,29,LAC,65,60,2248,355,959,.370,99,328,.302,256,631,.406,.422,159,210,.757,46,192,238,501,108,35,193,193,968,2009
Glen Davis,C,23,BOS,76,16,1637,199,450,.442,2,5,.400,197,445,.443,.444,130,178,.730,121,180,301,69,53,19,71,230,530,2009
Paul Davis,PF,24,LAC,27,1,320,40,98,.408,0,1,.000,40,97,.412,.408,27,34,.794,28,39,67,12,10,3,13,44,107,2009
Ricky Davis,SG,29,LAC,36,9,785,83,245,.339,35,111,.315,48,134,.358,.410,31,36,.861,9,51,60,82,19,5,39,63,232,2009
Luol Deng,SF,23,CHI,49,46,1665,265,591,.448,8,20,.400,257,571,.450,.455,152,191,.796,80,215,295,94,60,25,72,85,690,2009
Boris Diaw,PF,26,TOT,81,59,2754,448,884,.507,75,181,.414,373,703,.531,.549,101,147,.687,118,314,432,333,61,53,215,202,1072,2009
Boris Diaw,PF,26,PHO,22,0,538,80,141,.567,5,14,.357,75,127,.591,.585,18,26,.692,24,60,84,46,11,9,37,39,183,2009
Boris Diaw,PF,26,CHA,59,59,2216,368,743,.495,70,167,.419,298,576,.517,.542,83,121,.686,94,254,348,287,50,44,178,163,889,2009
Yakhouba Diawara,SF,26,MIA,63,21,851,76,217,.350,51,163,.313,25,54,.463,.468,10,19,.526,26,56,82,27,13,6,16,75,213,2009
Travis Diener,PG,26,IND,55,0,719,74,179,.413,46,118,.390,28,61,.459,.542,12,15,.800,6,80,86,122,26,5,21,42,206,2009
Ike Diogu,PF,25,TOT,29,1,215,39,74,.527,1,2,.500,38,72,.528,.534,40,53,.755,26,30,56,3,3,3,12,23,119,2009
Ike Diogu,PF,25,POR,19,0,73,6,19,.316,0,0,.000,6,19,.316,.316,15,20,.750,12,5,17,0,1,2,6,9,27,2009
Ike Diogu,PF,25,SAC,10,1,142,33,55,.600,1,2,.500,32,53,.604,.609,25,33,.758,14,25,39,3,2,1,6,14,92,2009
DeSagana Diop,C,27,TOT,75,1,1036,74,171,.433,0,0,.000,74,171,.433,.433,22,66,.333,114,159,273,32,29,56,39,128,170,2009
DeSagana Diop,C,27,DAL,34,0,452,22,58,.379,0,0,.000,22,58,.379,.379,12,29,.414,45,73,118,13,12,25,11,55,56,2009
DeSagana Diop,C,27,CHA,41,1,584,52,113,.460,0,0,.000,52,113,.460,.460,10,37,.270,69,86,155,19,17,31,28,73,114,2009
Juan Dixon,PG,30,WAS,50,6,816,101,256,.395,25,75,.333,76,181,.420,.443,34,39,.872,8,59,67,118,35,6,70,74,261,2009
Keyon Dooling,PG,28,NJN,77,18,2074,261,598,.436,99,235,.421,162,363,.446,.519,127,154,.825,24,131,155,270,71,8,105,135,748,2009
Joey Dorsey,PF,25,HOU,3,0,6,1,2,.500,0,0,.000,1,2,.500,.500,0,0,.000,0,1,1,1,0,0,0,0,2,2009
Quincy Douby,PG,24,TOT,27,0,300,42,110,.382,14,46,.304,28,64,.438,.445,17,19,.895,6,26,32,25,5,5,13,27,115,2009
Quincy Douby,PG,24,SAC,20,0,227,30,88,.341,10,37,.270,20,51,.392,.398,14,15,.933,3,22,25,13,2,5,6,23,84,2009
Quincy Douby,PG,24,TOR,7,0,73,12,22,.545,4,9,.444,8,13,.615,.636,3,4,.750,3,4,7,12,3,0,7,4,31,2009
Chris Douglas-Roberts,SG,22,NJN,44,3,585,81,176,.460,3,12,.250,78,164,.476,.469,51,62,.823,14,36,50,52,12,7,31,34,216,2009
Goran Dragic,PG,22,PHO,55,1,728,88,224,.393,20,54,.370,68,170,.400,.438,50,65,.769,33,70,103,111,29,3,73,87,246,2009
Jared Dudley,SF,23,TOT,68,7,1155,136,285,.477,29,74,.392,107,211,.507,.528,71,105,.676,82,123,205,56,57,8,43,105,372,2009
Jared Dudley,SF,23,CHA,20,7,427,45,96,.469,3,8,.375,42,88,.477,.484,15,24,.625,25,34,59,19,18,2,10,40,108,2009
Jared Dudley,SF,23,PHO,48,0,728,91,189,.481,26,66,.394,65,123,.528,.550,56,81,.691,57,89,146,37,39,6,33,65,264,2009
Chris Duhon,PG,26,NYK,79,78,2906,287,681,.421,127,325,.391,160,356,.449,.515,179,209,.856,45,201,246,566,72,7,221,126,880,2009
Tim Duncan,C,32,SAS,75,75,2524,558,1107,.504,0,2,.000,558,1105,.505,.504,334,483,.692,201,599,800,264,38,126,165,173,1450,2009
Mike Dunleavy,SG,28,IND,18,14,495,93,232,.401,32,90,.356,61,142,.430,.470,53,65,.815,14,54,68,44,12,9,38,36,271,2009
Kevin Durant,SF,20,OKC,74,74,2885,661,1390,.476,97,230,.422,564,1160,.486,.510,452,524,.863,77,405,482,205,96,53,225,134,1871,2009
Monta Ellis,SG,23,GSW,25,25,892,194,430,.451,8,26,.308,186,404,.460,.460,78,94,.830,14,94,108,93,39,8,67,67,474,2009
Francisco Elson,C,32,MIL,59,23,977,83,169,.491,1,4,.250,82,165,.497,.494,33,39,.846,100,129,229,32,36,36,48,144,200,2009
Melvin Ely,C,30,NOH,31,4,373,37,95,.389,0,0,.000,37,95,.389,.389,23,36,.639,30,34,64,18,2,9,23,58,97,2009
Maurice Evans,SF,30,ATL,80,25,1840,208,482,.432,98,248,.395,110,234,.470,.533,60,73,.822,88,155,243,54,50,10,43,163,574,2009
Reggie Evans,PF,28,PHI,79,7,1137,79,178,.444,0,1,.000,79,177,.446,.444,104,175,.594,135,226,361,26,41,8,69,161,262,2009
Jordan Farmar,PG,22,LAL,65,0,1192,161,412,.391,49,146,.336,112,266,.421,.450,45,77,.584,22,95,117,155,57,10,87,105,416,2009
Desmon Farmer,SG,27,SAS,3,0,54,4,14,.286,3,12,.250,1,2,.500,.393,2,2,1.000,0,6,6,2,0,0,4,6,13,2009
Raymond Felton,PG,24,CHA,82,81,3086,442,1083,.408,59,207,.285,383,876,.437,.435,219,272,.805,54,256,310,553,126,30,228,191,1162,2009
Rudy Fernandez,SG,23,POR,78,4,1993,268,630,.425,159,398,.399,109,232,.470,.552,120,143,.839,47,160,207,159,69,12,86,111,815,2009
Kyrylo Fesenko,C,22,UTA,21,1,156,21,36,.583,0,0,.000,21,36,.583,.583,7,21,.333,14,23,37,4,7,15,9,35,49,2009
Michael Finley,SF,35,SAS,81,77,2336,301,689,.437,131,319,.411,170,370,.459,.532,51,62,.823,26,244,270,114,37,17,61,82,784,2009
Derek Fisher,PG,34,LAL,82,82,2441,292,688,.424,120,302,.397,172,386,.446,.512,110,130,.846,25,163,188,261,95,6,72,187,814,2009
T.J. Ford,PG,25,IND,74,49,2258,413,913,.452,35,104,.337,378,809,.467,.472,245,281,.872,59,200,259,392,89,16,180,180,1106,2009
Jeff Foster,C,32,IND,74,26,1828,177,353,.501,2,7,.286,175,346,.506,.504,96,146,.658,215,293,508,130,53,49,88,229,452,2009
Randy Foye,SG,25,MIN,70,61,2494,399,981,.407,111,308,.360,288,673,.428,.463,230,272,.846,34,180,214,303,72,26,150,201,1139,2009
Adonal Foyle,C,33,TOT,10,0,62,7,11,.636,0,0,.000,7,11,.636,.636,3,6,.500,9,17,26,1,0,8,3,5,17,2009
Adonal Foyle,C,33,ORL,9,0,59,7,11,.636,0,0,.000,7,11,.636,.636,3,6,.500,9,17,26,1,0,8,3,4,17,2009
Adonal Foyle,C,33,MEM,1,0,3,0,0,.000,0,0,.000,0,0,.000,.000,0,0,.000,0,0,0,0,0,0,0,1,0,2009
Channing Frye,PF,25,POR,63,1,746,113,267,.423,11,33,.333,102,234,.436,.444,26,36,.722,41,99,140,24,17,16,29,106,263,2009
Dan Gadzuric,C,30,MIL,67,26,941,117,244,.480,0,2,.000,117,242,.483,.480,37,68,.544,95,160,255,39,32,43,41,162,271,2009
Danilo Gallinari,SG,20,NYK,28,2,412,56,125,.448,32,72,.444,24,53,.453,.576,26,27,.963,13,42,55,15,14,4,15,48,170,2009
Francisco Garcia,SF,27,SAC,65,36,1975,295,665,.444,88,221,.398,207,444,.466,.510,146,178,.820,56,162,218,150,80,67,112,196,824,2009
Thomas Gardner,SG,23,ATL,16,0,98,9,36,.250,4,23,.174,5,13,.385,.306,2,4,.500,0,7,7,2,4,1,3,4,24,2009
Kevin Garnett,PF,32,BOS,57,57,1772,393,740,.531,2,8,.250,391,732,.534,.532,111,132,.841,78,407,485,144,63,68,90,128,899,2009
Marc Gasol,C,24,MEM,82,75,2521,350,661,.530,0,1,.000,350,660,.530,.530,275,375,.733,201,404,605,143,63,90,164,265,975,2009
Pau Gasol,C,28,LAL,81,81,2999,592,1045,.567,1,2,.500,591,1043,.567,.567,343,439,.781,262,518,780,284,52,81,157,172,1528,2009
Rudy Gay,SF,22,MEM,79,78,2945,572,1262,.453,85,242,.351,487,1020,.477,.487,264,344,.767,109,328,437,135,98,59,203,221,1493,2009
Devean George,SF,31,DAL,43,17,708,54,142,.380,22,76,.289,32,66,.485,.458,17,22,.773,25,53,78,15,23,11,17,57,147,2009
Daniel Gibson,PG,22,CLE,75,0,1795,206,527,.391,108,283,.382,98,244,.402,.493,66,86,.767,31,124,155,132,44,16,61,163,586,2009
J.R. Giddens,SF,23,BOS,6,0,8,2,3,.667,0,0,.000,2,3,.667,.667,0,0,.000,2,1,3,0,1,0,1,1,4,2009
Eddie Gill,PG,30,MIL,6,0,43,6,9,.667,2,3,.667,4,6,.667,.778,0,0,.000,0,4,4,11,3,1,5,10,14,2009
Manu Ginobili,SG,31,SAS,44,7,1181,223,491,.454,69,209,.330,154,282,.546,.524,168,190,.884,24,174,198,157,64,16,88,90,683,2009
Ryan Gomes,SF,26,MIN,82,76,2614,420,974,.431,106,285,.372,314,689,.456,.486,146,181,.807,106,286,392,135,63,22,128,183,1092,2009
Drew Gooden,PF,27,TOT,51,28,1264,237,506,.468,0,4,.000,237,502,.472,.468,131,156,.840,113,249,362,48,30,18,76,144,605,2009
Drew Gooden,PF,27,CHI,31,27,918,161,352,.457,0,3,.000,161,349,.461,.457,84,97,.866,82,184,266,43,26,14,57,103,406,2009
Drew Gooden,PF,27,SAC,1,0,26,5,9,.556,0,0,.000,5,9,.556,.556,2,2,1.000,3,10,13,2,0,0,3,2,12,2009
Drew Gooden,PF,27,SAS,19,1,320,71,145,.490,0,1,.000,71,144,.493,.490,45,57,.789,28,55,83,3,4,4,16,39,187,2009
Ben Gordon,SG,25,CHI,82,76,2999,598,1315,.455,173,422,.410,425,893,.476,.521,330,382,.864,52,231,283,279,71,22,200,184,1699,2009
Eric Gordon,SG,20,LAC,78,65,2677,411,901,.456,131,337,.389,280,564,.496,.529,299,350,.854,45,156,201,215,78,35,164,172,1252,2009
Marcin Gortat,PF,24,ORL,63,3,794,106,187,.567,1,1,1.000,105,186,.565,.570,26,45,.578,96,190,286,14,18,53,25,111,239,2009
Joey Graham,SF,26,TOR,78,10,1541,231,480,.481,3,16,.188,228,464,.491,.484,132,160,.825,95,197,292,48,35,12,74,191,597,2009
Stephen Graham,SG,26,IND,52,6,684,106,256,.414,20,66,.303,86,190,.453,.453,50,62,.806,21,75,96,33,10,4,45,82,282,2009
Danny Granger,SF,25,IND,67,66,2424,571,1277,.447,182,450,.404,389,827,.470,.518,404,460,.878,49,292,341,183,69,97,165,207,1728,2009
Aaron Gray,C,24,CHI,56,18,715,81,167,.485,0,1,.000,81,166,.488,.485,34,59,.576,84,136,220,46,14,18,40,135,196,2009
Gerald Green,SG,23,DAL,38,12,376,79,180,.439,14,46,.304,65,134,.485,.478,27,32,.844,14,40,54,15,10,5,33,51,199,2009
Jeff Green,PF,22,OKC,78,78,2873,476,1068,.446,96,247,.389,380,821,.463,.491,242,307,.788,120,399,519,155,81,33,173,202,1290,2009
Willie Green,SG,27,PHI,81,60,1828,286,658,.435,51,161,.317,235,497,.473,.473,62,85,.729,29,97,126,158,53,13,64,154,685,2009
Donte Greene,SF,20,SAC,55,4,725,77,236,.326,26,100,.260,51,136,.375,.381,29,34,.853,19,67,86,30,16,14,37,68,209,2009
Hamed Haddadi,C,23,MEM,19,0,120,15,31,.484,0,0,.000,15,31,.484,.484,18,30,.600,16,31,47,8,1,12,9,20,48,2009
Malik Hairston,SG,21,SAS,15,0,155,24,49,.490,0,1,.000,24,48,.500,.490,2,7,.286,11,17,28,13,6,7,12,19,50,2009
Richard Hamilton,SG,30,DET,67,51,2279,466,1043,.447,70,190,.368,396,853,.464,.480,223,263,.848,44,163,207,297,40,4,133,176,1225,2009
Matt Harpring,SG,32,UTA,63,2,693,111,241,.461,0,2,.000,111,239,.464,.461,55,72,.764,47,76,123,28,29,9,29,102,277,2009
Al Harrington,PF,28,TOT,73,56,2546,532,1212,.439,171,470,.364,361,742,.487,.509,234,295,.793,99,356,455,102,88,22,161,227,1469,2009
Al Harrington,PF,28,GSW,5,5,166,23,70,.329,11,28,.393,12,42,.286,.407,5,10,.500,10,18,28,10,7,0,7,14,62,2009
Al Harrington,PF,28,NYK,68,51,2380,509,1142,.446,160,442,.362,349,700,.499,.516,229,285,.804,89,338,427,92,81,22,154,213,1407,2009
Devin Harris,PG,25,NJN,69,69,2494,455,1039,.438,64,220,.291,391,819,.477,.469,496,605,.820,30,201,231,476,114,13,212,164,1470,2009
Jason Hart,PG,30,TOT,39,2,348,30,94,.319,0,6,.000,30,88,.341,.319,18,23,.783,13,33,46,48,12,4,22,39,78,2009
Jason Hart,PG,30,LAC,28,2,312,25,84,.298,0,4,.000,25,80,.313,.298,15,19,.789,12,30,42,43,12,4,19,35,65,2009
Jason Hart,PG,30,DEN,11,0,36,5,10,.500,0,2,.000,5,8,.625,.500,3,4,.750,1,3,4,5,0,0,3,4,13,2009
Udonis Haslem,PF,28,MIA,75,75,2560,333,643,.518,0,0,.000,333,643,.518,.518,128,170,.753,169,449,618,85,43,25,82,204,794,2009
Trenton Hassell,SF,29,NJN,53,31,1094,86,191,.450,2,8,.250,84,183,.459,.455,20,25,.800,50,96,146,51,21,16,30,92,194,2009
Spencer Hawes,C,20,SAC,77,51,2259,373,800,.466,40,115,.348,333,685,.486,.491,90,136,.662,148,401,549,149,44,93,160,249,876,2009
Chuck Hayes,C,25,HOU,71,1,858,42,113,.372,0,4,.000,42,109,.385,.372,7,19,.368,74,176,250,42,34,19,25,134,91,2009
Jarvis Hayes,SF,27,NJN,74,1,1832,257,577,.445,94,244,.385,163,333,.489,.527,36,52,.692,27,240,267,54,52,7,49,162,644,2009
Brendan Haywood,C,29,WAS,6,5,175,24,50,.480,0,0,.000,24,50,.480,.480,10,21,.476,13,31,44,8,4,15,9,14,58,2009
Luther Head,PG-SG,26,TOT,32,4,498,55,144,.382,20,54,.370,35,90,.389,.451,19,24,.792,6,46,52,58,17,2,25,37,149,2009
Luther Head,PG,26,HOU,22,4,322,39,101,.386,14,38,.368,25,63,.397,.455,14,16,.875,3,24,27,35,6,1,16,15,106,2009
Luther Head,SG,26,MIA,10,0,176,16,43,.372,6,16,.375,10,27,.370,.442,5,8,.625,3,22,25,23,11,1,9,22,43,2009
Walter Herrmann,SF,29,DET,59,0,630,82,207,.396,41,120,.342,41,87,.471,.495,19,25,.760,28,79,107,22,7,4,17,43,224,2009
Roy Hibbert,C,22,IND,70,42,1009,198,420,.471,0,0,.000,198,420,.471,.471,98,147,.667,115,128,243,49,20,76,55,215,494,2009
J.J. Hickson,C,20,CLE,62,0,705,100,194,.515,0,0,.000,100,194,.515,.515,45,67,.672,52,113,165,9,14,30,45,81,245,2009
Nene Hilario,C,26,DEN,77,76,2510,428,709,.604,1,5,.200,427,704,.607,.604,266,368,.723,183,415,598,108,95,101,147,278,1123,2009
George Hill,PG,22,SAS,77,7,1270,150,372,.403,24,73,.329,126,299,.421,.435,114,146,.781,30,128,158,136,45,21,74,150,438,2009
Grant Hill,SF,36,PHO,82,68,2445,390,745,.523,24,76,.316,366,669,.547,.540,181,224,.808,64,341,405,186,90,54,126,182,985,2009
Steven Hill,PF,23,OKC,1,0,2,1,1,1.000,0,0,.000,1,1,1.000,1.000,0,0,.000,2,1,3,0,0,0,0,0,2,2009
Kirk Hinrich,SG,28,CHI,51,4,1339,183,419,.437,69,169,.408,114,250,.456,.519,68,86,.791,16,107,123,197,66,19,87,126,503,2009
Ryan Hollins,C,24,TOT,45,3,444,50,94,.532,0,0,.000,50,94,.532,.532,43,72,.597,46,51,97,7,7,32,24,78,143,2009
Ryan Hollins,C,24,CHA,18,1,184,19,35,.543,0,0,.000,19,35,.543,.543,26,39,.667,19,17,36,4,3,17,10,34,64,2009
Ryan Hollins,C,24,DAL,27,2,260,31,59,.525,0,0,.000,31,59,.525,.525,17,33,.515,27,34,61,3,4,15,14,44,79,2009
Al Horford,C,22,ATL,67,67,2242,312,594,.525,0,1,.000,312,593,.526,.525,149,205,.727,145,479,624,163,53,95,103,190,773,2009
Eddie House,PG,30,BOS,81,0,1479,249,560,.445,151,340,.444,98,220,.445,.579,42,53,.792,11,146,157,92,61,7,55,113,691,2009
Dwight Howard,C,23,ORL,79,79,2821,560,979,.572,0,2,.000,560,977,.573,.572,504,849,.594,336,757,1093,112,77,231,240,270,1624,2009
Josh Howard,SF,28,DAL,52,51,1663,353,783,.451,58,168,.345,295,615,.480,.488,172,220,.782,59,204,263,83,55,30,89,135,936,2009
Juwan Howard,SF-PF,35,TOT,42,2,472,75,147,.510,0,0,.000,75,147,.510,.510,23,34,.676,30,46,76,26,7,6,26,71,173,2009
Juwan Howard,PF,35,DEN,3,0,22,1,2,.500,0,0,.000,1,2,.500,.500,0,0,.000,1,3,4,2,1,1,0,4,2,2009
Juwan Howard,SF,35,CHA,39,2,450,74,145,.510,0,0,.000,74,145,.510,.510,23,34,.676,29,43,72,24,6,5,26,67,171,2009
Larry Hughes,SF-SG,30,TOT,55,20,1479,224,557,.402,75,193,.389,149,364,.409,.469,117,145,.807,16,143,159,119,72,14,71,96,640,2009
Larry Hughes,SF,30,CHI,30,6,792,127,308,.412,40,102,.392,87,206,.422,.477,67,82,.817,6,88,94,59,36,9,36,51,361,2009
Larry Hughes,SG,30,NYK,25,14,687,97,249,.390,35,91,.385,62,158,.392,.460,50,63,.794,10,55,65,60,36,5,35,45,279,2009
Kris Humphries,SF,23,TOR,29,0,265,38,90,.422,0,0,.000,38,90,.422,.422,38,48,.792,24,46,70,10,8,6,8,31,114,2009
Lindsey Hunter,PG,38,CHI,28,0,266,27,82,.329,16,48,.333,11,34,.324,.427,3,5,.600,2,10,12,37,20,1,19,28,73,2009
Othello Hunter,PF,22,ATL,16,0,92,11,20,.550,0,0,.000,11,20,.550,.550,0,5,.000,9,15,24,1,2,5,2,11,22,2009
Andre Iguodala,SF,25,PHI,82,82,3269,542,1147,.473,80,261,.307,462,886,.521,.507,377,521,.724,92,379,471,434,131,36,222,152,1541,2009
Zydrunas Ilgauskas,C,33,CLE,65,65,1765,342,724,.472,15,39,.385,327,685,.477,.483,139,174,.799,157,333,490,64,28,84,90,183,838,2009
Didier Ilunga-Mbenga,C,28,LAL,23,0,181,27,57,.474,0,1,.000,27,56,.482,.474,7,8,.875,9,22,31,9,10,24,13,33,61,2009
Allen Iverson,PG-SG,33,TOT,57,53,2093,348,834,.417,28,99,.283,320,735,.435,.434,271,347,.781,30,143,173,283,88,6,146,86,995,2009
Allen Iverson,SG,33,DEN,3,3,123,18,40,.450,2,8,.250,16,32,.500,.475,18,25,.720,3,5,8,20,3,1,10,3,56,2009
Allen Iverson,PG,33,DET,54,50,1970,330,794,.416,26,91,.286,304,703,.432,.432,253,322,.786,27,138,165,263,85,5,136,83,939,2009
Royal Ivey,SG,27,PHI,71,0,861,69,208,.332,39,114,.342,30,94,.319,.425,34,43,.791,19,57,76,43,36,7,23,76,211,2009
Jarrett Jack,SG,25,IND,82,53,2716,386,853,.453,78,221,.353,308,632,.487,.498,224,263,.852,44,232,276,338,88,17,184,179,1074,2009
Bobby Jackson,PG,35,SAC,71,10,1484,193,485,.398,60,197,.305,133,288,.462,.460,86,101,.851,42,158,200,143,62,4,66,100,532,2009
Darnell Jackson,PF,23,CLE,51,2,430,37,86,.430,0,2,.000,37,84,.440,.430,24,35,.686,32,55,87,8,10,4,14,77,98,2009
Stephen Jackson,SF,30,GSW,59,59,2339,413,997,.414,103,305,.338,310,692,.448,.466,294,356,.826,70,233,303,381,88,31,229,153,1223,2009
Jerome James,C,33,NYK,2,0,10,3,8,.375,0,0,.000,3,8,.375,.375,0,0,.000,1,2,3,0,1,1,1,2,6,2009
LeBron James,SF,24,CLE,81,81,3054,789,1613,.489,132,384,.344,657,1229,.535,.530,594,762,.780,106,507,613,587,137,93,241,139,2304,2009
Mike James,PG,33,TOT,61,50,1649,197,514,.383,69,184,.375,128,330,.388,.450,68,82,.829,25,108,133,201,44,6,94,108,531,2009
Mike James,PG,33,NOH,8,0,74,8,25,.320,3,4,.750,5,21,.238,.380,1,2,.500,1,6,7,8,2,0,3,7,20,2009
Mike James,PG,33,WAS,53,50,1575,189,489,.387,66,180,.367,123,309,.398,.454,67,80,.838,24,102,126,193,42,6,91,101,511,2009
Antawn Jamison,PF,32,WAS,81,81,3096,674,1441,.468,112,319,.351,562,1122,.501,.507,341,452,.754,196,525,721,153,95,25,125,218,1801,2009
Marko Jaric,SG,30,MEM,53,0,605,48,145,.331,11,28,.393,37,117,.316,.369,29,41,.707,23,42,65,74,29,11,49,62,136,2009
Nathan Jawai,PF,22,TOR,6,0,19,1,4,.250,0,0,.000,1,4,.250,.250,0,0,.000,1,1,2,0,0,0,2,3,2,2009
Al Jefferson,C,24,MIN,50,50,1836,485,975,.497,0,4,.000,485,971,.499,.497,186,252,.738,172,376,548,79,39,83,92,141,1156,2009
Dontell Jefferson,SG,25,CHA,6,0,84,11,22,.500,1,2,.500,10,20,.500,.523,6,9,.667,1,11,12,9,4,1,6,9,29,2009
Richard Jefferson,SF,28,MIL,82,82,2939,537,1222,.439,116,292,.397,421,930,.453,.487,417,518,.805,57,317,374,199,66,14,165,252,1607,2009
Jared Jeffries,SF,27,NYK,56,36,1310,120,273,.440,1,12,.083,119,261,.456,.441,55,90,.611,128,103,231,80,47,33,65,153,296,2009
Yi Jianlian,PF,21,NJN,61,52,1421,191,500,.382,48,140,.343,143,360,.397,.430,95,123,.772,67,259,326,60,29,36,70,157,525,2009
Amir Johnson,PF,21,DET,62,24,911,97,163,.595,0,0,.000,97,163,.595,.595,23,35,.657,102,130,232,20,20,60,33,171,217,2009
Anthony Johnson,PG,34,ORL,80,12,1481,154,381,.404,52,133,.391,102,248,.411,.472,61,81,.753,29,118,147,200,46,5,82,111,421,2009
Joe Johnson,SG,27,ATL,79,79,3124,620,1420,.437,149,414,.360,471,1006,.468,.489,299,362,.826,65,281,346,455,84,19,195,176,1688,2009
Linton Johnson,PF,28,TOT,10,0,55,4,11,.364,1,2,.500,3,9,.333,.409,0,0,.000,3,5,8,2,1,0,2,7,9,2009
Linton Johnson,PF,28,CHA,2,0,13,0,0,.000,0,0,.000,0,0,.000,.000,0,0,.000,0,0,0,0,0,0,0,1,0,2009
Linton Johnson,PF,28,CHI,8,0,42,4,11,.364,1,2,.500,3,9,.333,.409,0,0,.000,3,5,8,2,1,0,2,6,9,2009
Trey Johnson,SG,24,CLE,4,0,14,0,5,.000,0,0,.000,0,5,.000,.000,4,4,1.000,0,1,1,0,0,0,1,4,4,2009
Dahntay Jones,SG,28,DEN,79,71,1426,154,336,.458,11,17,.647,143,319,.448,.475,110,151,.728,58,110,168,78,49,19,68,199,429,2009
Damon Jones,PG,32,MIL,18,0,108,11,34,.324,11,28,.393,0,6,.000,.485,0,0,.000,0,6,6,7,3,0,6,4,33,2009
Dwayne Jones,PF,25,CHA,6,0,52,4,7,.571,0,0,.000,4,7,.571,.571,4,6,.667,6,6,12,0,0,1,4,6,12,2009
Fred Jones,SF,29,LAC,52,21,1495,129,317,.407,54,147,.367,75,170,.441,.492,66,81,.815,23,103,126,188,53,11,66,112,378,2009
James Jones,SF,28,MIA,40,1,630,55,149,.369,33,96,.344,22,53,.415,.480,26,31,.839,12,50,62,20,12,14,12,58,169,2009
Solomon Jones,C,24,ATL,63,0,675,67,111,.604,1,2,.500,66,109,.606,.608,53,74,.716,52,90,142,15,7,34,27,125,188,2009
DeAndre Jordan,C,20,LAC,53,13,771,93,147,.633,0,0,.000,93,147,.633,.633,42,109,.385,72,165,237,11,11,59,41,96,228,2009
Chris Kaman,C,26,LAC,31,24,921,161,305,.528,0,0,.000,161,305,.528,.528,51,75,.680,75,172,247,46,17,45,84,93,373,2009
Jason Kapono,SG,27,TOR,80,12,1831,261,604,.432,98,229,.428,163,375,.435,.513,34,42,.810,26,137,163,105,22,3,70,144,654,2009
Jason Kidd,PG,35,DAL,81,81,2886,257,618,.416,131,323,.406,126,295,.427,.522,86,105,.819,85,415,500,702,160,39,185,168,731,2009
Tarence Kinsey,SG,24,CLE,50,3,277,31,69,.449,7,18,.389,24,51,.471,.500,33,38,.868,10,28,38,10,12,0,22,34,102,2009
Andrei Kirilenko,PF,27,UTA,67,10,1831,256,570,.449,20,73,.274,236,497,.475,.467,244,311,.785,84,235,319,175,83,77,121,127,776,2009
Linas Kleiza,SF,24,DEN,82,7,1824,289,646,.447,87,267,.326,202,379,.533,.515,148,204,.725,92,235,327,64,31,14,82,155,813,2009
Brevin Knight,PG,33,UTA,74,0,938,66,189,.349,0,6,.000,66,183,.361,.349,48,64,.750,13,75,88,190,68,4,66,98,180,2009
Kyle Korver,SF,27,UTA,78,2,1874,245,560,.438,103,267,.386,142,293,.485,.529,112,127,.882,35,223,258,137,47,30,90,170,705,2009
Kosta Koufos,C,19,UTA,48,7,565,94,185,.508,0,0,.000,94,185,.508,.508,36,51,.706,50,88,138,20,12,31,26,70,224,2009
Nenad Krstic,C,25,OKC,46,29,1141,191,407,.469,0,0,.000,191,407,.469,.469,63,79,.797,85,168,253,29,21,49,45,114,445,2009
Rob Kurz,SF,23,GSW,40,5,442,51,131,.389,15,38,.395,36,93,.387,.447,40,50,.800,33,48,81,20,14,19,16,78,157,2009
Carl Landry,PF,25,HOU,69,0,1467,240,418,.574,1,3,.333,239,415,.576,.575,157,193,.813,124,219,343,39,26,31,68,166,638,2009
Acie Law,PG,24,ATL,55,1,560,52,139,.374,9,29,.310,43,110,.391,.406,49,60,.817,6,52,58,86,11,3,29,43,162,2009
Courtney Lee,SG,23,ORL,77,42,1939,243,540,.450,82,203,.404,161,337,.478,.526,78,94,.830,18,160,178,91,76,14,69,157,646,2009
David Lee,C,25,NYK,81,74,2824,522,951,.549,0,3,.000,522,948,.551,.549,249,330,.755,256,695,951,174,80,22,150,260,1293,2009
Rashard Lewis,PF,29,ORL,79,79,2859,478,1089,.439,220,554,.397,258,535,.482,.540,225,269,.836,92,361,453,205,81,51,158,194,1401,2009
Shaun Livingston,PG,23,TOT,12,1,231,31,60,.517,0,0,.000,31,60,.517,.517,9,10,.900,3,25,28,20,7,2,9,12,71,2009
Shaun Livingston,PG,23,MIA,4,0,41,3,8,.375,0,0,.000,3,8,.375,.375,3,4,.750,0,2,2,4,2,0,3,4,9,2009
Shaun Livingston,PG,23,OKC,8,1,190,28,52,.538,0,0,.000,28,52,.538,.538,6,6,1.000,3,23,26,16,5,2,6,8,62,2009
Brook Lopez,C,20,NJN,82,75,2501,448,844,.531,0,2,.000,448,842,.532,.531,172,217,.793,225,440,665,86,44,151,147,257,1068,2009
Robin Lopez,C,20,PHO,60,7,614,71,137,.518,0,1,.000,71,136,.522,.518,47,68,.691,52,66,118,8,11,41,28,97,189,2009
Kevin Love,C,20,MIN,81,37,2048,316,688,.459,2,19,.105,314,669,.469,.461,265,336,.789,274,460,734,84,35,50,118,205,899,2009
Kyle Lowry,PG,22,TOT,77,21,1679,189,434,.435,25,98,.255,164,336,.488,.464,181,226,.801,26,163,189,275,69,17,117,146,584,2009
Kyle Lowry,PG,22,MEM,49,21,1071,112,272,.412,17,69,.246,95,203,.468,.443,129,161,.801,13,98,111,178,48,8,79,89,370,2009
Kyle Lowry,PG,22,HOU,28,0,608,77,162,.475,8,29,.276,69,133,.519,.500,52,65,.800,13,65,78,97,21,9,38,57,214,2009
Tyronn Lue,PG,31,TOT,44,0,521,71,162,.438,27,62,.435,44,100,.440,.522,14,19,.737,6,40,46,60,8,0,23,54,183,2009
Tyronn Lue,PG,31,MIL,30,0,392,54,119,.454,21,45,.467,33,74,.446,.542,12,16,.750,6,29,35,46,6,0,21,41,141,2009
Tyronn Lue,PG,31,ORL,14,0,129,17,43,.395,6,17,.353,11,26,.423,.465,2,3,.667,0,11,11,14,2,0,2,13,42,2009
Mark Madsen,C,33,MIN,19,1,116,3,14,.214,0,0,.000,3,14,.214,.214,0,4,.000,10,8,18,4,1,1,3,18,6,2009
Corey Maggette,PF,29,GSW,51,19,1588,292,634,.461,24,95,.253,268,539,.497,.479,342,415,.824,49,233,282,92,44,8,120,192,950,2009
Jamaal Magloire,C,30,MIA,55,12,709,65,131,.496,0,0,.000,65,131,.496,.496,29,60,.483,82,140,222,22,11,25,32,121,159,2009
Stephon Marbury,PG,31,BOS,23,4,414,38,111,.342,6,25,.240,32,86,.372,.369,6,13,.462,2,26,28,75,10,3,37,34,88,2009
Shawn Marion,SF,30,TOT,69,68,2470,382,788,.485,10,53,.189,372,735,.506,.491,117,147,.796,180,409,589,139,88,66,105,132,891,2009
Shawn Marion,SF,30,MIA,42,41,1516,215,446,.482,8,40,.200,207,406,.510,.491,67,85,.788,107,258,365,77,57,45,56,92,505,2009
Shawn Marion,SF,30,TOR,27,27,954,167,342,.488,2,13,.154,165,329,.502,.491,50,62,.806,73,151,224,62,31,21,49,40,386,2009
Sean Marks,C,33,NOH,60,5,838,80,165,.485,2,10,.200,78,155,.503,.491,30,44,.682,62,125,187,14,7,33,35,121,192,2009
Donyell Marshall,PF,35,PHI,25,0,189,33,73,.452,25,55,.455,8,18,.444,.623,3,6,.500,6,34,40,15,4,5,6,24,94,2009
Cartier Martin,SF,24,CHA,33,1,266,28,77,.364,10,33,.303,18,44,.409,.429,20,25,.800,7,26,33,13,8,4,9,33,86,2009
Kenyon Martin,PF,31,DEN,66,66,2111,318,648,.491,14,38,.368,304,610,.498,.502,119,197,.604,81,314,395,132,96,74,104,201,769,2009
Kevin Martin,SG,25,SAC,51,46,1947,341,811,.420,115,277,.415,226,534,.423,.491,457,527,.867,29,154,183,138,61,8,146,116,1254,2009
Desmond Mason,SG,31,OKC,39,19,1064,124,285,.435,0,3,.000,124,282,.440,.435,46,85,.541,41,116,157,46,15,30,56,96,294,2009
Roger Mason,SG,28,SAS,82,71,2496,349,822,.425,166,394,.421,183,428,.428,.526,105,118,.890,16,235,251,173,40,12,100,160,969,2009
Jason Maxiell,C,25,DET,78,4,1408,184,320,.575,0,1,.000,184,319,.577,.575,84,158,.532,169,155,324,24,25,63,45,157,452,2009
Sean May,PF,24,CHA,24,12,301,39,98,.398,1,1,1.000,38,97,.392,.403,14,20,.700,20,49,69,10,5,4,26,32,93,2009
O.J. Mayo,SG,21,MEM,82,82,3120,562,1283,.438,145,378,.384,417,905,.461,.495,247,281,.879,56,252,308,262,91,13,226,204,1516,2009
Luc Mbah a Moute,PF,22,MIL,82,52,2114,227,491,.462,0,4,.000,227,487,.466,.462,140,192,.729,189,298,487,87,87,45,100,204,594,2009
Rashad McCants,SG,24,TOT,58,3,1101,192,488,.393,63,189,.333,129,299,.431,.458,107,141,.759,21,89,110,68,47,14,64,103,554,2009
Rashad McCants,SG,24,MIN,34,2,636,105,292,.360,38,119,.319,67,173,.387,.425,60,81,.741,11,52,63,32,27,6,45,63,308,2009
Rashad McCants,SG,24,SAC,24,1,465,87,196,.444,25,70,.357,62,126,.492,.508,47,60,.783,10,37,47,36,20,8,19,40,246,2009
Antonio McDyess,PF,34,DET,62,30,1866,268,525,.510,0,0,.000,268,525,.510,.510,60,86,.698,185,422,607,83,41,50,51,191,596,2009
JaVale McGee,C,21,WAS,75,14,1143,191,387,.494,0,0,.000,191,387,.494,.494,107,162,.660,120,174,294,23,33,75,61,155,489,2009
Tracy McGrady,SG,29,HOU,35,35,1181,188,485,.388,44,117,.376,144,368,.391,.433,125,156,.801,20,134,154,175,42,15,69,38,545,2009
Dominic McGuire,SF,23,WAS,79,57,2072,140,324,.432,2,4,.500,138,320,.431,.435,74,102,.725,113,315,428,198,62,74,92,153,356,2009
Josh McRoberts,PF,21,IND,33,0,279,35,83,.422,0,10,.000,35,73,.479,.422,10,13,.769,26,48,74,16,12,16,12,41,80,2009
Pops Mensah-Bonsu,PF,25,TOT,22,0,283,39,103,.379,0,2,.000,39,101,.386,.379,33,48,.688,55,58,113,6,9,5,19,43,111,2009
Pops Mensah-Bonsu,PF,25,SAS,3,0,20,5,7,.714,0,0,.000,5,7,.714,.714,5,7,.714,5,5,10,0,1,1,2,6,15,2009
Pops Mensah-Bonsu,PF,25,TOR,19,0,263,34,96,.354,0,2,.000,34,94,.362,.354,28,41,.683,50,53,103,6,8,4,17,37,96,2009
Chris Mihm,C,29,LAL,18,0,105,15,40,.375,0,0,.000,15,40,.375,.375,6,7,.857,15,19,34,10,1,6,10,23,36,2009
C.J. Miles,SG,21,UTA,72,72,1623,258,562,.459,63,179,.352,195,383,.509,.515,78,89,.876,45,122,167,107,46,15,64,187,657,2009
Darius Miles,SF,27,MEM,34,0,298,48,99,.485,1,6,.167,47,93,.505,.490,23,31,.742,19,38,57,17,11,20,21,32,120,2009
Darko Milicic,C,23,MEM,61,15,1034,137,266,.515,0,0,.000,137,266,.515,.515,59,105,.562,83,181,264,34,22,51,48,134,333,2009
Andre Miller,PG,32,PHI,82,82,2976,492,1041,.473,15,53,.283,477,988,.483,.480,338,409,.826,123,245,368,534,109,14,199,196,1337,2009
Brad Miller,C,32,TOT,70,43,2100,292,614,.476,23,56,.411,269,558,.482,.494,224,272,.824,150,395,545,234,52,36,130,223,831,2009
Brad Miller,C,32,SAC,43,43,1354,184,388,.474,20,43,.465,164,345,.475,.500,125,156,.801,83,261,344,148,30,24,83,135,513,2009
Brad Miller,C,32,CHI,27,0,746,108,226,.478,3,13,.231,105,213,.493,.485,99,116,.853,67,134,201,86,22,12,47,88,318,2009
Mike Miller,SF,28,MIN,73,47,2356,264,548,.482,85,225,.378,179,323,.554,.559,109,149,.732,73,410,483,326,30,31,145,139,722,2009
Paul Millsap,PF,23,UTA,76,38,2290,400,749,.534,0,4,.000,400,745,.537,.534,228,326,.699,251,403,654,138,78,73,129,288,1028,2009
Yao Ming,C,28,HOU,77,77,2589,566,1032,.548,1,1,1.000,565,1031,.548,.549,381,440,.866,204,557,761,137,30,150,234,257,1514,2009
Cuttino Mobley,SG,33,LAC,11,11,365,63,146,.432,12,35,.343,51,111,.459,.473,13,18,.722,9,20,29,12,15,2,18,21,151,2009
Nazr Mohammed,C,31,CHA,39,1,341,41,101,.406,0,0,.000,41,101,.406,.406,22,40,.550,35,44,79,8,5,16,23,63,104,2009
Jamario Moon,SF,28,TOT,80,60,2068,222,474,.468,65,183,.355,157,291,.540,.537,68,80,.850,58,307,365,95,86,60,43,133,577,2009
Jamario Moon,SF,28,TOR,54,39,1379,150,317,.473,38,110,.345,112,207,.541,.533,55,65,.846,48,201,249,70,65,44,31,85,393,2009
Jamario Moon,SF,28,MIA,26,21,689,72,157,.459,27,73,.370,45,84,.536,.545,13,15,.867,10,106,116,25,21,16,12,48,184,2009
Mikki Moore,PF-C,33,TOT,70,20,1202,114,206,.553,0,0,.000,114,206,.553,.553,48,61,.787,76,182,258,53,17,19,48,208,276,2009
Mikki Moore,PF,33,SAC,46,20,746,63,121,.521,0,0,.000,63,121,.521,.521,34,42,.810,45,107,152,28,13,14,27,112,160,2009
Mikki Moore,C,33,BOS,24,0,456,51,85,.600,0,0,.000,51,85,.600,.600,14,19,.737,31,75,106,25,4,5,21,96,116,2009
Randolph Morris,C,23,ATL,23,0,89,7,17,.412,0,0,.000,7,17,.412,.412,4,4,1.000,4,16,20,2,2,1,7,25,18,2009
Adam Morrison,SF,24,TOT,52,5,711,80,223,.359,32,96,.333,48,127,.378,.430,17,23,.739,18,62,80,41,9,4,32,77,209,2009
Adam Morrison,SF,24,CHA,44,5,667,76,211,.360,31,92,.337,45,119,.378,.434,16,21,.762,16,56,72,38,9,4,29,73,199,2009
Adam Morrison,SF,24,LAL,8,0,44,4,12,.333,1,4,.250,3,8,.375,.375,1,2,.500,2,6,8,3,0,0,3,4,10,2009
Anthony Morrow,SG,23,GSW,67,17,1515,255,534,.478,86,184,.467,169,350,.483,.558,80,92,.870,78,121,199,80,36,12,52,130,676,2009
Troy Murphy,PF,28,IND,73,73,2482,364,767,.475,161,358,.450,203,409,.496,.580,152,184,.826,146,715,861,172,58,34,114,226,1041,2009
Ronald Murray,SG,29,ATL,80,2,1975,355,795,.447,87,242,.360,268,553,.485,.501,177,233,.760,22,146,168,158,88,17,128,173,974,2009
Dikembe Mutombo,C,42,HOU,9,2,96,5,13,.385,0,0,.000,5,13,.385,.385,6,9,.667,12,21,33,0,0,11,6,11,16,2009
Eduardo Najera,PF,32,NJN,27,0,319,33,74,.446,5,25,.200,28,49,.571,.480,8,22,.364,17,50,67,19,10,4,18,50,79,2009
Steve Nash,PG,34,PHO,74,74,2484,428,851,.503,108,246,.439,320,605,.529,.566,196,210,.933,19,204,223,717,55,10,248,108,1160,2009
DeMarcus Nelson,PG,23,GSW,13,5,171,24,54,.444,0,3,.000,24,51,.471,.444,5,14,.357,6,18,24,13,9,2,15,24,53,2009
Jameer Nelson,PG,26,ORL,42,42,1309,267,531,.503,82,181,.453,185,350,.529,.580,86,97,.887,20,125,145,226,51,3,83,123,702,2009
Rasho Nesterovic,C,32,IND,70,19,1214,224,437,.513,0,1,.000,224,436,.514,.513,25,32,.781,93,147,240,109,30,38,63,171,473,2009
Demetris Nichols,SF,24,TOT,4,0,14,3,9,.333,0,2,.000,3,7,.429,.333,1,2,.500,0,2,2,1,0,1,0,1,7,2009
Demetris Nichols,SF,24,CHI,2,0,5,1,4,.250,0,1,.000,1,3,.333,.250,0,0,.000,0,0,0,1,0,0,0,1,2,2009
Demetris Nichols,SF,24,NYK,2,0,9,2,5,.400,0,1,.000,2,4,.500,.400,1,2,.500,0,2,2,0,0,1,0,0,5,2009
Joakim Noah,C,23,CHI,80,55,1938,207,372,.556,0,1,.000,207,371,.558,.556,123,182,.676,244,362,606,106,49,110,82,238,537,2009
Andres Nocioni,PF-SF,29,TOT,76,18,1991,299,701,.427,124,311,.399,175,390,.449,.515,145,183,.792,54,307,361,102,39,33,113,261,867,2009
Andres Nocioni,PF,29,CHI,53,2,1278,186,449,.414,79,209,.378,107,240,.446,.502,100,124,.806,34,188,222,60,26,16,73,176,551,2009
Andres Nocioni,SF,29,SAC,23,16,713,113,252,.448,45,102,.441,68,150,.453,.538,45,59,.763,20,119,139,42,13,17,40,85,316,2009
Steve Novak,PF,25,LAC,71,3,1161,176,396,.444,119,286,.416,57,110,.518,.595,21,23,.913,19,106,125,40,20,5,23,71,492,2009
Dirk Nowitzki,PF,30,DAL,81,81,3050,774,1616,.479,61,170,.359,713,1446,.493,.498,485,545,.890,88,593,681,197,61,63,157,176,2094,2009
Patrick O'Bryant,C,22,TOT,39,3,255,45,84,.536,0,2,.000,45,82,.549,.536,11,20,.550,13,53,66,11,6,19,22,61,101,2009
Patrick O'Bryant,C,22,BOS,26,0,108,16,31,.516,0,0,.000,16,31,.516,.516,8,12,.667,7,27,34,8,3,8,17,29,40,2009
Patrick O'Bryant,C,22,TOR,13,3,147,29,53,.547,0,2,.000,29,51,.569,.547,3,8,.375,6,26,32,3,3,11,5,32,61,2009
Jermaine O'Neal,C,30,TOT,68,61,2027,365,770,.474,0,1,.000,365,769,.475,.474,175,222,.788,126,307,433,122,29,136,144,211,905,2009
Jermaine O'Neal,C,30,TOR,41,34,1216,220,465,.473,0,1,.000,220,464,.474,.473,115,142,.810,71,217,288,67,18,82,92,130,555,2009
Jermaine O'Neal,C,30,MIA,27,27,811,145,305,.475,0,0,.000,145,305,.475,.475,60,80,.750,55,90,145,55,11,54,52,81,350,2009
Shaquille O'Neal,C,36,PHO,75,75,2252,512,841,.609,0,1,.000,512,840,.610,.609,309,519,.595,187,446,633,126,49,108,168,253,1333,2009
Fabricio Oberto,C,33,SAS,54,11,677,61,104,.587,0,1,.000,61,103,.592,.587,20,35,.571,65,77,142,59,7,11,38,95,142,2009
Greg Oden,C,21,POR,61,39,1314,198,351,.564,0,0,.000,198,351,.564,.564,144,226,.637,169,255,424,31,25,69,87,238,540,2009
Lamar Odom,PF,29,LAL,78,32,2316,346,703,.492,33,103,.320,313,600,.522,.516,160,257,.623,176,461,637,204,77,98,138,235,885,2009
Emeka Okafor,C,26,CHA,82,81,2691,433,772,.561,0,0,.000,433,772,.561,.561,219,369,.593,275,552,827,53,48,136,144,247,1085,2009
Mehmet Okur,C,29,UTA,72,72,2409,431,888,.485,90,202,.446,341,686,.497,.536,273,334,.817,124,433,557,120,54,53,132,219,1225,2009
Kevin Ollie,PG,36,MIN,50,21,850,61,150,.407,0,1,.000,61,149,.409,.407,80,96,.833,13,62,75,117,19,4,34,79,202,2009
Travis Outlaw,SF,24,POR,81,6,2246,385,850,.453,89,236,.377,296,614,.482,.505,175,242,.723,70,261,331,83,47,57,94,168,1034,2009
Zaza Pachulia,C,24,ATL,77,26,1473,159,320,.497,0,3,.000,159,317,.502,.497,163,230,.709,173,263,436,57,35,26,91,208,481,2009
Anthony Parker,SG,33,TOR,80,71,2637,321,754,.426,94,241,.390,227,513,.442,.488,121,145,.834,45,272,317,269,100,15,114,145,857,2009
Tony Parker,PG,26,SAS,72,71,2456,639,1263,.506,19,65,.292,620,1198,.518,.513,284,363,.782,27,196,223,496,67,4,186,110,1581,2009
Chris Paul,PG,23,NOH,78,78,3002,631,1255,.503,64,176,.364,567,1079,.525,.528,455,524,.868,69,363,432,861,216,10,231,212,1781,2009
Sasha Pavlovic,SF,25,CLE,66,12,1053,116,275,.422,48,117,.410,68,158,.430,.509,25,54,.463,31,96,127,72,22,16,48,122,305,2009
Oleksiy Pecherov,C,23,WAS,32,0,277,39,101,.386,14,43,.326,25,58,.431,.455,24,29,.828,35,41,76,2,6,3,10,34,116,2009
Kendrick Perkins,C,24,BOS,76,76,2253,276,478,.577,0,2,.000,276,476,.580,.577,96,160,.600,204,415,619,96,22,150,165,253,648,2009
Morris Peterson,SG,31,NOH,43,9,515,73,183,.399,33,85,.388,40,98,.408,.489,12,19,.632,13,71,84,16,15,2,15,51,191,2009
Johan Petro,C,23,TOT,49,22,559,73,176,.415,0,2,.000,73,174,.420,.415,16,29,.552,42,116,158,16,19,15,28,107,162,2009
Johan Petro,C,23,OKC,22,12,342,46,113,.407,0,1,.000,46,112,.411,.407,10,15,.667,27,68,95,6,16,5,15,51,102,2009
Johan Petro,C,23,DEN,27,10,217,27,63,.429,0,1,.000,27,62,.435,.429,6,14,.429,15,48,63,10,3,10,13,56,60,2009
Paul Pierce,SF,31,BOS,81,81,3035,540,1181,.457,119,304,.391,421,877,.480,.508,459,553,.830,56,401,457,294,80,27,228,215,1658,2009
Mickael Pietrus,SG,26,ORL,54,25,1329,176,426,.413,80,223,.359,96,203,.473,.507,78,110,.709,44,132,176,65,31,24,56,126,510,2009
James Posey,SG,32,NOH,75,0,2140,216,524,.412,116,314,.369,100,210,.476,.523,120,146,.822,38,324,362,82,58,21,79,216,668,2009
Leon Powe,PF,25,BOS,70,7,1227,177,338,.524,0,0,.000,177,338,.524,.524,184,267,.689,145,200,345,46,24,38,76,192,538,2009
Josh Powell,PF,26,LAL,60,1,703,106,239,.444,0,0,.000,106,239,.444,.444,38,50,.760,71,105,176,27,9,17,51,98,250,2009
Ronnie Price,PG,25,UTA,52,17,738,77,203,.379,19,61,.311,58,142,.408,.426,34,45,.756,12,57,69,108,39,5,61,74,207,2009
Tayshaun Prince,SF,28,DET,82,82,3057,459,1020,.450,56,141,.397,403,879,.458,.477,189,243,.778,128,348,476,253,44,51,101,104,1163,2009
Gabe Pruitt,SG,22,BOS,47,0,366,31,101,.307,14,48,.292,17,53,.321,.376,17,21,.810,9,34,43,39,15,3,19,34,93,2009
Joel Przybilla,C,29,POR,82,43,1952,168,269,.625,0,1,.000,168,268,.627,.625,112,169,.663,204,513,717,27,34,97,78,215,448,2009
Chris Quinn,PG,25,MIA,66,0,962,118,289,.408,56,137,.409,62,152,.408,.505,47,58,.810,8,67,75,132,24,2,33,79,339,2009
Vladimir Radmanovic,SF,28,TOT,78,31,1445,196,466,.421,105,262,.401,91,204,.446,.533,43,58,.741,45,177,222,81,46,15,98,111,540,2009
Vladimir Radmanovic,SF,28,LAL,46,28,771,95,214,.444,60,136,.441,35,78,.449,.584,23,27,.852,18,99,117,38,28,7,47,51,273,2009
Vladimir Radmanovic,SF,28,CHA,32,3,674,101,252,.401,45,126,.357,56,126,.444,.490,20,31,.645,27,78,105,43,18,8,51,60,267,2009
Anthony Randolph,PF,19,GSW,63,22,1129,199,431,.462,0,4,.000,199,427,.466,.462,101,141,.716,128,235,363,49,42,74,80,141,499,2009
Shavlik Randolph,PF,25,POR,10,0,37,8,13,.615,1,1,1.000,7,12,.583,.654,1,4,.250,10,8,18,0,0,1,6,4,18,2009
Zach Randolph,PF-C,27,TOT,50,45,1757,415,873,.475,32,97,.330,383,776,.494,.494,179,244,.734,157,347,504,103,43,16,114,133,1041,2009
Zach Randolph,C,27,NYK,11,11,388,82,189,.434,7,24,.292,75,165,.455,.452,55,67,.821,40,97,137,15,13,3,23,28,226,2009
Zach Randolph,PF,27,LAC,39,34,1369,333,684,.487,25,73,.342,308,611,.504,.505,124,177,.701,117,250,367,88,30,13,91,105,815,2009
Theo Ratliff,C,35,PHI,46,0,579,34,64,.531,0,0,.000,34,64,.531,.531,21,35,.600,46,82,128,9,17,47,14,77,89,2009
Michael Redd,SG,29,MIL,33,32,1203,249,547,.455,70,191,.366,179,356,.503,.519,131,161,.814,24,83,107,88,35,2,53,45,699,2009
J.J. Redick,SG,24,ORL,64,5,1111,117,299,.391,67,179,.374,50,120,.417,.503,81,93,.871,8,101,109,73,21,1,54,72,382,2009
Jason Richardson,SG,28,TOT,72,71,2410,465,974,.477,129,325,.397,336,649,.518,.544,153,199,.769,77,242,319,146,76,28,95,146,1212,2009
Jason Richardson,SG,28,CHA,14,14,491,97,220,.441,27,59,.458,70,161,.435,.502,41,55,.745,13,45,58,36,14,3,24,43,262,2009
Jason Richardson,SG,28,PHO,58,57,1919,368,754,.488,102,266,.383,266,488,.545,.556,112,144,.778,64,197,261,110,62,25,71,103,950,2009
Jeremy Richardson,SF,24,ORL,12,0,93,14,49,.286,6,17,.353,8,32,.250,.347,3,6,.500,1,13,14,3,0,0,3,6,37,2009
Quentin Richardson,SG,28,NYK,72,51,1894,262,667,.393,120,329,.365,142,338,.420,.483,89,117,.761,71,248,319,117,47,7,74,132,733,2009
Luke Ridnour,PG,27,MIL,72,50,2033,250,621,.403,55,157,.350,195,464,.420,.447,133,153,.869,33,185,218,365,92,16,128,200,688,2009
Anthony Roberson,PG,25,TOT,29,0,276,44,120,.367,26,81,.321,18,39,.462,.475,5,5,1.000,6,16,22,20,10,1,8,18,119,2009
Anthony Roberson,PG,25,NYK,23,0,253,39,103,.379,24,71,.338,15,32,.469,.495,5,5,1.000,4,11,15,19,10,1,7,18,107,2009
Anthony Roberson,PG,25,CHI,6,0,23,5,17,.294,2,10,.200,3,7,.429,.353,0,0,.000,2,5,7,1,0,0,1,0,12,2009
Nate Robinson,PG,24,NYK,74,11,2209,449,1028,.437,125,385,.325,324,643,.504,.498,249,296,.841,98,192,290,301,95,6,139,206,1272,2009
Sergio Rodriguez,PG,22,POR,80,13,1225,129,329,.392,37,114,.325,92,215,.428,.448,61,77,.792,43,87,130,286,54,2,119,133,356,2009
Rajon Rondo,PG,22,BOS,80,80,2642,383,759,.505,15,48,.313,368,711,.518,.514,172,268,.642,100,316,416,659,149,11,209,193,953,2009
Derrick Rose,PG,20,CHI,81,80,3000,574,1208,.475,16,72,.222,558,1136,.491,.482,197,250,.788,96,221,317,512,66,18,202,125,1361,2009
Malik Rose,SF-PF,34,TOT,38,0,470,45,131,.344,0,7,.000,45,124,.363,.344,40,51,.784,17,79,96,36,10,3,36,72,130,2009
Malik Rose,PF,34,NYK,18,0,160,11,41,.268,0,4,.000,11,37,.297,.268,8,11,.727,4,27,31,10,1,1,17,24,30,2009
Malik Rose,SF,34,OKC,20,0,310,34,90,.378,0,3,.000,34,87,.391,.378,32,40,.800,13,52,65,26,9,2,19,48,100,2009
Quinton Ross,SF,27,MEM,68,7,1164,99,259,.382,33,88,.375,66,171,.386,.446,34,42,.810,29,97,126,47,32,14,36,114,265,2009
Brandon Roy,SG,24,POR,78,78,2903,633,1318,.480,83,220,.377,550,1098,.501,.512,416,505,.824,104,266,370,400,88,22,152,127,1765,2009
Michael Ruffin,PF,32,POR,11,0,35,2,7,.286,0,0,.000,2,7,.286,.286,2,2,1.000,6,5,11,0,3,1,2,7,6,2009
Brandon Rush,SG,23,IND,75,19,1803,243,575,.423,78,209,.373,165,366,.451,.490,46,66,.697,34,199,233,66,38,37,75,128,610,2009
Kareem Rush,SG,28,PHI,25,1,199,20,58,.345,10,33,.303,10,25,.400,.431,4,4,1.000,0,15,15,15,5,1,10,10,54,2009
John Salmons,SF,29,TOT,79,74,2959,516,1093,.472,126,302,.417,390,791,.493,.530,288,347,.830,59,274,333,249,83,24,165,182,1446,2009
John Salmons,SF,29,SAC,53,53,1980,351,744,.472,77,184,.418,274,560,.489,.524,191,232,.823,43,178,221,196,58,9,122,122,970,2009
John Salmons,SF,29,CHI,26,21,979,165,349,.473,49,118,.415,116,231,.502,.543,97,115,.843,16,96,112,53,25,15,43,60,476,2009
Cheikh Samb,C,24,TOT,18,0,83,6,32,.188,0,3,.000,6,29,.207,.188,3,7,.429,10,14,24,1,3,10,3,7,15,2009
Cheikh Samb,C,24,DEN,6,0,24,2,13,.154,0,1,.000,2,12,.167,.154,0,0,.000,2,7,9,1,2,5,2,4,4,2009
Cheikh Samb,C,24,LAC,10,0,51,4,16,.250,0,2,.000,4,14,.286,.250,3,5,.600,7,6,13,0,1,5,1,3,11,2009
Cheikh Samb,C,24,NYK,2,0,8,0,3,.000,0,0,.000,0,3,.000,.000,0,2,.000,1,1,2,0,0,0,0,0,0,2009
Brian Scalabrine,C,30,BOS,39,8,504,48,114,.421,24,61,.393,24,53,.453,.526,16,18,.889,7,43,50,18,7,10,12,73,136,2009
Luis Scola,PF,28,HOU,82,82,2488,424,799,.531,0,3,.000,424,796,.533,.531,196,258,.760,200,520,720,123,68,11,123,261,1044,2009
Thabo Sefolosha,SF-SG,24,TOT,66,36,1453,152,357,.426,24,87,.276,128,270,.474,.459,61,73,.836,54,188,242,111,75,45,64,104,389,2009
Thabo Sefolosha,SF,24,CHI,43,14,735,79,182,.434,15,50,.300,64,132,.485,.475,21,25,.840,26,97,123,65,35,19,37,50,194,2009
Thabo Sefolosha,SG,24,OKC,23,22,718,73,175,.417,9,37,.243,64,138,.464,.443,40,48,.833,28,91,119,46,40,26,27,54,195,2009
Mouhamed Sene,C,22,TOT,6,0,29,6,9,.667,0,0,.000,6,9,.667,.667,8,10,.800,5,9,14,0,1,3,4,2,20,2009
Mouhamed Sene,C,22,OKC,5,0,23,5,7,.714,0,0,.000,5,7,.714,.714,7,9,.778,3,6,9,0,1,2,3,2,17,2009
Mouhamed Sene,C,22,NYK,1,0,6,1,2,.500,0,0,.000,1,2,.500,.500,1,1,1.000,2,3,5,0,0,1,1,0,3,2009
Ramon Sessions,PG,22,MIL,79,39,2173,345,775,.445,6,34,.176,339,741,.457,.449,281,354,.794,64,205,269,452,83,7,152,158,977,2009
Walter Sharpe,PF,22,DET,8,0,20,4,11,.364,0,2,.000,4,9,.444,.364,0,2,.000,0,3,3,0,0,2,0,3,8,2009
Bobby Simmons,SF,28,NJN,71,44,1729,198,441,.449,117,262,.447,81,179,.453,.582,43,58,.741,72,205,277,92,50,10,62,186,556,2009
Cedric Simmons,PF,23,TOT,18,0,84,11,25,.440,0,0,.000,11,25,.440,.440,7,16,.438,5,11,16,2,1,4,2,8,29,2009
Cedric Simmons,PF,23,CHI,11,0,61,11,21,.524,0,0,.000,11,21,.524,.524,6,14,.429,4,8,12,2,1,4,0,6,28,2009
Cedric Simmons,PF,23,SAC,7,0,23,0,4,.000,0,0,.000,0,4,.000,.000,1,2,.500,1,3,4,0,0,0,2,2,1,2009
Courtney Sims,C,25,TOT,2,0,13,3,6,.500,0,0,.000,3,6,.500,.500,0,0,.000,2,2,4,0,0,0,1,1,6,2009
Courtney Sims,C,25,PHO,1,0,2,0,0,.000,0,0,.000,0,0,.000,.000,0,0,.000,0,0,0,0,0,0,1,0,0,2009
Courtney Sims,C,25,NYK,1,0,11,3,6,.500,0,0,.000,3,6,.500,.500,0,0,.000,2,2,4,0,0,0,0,1,6,2009
Sean Singletary,PG,23,TOT,37,2,303,31,85,.365,10,25,.400,21,60,.350,.424,18,21,.857,10,25,35,29,11,0,23,45,90,2009
Sean Singletary,PG,23,PHO,13,1,122,12,37,.324,4,10,.400,8,27,.296,.378,6,6,1.000,5,11,16,12,6,0,5,14,34,2009
Sean Singletary,PG,23,CHA,24,1,181,19,48,.396,6,15,.400,13,33,.394,.458,12,15,.800,5,14,19,17,5,0,18,31,56,2009
James Singleton,PF,27,DAL,62,6,884,117,221,.529,13,40,.325,104,181,.575,.559,67,78,.859,89,161,250,17,26,28,36,110,314,2009
Brian Skinner,PF,32,LAC,51,21,843,92,205,.449,0,2,.000,92,203,.453,.449,30,47,.638,72,131,203,27,17,52,43,94,214,2009
Craig Smith,PF,25,MIN,74,31,1460,289,514,.562,0,1,.000,289,513,.563,.562,168,248,.677,98,186,284,79,31,19,105,184,746,2009
J.R. Smith,SG,23,DEN,81,18,2245,424,950,.446,180,453,.397,244,497,.491,.541,205,272,.754,43,254,297,227,78,14,150,190,1233,2009
Joe Smith,C,33,TOT,57,3,1102,156,333,.468,3,7,.429,153,326,.469,.473,59,82,.720,89,174,263,41,17,40,25,122,374,2009
Joe Smith,C,33,OKC,36,3,691,99,218,.454,2,4,.500,97,214,.453,.459,38,54,.704,53,110,163,25,10,26,15,72,238,2009
Joe Smith,C,33,CLE,21,0,411,57,115,.496,1,3,.333,56,112,.500,.500,21,28,.750,36,64,100,16,7,14,10,50,136,2009
Josh Smith,PF,23,ATL,69,69,2421,418,849,.492,26,87,.299,392,762,.514,.508,211,359,.588,134,364,498,169,94,111,161,184,1073,2009
Will Solomon,PG,30,TOT,53,9,712,105,245,.429,28,86,.326,77,159,.484,.486,25,34,.735,12,52,64,133,27,4,54,71,263,2009
Will Solomon,PG,30,TOR,39,9,544,79,181,.436,15,57,.263,64,124,.516,.478,20,24,.833,9,34,43,123,20,4,49,60,193,2009
Will Solomon,PG,30,SAC,14,0,168,26,64,.406,13,29,.448,13,35,.371,.508,5,10,.500,3,18,21,10,7,0,5,11,70,2009
Darius Songaila,C,30,WAS,77,29,1521,243,457,.532,0,1,.000,243,456,.533,.532,80,90,.889,75,152,227,94,64,20,74,200,566,2009
Marreese Speights,C,21,PHI,79,2,1263,252,502,.502,2,8,.250,250,494,.506,.504,102,132,.773,123,170,293,30,27,56,46,181,608,2009
Jerry Stackhouse,SG,34,DAL,10,1,162,16,60,.267,3,19,.158,13,41,.317,.292,7,7,1.000,5,12,17,12,4,1,9,6,42,2009
DeShawn Stevenson,SG,27,WAS,32,25,886,72,231,.312,35,129,.271,37,102,.363,.387,32,60,.533,11,65,76,98,21,2,32,43,211,2009
Peja Stojakovic,SF,31,NOH,61,59,2089,287,719,.399,145,384,.378,142,335,.424,.500,93,104,.894,44,220,264,75,52,3,51,101,812,2009
Amar'e Stoudemire,PF,26,PHO,53,53,1948,404,749,.539,3,7,.429,401,742,.540,.541,323,387,.835,116,314,430,104,49,57,150,163,1134,2009
Rodney Stuckey,PG,22,DET,79,65,2517,401,913,.439,23,78,.295,378,835,.453,.452,233,290,.803,69,206,275,387,78,11,173,217,1058,2009
Robert Swift,C,23,OKC,26,10,343,37,71,.521,0,0,.000,37,71,.521,.521,12,16,.750,21,68,89,9,5,17,8,50,86,2009
Stromile Swift,PF,29,TOT,19,0,185,24,56,.429,1,1,1.000,23,55,.418,.438,13,26,.500,16,30,46,3,4,8,16,40,62,2009
Stromile Swift,PF,29,NJN,6,0,64,9,15,.600,0,0,.000,9,15,.600,.600,5,11,.455,5,8,13,1,0,2,7,15,23,2009
Stromile Swift,PF,29,PHO,13,0,121,15,41,.366,1,1,1.000,14,40,.350,.378,8,15,.533,11,22,33,2,4,6,9,25,39,2009
Wally Szczerbiak,SF,31,CLE,74,5,1527,179,398,.450,69,168,.411,110,230,.478,.536,90,106,.849,43,189,232,82,28,10,55,130,517,2009
Mike Taylor,PG,23,LAC,51,5,771,110,267,.412,13,40,.325,97,227,.427,.436,56,81,.691,22,65,87,106,36,0,73,84,289,2009
Sebastian Telfair,PG,23,MIN,75,43,2095,267,697,.383,73,211,.346,194,486,.399,.435,131,160,.819,32,95,127,343,73,12,146,184,738,2009
Jason Terry,SG,31,DAL,74,11,2491,541,1168,.463,167,456,.366,374,712,.525,.535,198,225,.880,39,138,177,251,97,20,119,141,1447,2009
Etan Thomas,C,30,WAS,26,7,306,32,66,.485,0,0,.000,32,66,.485,.485,16,23,.696,25,41,66,6,3,18,18,35,80,2009
Kenny Thomas,PF,31,SAC,8,0,62,3,8,.375,0,0,.000,3,8,.375,.375,0,0,.000,4,11,15,1,6,1,1,9,6,2009
Kurt Thomas,PF,36,SAS,79,10,1404,153,304,.503,0,2,.000,153,302,.507,.503,37,45,.822,134,271,405,66,34,58,42,170,343,2009
Tim Thomas,PF,31,TOT,64,6,1247,189,438,.432,78,189,.413,111,249,.446,.521,89,121,.736,42,159,201,68,31,11,70,144,545,2009
Tim Thomas,PF,31,LAC,10,5,220,34,90,.378,6,20,.300,28,70,.400,.411,21,34,.618,14,32,46,10,3,1,14,26,95,2009
Tim Thomas,PF,31,NYK,36,1,773,119,258,.461,53,126,.421,66,132,.500,.564,54,67,.806,20,93,113,46,22,10,46,91,345,2009
Tim Thomas,PF,31,CHI,18,0,254,36,90,.400,19,43,.442,17,47,.362,.506,14,20,.700,8,34,42,12,6,0,10,27,105,2009
Tyrus Thomas,PF,22,CHI,79,61,2175,308,683,.451,3,9,.333,305,674,.453,.453,238,304,.783,148,360,508,77,91,151,129,220,857,2009
Jason Thompson,PF,22,SAC,82,56,2303,356,717,.497,0,8,.000,356,709,.502,.497,198,286,.692,234,372,606,93,46,59,146,314,910,2009
Al Thornton,SF,25,LAC,71,67,2654,469,1051,.446,20,79,.253,449,972,.462,.456,236,313,.754,122,246,368,103,59,62,130,227,1194,2009
Anthony Tolliver,PF,23,SAS,19,0,208,19,65,.292,9,41,.220,10,24,.417,.362,5,10,.500,12,29,41,17,5,1,7,16,52,2009
Alando Tucker,SG,24,PHO,30,1,282,52,121,.430,8,23,.348,44,98,.449,.463,26,33,.788,19,12,31,12,5,1,14,14,138,2009
Ronny Turiaf,C,26,GSW,79,26,1696,186,366,.508,0,3,.000,186,363,.512,.508,98,124,.790,88,272,360,166,34,168,70,243,470,2009
Hedo Turkoglu,SF,29,ORL,77,77,2815,423,1025,.413,134,376,.356,289,649,.445,.478,314,389,.807,45,365,410,375,64,19,204,218,1294,2009
Ime Udoka,SF,31,SAS,67,3,1035,110,287,.383,41,125,.328,69,162,.426,.455,28,46,.609,28,159,187,54,36,12,38,86,289,2009
Beno Udrih,PG,26,SAC,73,72,2270,321,696,.461,35,113,.310,286,583,.491,.486,123,150,.820,46,174,220,342,81,12,158,192,800,2009
Roko Ukic,PG,24,TOR,72,0,890,123,324,.380,11,62,.177,112,262,.427,.397,44,60,.733,27,48,75,153,30,2,60,77,301,2009
Anderson Varejao,PF,26,CLE,81,42,2306,270,504,.536,0,2,.000,270,502,.538,.536,154,250,.616,166,415,581,81,75,66,80,239,694,2009
Jacque Vaughn,PG,33,SAS,30,0,292,24,75,.320,1,1,1.000,23,74,.311,.327,16,18,.889,4,18,22,55,6,0,15,26,65,2009
Charlie Villanueva,PF,24,MIL,78,47,2095,487,1089,.447,89,258,.345,398,831,.479,.488,201,240,.838,154,366,520,137,50,56,138,254,1264,2009
Jake Voskuhl,C,31,TOR,38,1,240,12,45,.267,0,0,.000,12,45,.267,.267,11,14,.786,21,38,59,8,3,4,17,60,35,2009
Sasha Vujacic,SG,24,LAL,80,0,1293,155,401,.387,81,223,.363,74,178,.416,.488,70,76,.921,19,116,135,113,77,7,35,154,461,2009
Dwyane Wade,SG,27,MIA,79,79,3048,854,1739,.491,88,278,.317,766,1461,.524,.516,590,771,.765,89,309,398,589,173,106,272,178,2386,2009
Von Wafer,SG,23,HOU,63,11,1225,229,512,.447,64,164,.390,165,348,.474,.510,88,117,.752,19,94,113,71,40,8,59,71,610,2009
Henry Walker,SF,21,BOS,29,0,216,36,58,.621,0,1,.000,36,57,.632,.621,16,23,.696,8,21,29,13,6,2,18,51,88,2009
Ben Wallace,PF,34,CLE,56,53,1314,69,155,.445,0,0,.000,69,155,.445,.445,27,64,.422,136,226,362,44,48,75,34,82,165,2009
Gerald Wallace,SF,26,CHA,71,71,2669,389,811,.480,39,131,.298,350,680,.515,.504,365,454,.804,112,441,553,189,121,67,148,210,1182,2009
Rasheed Wallace,C,34,DET,66,63,2123,302,720,.419,113,319,.354,189,401,.471,.498,78,101,.772,56,434,490,91,62,86,59,197,795,2009
Luke Walton,SF,28,LAL,65,34,1166,134,307,.436,17,57,.298,117,250,.468,.464,41,57,.719,55,125,180,177,32,10,69,105,326,2009
Hakim Warrick,PF,26,MEM,82,7,2029,340,693,.491,5,23,.217,335,670,.500,.494,266,374,.711,129,277,406,66,48,39,98,170,951,2009
C.J. Watson,PG,24,GSW,77,18,1883,257,562,.457,48,120,.400,209,442,.473,.500,168,193,.870,39,153,192,206,96,4,92,137,730,2009
Earl Watson,PG,29,OKC,68,18,1776,174,453,.384,20,85,.235,154,368,.418,.406,80,106,.755,36,147,183,391,50,11,156,137,448,2009
Kyle Weaver,SG,22,OKC,56,19,1166,113,246,.459,32,93,.344,81,153,.529,.524,41,58,.707,31,99,130,101,47,25,69,81,299,2009
Martell Webster,SF,22,POR,1,0,5,0,1,.000,0,1,.000,0,0,.000,.000,0,0,.000,0,0,0,0,0,0,0,0,0,2009
Sonny Weems,SG,22,DEN,12,0,55,8,25,.320,0,3,.000,8,22,.364,.320,3,8,.375,0,4,4,3,1,0,6,8,19,2009
David West,PF,28,NOH,76,76,2982,610,1292,.472,6,25,.240,604,1267,.477,.474,367,415,.884,160,486,646,173,49,68,163,207,1593,2009
Delonte West,SG,25,CLE,64,64,2152,285,624,.457,91,228,.399,194,396,.490,.530,90,108,.833,31,172,203,226,94,13,92,125,751,2009
Mario West,SG,24,ATL,53,3,269,14,34,.412,1,1,1.000,13,33,.394,.426,14,30,.467,24,32,56,19,18,4,13,35,43,2009
Russell Westbrook,PG,20,OKC,82,65,2668,436,1095,.398,35,129,.271,401,966,.415,.414,349,428,.815,178,221,399,435,110,16,274,191,1256,2009
D.J. White,PF,22,OKC,7,0,130,26,50,.520,0,0,.000,26,50,.520,.520,10,13,.769,10,22,32,6,3,5,3,10,62,2009
James White,SF,26,HOU,4,0,11,3,5,.600,1,2,.500,2,3,.667,.700,0,0,.000,0,0,0,1,1,1,3,2,7,2009
Chris Wilcox,C,26,TOT,62,6,1049,184,370,.497,0,4,.000,184,366,.503,.497,79,140,.564,96,181,277,47,26,16,75,137,447,2009
Chris Wilcox,C,26,OKC,37,6,719,130,268,.485,0,3,.000,130,265,.491,.485,52,87,.598,65,130,195,33,18,11,55,89,312,2009
Chris Wilcox,C,26,NYK,25,0,330,54,102,.529,0,1,.000,54,101,.535,.529,27,53,.509,31,51,82,14,8,5,20,48,135,2009
Damien Wilkins,SG,29,OKC,41,14,636,77,213,.362,27,72,.375,50,141,.355,.425,37,46,.804,20,50,70,37,22,7,37,55,218,2009
Deron Williams,PG,24,UTA,68,68,2505,463,984,.471,70,226,.310,393,758,.518,.506,326,384,.849,24,171,195,725,73,20,228,134,1322,2009
Jawad Williams,SF,25,CLE,10,0,20,5,12,.417,2,6,.333,3,6,.500,.500,0,0,.000,1,1,2,0,1,0,1,2,12,2009
Lou Williams,SG,22,PHI,81,0,1919,336,844,.398,63,220,.286,273,624,.438,.435,304,385,.790,36,129,165,242,85,14,151,128,1039,2009
Marcus Williams,PG,23,GSW,9,0,54,4,17,.235,2,6,.333,2,11,.182,.294,2,6,.333,0,4,4,13,1,1,4,6,12,2009
Marcus Williams,PF,22,SAS,2,0,3,2,2,1.000,0,0,.000,2,2,1.000,1.000,0,0,.000,0,0,0,0,0,0,0,1,4,2009
Marvin Williams,SF,22,ATL,61,59,2093,285,622,.458,55,155,.355,230,467,.493,.502,220,273,.806,110,272,382,81,57,39,70,127,845,2009
Mo Williams,PG,26,CLE,81,81,2834,526,1126,.467,183,420,.436,343,706,.486,.548,208,228,.912,47,232,279,329,69,9,179,215,1443,2009
Sean Williams,PF,22,NJN,33,0,366,30,72,.417,0,0,.000,30,72,.417,.417,20,32,.625,34,45,79,13,7,29,20,72,80,2009
Shawne Williams,SF,22,DAL,15,0,170,16,56,.286,1,17,.059,15,39,.385,.295,9,11,.818,19,27,46,2,2,9,5,19,42,2009
Shelden Williams,PF,25,TOT,45,0,512,70,157,.446,0,2,.000,70,155,.452,.446,46,63,.730,49,104,153,12,22,18,34,64,186,2009
Shelden Williams,PF,25,SAC,30,0,305,40,89,.449,0,2,.000,40,87,.460,.449,32,42,.762,25,53,78,8,12,10,26,36,112,2009
Shelden Williams,PF,25,MIN,15,0,207,30,68,.441,0,0,.000,30,68,.441,.441,14,21,.667,24,51,75,4,10,8,8,28,74,2009
Metta World Peace,SF,29,HOU,69,55,2452,416,1037,.401,153,383,.399,263,654,.402,.475,196,262,.748,65,294,359,229,105,24,140,155,1181,2009
Antoine Wright,SF,24,DAL,65,53,1552,179,431,.415,45,149,.302,134,282,.475,.468,71,95,.747,31,105,136,77,46,27,54,172,474,2009
Brandan Wright,PF,21,GSW,39,23,688,130,246,.528,0,4,.000,130,242,.537,.528,63,85,.741,62,95,157,21,22,37,23,74,323,2009
Dorell Wright,SF,23,MIA,6,0,73,8,20,.400,0,0,.000,8,20,.400,.400,2,6,.333,2,18,20,2,2,0,6,8,18,2009
Julian Wright,SF,21,NOH,54,19,772,109,234,.466,2,21,.095,107,213,.502,.470,17,30,.567,46,106,152,43,35,19,43,49,237,2009
Lorenzen Wright,C,33,CLE,17,2,125,10,27,.370,0,0,.000,10,27,.370,.370,3,8,.375,7,18,25,3,4,5,9,17,23,2009
Nick Young,SG,23,WAS,82,5,1837,336,756,.444,56,164,.341,280,592,.473,.481,164,193,.850,31,119,150,95,39,20,92,140,892,2009
Thaddeus Young,PF,20,PHI,75,71,2580,475,960,.495,56,164,.341,419,796,.526,.524,139,189,.735,139,238,377,86,100,23,118,165,1145,2009
Sun Yue,SG,23,LAL,10,0,28,3,11,.273,0,6,.000,3,5,.600,.273,0,0,.000,0,0,0,2,1,1,3,10,6,2009
Shareef Abdur-Rahim,PF,31,SAC,6,0,51,3,14,.214,0,0,.000,3,14,.214,.214,4,4,1.000,6,4,10,4,1,0,1,9,10,2008
Arron Afflalo,SG,22,DET,75,9,970,99,241,.411,10,48,.208,89,193,.461,.432,68,87,.782,36,101,137,52,31,8,34,83,276,2008
Maurice Ager,SG,23,TOT,26,3,165,21,65,.323,3,19,.158,18,46,.391,.346,6,12,.500,4,9,13,8,0,1,6,17,51,2008
Maurice Ager,SG,23,DAL,12,3,77,5,27,.185,0,8,.000,5,19,.263,.185,5,6,.833,1,3,4,4,0,1,3,11,15,2008
Maurice Ager,SG,23,NJN,14,0,88,16,38,.421,3,11,.273,13,27,.481,.461,1,6,.167,3,6,9,4,0,0,3,6,36,2008
Blake Ahearn,PG,23,MIA,12,0,177,15,57,.263,10,34,.294,5,23,.217,.351,30,31,.968,1,18,19,19,6,0,16,20,70,2008
LaMarcus Aldridge,PF,22,POR,76,76,2649,561,1160,.484,1,7,.143,560,1153,.486,.484,227,298,.762,220,358,578,122,55,94,126,240,1350,2008
Malik Allen,PF,29,TOT,73,16,1096,157,327,.480,1,2,.500,156,325,.480,.482,23,25,.920,66,130,196,44,19,31,45,149,338,2008
Malik Allen,PF,29,NJN,48,12,763,124,261,.475,1,2,.500,123,259,.475,.477,12,13,.923,42,86,128,29,15,21,32,89,261,2008
Malik Allen,PF,29,DAL,25,4,333,33,66,.500,0,0,.000,33,66,.500,.500,11,12,.917,24,44,68,15,4,10,13,60,77,2008
Ray Allen,SG,32,BOS,73,73,2624,439,986,.445,180,452,.398,259,534,.485,.537,215,237,.907,75,193,268,225,65,16,127,147,1273,2008
Tony Allen,SG,26,BOS,75,11,1373,169,389,.434,18,57,.316,151,332,.455,.458,138,181,.762,34,134,168,114,62,21,109,168,494,2008
Lance Allred,C,26,CLE,3,0,10,1,4,.250,0,0,.000,1,4,.250,.250,1,2,.500,0,1,1,0,0,0,0,1,3,2008
Morris Almond,SG,22,UTA,9,0,39,4,15,.267,1,4,.250,3,11,.273,.300,4,6,.667,0,2,2,3,1,0,2,5,13,2008
Rafer Alston,PG,31,HOU,74,74,2526,364,924,.394,143,407,.351,221,517,.427,.471,98,137,.715,28,232,260,392,98,18,160,139,969,2008
Lou Amundson,PF,25,PHI,16,0,64,8,16,.500,0,0,.000,8,16,.500,.500,2,7,.286,7,5,12,0,1,1,2,13,18,2008
Chris Andersen,C,29,NOH,5,0,34,2,7,.286,0,0,.000,2,7,.286,.286,2,4,.500,2,7,9,0,0,4,1,6,6,2008
Derek Anderson,SG,33,CHA,28,0,396,47,125,.376,19,52,.365,28,73,.384,.452,28,38,.737,9,43,52,44,12,1,25,49,141,2008
Carmelo Anthony,SF,23,DEN,77,77,2806,728,1481,.492,58,164,.354,670,1317,.509,.511,464,590,.786,178,393,571,259,98,39,253,253,1978,2008
Joel Anthony,PF,25,MIA,24,1,498,28,60,.467,0,0,.000,28,60,.467,.467,29,49,.592,38,55,93,3,9,31,17,55,85,2008
Gilbert Arenas,PG,26,WAS,13,8,425,78,196,.398,22,78,.282,56,118,.475,.454,74,96,.771,6,45,51,66,23,1,49,30,252,2008
Trevor Ariza,SF,22,TOT,35,3,546,69,136,.507,5,18,.278,64,118,.542,.526,49,75,.653,30,78,108,44,31,11,23,45,192,2008
Trevor Ariza,SF,22,ORL,11,0,115,14,31,.452,0,3,.000,14,28,.500,.452,8,15,.533,5,19,24,8,5,3,5,9,36,2008
Trevor Ariza,SF,22,LAL,24,3,431,55,105,.524,5,15,.333,50,90,.556,.548,41,60,.683,25,59,84,36,26,8,18,36,156,2008
Darrell Armstrong,PG,39,NJN,50,2,549,40,110,.364,23,69,.333,17,41,.415,.468,20,30,.667,17,50,67,73,28,2,41,53,123,2008
Hilton Armstrong,C,23,NOH,65,3,732,67,148,.453,0,0,.000,67,148,.453,.453,44,70,.629,65,98,163,23,15,34,59,130,178,2008
Carlos Arroyo,PG,28,ORL,62,20,1269,157,348,.451,29,84,.345,128,264,.485,.493,87,102,.853,10,103,113,219,26,2,77,85,430,2008
Chucky Atkins,SG,33,DEN,24,0,352,42,122,.344,25,79,.316,17,43,.395,.447,4,9,.444,3,28,31,47,9,1,10,27,113,2008
James Augustine,PF,23,ORL,25,0,149,18,34,.529,0,0,.000,18,34,.529,.529,4,8,.500,16,14,30,2,5,2,6,18,40,2008
Kelenna Azubuike,SG,24,GSW,81,17,1732,261,587,.445,71,195,.364,190,392,.485,.505,99,138,.717,107,217,324,75,45,34,58,159,692,2008
Renaldo Balkman,SF,23,NYK,65,0,952,91,186,.489,1,12,.083,90,174,.517,.492,41,95,.432,83,133,216,40,44,30,37,132,224,2008
Marcus Banks,PG,26,TOT,36,3,569,86,191,.450,40,102,.392,46,89,.517,.555,27,35,.771,4,41,45,61,14,13,37,65,239,2008
Marcus Banks,PG,26,PHO,24,1,310,44,109,.404,25,65,.385,19,44,.432,.518,12,16,.750,3,17,20,25,8,8,16,38,125,2008
Marcus Banks,PG,26,MIA,12,2,259,42,82,.512,15,37,.405,27,45,.600,.604,15,19,.789,1,24,25,36,6,5,21,27,114,2008
Leandro Barbosa,SG,25,PHO,82,12,2421,472,1021,.462,164,422,.389,308,599,.514,.543,175,213,.822,40,191,231,216,75,18,117,195,1283,2008
J.J. Barea,PG,23,DAL,44,9,460,71,170,.418,21,54,.389,50,116,.431,.479,28,35,.800,4,43,47,58,14,1,35,48,191,2008
Andrea Bargnani,PF,22,TOR,78,53,1861,280,725,.386,90,261,.345,190,464,.409,.448,142,169,.840,50,238,288,89,23,37,88,211,792,2008
Matt Barnes,PF,27,GSW,73,18,1414,187,442,.423,53,181,.293,134,261,.513,.483,59,79,.747,94,230,324,139,48,36,85,159,486,2008
Andre Barrett,PG,25,LAC,4,0,25,2,5,.400,1,3,.333,1,2,.500,.500,1,2,.500,0,1,1,7,0,0,1,1,6,2008
Earl Barron,C,26,MIA,46,15,889,132,327,.404,1,13,.077,131,314,.417,.405,61,87,.701,67,131,198,29,19,8,48,114,326,2008
Brent Barry,SF,36,SAS,31,1,554,77,160,.481,48,112,.429,29,48,.604,.631,19,20,.950,12,43,55,54,17,3,18,43,221,2008
Brandon Bass,C,22,DAL,79,1,1557,246,493,.499,0,4,.000,246,489,.503,.499,162,197,.822,120,227,347,58,22,48,82,150,654,2008
Maceo Baston,PF,32,TOR,15,2,103,17,25,.680,0,0,.000,17,25,.680,.680,7,10,.700,9,17,26,3,2,4,4,20,41,2008
Shane Battier,SF,29,HOU,80,78,2907,265,619,.428,139,369,.377,126,250,.504,.540,75,101,.743,131,276,407,155,77,90,78,196,744,2008
Marco Belinelli,PG,21,GSW,33,0,241,36,93,.387,16,41,.390,20,52,.385,.473,7,9,.778,3,11,14,15,5,0,12,15,95,2008
Charlie Bell,SG,28,MIL,68,5,1628,185,486,.381,74,217,.341,111,269,.413,.457,70,87,.805,31,136,167,210,52,2,76,121,514,2008
Raja Bell,SG,31,PHO,75,75,2646,317,753,.421,176,439,.401,141,314,.449,.538,79,91,.868,47,227,274,168,54,27,65,220,889,2008
Mike Bibby,PG,29,TOT,48,44,1573,248,603,.411,93,248,.375,155,355,.437,.488,78,100,.780,16,144,160,290,54,4,119,97,667,2008
Mike Bibby,PG,29,SAC,15,12,473,78,192,.406,24,61,.393,54,131,.412,.469,23,31,.742,11,45,56,75,19,2,38,34,203,2008
Mike Bibby,PG,29,ATL,33,32,1100,170,411,.414,69,187,.369,101,224,.451,.498,55,69,.797,5,99,104,215,35,2,81,63,464,2008
Andris Biedrins,C,21,GSW,76,59,2078,340,543,.626,0,0,.000,340,543,.626,.626,116,187,.620,256,488,744,75,56,94,85,262,796,2008
Chauncey Billups,PG,31,DET,78,78,2522,393,877,.448,137,342,.401,256,535,.479,.526,401,437,.918,42,170,212,529,101,17,160,130,1324,2008
Steve Blake,PG,27,POR,81,78,2424,261,640,.408,121,298,.406,140,342,.409,.502,49,64,.766,31,164,195,413,55,4,113,133,692,2008
Andray Blatche,PF,21,WAS,82,15,1675,254,536,.474,3,13,.231,251,523,.480,.477,107,154,.695,164,261,425,92,53,114,112,258,618,2008
Mark Blount,C,32,MIA,69,46,1542,238,515,.462,17,44,.386,221,471,.469,.479,88,138,.638,69,194,263,41,33,34,70,133,581,2008
Keith Bogans,SG,27,ORL,82,35,2198,241,588,.410,148,409,.362,93,179,.520,.536,81,110,.736,42,224,266,104,59,10,53,164,711,2008
Andrew Bogut,C,23,MIL,78,78,2720,465,910,.511,0,7,.000,465,903,.515,.511,189,322,.587,245,518,763,199,64,135,172,254,1119,2008
Matt Bonner,PF,27,SAS,68,3,853,121,291,.416,46,137,.336,75,154,.487,.495,38,44,.864,53,139,192,32,14,17,39,111,326,2008
Josh Boone,PF,23,NJN,70,53,1773,238,434,.548,0,0,.000,238,434,.548,.548,99,217,.456,192,317,509,55,36,61,68,155,575,2008
Calvin Booth,C,31,PHI,31,0,204,9,27,.333,0,0,.000,9,27,.333,.333,6,10,.600,6,32,38,8,6,18,4,35,24,2008
Carlos Boozer,PF,26,UTA,81,81,2827,709,1297,.547,0,1,.000,709,1296,.547,.547,290,393,.738,197,647,844,233,100,41,210,293,1708,2008
Chris Bosh,C,23,TOR,67,67,2425,507,1027,.494,10,25,.400,497,1002,.496,.499,472,559,.844,174,409,583,171,63,67,153,157,1496,2008
Bruce Bowen,SF,36,SAS,81,81,2448,174,428,.407,90,215,.419,84,213,.394,.512,45,69,.652,33,201,234,91,54,22,46,177,483,2008
Ryan Bowen,SF,32,NOH,53,4,660,49,100,.490,0,1,.000,49,99,.495,.490,16,29,.552,55,45,100,25,32,11,15,77,114,2008
Earl Boykins,PG,31,CHA,36,0,577,61,172,.355,14,44,.318,47,128,.367,.395,49,59,.831,9,25,34,96,13,0,41,21,185,2008
Elton Brand,PF,28,LAC,8,6,274,52,114,.456,0,0,.000,52,114,.456,.456,37,47,.787,21,43,64,16,3,15,17,21,141,2008
Corey Brewer,SF,21,MIN,79,35,1803,182,486,.374,7,36,.194,175,450,.389,.382,88,110,.800,82,210,292,111,76,25,89,188,459,2008
Ronnie Brewer,SG,22,UTA,76,76,2088,354,634,.558,11,50,.220,343,584,.587,.567,195,257,.759,97,121,218,134,129,19,69,110,914,2008
Primoz Brezec,C,28,TOT,50,18,475,44,94,.468,0,0,.000,44,94,.468,.468,24,40,.600,30,51,81,11,3,7,24,83,112,2008
Primoz Brezec,C,28,CHA,20,18,267,17,43,.395,0,0,.000,17,43,.395,.395,3,5,.600,14,30,44,6,0,3,15,35,37,2008
Primoz Brezec,C,28,DET,17,0,98,10,13,.769,0,0,.000,10,13,.769,.769,7,14,.500,7,12,19,4,2,2,5,23,27,2008
Primoz Brezec,C,28,TOR,13,0,110,17,38,.447,0,0,.000,17,38,.447,.447,14,21,.667,9,9,18,1,1,2,4,25,48,2008
Aaron Brooks,PG,23,HOU,51,0,608,93,225,.413,36,109,.330,57,116,.491,.493,42,49,.857,13,43,56,87,13,5,44,69,264,2008
Andre Brown,PF,26,MEM,33,1,286,39,78,.500,0,0,.000,39,78,.500,.500,22,49,.449,37,55,92,8,7,4,14,38,100,2008
Devin Brown,SG,29,CLE,78,20,1762,217,531,.409,45,146,.308,172,385,.447,.451,107,142,.754,65,198,263,175,52,7,99,144,586,2008
Kwame Brown,C,25,TOT,38,15,713,72,142,.507,0,0,.000,72,142,.507,.507,40,98,.408,51,137,188,45,22,23,51,82,184,2008
Kwame Brown,C,25,LAL,23,14,509,53,103,.515,0,0,.000,53,103,.515,.515,26,64,.406,31,100,131,28,16,19,37,58,132,2008
Kwame Brown,C,25,MEM,15,1,204,19,39,.487,0,0,.000,19,39,.487,.487,14,34,.412,20,37,57,17,6,4,14,24,52,2008
P.J. Brown,PF,38,BOS,18,0,209,14,41,.341,0,1,.000,14,40,.350,.341,11,16,.688,29,39,68,10,5,8,10,29,39,2008
Shannon Brown,SG,22,TOT,21,4,240,44,126,.349,9,30,.300,35,96,.365,.385,17,29,.586,6,14,20,17,11,3,24,29,114,2008
Shannon Brown,SG,22,CLE,15,4,218,41,111,.369,9,29,.310,32,82,.390,.410,14,23,.609,5,13,18,17,10,1,19,27,105,2008
Shannon Brown,SG,22,CHI,6,0,22,3,15,.200,0,1,.000,3,14,.214,.200,3,6,.500,1,1,2,0,1,2,5,2,9,2008
Kobe Bryant,SG,29,LAL,82,82,3192,775,1690,.459,150,415,.361,625,1275,.490,.503,623,742,.840,94,423,517,441,151,40,257,227,2323,2008
Greg Buckner,SG,31,MIN,31,4,520,45,117,.385,15,50,.300,30,67,.448,.449,19,22,.864,10,55,65,39,21,2,29,63,124,2008
Caron Butler,SF,27,WAS,58,58,2314,439,943,.466,66,185,.357,373,758,.492,.501,236,262,.901,93,295,388,284,128,20,150,160,1180,2008
Rasual Butler,SF,28,NOH,51,8,875,91,260,.350,44,133,.331,47,127,.370,.435,26,31,.839,16,84,100,36,15,21,10,66,252,2008
Andrew Bynum,C,20,LAL,35,25,1008,189,297,.636,0,0,.000,189,297,.636,.636,82,118,.695,105,251,356,61,12,72,52,98,460,2008
Jose Calderon,PG,26,TOR,82,56,2484,367,707,.519,79,184,.429,288,523,.551,.575,109,120,.908,34,202,236,678,87,6,126,134,922,2008
Marcus Camby,C,33,DEN,79,79,2758,286,635,.450,6,20,.300,280,615,.455,.455,143,202,.708,230,807,1037,259,85,285,118,216,721,2008
Brian Cardinal,PF,30,MEM,37,1,440,43,126,.341,25,81,.309,18,45,.400,.440,13,19,.684,26,70,96,22,10,2,23,62,124,2008
Rodney Carney,SF,23,PHI,70,6,1039,158,392,.403,38,120,.317,120,272,.441,.452,55,81,.679,50,99,149,32,39,23,34,96,409,2008
Matt Carroll,SG,27,CHA,80,18,2016,252,589,.428,105,241,.436,147,348,.422,.517,111,138,.804,33,193,226,73,46,19,58,187,720,2008
Anthony Carter,PG,32,DEN,70,67,1960,218,476,.458,45,129,.349,173,347,.499,.505,64,85,.753,27,173,200,388,107,28,124,172,545,2008
Vince Carter,SG,31,NJN,76,72,2959,587,1287,.456,98,273,.359,489,1014,.482,.494,350,429,.816,112,341,453,389,93,33,181,241,1622,2008
Sam Cassell,PG,38,TOT,55,34,1274,233,532,.438,23,76,.303,210,456,.461,.460,127,144,.882,17,119,136,214,37,6,97,98,616,2008
Sam Cassell,PG,38,LAC,38,33,975,183,402,.455,14,54,.259,169,348,.486,.473,106,119,.891,12,93,105,179,28,3,78,69,486,2008
Sam Cassell,PG,38,BOS,17,1,299,50,130,.385,9,22,.409,41,108,.380,.419,21,25,.840,5,26,31,35,9,3,19,29,130,2008
Tyson Chandler,C,25,NOH,79,79,2783,377,605,.623,0,1,.000,377,604,.624,.623,175,295,.593,322,606,928,81,45,84,136,243,929,2008
Wilson Chandler,SF,20,NYK,35,16,685,106,242,.438,9,30,.300,97,212,.458,.457,34,54,.630,38,89,127,33,15,16,27,83,255,2008
Josh Childress,SF,24,ATL,76,0,2274,327,573,.571,22,60,.367,305,513,.595,.590,222,275,.807,174,199,373,117,71,43,98,129,898,2008
Jarron Collins,C,29,UTA,70,9,702,36,82,.439,0,1,.000,36,81,.444,.439,46,74,.622,40,76,116,37,10,6,22,106,118,2008
Jason Collins,C,29,TOT,74,26,1172,53,113,.469,0,1,.000,53,112,.473,.469,34,74,.459,64,114,178,25,23,25,48,194,140,2008
Jason Collins,C,29,NJN,43,23,684,23,54,.426,0,0,.000,23,54,.426,.426,14,36,.389,35,54,89,19,11,8,23,110,60,2008
Jason Collins,C,29,MEM,31,3,488,30,59,.508,0,1,.000,30,58,.517,.508,20,38,.526,29,60,89,6,12,17,25,84,80,2008
Mardy Collins,SG,23,NYK,46,8,634,57,175,.326,8,32,.250,49,143,.343,.349,23,38,.605,19,56,75,89,24,8,56,56,145,2008
Nick Collison,PF,27,SEA,78,35,2223,322,641,.502,0,2,.000,322,639,.504,.502,123,167,.737,254,476,730,113,47,60,118,250,767,2008
Mike Conley,PG,20,MEM,53,46,1381,189,442,.428,30,91,.330,159,351,.453,.462,90,123,.732,21,118,139,222,44,2,89,85,498,2008
Brian Cook,PF,27,TOT,51,2,629,88,234,.376,43,115,.374,45,119,.378,.468,19,21,.905,28,81,109,27,13,12,39,93,238,2008
Brian Cook,PF,27,LAL,6,2,70,4,21,.190,2,10,.200,2,11,.182,.238,4,4,1.000,4,6,10,3,2,0,4,6,14,2008
Brian Cook,PF,27,ORL,45,0,559,84,213,.394,41,105,.390,43,108,.398,.491,15,17,.882,24,75,99,24,11,12,35,87,224,2008
Daequan Cook,SG,20,MIA,59,19,1441,196,514,.381,79,238,.332,117,276,.424,.458,47,57,.825,20,157,177,75,23,9,63,157,518,2008
Jamal Crawford,SG,27,NYK,80,80,3190,570,1391,.410,176,494,.356,394,897,.439,.473,329,381,.864,37,170,207,398,81,17,192,144,1645,2008
Javaris Crittenton,SG,20,TOT,50,0,679,98,233,.421,10,37,.270,88,196,.449,.442,72,104,.692,27,83,110,51,19,2,55,47,278,2008
Javaris Crittenton,SG,20,LAL,22,0,171,26,53,.491,1,3,.333,25,50,.500,.500,19,28,.679,7,14,21,18,7,0,22,12,72,2008
Javaris Crittenton,SG,20,MEM,28,0,508,72,180,.400,9,34,.265,63,146,.432,.425,53,76,.697,20,69,89,33,12,2,33,35,206,2008
Austin Croshere,PF,32,GSW,44,0,457,61,137,.445,22,61,.361,39,76,.513,.526,29,32,.906,33,71,104,30,8,6,22,60,173,2008
Eddy Curry,C,25,NYK,59,58,1530,297,544,.546,0,0,.000,297,544,.546,.546,187,300,.623,111,164,275,32,14,29,126,157,781,2008
Samuel Dalembert,C,26,PHI,82,82,2724,339,661,.513,0,1,.000,339,660,.514,.513,186,263,.707,304,545,849,45,40,192,155,269,864,2008
Erick Dampier,C,32,DAL,72,64,1755,178,277,.643,0,0,.000,178,277,.643,.643,84,146,.575,207,332,539,63,24,106,80,226,440,2008
Antonio Daniels,PG,32,WAS,71,63,2161,205,447,.459,17,74,.230,188,373,.504,.478,170,219,.776,23,180,203,340,69,2,91,78,597,2008
Marquis Daniels,SG,27,IND,74,1,1546,241,561,.430,27,102,.265,214,459,.466,.454,97,139,.698,66,146,212,137,79,18,112,121,606,2008
Jermareo Davidson,SF,23,CHA,38,2,322,51,125,.408,0,0,.000,51,125,.408,.408,18,28,.643,21,41,62,13,7,15,17,46,120,2008
Baron Davis,PG,28,GSW,82,82,3196,650,1526,.426,173,525,.330,477,1001,.477,.483,318,424,.750,96,289,385,623,191,43,232,247,1791,2008
Glen Davis,C,22,BOS,69,1,940,107,221,.484,0,0,.000,107,221,.484,.484,99,150,.660,95,113,208,28,31,20,65,160,313,2008
Paul Davis,PF,23,LAC,22,1,194,24,65,.369,0,0,.000,24,65,.369,.369,6,10,.600,25,22,47,10,6,6,9,33,54,2008
Ricky Davis,SF,28,MIA,82,47,2963,420,971,.433,135,333,.405,285,638,.447,.502,155,197,.787,55,298,353,276,87,14,191,187,1130,2008
Carlos Delfino,SG,25,TOR,82,0,1928,251,632,.397,120,314,.382,131,318,.412,.492,116,156,.744,66,293,359,145,69,11,75,177,738,2008
Luol Deng,SF,22,CHI,63,59,2128,429,896,.479,8,22,.364,421,874,.482,.483,204,265,.770,136,258,394,155,57,29,120,117,1070,2008
Boris Diaw,PF,25,PHO,82,19,2308,308,646,.477,13,41,.317,295,605,.488,.487,96,129,.744,97,281,378,317,61,39,155,166,725,2008
Yakhouba Diawara,SG,25,DEN,54,14,542,55,134,.410,21,66,.318,34,68,.500,.489,22,31,.710,23,39,62,37,8,3,16,61,153,2008
Guillermo Diaz,SG,22,LAC,6,0,18,1,4,.250,0,1,.000,1,3,.333,.250,3,5,.600,2,0,2,1,0,0,0,0,5,2008
Dan Dickau,PG,29,LAC,67,8,1040,124,296,.419,36,108,.333,88,188,.468,.480,68,82,.829,13,84,97,172,32,3,55,108,352,2008
Kaniel Dickens,PF,29,CLE,5,0,12,1,3,.333,0,0,.000,1,3,.333,.333,0,0,.000,0,1,1,1,0,1,0,1,2,2008
Travis Diener,PG,25,IND,66,21,1356,159,430,.370,74,233,.318,85,197,.431,.456,64,71,.901,26,89,115,251,35,4,55,107,456,2008
Ike Diogu,PF,24,IND,30,1,305,64,134,.478,0,0,.000,64,134,.478,.478,40,47,.851,38,47,85,10,7,3,20,43,168,2008
DeSagana Diop,C,26,TOT,79,23,1295,94,180,.522,0,0,.000,94,180,.522,.522,38,70,.543,160,232,392,40,26,88,58,146,226,2008
DeSagana Diop,C,26,DAL,52,18,894,67,115,.583,0,0,.000,67,115,.583,.583,24,40,.600,111,159,270,26,20,63,42,100,158,2008
DeSagana Diop,C,26,NJN,27,5,401,27,65,.415,0,0,.000,27,65,.415,.415,14,30,.467,49,73,122,14,6,25,16,46,68,2008
Juan Dixon,PG,29,TOT,53,0,668,106,258,.411,30,72,.417,76,186,.409,.469,21,26,.808,15,60,75,97,21,2,54,62,263,2008
Juan Dixon,PG,29,TOR,36,0,424,59,160,.369,17,39,.436,42,121,.347,.422,18,19,.947,9,38,47,65,21,2,35,38,153,2008
Juan Dixon,PG,29,DET,17,0,244,47,98,.480,13,33,.394,34,65,.523,.546,3,7,.429,6,22,28,32,0,0,19,24,110,2008
Michael Doleac,C,30,MIN,24,8,257,28,63,.444,0,0,.000,28,63,.444,.444,1,2,.500,16,33,49,7,10,10,12,44,57,2008
Keyon Dooling,PG,27,ORL,72,1,1334,198,423,.468,22,65,.338,176,358,.492,.494,163,193,.845,7,94,101,133,36,5,61,131,581,2008
Quincy Douby,PG,23,SAC,74,0,876,132,335,.394,42,122,.344,90,213,.423,.457,48,52,.923,17,66,83,53,30,12,59,80,354,2008
Jared Dudley,PF,22,CHA,73,14,1384,163,348,.468,9,41,.220,154,307,.502,.481,87,118,.737,121,165,286,81,55,10,50,128,422,2008
Chris Duhon,PG,25,CHI,66,18,1490,133,344,.387,54,155,.348,79,189,.418,.465,65,80,.813,19,97,116,263,48,2,71,92,385,2008
Tim Duncan,C,31,SAS,78,78,2651,585,1178,.497,0,4,.000,585,1174,.498,.497,338,463,.730,237,644,881,218,56,152,178,185,1508,2008
Mike Dunleavy,SG,27,IND,82,82,2953,532,1117,.476,165,389,.424,367,728,.504,.550,336,403,.834,59,365,424,288,86,31,190,208,1565,2008
Ronald Dupree,SF,27,TOT,5,0,21,1,3,.333,0,0,.000,1,3,.333,.333,2,2,1.000,1,7,8,1,1,0,0,0,4,2008
Ronald Dupree,SF,27,DET,1,0,3,0,0,.000,0,0,.000,0,0,.000,.000,0,0,.000,0,0,0,0,0,0,0,0,0,2008
Ronald Dupree,SF,27,SEA,4,0,18,1,3,.333,0,0,.000,1,3,.333,.333,2,2,1.000,1,7,8,1,1,0,0,0,4,2008
Kevin Durant,SG,19,SEA,80,80,2768,587,1366,.430,59,205,.288,528,1161,.455,.451,391,448,.873,70,278,348,192,78,75,232,122,1624,2008
Monta Ellis,SG,22,GSW,81,72,3071,652,1227,.531,12,52,.231,640,1175,.545,.536,320,417,.767,133,271,404,315,124,27,173,195,1636,2008
Francisco Elson,C,31,TOT,63,5,813,92,236,.390,0,1,.000,92,235,.391,.390,26,37,.703,50,150,200,24,15,20,47,96,210,2008
Francisco Elson,C,31,SAS,41,3,534,62,148,.419,0,0,.000,62,148,.419,.419,20,24,.833,33,102,135,16,9,14,30,62,144,2008
Francisco Elson,C,31,SEA,22,2,279,30,88,.341,0,1,.000,30,87,.345,.341,6,13,.462,17,48,65,8,6,6,17,34,66,2008
Melvin Ely,C,29,NOH,52,1,621,85,180,.472,0,0,.000,85,180,.472,.472,32,58,.552,28,117,145,22,7,18,42,79,202,2008
Maurice Evans,SG,29,TOT,75,47,1720,262,545,.481,81,209,.388,181,336,.539,.555,59,83,.711,92,126,218,81,46,10,40,142,664,2008
Maurice Evans,SG,29,LAL,7,0,96,9,28,.321,1,7,.143,8,21,.381,.339,12,15,.800,4,5,9,12,5,1,0,10,31,2008
Maurice Evans,SG,29,ORL,68,47,1624,253,517,.489,80,202,.396,173,315,.549,.567,47,68,.691,88,121,209,69,41,9,40,132,633,2008
Reggie Evans,PF,27,PHI,81,61,1879,152,346,.439,1,1,1.000,151,345,.438,.441,120,257,.467,224,387,611,65,86,8,108,213,425,2008
Jordan Farmar,PG,21,LAL,82,0,1690,291,631,.461,114,307,.371,177,324,.546,.552,53,78,.679,39,144,183,225,77,5,108,105,749,2008
Nick Fazekas,PF,22,TOT,26,0,269,46,82,.561,0,2,.000,46,80,.575,.561,15,22,.682,34,55,89,11,8,11,13,25,107,2008
Nick Fazekas,PF,22,DAL,4,0,9,2,5,.400,0,0,.000,2,5,.400,.400,0,0,.000,1,2,3,0,0,0,0,0,4,2008
Nick Fazekas,PF,22,LAC,22,0,260,44,77,.571,0,2,.000,44,75,.587,.571,15,22,.682,33,53,86,11,8,11,13,25,103,2008
Raymond Felton,PG,23,CHA,79,79,2972,412,997,.413,56,200,.280,356,797,.447,.441,260,325,.800,37,199,236,583,96,12,213,184,1140,2008
Kyrylo Fesenko,C,21,UTA,9,0,70,6,16,.375,0,0,.000,6,16,.375,.375,2,4,.500,14,11,25,2,0,3,8,19,14,2008
Michael Finley,SG,34,SAS,82,61,2204,315,761,.414,132,357,.370,183,404,.453,.501,64,80,.800,27,227,254,114,29,10,56,93,826,2008
Derek Fisher,PG,33,LAL,82,82,2249,339,777,.436,112,276,.406,227,501,.453,.508,166,188,.883,24,146,170,239,86,3,90,188,956,2008
T.J. Ford,PG,24,TOR,51,26,1199,246,524,.469,15,51,.294,231,473,.488,.484,110,125,.880,23,77,100,313,54,0,102,93,617,2008
Jeff Foster,C,31,IND,77,52,1884,205,373,.550,0,3,.000,205,370,.554,.550,86,145,.593,264,404,668,129,56,32,62,221,496,2008
Randy Foye,PG,24,MIN,39,31,1259,198,462,.429,61,148,.412,137,314,.436,.495,53,65,.815,13,115,128,164,36,3,79,102,510,2008
Adonal Foyle,C,32,ORL,82,0,774,70,153,.458,0,0,.000,70,153,.458,.458,16,34,.471,71,137,208,18,16,45,32,94,156,2008
Richie Frahm,SG,30,LAC,10,2,163,20,54,.370,7,25,.280,13,29,.448,.435,0,2,.000,4,10,14,8,2,0,6,7,47,2008
Steve Francis,PG,30,HOU,10,3,199,19,57,.333,4,17,.235,15,40,.375,.368,13,23,.565,8,15,23,30,9,5,14,25,55,2008
Channing Frye,C,24,POR,78,20,1342,221,453,.488,3,10,.300,218,443,.492,.491,85,109,.780,107,247,354,57,29,27,55,208,530,2008
Dan Gadzuric,C,29,MIL,51,4,534,64,154,.416,0,1,.000,64,153,.418,.416,33,63,.524,67,77,144,11,20,24,34,83,161,2008
Jorge Garbajosa,PF,30,TOR,7,0,74,8,25,.320,6,16,.375,2,9,.222,.440,0,0,.000,2,13,15,3,3,0,1,2,22,2008
Francisco Garcia,SF,26,SAC,79,20,2096,348,752,.463,113,289,.391,235,463,.508,.538,162,208,.779,52,212,264,128,96,50,128,232,971,2008
Thomas Gardner,SG,22,CHI,4,0,45,9,23,.391,3,12,.250,6,11,.545,.457,0,2,.000,3,1,4,1,0,0,4,4,21,2008
Kevin Garnett,PF,31,BOS,71,71,2328,534,990,.539,0,11,.000,534,979,.545,.539,269,336,.801,135,520,655,244,100,89,138,163,1337,2008
Pat Garrity,PF,31,ORL,31,0,284,27,80,.338,8,37,.216,19,43,.442,.388,4,5,.800,9,35,44,13,6,1,17,35,66,2008
Pau Gasol,C,27,TOT,66,66,2351,475,890,.534,4,16,.250,471,874,.539,.536,292,362,.807,155,398,553,211,30,98,124,139,1246,2008
Pau Gasol,C,27,MEM,39,39,1433,279,557,.501,4,15,.267,275,542,.507,.504,176,215,.819,94,248,342,116,16,56,80,85,738,2008
Pau Gasol,C,27,LAL,27,27,918,196,333,.589,0,1,.000,196,332,.590,.589,116,147,.789,61,150,211,95,14,42,44,54,508,2008
Rudy Gay,SF,21,MEM,81,81,3000,625,1355,.461,134,387,.346,491,968,.507,.511,248,316,.785,140,359,499,158,111,79,190,230,1632,2008
Mickael Gelabale,SG,24,SEA,39,0,465,69,157,.439,16,37,.432,53,120,.442,.490,14,18,.778,16,42,58,33,10,9,27,31,168,2008
Devean George,SF,30,DAL,53,4,821,74,207,.357,22,68,.324,52,139,.374,.411,24,34,.706,28,109,137,35,19,13,24,90,194,2008
Daniel Gibson,PG,21,CLE,58,26,1765,201,465,.432,118,268,.440,83,197,.421,.559,85,105,.810,30,104,134,145,47,14,76,163,605,2008
Eddie Gill,PG,29,TOT,14,1,154,12,31,.387,5,15,.333,7,16,.438,.468,9,9,1.000,1,21,22,22,7,2,9,18,38,2008
Eddie Gill,PG,29,NJN,13,1,149,12,29,.414,5,14,.357,7,15,.467,.500,9,9,1.000,1,21,22,21,7,2,8,18,38,2008
Eddie Gill,PG,29,SEA,1,0,5,0,2,.000,0,1,.000,0,1,.000,.000,0,0,.000,0,0,0,1,0,0,1,0,0,2008
Manu Ginobili,SG,30,SAS,74,23,2299,453,984,.460,156,389,.401,297,595,.499,.540,380,442,.860,63,291,354,332,109,33,200,173,1442,2008
Gordan Giricek,SG,30,TOT,56,0,831,133,302,.440,36,99,.364,97,203,.478,.500,23,26,.885,16,80,96,62,24,4,52,82,325,2008
Gordan Giricek,SG,30,UTA,22,0,279,41,102,.402,12,34,.353,29,68,.426,.461,1,1,1.000,6,25,31,16,13,1,21,24,95,2008
Gordan Giricek,SG,30,PHI,12,0,110,13,41,.317,5,15,.333,8,26,.308,.378,6,8,.750,1,13,14,11,3,1,8,9,37,2008
Gordan Giricek,SG,30,PHO,22,0,442,79,159,.497,19,50,.380,60,109,.550,.557,16,17,.941,9,42,51,35,8,2,23,49,193,2008
Ryan Gomes,PF,25,MIN,82,74,2434,392,857,.457,59,179,.330,333,678,.491,.492,190,229,.830,133,342,475,145,65,10,96,154,1033,2008
Drew Gooden,PF,26,TOT,69,65,2122,332,740,.449,0,6,.000,332,734,.452,.449,162,215,.753,175,415,590,81,48,53,122,203,826,2008
Drew Gooden,PF,26,CLE,51,51,1564,232,523,.444,0,3,.000,232,520,.446,.444,110,151,.728,117,306,423,50,35,30,91,144,574,2008
Drew Gooden,PF,26,CHI,18,14,558,100,217,.461,0,3,.000,100,214,.467,.461,52,64,.813,58,109,167,31,13,23,31,59,252,2008
Ben Gordon,SG,24,CHI,72,27,2291,464,1069,.434,142,346,.410,322,723,.445,.500,266,293,.908,40,181,221,213,55,8,150,171,1336,2008
Marcin Gortat,C,23,ORL,6,0,41,8,17,.471,0,0,.000,8,17,.471,.471,2,3,.667,8,8,16,2,1,1,2,4,18,2008
Joey Graham,SF,25,TOR,38,3,331,49,113,.434,2,3,.667,47,110,.427,.442,38,45,.844,18,49,67,15,3,0,23,47,138,2008
Stephen Graham,SF,25,IND,22,0,128,34,58,.586,7,14,.500,27,44,.614,.647,12,16,.750,4,18,22,9,4,1,10,14,87,2008
Danny Granger,SF,24,IND,80,80,2876,537,1205,.446,171,423,.404,366,782,.468,.517,322,378,.852,93,393,486,166,95,84,171,290,1567,2008
Aaron Gray,C,23,CHI,61,1,613,103,204,.505,0,1,.000,103,203,.507,.505,56,99,.566,70,98,168,41,21,16,57,117,262,2008
Gerald Green,SF,22,TOT,30,0,362,52,151,.344,15,39,.385,37,112,.330,.394,34,41,.829,13,51,64,29,8,4,32,45,153,2008
Gerald Green,SF,22,MIN,29,0,358,49,148,.331,15,39,.385,34,109,.312,.382,34,41,.829,11,51,62,29,8,4,32,43,147,2008
Gerald Green,SF,22,HOU,1,0,4,3,3,1.000,0,0,.000,3,3,1.000,1.000,0,0,.000,2,0,2,0,0,0,0,2,6,2008
Jeff Green,SF,21,SEA,80,52,2253,320,749,.427,21,76,.276,299,673,.444,.441,177,238,.744,101,278,379,119,46,49,158,198,838,2008
Taurean Green,SG-PG,21,TOT,17,0,74,7,25,.280,2,11,.182,5,14,.357,.320,11,12,.917,0,10,10,11,2,0,9,5,27,2008
Taurean Green,PG,21,POR,8,0,44,4,16,.250,1,8,.125,3,8,.375,.281,8,8,1.000,0,4,4,8,1,0,7,3,17,2008
Taurean Green,SG,21,DEN,9,0,30,3,9,.333,1,3,.333,2,6,.333,.389,3,4,.750,0,6,6,3,1,0,2,2,10,2008
Willie Green,SG,26,PHI,74,74,1970,379,870,.436,51,179,.285,328,691,.475,.465,112,148,.757,32,150,182,151,54,22,109,119,921,2008
Orien Greene,SG,25,SAC,7,2,61,3,11,.273,0,1,.000,3,10,.300,.273,0,0,.000,0,6,6,3,3,1,7,9,6,2008
Adrian Griffin,SG-SF,33,TOT,35,2,307,30,76,.395,0,0,.000,30,76,.395,.395,5,9,.556,28,31,59,27,17,2,21,27,65,2008
Adrian Griffin,SG,33,CHI,22,2,222,24,60,.400,0,0,.000,24,60,.400,.400,3,7,.429,19,18,37,22,12,1,16,19,51,2008
Adrian Griffin,SF,33,SEA,13,0,85,6,16,.375,0,0,.000,6,16,.375,.375,2,2,1.000,9,13,22,5,5,1,5,8,14,2008
Richard Hamilton,SG,29,DET,72,72,2424,499,1030,.484,62,141,.440,437,889,.492,.515,184,221,.833,75,160,235,299,73,10,132,171,1244,2008
Anfernee Hardaway,SF,36,MIA,16,8,325,22,60,.367,8,19,.421,14,41,.341,.433,8,9,.889,3,32,35,35,19,1,13,24,60,2008
Matt Harpring,SF,31,UTA,76,0,1374,237,474,.500,2,10,.200,235,464,.506,.502,146,205,.712,96,144,240,82,45,14,95,162,622,2008
Al Harrington,C,27,GSW,81,59,2190,401,923,.434,153,408,.375,248,515,.482,.517,147,190,.774,107,332,439,132,74,16,90,266,1102,2008
Othella Harrington,C,34,CHA,22,0,166,18,42,.429,0,0,.000,18,42,.429,.429,10,16,.625,11,31,42,4,1,4,11,34,46,2008
Devin Harris,PG,24,TOT,64,61,2022,321,693,.463,56,167,.335,265,526,.504,.504,248,301,.824,28,145,173,369,90,10,161,190,946,2008
Devin Harris,PG,24,DAL,39,39,1184,187,387,.483,25,70,.357,162,317,.511,.516,161,196,.821,17,74,91,206,56,2,93,127,560,2008
Devin Harris,PG,24,NJN,25,22,838,134,306,.438,31,97,.320,103,209,.493,.489,87,105,.829,11,71,82,163,34,8,68,63,386,2008
Mike Harris,PF,24,HOU,17,0,159,27,54,.500,0,2,.000,27,52,.519,.500,8,13,.615,24,30,54,3,6,3,9,16,62,2008
David Harrison,C,25,IND,55,0,702,90,170,.529,0,0,.000,90,170,.529,.529,49,96,.510,43,75,118,14,20,59,58,164,229,2008
Jason Hart,PG,29,UTA,57,0,606,58,180,.322,11,31,.355,47,149,.315,.353,38,45,.844,5,50,55,86,30,3,28,75,165,2008
Udonis Haslem,PF,27,MIA,49,48,1805,237,507,.467,0,0,.000,237,507,.467,.467,115,142,.810,107,336,443,68,39,18,67,145,589,2008
Trenton Hassell,SG,28,TOT,63,6,773,57,135,.422,2,9,.222,55,126,.437,.430,7,10,.700,20,63,83,41,13,3,22,90,123,2008
Trenton Hassell,SG,28,DAL,37,6,463,37,80,.463,1,4,.250,36,76,.474,.469,1,2,.500,11,33,44,26,9,1,14,55,76,2008
Trenton Hassell,SG,28,NJN,26,0,310,20,55,.364,1,5,.200,19,50,.380,.373,6,8,.750,9,30,39,15,4,2,8,35,47,2008
Spencer Hawes,C,19,SAC,71,8,931,146,318,.459,4,21,.190,142,297,.478,.465,38,58,.655,68,162,230,44,14,40,56,128,334,2008
Chuck Hayes,PF,24,HOU,79,44,1575,113,221,.511,0,3,.000,113,218,.518,.511,11,24,.458,132,295,427,91,85,43,62,212,237,2008
Jarvis Hayes,SF,26,DET,82,1,1287,217,504,.431,73,194,.376,144,310,.465,.503,45,60,.750,35,143,178,62,47,6,47,137,552,2008
Brendan Haywood,C,28,WAS,80,80,2228,316,599,.528,0,0,.000,316,599,.528,.528,216,294,.735,273,303,576,71,31,133,108,216,848,2008
Luther Head,SG,25,HOU,73,17,1379,206,477,.432,79,225,.351,127,252,.504,.515,66,81,.815,18,117,135,138,44,9,70,75,557,2008
Walter Herrmann,PF,28,TOT,45,0,373,56,144,.389,20,64,.313,36,80,.450,.458,21,25,.840,22,51,73,18,7,1,12,24,153,2008
Walter Herrmann,PF,28,CHA,17,0,174,25,65,.385,9,26,.346,16,39,.410,.454,9,10,.900,10,26,36,4,4,0,4,12,68,2008
Walter Herrmann,PF,28,DET,28,0,199,31,79,.392,11,38,.289,20,41,.488,.462,12,15,.800,12,25,37,14,3,1,8,12,85,2008
Nene Hilario,PF,25,DEN,16,1,266,29,71,.408,0,1,.000,29,70,.414,.408,27,49,.551,30,57,87,15,9,14,21,46,85,2008
Grant Hill,SF,35,PHO,70,68,2222,358,712,.503,33,104,.317,325,608,.535,.526,170,196,.867,74,279,353,203,65,56,96,153,919,2008
Kirk Hinrich,PG,27,CHI,75,72,2380,330,797,.414,84,240,.350,246,557,.442,.467,118,142,.831,28,216,244,452,87,19,157,224,862,2008
Ryan Hollins,PF,23,CHA,60,1,532,46,94,.489,0,0,.000,46,94,.489,.489,55,82,.671,53,54,107,14,10,30,25,96,147,2008
Al Horford,C,21,ATL,81,77,2540,333,668,.499,0,5,.000,333,663,.502,.499,155,212,.731,248,537,785,124,60,76,137,267,821,2008
Robert Horry,PF,37,SAS,45,5,583,38,119,.319,18,70,.257,20,49,.408,.395,18,28,.643,35,74,109,47,21,19,22,55,112,2008
Eddie House,PG,29,BOS,78,2,1480,217,531,.409,117,298,.393,100,233,.429,.519,33,36,.917,19,148,167,152,59,10,76,114,584,2008
Dwight Howard,C,22,ORL,82,82,3088,583,974,.599,0,4,.000,583,970,.601,.599,529,897,.590,279,882,1161,110,74,176,263,274,1695,2008
Josh Howard,SF,27,DAL,76,76,2757,567,1247,.455,67,210,.319,500,1037,.482,.482,312,384,.813,120,412,532,164,59,32,114,202,1513,2008
Juwan Howard,PF,34,DAL,50,0,353,23,64,.359,0,0,.000,23,64,.359,.359,11,14,.786,21,60,81,17,5,2,17,62,57,2008
Troy Hudson,PG,31,GSW,9,0,93,9,31,.290,4,12,.333,5,19,.263,.355,6,6,1.000,0,7,7,9,3,0,7,4,28,2008
Larry Hughes,PG-SG,29,TOT,68,57,2020,305,801,.381,67,194,.345,238,607,.392,.423,150,188,.798,39,191,230,181,99,17,116,139,827,2008
Larry Hughes,PG,29,CLE,40,32,1210,180,478,.377,43,126,.341,137,352,.389,.422,88,108,.815,27,116,143,94,60,11,72,91,491,2008
Larry Hughes,SG,29,CHI,28,25,810,125,323,.387,24,68,.353,101,255,.396,.424,62,80,.775,12,75,87,87,39,6,44,48,336,2008
Kris Humphries,PF,22,TOR,70,0,925,161,333,.483,0,2,.000,161,331,.486,.483,75,124,.605,90,169,259,28,25,28,47,107,397,2008
Lindsey Hunter,PG,37,DET,24,0,215,22,64,.344,7,26,.269,15,38,.395,.398,7,9,.778,4,9,13,33,13,2,13,30,58,2008
Steven Hunter,C,26,DEN,19,2,120,15,28,.536,0,0,.000,15,28,.536,.536,9,20,.450,10,19,29,0,0,6,7,20,39,2008
Andre Iguodala,SF,24,PHI,82,82,3242,582,1277,.456,101,307,.329,481,970,.496,.495,365,506,.721,85,361,446,391,171,49,214,187,1630,2008
Zydrunas Ilgauskas,C,32,CLE,73,73,2222,417,879,.474,0,1,.000,417,878,.475,.474,195,243,.802,263,419,682,104,34,120,135,247,1029,2008
Didier Ilunga-Mbenga,C,27,TOT,42,0,326,39,84,.464,0,0,.000,39,84,.464,.464,5,12,.417,28,44,72,10,7,26,12,70,83,2008
Didier Ilunga-Mbenga,C,27,GSW,16,0,130,9,23,.391,0,0,.000,9,23,.391,.391,1,2,.500,13,18,31,4,3,10,4,32,19,2008
Didier Ilunga-Mbenga,C,27,LAL,26,0,196,30,61,.492,0,0,.000,30,61,.492,.492,4,10,.400,15,26,41,6,4,16,8,38,64,2008
Allen Iverson,SG,32,DEN,82,82,3424,712,1556,.458,95,275,.345,617,1281,.482,.488,645,797,.809,47,196,243,586,160,12,245,109,2164,2008
Royal Ivey,PG,26,MIL,75,20,1437,149,378,.394,35,107,.327,114,271,.421,.440,85,117,.726,38,80,118,160,45,7,75,166,418,2008
Jarrett Jack,SG,24,POR,82,16,2229,267,620,.431,65,190,.342,202,430,.470,.483,215,248,.867,31,203,234,313,61,1,178,129,814,2008
Bobby Jackson,SG-PG,34,TOT,72,5,1389,204,506,.403,81,226,.358,123,280,.439,.483,64,81,.790,33,148,181,139,45,5,59,96,553,2008
Bobby Jackson,SG,34,NOH,46,0,891,116,296,.392,53,144,.368,63,152,.414,.481,40,49,.816,23,87,110,76,32,3,31,59,325,2008
Bobby Jackson,PG,34,HOU,26,5,498,88,210,.419,28,82,.341,60,128,.469,.486,24,32,.750,10,61,71,63,13,2,28,37,228,2008
Luke Jackson,SF,26,MIA,14,1,228,26,80,.325,11,30,.367,15,50,.300,.394,16,23,.696,7,26,33,17,8,0,9,22,79,2008
Stephen Jackson,SF,29,GSW,73,73,2855,488,1204,.405,182,501,.363,306,703,.435,.481,308,370,.832,67,251,318,300,92,29,197,171,1466,2008
Casey Jacobsen,SG,26,MEM,53,0,547,39,115,.339,16,72,.222,23,43,.535,.409,13,17,.765,12,53,65,20,5,1,16,34,107,2008
Jerome James,C,32,NYK,2,0,5,1,1,1.000,0,0,.000,1,1,1.000,1.000,2,2,1.000,0,3,3,0,0,0,0,0,4,2008
LeBron James,SF,23,CLE,75,74,3027,794,1642,.484,113,359,.315,681,1283,.531,.518,549,771,.712,133,459,592,539,138,81,255,165,2250,2008
Mike James,PG,32,TOT,54,1,720,101,290,.348,31,97,.320,70,193,.363,.402,39,48,.813,14,55,69,60,21,2,36,56,272,2008
Mike James,PG,32,HOU,33,1,537,79,226,.350,24,74,.324,55,152,.362,.403,33,42,.786,11,41,52,54,17,2,29,44,215,2008
Mike James,PG,32,NOH,21,0,183,22,64,.344,7,23,.304,15,41,.366,.398,6,6,1.000,3,14,17,6,4,0,7,12,57,2008
Antawn Jamison,PF,31,WAS,79,79,3061,618,1417,.436,120,354,.339,498,1063,.468,.478,333,438,.760,215,591,806,120,106,34,113,195,1689,2008
Marko Jaric,SG,29,MIN,75,56,2189,227,528,.430,46,127,.362,181,401,.451,.473,121,163,.742,38,184,222,311,97,32,128,180,621,2008
Al Jefferson,C,23,MIN,82,82,2919,721,1441,.500,0,5,.000,721,1436,.502,.500,284,394,.721,308,603,911,117,74,119,167,222,1726,2008
Richard Jefferson,SF,27,NJN,82,82,3200,619,1328,.466,77,213,.362,542,1115,.486,.495,542,679,.798,93,249,342,252,76,21,199,225,1857,2008
Jared Jeffries,SF,26,NYK,73,19,1325,108,270,.400,4,25,.160,104,245,.424,.407,49,93,.527,118,125,243,66,36,23,64,132,269,2008
Yi Jianlian,PF,20,MIL,66,49,1647,219,520,.421,6,21,.286,213,499,.427,.427,122,145,.841,106,238,344,55,36,56,90,153,566,2008
Alexander Johnson,PF,24,MIA,43,6,549,61,125,.488,0,0,.000,61,125,.488,.488,57,83,.687,32,62,94,13,13,10,42,80,179,2008
Amir Johnson,PF,20,DET,62,0,764,92,165,.558,0,0,.000,92,165,.558,.558,37,55,.673,87,148,235,29,24,82,39,141,221,2008
Anthony Johnson,PG,33,TOT,69,52,1531,155,355,.437,42,93,.452,113,262,.431,.496,35,43,.814,22,115,137,262,52,9,84,115,387,2008
Anthony Johnson,PG,33,ATL,42,41,1121,115,267,.431,27,63,.429,88,204,.431,.481,26,32,.813,17,81,98,202,42,8,50,86,283,2008
Anthony Johnson,PG,33,SAC,27,11,410,40,88,.455,15,30,.500,25,58,.431,.540,9,11,.818,5,34,39,60,10,1,34,29,104,2008
DerMarr Johnson,SF,27,SAS,5,0,28,7,14,.500,3,9,.333,4,5,.800,.607,0,2,.000,0,1,1,1,1,0,0,4,17,2008
Joe Johnson,SG,26,ATL,82,82,3343,647,1497,.432,169,444,.381,478,1053,.454,.489,316,379,.834,83,284,367,474,84,18,223,168,1779,2008
Linton Johnson,PF,27,TOT,8,0,63,9,19,.474,1,3,.333,8,16,.500,.500,2,2,1.000,5,9,14,4,0,1,5,11,21,2008
Linton Johnson,PF,27,PHO,6,0,53,7,14,.500,1,2,.500,6,12,.500,.536,0,0,.000,5,8,13,3,0,1,2,10,15,2008
Linton Johnson,PF,27,TOR,2,0,10,2,5,.400,0,1,.000,2,4,.500,.400,2,2,1.000,0,1,1,1,0,0,3,1,6,2008
Bobby Jones,C-SF,24,TOT,47,2,531,60,140,.429,18,53,.340,42,87,.483,.493,40,51,.784,29,63,92,28,15,3,28,85,178,2008
Bobby Jones,C,24,DEN,25,0,222,26,64,.406,9,23,.391,17,41,.415,.477,23,28,.821,11,27,38,11,5,1,14,46,84,2008
Bobby Jones,SF,24,MEM,9,2,137,14,36,.389,3,13,.231,11,23,.478,.431,9,10,.900,10,17,27,11,5,2,5,17,40,2008
Bobby Jones,SF,24,HOU,4,0,9,2,4,.500,0,0,.000,2,4,.500,.500,0,0,.000,0,1,1,0,1,0,1,3,4,2008
Bobby Jones,SF,24,MIA,6,0,143,17,32,.531,6,15,.400,11,17,.647,.625,8,13,.615,8,16,24,5,2,0,7,18,48,2008
Bobby Jones,SF,24,SAS,3,0,20,1,4,.250,0,2,.000,1,2,.500,.250,0,0,.000,0,2,2,1,2,0,1,1,2,2008
Dahntay Jones,SG,27,SAC,25,0,206,23,53,.434,1,6,.167,22,47,.468,.443,34,51,.667,7,28,35,12,8,6,10,28,81,2008
Damon Jones,SG,31,CLE,67,3,1336,151,363,.416,115,276,.417,36,87,.414,.574,20,28,.714,5,67,72,126,19,1,36,66,437,2008
Dwayne Jones,PF,24,CLE,56,0,472,25,47,.532,0,1,.000,25,46,.543,.532,28,58,.483,69,71,140,10,10,25,17,88,78,2008
Eddie Jones,SG,36,DAL,47,33,922,66,180,.367,34,116,.293,32,64,.500,.461,10,14,.714,18,114,132,69,26,8,29,72,176,2008
Fred Jones,SG,28,NYK,70,26,1757,182,432,.421,74,192,.385,108,240,.450,.507,94,126,.746,30,140,170,166,48,18,78,140,532,2008
James Jones,SF,27,POR,58,3,1276,143,327,.437,91,205,.444,52,122,.426,.576,86,98,.878,43,118,161,34,24,15,28,96,463,2008
Solomon Jones,PF,23,ATL,35,0,145,12,30,.400,0,2,.000,12,28,.429,.400,11,20,.550,19,23,42,0,3,5,11,28,35,2008
Chris Kaman,C,25,LAC,56,55,2083,338,700,.483,0,4,.000,338,696,.486,.483,202,265,.762,173,538,711,107,33,155,164,179,878,2008
Jason Kapono,SF,26,TOR,81,7,1530,243,498,.488,57,118,.483,186,380,.489,.545,37,43,.860,31,89,120,65,34,2,58,131,580,2008
Coby Karl,SG,24,LAL,17,0,71,9,26,.346,4,13,.308,5,13,.385,.423,8,10,.800,3,11,14,9,4,2,5,4,30,2008
Viktor Khryapa,PF,25,CHI,9,0,105,12,31,.387,0,1,.000,12,30,.400,.387,8,14,.571,6,14,20,8,6,0,6,11,32,2008
Jason Kidd,PG,34,TOT,80,80,2906,305,793,.385,119,312,.381,186,481,.387,.460,135,165,.818,94,506,600,806,136,26,266,165,864,2008
Jason Kidd,PG,34,NJN,51,51,1895,201,549,.366,84,236,.356,117,313,.374,.443,91,111,.820,58,354,412,530,74,15,185,90,577,2008
Jason Kidd,PG,34,DAL,29,29,1011,104,244,.426,35,76,.461,69,168,.411,.498,44,54,.815,36,152,188,276,62,11,81,75,287,2008
Tarence Kinsey,SG,23,MEM,11,0,96,16,38,.421,3,7,.429,13,31,.419,.461,5,6,.833,3,9,12,2,3,0,3,11,40,2008
Andrei Kirilenko,SF,26,UTA,72,72,2217,275,544,.506,44,116,.379,231,428,.540,.546,198,257,.770,121,218,339,285,86,109,140,165,792,2008
Linas Kleiza,SF,23,DEN,79,13,1889,311,659,.472,94,277,.339,217,382,.568,.543,164,213,.770,92,241,333,95,44,19,89,181,880,2008
Brevin Knight,PG,32,LAC,74,39,1674,138,342,.404,0,6,.000,138,336,.411,.404,62,71,.873,15,127,142,328,100,11,71,160,338,2008
Kyle Korver,SG-PF,26,TOT,75,0,1732,255,575,.443,111,296,.375,144,279,.516,.540,119,130,.915,21,151,172,101,42,29,75,192,740,2008
Kyle Korver,PF,26,PHI,25,0,657,90,227,.396,38,108,.352,52,119,.437,.480,31,34,.912,12,61,73,33,20,6,28,67,249,2008
Kyle Korver,SG,26,UTA,50,0,1075,165,348,.474,73,188,.388,92,160,.575,.579,88,96,.917,9,90,99,68,22,23,47,125,491,2008
Nenad Krstic,C,24,NJN,45,38,812,123,300,.410,0,2,.000,123,298,.413,.410,52,69,.754,35,165,200,27,9,17,41,111,298,2008
Raef LaFrentz,C,31,POR,39,0,291,27,61,.443,0,4,.000,27,57,.474,.443,11,19,.579,28,39,67,6,12,17,10,59,65,2008
Carl Landry,PF,24,HOU,42,0,711,135,219,.616,0,1,.000,135,218,.619,.616,72,109,.661,96,111,207,21,17,7,26,98,342,2008
Keith Langford,SG,24,SAS,2,0,10,1,4,.250,0,0,.000,1,4,.250,.250,0,0,.000,0,2,2,0,0,0,0,1,2,2008
Stephane Lasme,PF-SF,25,TOT,16,4,303,32,71,.451,0,0,.000,32,71,.451,.451,19,32,.594,26,27,53,3,13,22,15,35,83,2008
Stephane Lasme,SF,25,GSW,1,0,0,0,0,.000,0,0,.000,0,0,.000,.000,0,0,.000,0,0,0,0,0,0,0,0,0,2008
Stephane Lasme,PF,25,MIA,15,4,303,32,71,.451,0,0,.000,32,71,.451,.451,19,32,.594,26,27,53,3,13,22,15,35,83,2008
Acie Law,PG,23,ATL,56,6,865,95,237,.401,7,34,.206,88,203,.433,.416,38,48,.792,12,45,57,113,29,0,56,73,235,2008
David Lee,PF,24,NYK,81,29,2356,341,618,.552,0,2,.000,341,616,.554,.552,194,237,.819,242,482,724,95,55,29,97,210,876,2008
Rashard Lewis,PF,28,ORL,81,81,3076,516,1135,.455,226,553,.409,290,582,.498,.554,218,260,.838,97,340,437,196,99,38,140,214,1476,2008
Kyle Lowry,PG,21,MEM,82,9,2089,256,592,.432,36,140,.257,220,452,.487,.463,243,348,.698,41,209,250,296,92,22,127,185,791,2008
Tyronn Lue,PG,30,TOT,50,3,736,113,253,.447,39,86,.453,74,167,.443,.524,25,32,.781,9,45,54,74,11,1,27,66,290,2008
Tyronn Lue,PG,30,ATL,33,3,564,86,196,.439,30,69,.435,56,127,.441,.515,24,28,.857,9,32,41,59,11,0,22,38,226,2008
Tyronn Lue,PG,30,DAL,17,0,172,27,57,.474,9,17,.529,18,40,.450,.553,1,4,.250,0,13,13,15,0,1,5,28,64,2008
Mark Madsen,PF,32,MIN,20,6,151,3,19,.158,0,0,.000,3,19,.158,.158,3,12,.250,18,20,38,4,3,2,9,25,9,2008
Corey Maggette,SF,28,LAC,70,65,2502,458,1000,.458,78,203,.384,380,797,.477,.497,553,681,.812,78,316,394,189,71,7,195,210,1547,2008
Jamaal Magloire,C,29,TOT,31,2,286,18,55,.327,0,0,.000,18,55,.327,.327,20,44,.455,19,70,89,7,1,10,30,50,56,2008
Jamaal Magloire,C,29,NJN,24,2,259,15,49,.306,0,0,.000,15,49,.306,.306,14,31,.452,18,63,81,7,0,10,23,42,44,2008
Jamaal Magloire,C,29,DAL,7,0,27,3,6,.500,0,0,.000,3,6,.500,.500,6,13,.462,1,7,8,0,1,0,7,8,12,2008
Ian Mahinmi,C,21,SAS,6,0,23,6,12,.500,0,0,.000,6,12,.500,.500,9,9,1.000,0,5,5,1,0,4,2,4,21,2008
Stephon Marbury,PG,30,NYK,24,19,805,111,265,.419,28,74,.378,83,191,.435,.472,83,116,.716,17,42,59,113,21,2,48,57,333,2008
Shawn Marion,PF,29,TOT,63,62,2315,400,787,.508,66,198,.333,334,589,.567,.550,106,150,.707,136,507,643,138,125,85,86,150,972,2008
Shawn Marion,PF,29,PHO,47,47,1713,304,578,.526,58,167,.347,246,411,.599,.576,77,108,.713,86,378,464,98,95,70,49,117,743,2008
Shawn Marion,PF,29,MIA,16,15,602,96,209,.459,8,31,.258,88,178,.494,.478,29,42,.690,50,129,179,40,30,15,37,33,229,2008
Sean Marks,C,32,PHO,19,0,130,23,43,.535,1,4,.250,22,39,.564,.547,12,19,.632,9,27,36,4,3,10,8,23,59,2008
Donyell Marshall,PF,34,TOT,26,1,340,32,98,.327,15,53,.283,17,45,.378,.403,19,22,.864,24,52,76,10,6,16,15,31,98,2008
Donyell Marshall,PF,34,CLE,11,1,156,13,44,.295,8,23,.348,5,21,.238,.386,7,9,.778,9,21,30,5,2,9,6,16,41,2008
Donyell Marshall,PF,34,SEA,15,0,184,19,54,.352,7,30,.233,12,24,.500,.417,12,13,.923,15,31,46,5,4,7,9,15,57,2008
Darrick Martin,PG,36,TOR,17,0,141,10,43,.233,2,16,.125,8,27,.296,.256,5,6,.833,3,4,7,21,6,0,1,12,27,2008
Kenyon Martin,PF,30,DEN,71,71,2159,376,699,.538,2,11,.182,374,688,.544,.539,123,212,.580,105,356,461,90,88,85,91,235,877,2008
Kevin Martin,SG,24,SAC,61,57,2216,417,914,.456,107,266,.402,310,648,.478,.515,502,578,.869,48,225,273,129,62,5,131,150,1443,2008
Desmond Mason,SF,30,MIL,59,56,1702,230,477,.482,0,0,.000,230,477,.482,.482,114,173,.659,75,181,256,121,40,30,83,106,574,2008
Roger Mason,PG,27,WAS,80,9,1708,266,600,.443,130,327,.398,136,273,.498,.552,62,71,.873,17,113,130,134,40,18,69,140,724,2008
Jason Maxiell,C,24,DET,82,7,1768,240,446,.538,0,1,.000,240,445,.539,.538,171,270,.633,177,256,433,46,21,94,71,183,651,2008
Rashad McCants,SG,23,MIN,75,24,2020,428,944,.453,142,349,.407,286,595,.481,.529,116,155,.748,50,156,206,162,66,18,172,234,1114,2008
Jelani McCoy,C,30,DEN,6,1,33,1,1,1.000,0,0,.000,1,1,1.000,1.000,1,2,.500,1,6,7,0,0,5,4,7,3,2008
Antonio McDyess,PF,33,DET,78,78,2285,293,600,.488,0,2,.000,293,598,.490,.488,97,156,.622,204,462,666,89,61,53,75,246,683,2008
Tracy McGrady,SG,28,HOU,66,62,2440,548,1307,.419,86,295,.292,462,1012,.457,.452,245,358,.684,42,297,339,387,68,30,160,91,1427,2008
Dominic McGuire,SG,22,WAS,70,1,695,39,103,.379,1,6,.167,38,97,.392,.383,14,32,.438,53,86,139,40,20,26,40,76,93,2008
Jeff McInnis,PG,33,CHA,54,26,1410,108,249,.434,3,19,.158,105,230,.457,.440,23,30,.767,16,80,96,220,23,3,76,120,242,2008
Josh McRoberts,PF,20,POR,8,0,28,6,10,.600,0,1,.000,6,9,.667,.600,0,0,.000,2,8,10,2,1,0,2,1,12,2008
Chris Mihm,C,28,LAL,23,5,278,32,95,.337,0,0,.000,32,95,.337,.337,18,27,.667,28,49,77,13,4,14,17,42,82,2008
C.J. Miles,SG,20,UTA,60,13,689,113,236,.479,30,77,.390,83,159,.522,.542,41,52,.788,16,62,78,53,32,8,27,98,297,2008
Darko Milicic,C,22,MEM,70,64,1663,219,500,.438,0,1,.000,219,499,.439,.438,67,121,.554,127,297,424,58,32,114,101,185,505,2008
Andre Miller,PG,31,PHI,82,82,3016,569,1156,.492,3,34,.088,566,1122,.504,.494,257,333,.772,95,229,324,565,105,6,206,181,1398,2008
Brad Miller,C,31,SAC,72,72,2513,337,728,.463,28,90,.311,309,638,.484,.482,262,309,.848,167,514,681,264,69,74,164,247,964,2008
Mike Miller,SG,27,MEM,70,70,2474,414,824,.502,155,359,.432,259,465,.557,.596,164,212,.774,51,416,467,240,35,16,182,145,1147,2008
Paul Millsap,PF,22,UTA,82,2,1702,253,502,.504,0,4,.000,253,498,.508,.504,155,229,.677,167,293,460,81,72,73,87,269,661,2008
Yao Ming,C,27,HOU,55,55,2044,432,852,.507,0,2,.000,432,850,.508,.507,345,406,.850,172,422,594,129,25,111,183,171,1209,2008
Cuttino Mobley,SG,32,LAC,77,38,2702,377,870,.433,67,192,.349,310,678,.457,.472,163,199,.819,50,225,275,202,78,34,123,152,984,2008
Nazr Mohammed,C,30,TOT,82,29,1650,272,528,.515,0,1,.000,272,527,.516,.515,95,163,.583,194,300,494,72,45,60,101,230,639,2008
Nazr Mohammed,C,30,DET,21,0,228,28,59,.475,0,1,.000,28,58,.483,.475,13,30,.433,29,44,73,6,7,8,11,36,69,2008
Nazr Mohammed,C,30,CHA,61,29,1422,244,469,.520,0,0,.000,244,469,.520,.520,82,133,.617,165,256,421,66,38,52,90,194,570,2008
Jamario Moon,SF,27,TOR,78,75,2166,279,575,.485,40,122,.328,239,453,.528,.520,63,85,.741,92,392,484,90,80,108,51,152,661,2008
Mikki Moore,PF,32,SAC,82,79,2385,282,489,.577,0,2,.000,282,487,.579,.577,134,182,.736,160,334,494,84,35,46,110,310,698,2008
Randolph Morris,C,22,NYK,18,2,181,21,58,.362,0,0,.000,21,58,.362,.362,14,29,.483,12,25,37,2,4,2,9,37,56,2008
Alonzo Mourning,C,37,MIA,25,0,389,52,95,.547,0,0,.000,52,95,.547,.547,45,76,.592,34,59,93,7,4,42,25,56,149,2008
Troy Murphy,PF,27,IND,75,61,2106,315,693,.455,94,236,.398,221,457,.484,.522,192,241,.797,108,435,543,165,49,32,96,217,916,2008
Ronald Murray,PG,28,TOT,42,19,874,154,367,.420,20,63,.317,134,304,.441,.447,68,98,.694,23,60,83,144,38,4,84,50,396,2008
Ronald Murray,PG,28,DET,19,2,347,57,139,.410,6,27,.222,51,112,.455,.432,22,37,.595,13,23,36,64,13,1,31,19,142,2008
Ronald Murray,PG,28,IND,23,17,527,97,228,.425,14,36,.389,83,192,.432,.456,46,61,.754,10,37,47,80,25,3,53,31,254,2008
Dikembe Mutombo,C,41,HOU,39,25,619,43,80,.538,0,0,.000,43,80,.538,.538,32,45,.711,68,131,199,5,11,48,17,55,118,2008
Bostjan Nachbar,PF,27,NJN,75,1,1660,245,609,.402,94,262,.359,151,347,.435,.479,154,196,.786,56,204,260,88,44,21,85,182,738,2008
Eduardo Najera,PF,31,DEN,78,3,1664,174,368,.473,53,147,.361,121,221,.548,.545,63,89,.708,113,224,337,95,69,40,59,199,464,2008
Steve Nash,PG,33,PHO,81,81,2780,485,962,.504,179,381,.470,306,581,.527,.597,222,245,.906,28,254,282,898,53,5,295,113,1371,2008
Juan Carlos Navarro,SG,27,MEM,82,30,2117,308,766,.402,156,432,.361,152,334,.455,.504,124,146,.849,34,176,210,177,48,1,134,94,896,2008
Jameer Nelson,PG,25,ORL,69,62,1961,283,603,.469,64,154,.416,219,449,.488,.522,125,151,.828,28,215,243,383,63,4,141,167,755,2008
Rasho Nesterovic,C,31,TOR,71,39,1486,257,467,.550,1,3,.333,256,464,.552,.551,37,49,.755,130,212,342,82,20,52,60,132,552,2008
Ira Newble,SG-SF,33,TOT,49,13,698,76,174,.437,16,49,.327,60,125,.480,.483,20,26,.769,47,78,125,18,28,8,34,69,188,2008
Ira Newble,SG,33,CLE,41,13,650,71,158,.449,15,45,.333,56,113,.496,.497,20,26,.769,41,73,114,14,27,7,31,64,177,2008
Ira Newble,SF,33,SEA,2,0,17,2,7,.286,0,2,.000,2,5,.400,.286,0,0,.000,0,0,0,1,0,0,0,0,4,2008
Ira Newble,SF,33,LAL,6,0,31,3,9,.333,1,2,.500,2,7,.286,.389,0,0,.000,6,5,11,3,1,1,3,5,7,2008
Demetris Nichols,SF,23,TOT,14,0,44,6,23,.261,3,13,.231,3,10,.300,.326,0,0,.000,0,5,5,1,0,3,4,4,15,2008
Demetris Nichols,SF,23,CLE,3,0,14,1,8,.125,0,3,.000,1,5,.200,.125,0,0,.000,0,1,1,0,0,0,2,0,2,2008
Demetris Nichols,SF,23,CHI,11,0,30,5,15,.333,3,10,.300,2,5,.400,.433,0,0,.000,0,4,4,1,0,3,2,4,13,2008
Joakim Noah,C,22,CHI,74,31,1534,177,367,.482,0,1,.000,177,366,.484,.482,134,194,.691,174,242,416,84,68,64,89,173,488,2008
Andres Nocioni,SF,28,CHI,82,27,2021,379,877,.432,126,346,.364,253,531,.476,.504,196,243,.807,48,294,342,95,25,43,133,245,1080,2008
Steve Novak,SF,24,HOU,35,0,264,49,102,.480,34,71,.479,15,31,.484,.647,3,4,.750,4,31,35,6,2,3,4,17,135,2008
Dirk Nowitzki,PF,29,DAL,77,77,2769,630,1314,.479,79,220,.359,551,1094,.504,.510,478,544,.879,95,564,659,266,51,71,160,198,1817,2008
Patrick O'Bryant,C,21,GSW,24,0,99,16,29,.552,0,0,.000,16,29,.552,.552,3,5,.600,10,19,29,4,4,9,7,27,35,2008
Jermaine O'Neal,C,29,IND,42,34,1206,225,512,.439,0,5,.000,225,507,.444,.439,121,163,.742,82,201,283,93,20,87,106,129,571,2008
Shaquille O'Neal,C,35,TOT,61,61,1748,331,558,.593,0,0,.000,331,558,.593,.593,170,338,.503,166,388,554,93,32,88,181,228,832,2008
Shaquille O'Neal,C,35,MIA,33,33,945,191,329,.581,0,0,.000,191,329,.581,.581,88,178,.494,99,159,258,45,19,54,98,134,470,2008
Shaquille O'Neal,C,35,PHO,28,28,803,140,229,.611,0,0,.000,140,229,.611,.611,82,160,.513,67,229,296,48,13,34,83,94,362,2008
Fabricio Oberto,PF,32,SAS,82,64,1644,180,296,.608,0,1,.000,180,295,.610,.608,37,61,.607,153,277,430,95,37,20,51,203,397,2008
Lamar Odom,PF,28,LAL,77,77,2921,417,795,.525,31,113,.274,386,682,.566,.544,229,328,.698,197,622,819,273,75,72,156,222,1094,2008
Emeka Okafor,C,25,CHA,82,82,2718,460,860,.535,0,0,.000,460,860,.535,.535,213,374,.570,255,621,876,70,62,138,164,241,1133,2008
Mehmet Okur,C,28,UTA,72,72,2390,374,841,.445,114,294,.388,260,547,.475,.512,185,230,.804,132,424,556,145,55,29,104,236,1047,2008
Kevin Ollie,SG,35,PHI,40,0,300,29,69,.420,0,1,.000,29,68,.426,.420,12,15,.800,4,15,19,38,10,0,5,28,70,2008
Bo Outlaw,PF,36,ORL,2,0,7,2,3,.667,0,0,.000,2,3,.667,.667,0,0,.000,0,0,0,0,0,0,1,1,4,2008
Travis Outlaw,PF,23,POR,82,6,2186,417,964,.433,40,101,.396,377,863,.437,.453,218,294,.741,96,280,376,106,59,63,107,173,1092,2008
Andre Owens,PG,27,IND,31,7,392,40,107,.374,18,40,.450,22,67,.328,.458,25,34,.735,13,34,47,47,13,3,24,37,123,2008
Zaza Pachulia,C,23,ATL,62,5,944,107,245,.437,0,3,.000,107,242,.442,.437,108,153,.706,89,159,248,36,24,13,69,140,322,2008
Jannero Pargo,SG,28,NOH,80,5,1497,254,652,.390,65,186,.349,189,466,.406,.439,71,81,.877,26,104,130,192,50,5,93,123,644,2008
Anthony Parker,SG,32,TOR,82,82,2634,395,829,.476,133,304,.438,262,525,.499,.557,102,125,.816,50,284,334,183,79,17,87,157,1025,2008
Smush Parker,PG,26,TOT,28,2,592,64,184,.348,18,78,.231,46,106,.434,.397,19,28,.679,4,47,51,84,24,6,44,60,165,2008
Smush Parker,PG,26,MIA,9,0,183,17,54,.315,6,24,.250,11,30,.367,.370,3,4,.750,2,17,19,15,5,3,8,13,43,2008
Smush Parker,PG,26,LAC,19,2,409,47,130,.362,12,54,.222,35,76,.461,.408,16,24,.667,2,30,32,69,19,3,36,47,122,2008
Tony Parker,PG,25,SAS,69,68,2312,515,1043,.494,17,66,.258,498,977,.510,.502,248,347,.715,30,191,221,411,55,8,164,93,1295,2008
Ruben Patterson,SF,32,LAC,20,5,327,39,86,.453,0,2,.000,39,84,.464,.453,24,43,.558,24,40,64,17,21,7,27,37,102,2008
Chris Paul,PG,22,NOH,80,80,3006,630,1291,.488,92,249,.369,538,1042,.516,.524,332,390,.851,62,259,321,925,217,4,201,185,1684,2008
Sasha Pavlovic,SG,24,CLE,51,45,1188,146,403,.362,34,114,.298,112,289,.388,.404,53,77,.688,35,93,128,82,29,6,55,117,379,2008
Oleksiy Pecherov,C,22,WAS,35,0,320,44,125,.352,17,60,.283,27,65,.415,.420,20,31,.645,21,45,66,7,6,5,17,30,125,2008
Kendrick Perkins,C,23,BOS,78,78,1912,214,348,.615,0,1,.000,214,347,.617,.615,114,183,.623,145,329,474,84,31,114,125,242,542,2008
Kosta Perovic,C,22,GSW,7,0,38,3,10,.300,0,0,.000,3,10,.300,.300,4,6,.667,6,7,13,1,0,2,1,6,10,2008
Morris Peterson,SG,30,NOH,76,76,1796,215,516,.417,113,287,.394,102,229,.445,.526,65,85,.765,36,170,206,67,47,7,41,125,608,2008
Johan Petro,C,22,SEA,72,28,1310,184,439,.419,0,1,.000,184,438,.420,.419,64,87,.736,98,272,370,32,35,42,73,173,432,2008
Eric Piatkowski,SF,37,PHO,16,0,113,12,33,.364,11,26,.423,1,7,.143,.530,4,4,1.000,1,11,12,10,0,1,6,11,39,2008
Paul Pierce,SF,30,BOS,80,80,2874,509,1098,.464,143,365,.392,366,733,.499,.529,409,485,.843,53,358,411,363,101,36,221,200,1570,2008
Mickael Pietrus,SF,25,GSW,66,16,1316,170,387,.439,66,183,.361,104,204,.510,.525,66,98,.673,67,175,242,49,66,43,48,200,472,2008
Scot Pollard,C,32,BOS,22,0,173,12,23,.522,0,0,.000,12,23,.522,.522,15,22,.682,14,23,37,3,3,6,5,43,39,2008
James Posey,PF,31,BOS,74,2,1821,173,414,.418,106,279,.380,67,135,.496,.546,93,115,.809,30,292,322,114,72,19,65,182,545,2008
Leon Powe,C,24,BOS,56,5,809,154,269,.572,0,1,.000,154,268,.575,.572,137,193,.710,95,132,227,15,15,16,43,127,445,2008
Josh Powell,C,25,LAC,64,25,1228,145,315,.460,0,3,.000,145,312,.465,.460,63,87,.724,115,216,331,47,14,23,65,130,353,2008
Kasib Powell,SF,26,MIA,11,4,304,35,95,.368,8,33,.242,27,62,.435,.411,6,9,.667,8,36,44,18,9,2,5,18,84,2008
Ronnie Price,PG,24,UTA,61,3,588,88,204,.431,26,75,.347,62,129,.481,.495,26,38,.684,8,38,46,78,32,3,30,83,228,2008
Tayshaun Prince,SF,27,DET,82,82,2694,421,940,.448,53,146,.363,368,794,.463,.476,185,241,.768,109,289,398,268,42,33,91,90,1080,2008
Gabe Pruitt,PG,21,BOS,15,0,95,14,39,.359,3,12,.250,11,27,.407,.397,1,2,.500,1,7,8,13,5,0,5,10,32,2008
Joel Przybilla,C,28,POR,77,67,1819,144,250,.576,0,1,.000,144,249,.578,.576,83,122,.680,195,454,649,27,13,93,95,234,371,2008
Chris Quinn,PG,24,MIA,60,25,1340,158,373,.424,64,159,.403,94,214,.439,.509,85,98,.867,11,107,118,178,46,4,55,90,465,2008
Vladimir Radmanovic,SF,27,LAL,65,41,1483,198,437,.453,95,234,.406,103,203,.507,.562,52,65,.800,56,159,215,123,46,12,73,147,543,2008
Shavlik Randolph,PF,24,PHI,9,0,27,4,14,.286,0,0,.000,4,14,.286,.286,0,0,.000,9,2,11,3,1,3,2,5,8,2008
Zach Randolph,C,26,NYK,69,68,2244,486,1058,.459,22,80,.275,464,978,.474,.470,223,289,.772,184,526,710,140,59,16,186,194,1217,2008
Theo Ratliff,C-PF,34,TOT,26,9,437,41,85,.482,0,1,.000,41,84,.488,.482,29,43,.674,32,57,89,14,7,37,21,59,111,2008
Theo Ratliff,PF,34,MIN,10,6,214,23,45,.511,0,1,.000,23,44,.523,.511,17,25,.680,13,26,39,7,3,19,12,30,63,2008
Theo Ratliff,C,34,DET,16,3,223,18,40,.450,0,0,.000,18,40,.450,.450,12,18,.667,19,31,50,7,4,18,9,29,48,2008
Michael Redd,SG,28,MIL,72,71,2702,550,1243,.442,130,359,.362,420,884,.475,.495,402,490,.820,85,224,309,247,65,13,181,120,1632,2008
J.J. Redick,SG,23,ORL,34,0,276,48,108,.444,17,43,.395,31,65,.477,.523,27,34,.794,1,22,23,16,4,0,15,29,140,2008
Chris Richard,C,23,MIN,52,3,556,41,87,.471,0,0,.000,41,87,.471,.471,16,27,.593,52,83,135,18,10,12,24,83,98,2008
Jason Richardson,SF,27,CHA,82,82,3149,648,1468,.441,243,599,.406,405,869,.466,.524,249,331,.752,80,361,441,258,116,57,166,241,1788,2008
Jeremy Richardson,SG-SF,23,TOT,27,1,132,16,44,.364,7,19,.368,9,25,.360,.443,2,2,1.000,1,8,9,2,3,0,6,13,41,2008
Jeremy Richardson,SF,23,MEM,3,0,15,0,6,.000,0,2,.000,0,4,.000,.000,0,0,.000,0,1,1,1,0,0,1,2,0,2008
Jeremy Richardson,SG,23,SAS,5,1,29,3,7,.429,2,5,.400,1,2,.500,.571,2,2,1.000,0,1,1,1,1,0,0,5,10,2008
Jeremy Richardson,SF,23,ATL,19,0,88,13,31,.419,5,12,.417,8,19,.421,.500,0,0,.000,1,6,7,0,2,0,5,6,31,2008
Quentin Richardson,SF,27,NYK,65,65,1841,199,555,.359,69,214,.322,130,341,.381,.421,60,88,.682,56,259,315,116,44,15,69,153,527,2008
Luke Ridnour,PG,26,SEA,61,5,1223,147,368,.399,21,71,.296,126,297,.424,.428,78,91,.857,13,81,94,241,37,14,80,120,393,2008
Nate Robinson,PG,23,NYK,72,17,1883,331,782,.423,97,292,.332,234,490,.478,.485,154,196,.786,51,171,222,212,60,1,103,186,913,2008
Sergio Rodriguez,PG,21,POR,72,0,628,69,196,.352,17,58,.293,52,138,.377,.395,25,38,.658,13,45,58,123,24,0,53,57,180,2008
Rajon Rondo,PG,21,BOS,77,77,2306,351,713,.492,5,19,.263,346,694,.499,.496,107,175,.611,78,244,322,393,129,13,147,187,814,2008
Malik Rose,PF,33,NYK,49,3,494,66,180,.367,2,7,.286,64,173,.370,.372,37,51,.725,31,72,103,28,16,7,40,80,171,2008
Quinton Ross,SG,26,LAC,76,44,1505,131,335,.391,9,21,.429,122,314,.389,.404,40,60,.667,54,118,172,88,43,33,29,132,311,2008
Brandon Roy,SG,23,POR,74,74,2792,531,1170,.454,73,215,.340,458,955,.480,.485,281,373,.753,81,267,348,430,79,16,136,147,1416,2008
Michael Ruffin,C,31,MIL,46,2,632,33,62,.532,0,0,.000,33,62,.532,.532,25,63,.397,90,96,186,24,31,19,19,93,91,2008
Kareem Rush,SG,27,IND,71,15,1504,228,569,.401,102,262,.389,126,307,.410,.490,30,42,.714,19,149,168,89,42,19,62,108,588,2008
John Salmons,SG,28,SAC,81,41,2517,381,799,.477,39,120,.325,342,679,.504,.501,214,260,.823,76,273,349,208,93,31,170,171,1015,2008
Cheikh Samb,C,23,DET,4,0,31,3,4,.750,0,0,.000,3,4,.750,.750,1,2,.500,3,4,7,0,1,2,1,8,7,2008
Brian Scalabrine,PF,29,BOS,48,9,512,29,94,.309,15,46,.326,14,48,.292,.388,15,20,.750,22,57,79,40,9,8,26,63,88,2008
Luis Scola,PF,27,HOU,82,39,2024,345,670,.515,0,3,.000,345,667,.517,.515,157,235,.668,174,351,525,106,60,19,105,235,847,2008
Thabo Sefolosha,SG,23,CHI,69,22,1436,180,421,.428,29,88,.330,151,333,.453,.462,75,104,.721,50,205,255,129,61,30,93,128,464,2008
Mouhamed Sene,C,21,SEA,13,0,62,11,24,.458,0,0,.000,11,24,.458,.458,8,17,.471,7,9,16,1,0,7,0,9,30,2008
Ramon Sessions,PG,21,MIL,17,7,450,51,117,.436,3,7,.429,48,110,.436,.449,32,41,.780,8,50,58,127,17,3,36,26,137,2008
Bobby Simmons,SF,27,MIL,70,21,1521,209,496,.421,60,171,.351,149,325,.458,.482,53,70,.757,67,159,226,80,50,5,78,140,531,2008
Cedric Simmons,PF,22,TOT,14,0,87,4,14,.286,0,0,.000,4,14,.286,.286,0,10,.000,6,12,18,0,2,5,6,8,8,2008
Cedric Simmons,PF,22,CLE,7,0,68,2,6,.333,0,0,.000,2,6,.333,.333,0,8,.000,5,10,15,0,2,5,4,7,4,2008
Cedric Simmons,PF,22,CHI,7,0,19,2,8,.250,0,0,.000,2,8,.250,.250,0,2,.000,1,2,3,0,0,0,2,1,4,2008
Courtney Sims,C,24,IND,3,0,11,0,1,.000,0,0,.000,0,1,.000,.000,0,0,.000,1,1,2,1,0,0,0,2,0,2008
Brian Skinner,C,31,PHO,66,0,844,92,198,.465,2,3,.667,90,195,.462,.470,33,63,.524,63,175,238,15,21,77,39,112,219,2008
Craig Smith,PF,24,MIN,77,11,1547,297,528,.563,0,9,.000,297,519,.572,.563,133,200,.665,123,230,353,60,36,17,89,217,727,2008
J.R. Smith,SG,22,DEN,74,0,1421,311,674,.461,157,390,.403,154,284,.542,.578,128,178,.719,43,109,152,128,62,12,112,144,907,2008
Jason Smith,PF,21,PHI,76,1,1107,141,310,.455,4,14,.286,137,296,.463,.461,54,82,.659,77,153,230,20,22,50,48,142,340,2008
Joe Smith,PF,32,TOT,77,36,1726,312,653,.478,0,3,.000,312,650,.480,.478,154,204,.755,163,238,401,66,34,47,71,186,778,2008
Joe Smith,PF,32,CHI,50,35,1146,225,483,.466,0,1,.000,225,482,.467,.466,109,135,.807,108,157,265,47,25,31,49,113,559,2008
Joe Smith,PF,32,CLE,27,1,580,87,170,.512,0,2,.000,87,168,.518,.512,45,69,.652,55,81,136,19,9,16,22,73,219,2008
Josh Smith,PF,22,ATL,81,81,2873,518,1133,.457,25,99,.253,493,1034,.477,.468,333,469,.710,161,506,667,272,123,227,245,269,1394,2008
Eric Snow,PG,34,CLE,22,5,305,6,38,.158,0,2,.000,6,36,.167,.158,10,22,.455,4,16,20,42,10,4,10,30,22,2008
Kirk Snyder,SF-PF,24,TOT,36,18,761,96,189,.508,5,23,.217,91,166,.548,.521,64,88,.727,30,96,126,64,20,15,52,55,261,2008
Kirk Snyder,PF,24,HOU,9,0,81,13,28,.464,2,9,.222,11,19,.579,.500,6,11,.545,5,7,12,8,1,1,4,6,34,2008
Kirk Snyder,SF,24,MIN,27,18,680,83,161,.516,3,14,.214,80,147,.544,.525,58,77,.753,25,89,114,56,19,14,48,49,227,2008
Darius Songaila,C,29,WAS,80,13,1554,214,467,.458,0,2,.000,214,465,.460,.458,67,73,.918,81,190,271,135,53,16,86,181,495,2008
Jerry Stackhouse,SG,33,DAL,58,13,1412,213,526,.405,60,184,.326,153,342,.447,.462,132,148,.892,33,100,133,145,28,10,86,82,618,2008
DeShawn Stevenson,SG,26,WAS,82,82,2564,301,780,.386,158,413,.383,143,367,.390,.487,157,197,.797,37,198,235,252,65,15,102,110,917,2008
Peja Stojakovic,SF,30,NOH,77,77,2711,451,1026,.440,231,524,.441,220,502,.438,.552,130,140,.929,64,267,331,96,57,10,61,127,1263,2008
Awvee Storey,SG,30,MIL,26,0,259,39,89,.438,0,7,.000,39,82,.476,.438,14,29,.483,31,23,54,16,7,1,10,41,92,2008
Damon Stoudamire,PG,34,TOT,60,33,1037,120,337,.356,50,149,.336,70,188,.372,.430,27,34,.794,20,98,118,165,30,2,80,76,317,2008
Damon Stoudamire,PG,34,MEM,29,29,624,77,194,.397,36,94,.383,41,100,.410,.490,21,26,.808,14,57,71,112,19,0,50,46,211,2008
Damon Stoudamire,PG,34,SAS,31,4,413,43,143,.301,14,55,.255,29,88,.330,.350,6,8,.750,6,41,47,53,11,2,30,30,106,2008
Salim Stoudamire,PG,25,ATL,35,0,402,65,180,.361,29,85,.341,36,95,.379,.442,41,50,.820,4,20,24,28,7,5,21,34,200,2008
Amar'e Stoudemire,C,25,PHO,79,79,2677,714,1211,.590,5,31,.161,709,1180,.601,.592,556,691,.805,178,541,719,118,64,163,174,294,1989,2008
D.J. Strawberry,SG,22,PHO,33,0,270,29,92,.315,6,25,.240,23,67,.343,.348,9,19,.474,9,19,28,30,12,6,11,36,73,2008
Rodney Stuckey,PG,21,DET,57,2,1081,153,382,.401,3,16,.188,150,366,.410,.404,127,156,.814,32,97,129,160,49,6,78,113,436,2008
Robert Swift,C,22,SEA,8,4,98,6,17,.353,0,0,.000,6,17,.353,.353,2,2,1.000,6,12,18,1,5,6,10,16,14,2008
Stromile Swift,PF,28,TOT,56,4,844,135,265,.509,0,2,.000,135,263,.513,.509,73,109,.670,64,135,199,26,15,54,51,113,343,2008
Stromile Swift,PF,28,MEM,35,4,549,93,177,.525,0,2,.000,93,175,.531,.525,52,81,.642,46,83,129,22,10,36,39,74,238,2008
Stromile Swift,PF,28,NJN,21,0,295,42,88,.477,0,0,.000,42,88,.477,.477,21,28,.750,18,52,70,4,5,18,12,39,105,2008
Wally Szczerbiak,SF,30,TOT,75,2,1736,311,722,.431,90,218,.413,221,504,.438,.493,149,175,.851,34,183,217,104,23,12,76,103,861,2008
Wally Szczerbiak,SF,30,SEA,50,1,1180,236,513,.460,71,166,.428,165,347,.476,.529,113,134,.843,16,120,136,69,14,5,56,67,656,2008
Wally Szczerbiak,SF,30,CLE,25,1,556,75,209,.359,19,52,.365,56,157,.357,.404,36,41,.878,18,63,81,35,9,7,20,36,205,2008
Sebastian Telfair,PG,22,MIN,60,51,1933,223,556,.401,32,114,.281,191,442,.432,.430,78,105,.743,16,119,135,355,59,11,111,171,556,2008
Jason Terry,SG,30,DAL,82,34,2579,471,1008,.467,136,363,.375,335,645,.519,.535,191,223,.857,30,178,208,264,88,18,92,170,1269,2008
Billy Thomas,SF,32,TOT,11,0,42,4,17,.235,4,16,.250,0,1,.000,.353,2,2,1.000,0,2,2,0,1,0,4,4,14,2008
Billy Thomas,SF,32,NJN,4,0,8,0,3,.000,0,3,.000,0,0,.000,.000,2,2,1.000,0,0,0,0,0,0,1,0,2,2008
Billy Thomas,SF,32,CLE,7,0,34,4,14,.286,4,13,.308,0,1,.000,.429,0,0,.000,0,2,2,0,1,0,3,4,12,2008
Kenny Thomas,PF,30,SAC,23,3,281,16,38,.421,0,0,.000,16,38,.421,.421,0,5,.000,18,43,61,13,6,1,21,38,32,2008
Kurt Thomas,C-PF,35,TOT,70,48,1584,195,396,.492,0,1,.000,195,395,.494,.492,53,80,.663,130,377,507,67,56,57,46,188,443,2008
Kurt Thomas,C,35,SEA,42,39,1060,139,271,.513,0,0,.000,139,271,.513,.513,39,56,.696,94,275,369,53,35,43,28,131,317,2008
Kurt Thomas,PF,35,SAS,28,9,524,56,125,.448,0,1,.000,56,124,.452,.448,14,24,.583,36,102,138,14,21,14,18,57,126,2008
Tim Thomas,PF,30,LAC,63,51,1940,291,705,.413,83,271,.306,208,434,.479,.472,115,153,.752,62,261,323,171,40,29,98,192,780,2008
Tyrus Thomas,PF,21,CHI,74,27,1330,186,440,.423,1,6,.167,185,434,.426,.424,129,174,.741,102,240,342,90,48,72,77,170,502,2008
Al Thornton,PF,24,LAC,79,31,2158,374,871,.429,43,130,.331,331,741,.447,.454,214,288,.743,98,260,358,98,46,43,128,195,1005,2008
Jamaal Tinsley,PG,29,IND,39,36,1293,176,463,.380,40,141,.284,136,322,.422,.423,72,100,.720,24,117,141,326,66,10,130,97,464,2008
Alando Tucker,SF,23,PHO,6,0,48,8,22,.364,1,4,.250,7,18,.389,.386,5,6,.833,4,4,8,0,0,1,0,2,22,2008
Ronny Turiaf,C,25,LAL,78,21,1458,188,397,.474,0,1,.000,188,396,.475,.474,140,186,.753,95,211,306,128,28,108,72,199,516,2008
Hedo Turkoglu,SF,28,ORL,82,82,3026,556,1219,.456,166,415,.400,390,804,.485,.524,324,391,.829,83,388,471,409,74,25,246,244,1602,2008
Ime Udoka,PF,30,SAS,73,0,1316,159,375,.424,61,165,.370,98,210,.467,.505,44,58,.759,36,192,228,63,56,17,58,127,423,2008
Beno Udrih,PG,25,SAC,65,51,2080,328,708,.463,53,137,.387,275,571,.482,.501,125,147,.850,34,183,217,282,56,10,148,138,834,2008
Anderson Varejao,C,25,CLE,48,13,1320,136,295,.461,0,2,.000,136,293,.464,.461,49,82,.598,134,265,399,53,37,26,59,134,321,2008
Jacque Vaughn,PG,32,SAS,74,9,1139,121,283,.428,3,10,.300,118,273,.432,.433,61,80,.763,13,61,74,159,23,1,54,97,306,2008
Charlie Villanueva,PF,23,MIL,76,31,1829,354,814,.435,55,185,.297,299,629,.475,.469,123,157,.783,145,321,466,78,30,35,107,174,886,2008
Marcus Vinicius,SF,23,NOH,13,0,69,9,20,.450,5,12,.417,4,8,.500,.575,5,11,.455,1,7,8,2,1,1,3,4,28,2008
Jake Voskuhl,C,30,MIL,44,0,386,37,80,.463,0,0,.000,37,80,.463,.463,24,29,.828,30,67,97,13,9,21,29,83,98,2008
Sasha Vujacic,SG,23,LAL,72,0,1279,219,482,.454,118,270,.437,101,212,.476,.577,76,91,.835,19,135,154,72,36,5,52,107,632,2008
Dwyane Wade,SG,26,MIA,51,49,1954,439,937,.469,22,77,.286,417,860,.485,.480,354,467,.758,45,169,214,354,87,37,224,137,1254,2008
Von Wafer,SG,22,TOT,29,0,154,17,61,.279,4,26,.154,13,35,.371,.311,8,12,.667,1,18,19,7,2,3,13,7,46,2008
Von Wafer,SG,22,DEN,21,0,90,10,38,.263,1,15,.067,9,23,.391,.276,6,8,.750,1,9,10,5,2,1,11,4,27,2008
Von Wafer,SG,22,POR,8,0,64,7,23,.304,3,11,.273,4,12,.333,.370,2,4,.500,0,9,9,2,0,2,2,3,19,2008
Antoine Walker,PF,31,MIN,46,1,892,136,375,.363,61,188,.324,75,187,.401,.444,35,66,.530,56,112,168,45,33,8,46,80,368,2008
Ben Wallace,C-PF,33,TOT,72,72,2205,138,352,.392,0,4,.000,138,348,.397,.392,72,169,.426,234,370,604,105,88,117,67,121,348,2008
Ben Wallace,C,33,CHI,50,50,1627,101,271,.373,0,4,.000,101,267,.378,.373,53,125,.424,175,266,441,92,69,80,49,86,255,2008
Ben Wallace,PF,33,CLE,22,22,578,37,81,.457,0,0,.000,37,81,.457,.457,19,44,.432,59,104,163,13,19,37,18,35,93,2008
Gerald Wallace,PF,25,CHA,62,59,2376,408,908,.449,71,221,.321,337,687,.491,.488,313,428,.731,58,315,373,216,131,58,180,189,1200,2008
Rasheed Wallace,C,33,DET,77,76,2346,376,870,.432,112,315,.356,264,555,.476,.497,115,150,.767,84,427,511,137,91,129,86,213,979,2008
Luke Walton,SF,27,LAL,74,31,1729,215,478,.450,28,84,.333,187,394,.475,.479,77,109,.706,85,206,291,218,60,18,100,133,535,2008
Hakim Warrick,PF,25,MEM,75,30,1754,328,653,.502,13,48,.271,315,605,.521,.512,183,260,.704,123,233,356,53,36,28,85,156,852,2008
Darius Washington,SG,22,SAS,18,0,146,21,48,.438,4,12,.333,17,36,.472,.479,7,13,.538,4,16,20,15,5,0,14,16,53,2008
Darryl Watkins,C,23,SAC,9,0,71,5,15,.333,0,0,.000,5,15,.333,.333,2,5,.400,5,7,12,0,2,2,7,8,12,2008
C.J. Watson,PG,23,GSW,32,0,368,43,101,.426,9,26,.346,34,75,.453,.470,23,29,.793,13,19,32,35,15,0,18,19,118,2008
Earl Watson,PG,28,SEA,78,73,2269,339,747,.454,49,132,.371,290,615,.472,.487,111,145,.766,43,182,225,531,69,11,175,158,838,2008
Chris Webber,PF,34,GSW,9,8,126,15,31,.484,0,0,.000,15,31,.484,.484,5,12,.417,2,30,32,18,4,6,11,17,35,2008
Martell Webster,SF,21,POR,75,70,2132,277,656,.422,123,317,.388,154,339,.454,.516,122,166,.735,54,242,296,90,42,28,83,159,799,2008
Bonzi Wells,SG,31,TOT,73,7,1562,252,569,.443,12,50,.240,240,519,.462,.453,146,227,.643,84,247,331,97,75,32,103,157,662,2008
Bonzi Wells,SG,31,HOU,51,7,1124,175,412,.425,8,38,.211,167,374,.447,.434,111,174,.638,63,197,260,80,51,24,76,113,469,2008
Bonzi Wells,SG,31,NOH,22,0,438,77,157,.490,4,12,.333,73,145,.503,.503,35,53,.660,21,50,71,17,24,8,27,44,193,2008
David West,PF,27,NOH,76,76,2870,629,1305,.482,6,25,.240,623,1280,.487,.484,300,353,.850,180,495,675,177,62,99,165,208,1564,2008
Delonte West,PG,24,TOT,61,31,1533,196,475,.413,48,135,.356,148,340,.435,.463,67,91,.736,31,162,193,229,59,29,117,103,507,2008
Delonte West,PG,24,SEA,35,5,727,97,250,.388,19,56,.339,78,194,.402,.426,26,39,.667,13,83,96,113,30,10,66,44,239,2008
Delonte West,PG,24,CLE,26,26,806,99,225,.440,29,79,.367,70,146,.479,.504,41,52,.788,18,79,97,116,29,19,51,59,268,2008
Mario West,SG,23,ATL,64,2,269,21,49,.429,0,4,.000,21,45,.467,.429,17,26,.654,26,22,48,13,12,4,9,61,59,2008
Chris Wilcox,PF,25,SEA,62,55,1739,334,638,.524,0,3,.000,334,635,.526,.524,160,248,.645,126,307,433,74,46,36,103,174,828,2008
Damien Wilkins,SF,28,SEA,76,31,1843,271,673,.403,50,155,.323,221,518,.427,.440,106,144,.736,72,173,245,150,62,19,89,128,698,2008
Mike Wilks,PG,28,TOT,15,0,188,17,36,.472,3,8,.375,14,28,.500,.514,4,4,1.000,5,14,19,14,9,0,9,13,41,2008
Mike Wilks,PG,28,DEN,8,0,122,10,23,.435,2,5,.400,8,18,.444,.478,2,2,1.000,4,8,12,6,5,0,5,9,24,2008
Mike Wilks,PG,28,WAS,4,0,44,2,4,.500,1,2,.500,1,2,.500,.625,0,0,.000,1,5,6,3,3,0,1,2,5,2008
Mike Wilks,PG,28,SEA,3,0,22,5,9,.556,0,1,.000,5,8,.625,.556,2,2,1.000,0,1,1,5,1,0,3,2,12,2008
Aaron Williams,C,36,LAC,30,5,297,27,55,.491,0,0,.000,27,55,.491,.491,14,18,.778,15,46,61,9,12,15,13,44,68,2008
Deron Williams,PG,23,UTA,82,82,3059,566,1117,.507,83,210,.395,483,907,.533,.544,330,411,.803,34,209,243,862,90,23,279,200,1545,2008
Jason Williams,PG,32,MIA,67,53,1886,211,550,.384,97,275,.353,114,275,.415,.472,69,80,.863,12,118,130,307,83,5,91,93,588,2008
Justin Williams,C,23,TOT,23,0,123,13,29,.448,0,0,.000,13,29,.448,.448,8,26,.308,20,29,49,0,5,5,4,17,34,2008
Justin Williams,C,23,SAC,22,0,117,12,26,.462,0,0,.000,12,26,.462,.462,7,22,.318,19,29,48,0,5,5,3,14,31,2008
Justin Williams,C,23,HOU,1,0,6,1,3,.333,0,0,.000,1,3,.333,.333,1,4,.250,1,0,1,0,0,0,1,3,3,2008
Lou Williams,PG,21,PHI,80,0,1862,319,752,.424,55,153,.359,264,599,.441,.461,227,290,.783,41,126,167,253,81,13,125,130,920,2008
Marcus Williams,PG,22,NJN,53,7,854,111,293,.379,54,142,.380,57,151,.377,.471,37,47,.787,14,87,101,140,25,3,75,52,313,2008
Marcus Williams,PF-SF,21,TOT,11,0,36,5,20,.250,0,0,.000,5,20,.250,.250,0,0,.000,4,8,12,3,1,1,0,3,10,2008
Marcus Williams,SF,21,SAS,1,0,2,0,1,.000,0,0,.000,0,1,.000,.000,0,0,.000,0,0,0,0,0,1,0,0,0,2008
Marcus Williams,PF,21,LAC,10,0,34,5,19,.263,0,0,.000,5,19,.263,.263,0,0,.000,4,8,12,3,1,0,0,3,10,2008
Marvin Williams,SF,21,ATL,80,80,2765,424,918,.462,1,10,.100,423,908,.466,.462,336,409,.822,119,338,457,137,81,33,127,225,1185,2008
Mo Williams,PG,25,MIL,66,66,2410,441,919,.480,89,231,.385,352,688,.512,.528,166,194,.856,37,193,230,419,78,10,182,188,1137,2008
Sean Williams,C,21,NJN,73,29,1278,164,305,.538,0,0,.000,164,305,.538,.538,81,133,.609,115,207,322,28,28,106,70,193,409,2008
Shawne Williams,SF,21,IND,65,3,967,159,372,.427,43,137,.314,116,235,.494,.485,76,106,.717,54,122,176,59,26,26,58,132,437,2008
Shelden Williams,PF,24,TOT,64,0,776,92,212,.434,0,2,.000,92,210,.438,.434,71,105,.676,68,137,205,19,22,21,35,110,255,2008
Shelden Williams,PF,24,ATL,36,0,414,37,100,.370,0,1,.000,37,99,.374,.370,35,51,.686,34,73,107,11,13,11,14,60,109,2008
Shelden Williams,PF,24,SAC,28,0,362,55,112,.491,0,1,.000,55,111,.495,.491,36,54,.667,34,64,98,8,9,10,21,50,146,2008
Loren Woods,C,29,HOU,7,0,17,3,5,.600,0,0,.000,3,5,.600,.600,0,0,.000,0,1,1,2,0,0,0,2,6,2008
Metta World Peace,SF,28,SAC,57,54,2172,436,962,.453,84,221,.380,352,741,.475,.497,212,295,.719,101,227,328,199,133,38,148,159,1168,2008
Antoine Wright,SG,23,TOT,56,10,1232,136,329,.413,32,110,.291,104,219,.475,.462,46,67,.687,40,107,147,80,28,21,50,127,350,2008
Antoine Wright,SG,23,NJN,41,10,1056,115,287,.401,27,101,.267,88,186,.473,.448,41,58,.707,35,90,125,67,26,17,39,105,298,2008
Antoine Wright,SG,23,DAL,15,0,176,21,42,.500,5,9,.556,16,33,.485,.560,5,9,.556,5,17,22,13,2,4,11,22,52,2008
Brandan Wright,PF,20,GSW,38,6,376,62,112,.554,0,0,.000,62,112,.554,.554,27,40,.675,38,61,99,9,6,22,13,36,151,2008
Dorell Wright,SF,22,MIA,44,34,1104,143,293,.488,4,11,.364,139,282,.493,.495,57,69,.826,48,172,220,60,29,41,29,79,347,2008
Julian Wright,SF,20,NOH,57,1,640,90,169,.533,10,24,.417,80,145,.552,.562,33,52,.635,33,84,117,40,29,12,34,43,223,2008
Lorenzen Wright,C,32,TOT,18,1,161,6,21,.286,0,0,.000,6,21,.286,.286,3,6,.500,8,30,38,4,3,3,4,31,15,2008
Lorenzen Wright,C,32,ATL,13,1,148,5,17,.294,0,0,.000,5,17,.294,.294,3,6,.500,7,30,37,3,3,3,2,26,13,2008
Lorenzen Wright,C,32,SAC,5,0,13,1,4,.250,0,0,.000,1,4,.250,.250,0,0,.000,1,0,1,1,0,0,2,5,2,2008
Nick Young,SG,22,WAS,75,2,1158,210,478,.439,40,100,.400,170,378,.450,.481,101,124,.815,23,92,115,63,35,7,94,130,561,2008
Thaddeus Young,PF,19,PHI,74,22,1554,264,490,.539,6,19,.316,258,471,.548,.545,76,103,.738,120,192,312,58,73,8,64,126,610,2008
Shareef Abdur-Rahim,C,30,SAC,80,45,2015,310,654,.474,3,20,.150,307,634,.484,.476,170,234,.726,122,276,398,109,53,40,116,243,793,2007
Hassan Adams,SG,22,NJN,61,8,495,75,135,.556,0,1,.000,75,134,.560,.556,24,36,.667,35,42,77,13,17,4,22,47,174,2007
Maurice Ager,SG,22,DAL,32,1,214,22,70,.314,5,15,.333,17,55,.309,.350,20,33,.606,1,20,21,7,4,3,15,27,69,2007
LaMarcus Aldridge,C,21,POR,63,22,1392,241,479,.503,0,2,.000,241,477,.505,.503,83,115,.722,144,168,312,24,22,73,43,186,565,2007
Malik Allen,PF,28,CHI,60,1,638,107,258,.415,0,1,.000,107,257,.416,.415,28,34,.824,42,77,119,16,17,16,21,85,242,2007
Ray Allen,SG,31,SEA,55,55,2219,505,1153,.438,165,443,.372,340,710,.479,.510,279,309,.903,57,190,247,228,82,11,154,113,1454,2007
Tony Allen,SG,25,BOS,33,18,805,133,259,.514,8,33,.242,125,226,.553,.529,105,134,.784,35,89,124,56,49,12,75,87,379,2007
Rafer Alston,PG,30,HOU,82,82,3040,383,1020,.375,192,529,.363,191,491,.389,.470,130,177,.734,29,253,282,444,129,10,170,195,1088,2007
Lou Amundson,PF,24,TOT,11,0,89,6,15,.400,0,0,.000,6,15,.400,.400,4,10,.400,13,15,28,1,1,8,5,15,16,2007
Lou Amundson,PF,24,UTA,1,0,2,0,0,.000,0,0,.000,0,0,.000,.000,0,0,.000,0,0,0,0,0,0,0,0,0,2007
Lou Amundson,PF,24,PHI,10,0,87,6,15,.400,0,0,.000,6,15,.400,.400,4,10,.400,13,15,28,1,1,8,5,15,16,2007
Alan Anderson,SG,24,CHA,17,0,256,37,81,.457,5,20,.250,32,61,.525,.488,19,23,.826,11,21,32,21,7,0,22,33,98,2007
Derek Anderson,SF,32,CHA,50,32,1190,126,294,.429,54,152,.355,72,142,.507,.520,93,106,.877,29,84,113,133,52,7,56,115,399,2007
Carmelo Anthony,SF,22,DEN,65,65,2486,691,1453,.476,40,149,.268,651,1304,.499,.489,459,568,.808,143,248,391,249,77,23,234,203,1881,2007
Rafael Araujo,C,26,UTA,28,0,248,27,65,.415,0,0,.000,27,65,.415,.415,18,29,.621,22,44,66,10,6,2,17,39,72,2007
Gilbert Arenas,PG,25,WAS,74,73,2942,647,1548,.418,205,584,.351,442,964,.459,.484,606,718,.844,61,277,338,443,139,13,236,249,2105,2007
Trevor Ariza,SG,21,ORL,57,7,1278,200,371,.539,0,7,.000,200,364,.549,.539,106,171,.620,98,151,249,65,59,19,84,134,506,2007
Darrell Armstrong,PG,38,IND,81,4,1275,156,377,.414,72,214,.336,84,163,.515,.509,73,93,.785,34,101,135,191,70,6,76,102,457,2007
Hilton Armstrong,C,22,NOK,56,5,634,68,125,.544,0,0,.000,68,125,.544,.544,40,67,.597,58,91,149,10,12,26,35,79,176,2007
Carlos Arroyo,PG,27,ORL,72,5,1304,203,478,.425,14,51,.275,189,427,.443,.439,132,166,.795,31,103,134,202,39,2,90,131,552,2007
Chucky Atkins,PG,32,MEM,75,23,2064,310,715,.434,116,306,.379,194,409,.474,.515,252,311,.810,18,121,139,346,50,4,127,136,988,2007
James Augustine,PF,22,ORL,2,0,7,1,3,.333,0,0,.000,1,3,.333,.333,0,0,.000,1,2,3,2,0,0,0,2,2,2007
Kelenna Azubuike,SG,23,GSW,41,9,669,98,220,.445,34,79,.430,64,141,.454,.523,61,78,.782,26,68,94,28,22,10,39,49,291,2007
Renaldo Balkman,SF,22,NYK,68,1,1064,139,275,.505,5,27,.185,134,248,.540,.515,51,90,.567,97,197,294,44,57,44,49,146,334,2007
Marcus Banks,PG,25,PHO,45,1,503,84,196,.429,5,29,.172,79,167,.473,.441,48,60,.800,10,28,38,60,23,3,40,70,221,2007
Leandro Barbosa,SG,24,PHO,80,18,2613,529,1111,.476,190,438,.434,339,673,.504,.562,196,232,.845,22,192,214,317,96,15,146,210,1444,2007
J.J. Barea,PG,22,DAL,33,1,191,28,78,.359,6,21,.286,22,57,.386,.397,16,24,.667,7,18,25,24,1,1,14,19,78,2007
Andrea Bargnani,PF,21,TOR,65,2,1629,267,625,.427,100,268,.373,167,357,.468,.507,117,142,.824,52,203,255,50,32,53,107,180,751,2007
Matt Barnes,PF,26,GSW,76,23,1813,275,628,.438,106,290,.366,169,338,.500,.522,90,123,.732,91,259,350,156,73,41,105,188,746,2007
Andre Barrett,PG,24,CHI,6,0,29,4,8,.500,0,0,.000,4,8,.500,.500,0,0,.000,1,4,5,7,0,0,4,4,8,2007
Earl Barron,C,25,MIA,28,0,203,24,83,.289,0,1,.000,24,82,.293,.289,17,18,.944,19,22,41,5,6,4,11,21,65,2007
Brent Barry,SG,35,SAS,75,28,1631,202,425,.475,128,287,.446,74,138,.536,.626,103,117,.880,17,143,160,138,56,12,61,88,635,2007
Brandon Bass,PF,21,NOK,21,3,162,15,44,.341,0,1,.000,15,43,.349,.341,12,16,.750,13,30,43,3,2,3,10,16,42,2007
Maceo Baston,PF,31,IND,47,2,405,49,76,.645,3,7,.429,46,69,.667,.664,37,47,.787,21,53,74,16,12,18,32,65,138,2007
Esteban Batista,PF,23,ATL,13,0,81,8,16,.500,0,0,.000,8,16,.500,.500,4,7,.571,7,23,30,4,3,0,4,13,20,2007
Tony Battie,PF,30,ORL,66,66,1575,176,360,.489,0,1,.000,176,359,.490,.489,52,77,.675,92,252,344,35,29,30,61,185,404,2007
Shane Battier,SF,28,HOU,82,82,2988,292,654,.446,157,373,.421,135,281,.480,.567,88,113,.779,67,271,338,175,79,60,72,190,829,2007
Charlie Bell,SG,27,MIL,82,64,2848,426,974,.437,127,361,.352,299,613,.488,.503,131,168,.780,57,181,238,247,97,4,104,213,1110,2007
Raja Bell,SG,30,PHO,78,78,2917,410,950,.432,205,496,.413,205,454,.452,.539,118,152,.776,48,203,251,196,50,22,83,233,1143,2007
Mike Bibby,PG,28,SAC,82,82,2784,471,1166,.404,173,481,.360,298,685,.435,.478,288,347,.830,39,224,263,388,88,6,197,139,1403,2007
Andris Biedrins,C,20,GSW,82,63,2382,348,581,.599,0,0,.000,348,581,.599,.599,87,167,.521,251,511,762,88,67,136,119,304,783,2007
Chauncey Billups,PG,30,DET,70,70,2533,348,815,.427,109,316,.345,239,499,.479,.494,386,437,.883,23,214,237,502,84,17,140,161,1191,2007
Steve Blake,PG,26,TOT,82,42,2225,209,509,.411,67,208,.322,142,301,.472,.476,43,64,.672,21,148,169,408,61,8,129,121,528,2007
Steve Blake,PG,26,MIL,33,2,583,45,129,.349,19,68,.279,26,61,.426,.422,11,20,.550,7,38,45,84,10,3,28,49,120,2007
Steve Blake,PG,26,DEN,49,40,1642,164,380,.432,48,140,.343,116,240,.483,.495,32,44,.727,14,110,124,324,51,5,101,72,408,2007
Will Blalock,PG,23,DET,14,0,166,9,30,.300,1,5,.200,8,25,.320,.317,6,6,1.000,6,9,15,17,5,0,12,9,25,2007
Andray Blatche,PF,20,WAS,56,13,682,86,197,.437,4,27,.148,82,170,.482,.447,30,49,.612,77,114,191,39,17,32,49,94,206,2007
Mark Blount,C,31,MIN,82,81,2544,427,839,.509,9,31,.290,418,808,.517,.514,147,195,.754,136,369,505,67,43,58,159,239,1010,2007
Keith Bogans,SG,26,ORL,59,18,990,99,245,.404,53,137,.387,46,108,.426,.512,47,63,.746,16,77,93,59,28,2,46,98,298,2007
Andrew Bogut,C,22,MIL,66,66,2258,348,629,.553,1,5,.200,347,624,.556,.554,112,194,.577,168,416,584,198,49,35,150,216,809,2007
Matt Bonner,PF,26,SAS,56,0,653,106,237,.447,36,94,.383,70,143,.490,.523,27,38,.711,64,92,156,22,17,11,25,67,275,2007
Josh Boone,PF,22,NJN,61,0,669,99,171,.579,0,0,.000,99,171,.579,.579,56,103,.544,64,112,176,10,11,21,33,94,254,2007
Calvin Booth,C,30,WAS,44,1,380,31,66,.470,1,2,.500,30,64,.469,.477,6,10,.600,27,54,81,18,4,29,9,71,69,2007
Carlos Boozer,PF,25,UTA,74,74,2557,647,1154,.561,0,0,.000,647,1154,.561,.561,255,372,.685,235,632,867,221,70,21,194,217,1549,2007
Chris Bosh,C,22,TOR,69,69,2658,543,1094,.496,12,35,.343,531,1059,.501,.502,463,590,.785,186,555,741,175,39,90,179,163,1561,2007
Bruce Bowen,SF,35,SAS,82,82,2464,189,467,.405,89,232,.384,100,235,.426,.500,43,73,.589,23,200,223,117,62,25,65,175,510,2007
Earl Boykins,PG,30,TOT,66,23,2031,323,769,.420,95,239,.397,228,530,.430,.482,220,245,.898,49,90,139,291,56,2,120,92,961,2007
Earl Boykins,PG,30,DEN,31,4,877,156,378,.413,41,110,.373,115,268,.429,.467,119,131,.908,23,40,63,132,25,2,52,31,472,2007
Earl Boykins,PG,30,MIL,35,19,1154,167,391,.427,54,129,.419,113,262,.431,.496,101,114,.886,26,50,76,159,31,0,68,61,489,2007
Cedric Bozeman,SG,23,ATL,23,5,199,11,39,.282,2,13,.154,9,26,.346,.308,2,6,.333,3,20,23,9,5,2,9,32,26,2007
Elton Brand,PF,27,LAC,80,80,3077,645,1211,.533,1,1,1.000,644,1210,.532,.533,351,461,.761,268,476,744,235,77,179,202,238,1642,2007
Ronnie Brewer,SG,21,UTA,56,14,675,102,193,.528,0,9,.000,102,184,.554,.528,56,83,.675,37,38,75,24,37,6,24,44,260,2007
Primoz Brezec,C,27,CHA,58,40,838,122,274,.445,1,3,.333,121,271,.446,.447,43,68,.632,80,104,184,23,11,23,38,161,288,2007
Andre Brown,PF,25,SEA,38,0,271,42,74,.568,0,1,.000,42,73,.575,.568,9,15,.600,26,48,74,2,6,4,29,26,93,2007
Dee Brown,PG,22,UTA,49,0,450,32,98,.327,6,28,.214,26,70,.371,.357,24,37,.649,8,32,40,83,22,7,31,51,94,2007
Devin Brown,SG,28,NOK,58,49,1662,233,555,.420,81,227,.357,152,328,.463,.493,123,155,.794,55,196,251,149,44,9,91,139,670,2007
Kwame Brown,C,24,LAL,41,28,1132,143,242,.591,0,1,.000,143,241,.593,.591,59,134,.440,81,163,244,75,39,49,76,124,345,2007
P.J. Brown,PF,37,CHI,72,49,1456,170,418,.407,0,2,.000,170,416,.409,.407,96,122,.787,129,218,347,48,24,52,85,187,436,2007
Shannon Brown,SG,21,CLE,23,5,202,28,74,.378,7,25,.280,21,49,.429,.426,10,14,.714,6,15,21,10,7,3,14,24,73,2007
Kobe Bryant,SG,28,LAL,77,77,3140,813,1757,.463,137,398,.344,676,1359,.497,.502,667,768,.868,75,364,439,413,111,36,255,205,2430,2007
Greg Buckner,SG,30,DAL,76,11,1372,123,299,.411,32,103,.311,91,196,.464,.465,27,34,.794,35,123,158,70,47,7,40,152,305,2007
Pat Burke,C,33,PHO,23,0,164,23,65,.354,6,22,.273,17,43,.395,.400,8,13,.615,12,35,47,5,3,2,7,19,60,2007
Caron Butler,SF,26,WAS,63,63,2474,451,975,.463,18,72,.250,433,903,.480,.472,283,328,.863,147,320,467,233,134,17,181,188,1203,2007
Jackie Butler,C,21,SAS,11,2,103,16,35,.457,0,0,.000,16,35,.457,.457,9,10,.900,6,16,22,5,2,0,10,16,41,2007
Rasual Butler,SF,27,NOK,81,38,2223,314,788,.398,134,363,.369,180,425,.424,.484,56,87,.644,42,214,256,63,40,54,67,148,818,2007
Andrew Bynum,C,19,LAL,82,53,1793,247,443,.558,0,3,.000,247,440,.561,.558,143,214,.668,139,345,484,94,12,128,115,249,637,2007
Jose Calderon,PG,25,TOR,77,11,1614,263,505,.521,25,75,.333,238,430,.553,.546,117,143,.818,21,113,134,387,63,5,110,136,668,2007
Marcus Camby,C,32,DEN,70,70,2369,312,659,.473,0,2,.000,312,657,.475,.473,161,221,.729,164,652,816,223,87,231,122,183,785,2007
Brian Cardinal,PF,29,MEM,28,1,313,42,85,.494,18,44,.409,24,41,.585,.600,25,27,.926,13,46,59,31,22,1,23,42,127,2007
Rodney Carney,SF,22,PHI,67,35,1169,182,392,.464,25,72,.347,157,320,.491,.496,53,87,.609,39,89,128,26,38,23,43,118,442,2007
Matt Carroll,SG,26,CHA,72,47,1878,285,658,.433,111,267,.416,174,391,.445,.517,188,208,.904,35,172,207,91,53,9,73,176,869,2007
Anthony Carter,PG,31,DEN,2,0,37,3,8,.375,0,2,.000,3,6,.500,.375,0,0,.000,0,3,3,11,0,1,6,4,6,2007
Vince Carter,SG,30,NJN,82,82,3126,726,1598,.454,156,437,.357,570,1161,.491,.503,462,576,.802,114,378,492,393,82,30,217,266,2070,2007
Sam Cassell,PG,37,LAC,58,30,1407,261,625,.418,32,109,.294,229,516,.444,.443,160,182,.879,27,140,167,270,28,8,101,126,714,2007
Kelvin Cato,C,32,NYK,18,0,95,7,22,.318,0,0,.000,7,22,.318,.318,8,12,.667,12,19,31,0,3,10,6,10,22,2007
Tyson Chandler,C,24,NOK,73,73,2525,292,468,.624,0,1,.000,292,467,.625,.624,106,201,.527,320,584,904,66,37,129,126,244,690,2007
Josh Childress,SG,23,ATL,55,13,2024,261,518,.504,26,77,.338,235,441,.533,.529,167,210,.795,123,217,340,127,58,36,80,118,715,2007
Doug Christie,SG,36,LAC,7,0,82,5,17,.294,1,6,.167,4,11,.364,.324,2,3,.667,3,8,11,8,3,1,5,11,13,2007
Speedy Claxton,PG,28,ATL,42,31,1054,91,278,.327,6,28,.214,85,250,.340,.338,33,60,.550,12,69,81,185,72,4,75,131,221,2007
Jarron Collins,C,28,UTA,82,9,913,75,170,.441,0,0,.000,75,170,.441,.441,54,83,.651,71,100,171,60,13,8,37,147,204,2007
Jason Collins,PF,28,NJN,80,78,1844,55,151,.364,0,2,.000,55,149,.369,.364,59,127,.465,90,226,316,46,40,38,73,273,169,2007
Mardy Collins,SF,22,NYK,52,9,777,87,228,.382,13,47,.277,74,181,.409,.410,48,82,.585,28,76,104,83,32,3,57,75,235,2007
Nick Collison,C,26,SEA,82,56,2378,318,636,.500,0,2,.000,318,634,.502,.500,154,199,.774,229,437,666,82,48,66,123,289,790,2007
Will Conroy,PG-SG,24,TOT,7,0,52,0,3,.000,0,0,.000,0,3,.000,.000,0,4,.000,3,4,7,9,0,0,2,7,0,2007
Will Conroy,SG,24,MEM,3,0,17,0,0,.000,0,0,.000,0,0,.000,.000,0,0,.000,1,1,2,1,0,0,0,1,0,2007
Will Conroy,PG,24,LAC,4,0,35,0,3,.000,0,0,.000,0,3,.000,.000,0,4,.000,2,3,5,8,0,0,2,6,0,2007
Brian Cook,PF,26,LAL,65,24,1018,185,408,.453,46,115,.400,139,293,.474,.510,34,47,.723,61,154,215,65,25,27,51,134,450,2007
Jamal Crawford,SG,26,NYK,59,36,2198,354,886,.400,103,322,.320,251,564,.445,.458,228,272,.838,44,145,189,259,57,8,162,114,1039,2007
Austin Croshere,PF,31,DAL,61,2,727,78,222,.351,26,91,.286,52,131,.397,.410,45,52,.865,33,153,186,44,14,6,33,68,227,2007
Eddy Curry,C,24,NYK,81,81,2849,585,1016,.576,1,1,1.000,584,1015,.575,.576,405,659,.615,195,376,571,68,34,40,295,265,1576,2007
Samuel Dalembert,C,25,PHI,82,82,2535,356,658,.541,0,2,.000,356,656,.543,.541,167,224,.746,239,494,733,64,47,159,161,287,879,2007
Erick Dampier,C,31,DAL,76,73,1915,209,334,.626,0,0,.000,209,334,.626,.626,119,191,.623,217,349,566,44,24,82,107,239,537,2007
Antonio Daniels,SG,31,WAS,80,8,1761,172,389,.442,19,63,.302,153,326,.469,.467,208,250,.832,18,133,151,290,39,9,69,79,571,2007
Marquis Daniels,SG,26,IND,45,4,800,129,281,.459,6,26,.231,123,255,.482,.470,56,80,.700,26,56,82,57,27,7,55,56,320,2007
Baron Davis,PG,27,GSW,63,62,2221,452,1030,.439,85,280,.304,367,750,.489,.480,275,369,.745,51,225,276,509,135,29,193,181,1264,2007
Dale Davis,C,37,DET,46,6,464,33,74,.446,0,0,.000,33,74,.446,.446,17,26,.654,59,78,137,12,10,34,15,59,83,2007
Paul Davis,C,22,LAC,31,0,180,22,52,.423,0,0,.000,22,52,.423,.423,7,10,.700,21,23,44,7,6,5,8,28,51,2007
Ricky Davis,SF,27,MIN,81,81,3021,506,1089,.465,123,310,.397,383,779,.492,.521,239,285,.839,54,261,315,385,80,23,210,189,1374,2007
Carlos Delfino,SG,24,DET,82,1,1372,156,376,.415,46,138,.333,110,238,.462,.476,70,89,.787,67,199,266,88,46,8,61,97,428,2007
Luol Deng,SF,21,CHI,82,82,3071,630,1218,.517,1,7,.143,629,1211,.519,.518,279,359,.777,148,431,579,204,97,48,153,167,1540,2007
Boris Diaw,PF,24,PHO,73,59,2268,306,569,.538,15,45,.333,291,524,.555,.551,82,120,.683,91,226,317,352,28,38,154,177,709,2007
Yakhouba Diawara,SG,24,DEN,64,19,1177,100,292,.342,49,170,.288,51,122,.418,.426,35,53,.660,27,83,110,55,30,7,37,132,284,2007
Dan Dickau,PG,28,POR,50,3,444,54,151,.358,16,61,.262,38,90,.422,.411,42,53,.792,7,36,43,70,14,1,27,55,166,2007
Travis Diener,PG,24,ORL,26,0,288,34,80,.425,18,50,.360,16,30,.533,.538,12,15,.800,3,15,18,35,4,0,13,27,98,2007
Ike Diogu,PF,23,TOT,59,2,760,127,266,.477,0,0,.000,127,266,.477,.477,112,140,.800,75,128,203,25,8,26,67,122,366,2007
Ike Diogu,PF,23,GSW,17,0,222,44,83,.530,0,0,.000,44,83,.530,.530,35,44,.795,21,42,63,5,3,11,18,35,123,2007
Ike Diogu,PF,23,IND,42,2,538,83,183,.454,0,0,.000,83,183,.454,.454,77,96,.802,54,86,140,20,5,15,49,87,243,2007
DeSagana Diop,C,25,DAL,81,9,1480,71,151,.470,0,1,.000,71,150,.473,.470,48,86,.558,166,272,438,30,40,113,63,244,190,2007
Juan Dixon,SG,28,TOT,81,6,1926,299,703,.425,79,226,.350,220,477,.461,.482,101,116,.871,27,131,158,123,76,9,101,177,778,2007
Juan Dixon,SG,28,POR,55,1,1243,189,444,.426,52,143,.364,137,301,.455,.484,60,72,.833,16,69,85,82,49,7,77,112,490,2007
Juan Dixon,SG,28,TOR,26,5,683,110,259,.425,27,83,.325,83,176,.472,.477,41,44,.932,11,62,73,41,27,2,24,65,288,2007
Michael Doleac,C,29,MIA,56,0,698,82,175,.469,0,1,.000,82,174,.471,.469,36,41,.878,44,111,155,22,18,15,30,96,200,2007
Keyon Dooling,SG,26,ORL,66,2,1435,188,458,.410,31,96,.323,157,362,.434,.444,114,141,.809,22,64,86,112,52,15,72,125,521,2007
Quincy Douby,PG,22,SAC,42,0,359,48,126,.381,12,50,.240,36,76,.474,.429,11,15,.733,11,26,37,15,15,4,15,21,119,2007
Chris Duhon,PG,24,CHI,78,30,1906,197,483,.408,88,245,.359,109,238,.458,.499,76,101,.752,23,146,169,310,69,6,105,150,558,2007
Tim Duncan,C,30,SAS,80,80,2726,618,1131,.546,1,9,.111,617,1122,.550,.547,362,568,.637,213,633,846,273,66,190,224,203,1599,2007
Mike Dunleavy,SG-PF,26,TOT,82,49,2580,384,850,.452,70,224,.313,314,626,.502,.493,211,269,.784,84,347,431,228,84,22,149,203,1049,2007
Mike Dunleavy,PF,26,GSW,39,6,1051,166,370,.449,36,104,.346,130,266,.489,.497,78,101,.772,40,147,187,117,38,12,71,83,446,2007
Mike Dunleavy,SG,26,IND,43,43,1529,218,480,.454,34,120,.283,184,360,.511,.490,133,168,.792,44,200,244,111,46,10,78,120,603,2007
Ronald Dupree,SF,26,DET,19,0,94,11,31,.355,0,0,.000,11,31,.355,.355,3,9,.333,5,12,17,5,5,1,3,12,25,2007
Monta Ellis,SG,21,GSW,77,53,2638,480,1010,.475,39,143,.273,441,867,.509,.495,273,358,.763,62,181,243,319,132,21,221,210,1272,2007
Francisco Elson,C,30,SAS,70,41,1332,144,282,.511,0,2,.000,144,280,.514,.511,62,80,.775,81,255,336,55,31,59,86,184,350,2007
Melvin Ely,PF-C,28,TOT,30,0,309,29,80,.363,0,0,.000,29,80,.363,.363,31,47,.660,15,38,53,18,6,8,28,51,89,2007
Melvin Ely,PF,28,CHA,24,0,244,23,60,.383,0,0,.000,23,60,.383,.383,24,35,.686,12,27,39,14,2,6,23,39,70,2007
Melvin Ely,C,28,SAS,6,0,65,6,20,.300,0,0,.000,6,20,.300,.300,7,12,.583,3,11,14,4,4,2,5,12,19,2007
Maurice Evans,SG,28,LAL,76,10,1732,234,542,.432,48,133,.361,186,409,.455,.476,122,155,.787,93,128,221,74,38,14,57,126,638,2007
Reggie Evans,PF,26,DEN,66,11,1127,117,215,.544,0,0,.000,117,215,.544,.544,91,183,.497,156,304,460,45,42,16,95,144,325,2007
Daniel Ewing,PG,23,LAC,61,3,712,65,161,.404,14,44,.318,51,117,.436,.447,35,45,.778,9,64,73,90,32,4,50,62,179,2007
Jordan Farmar,PG,20,LAL,72,2,1090,124,294,.422,45,137,.328,79,157,.503,.498,27,38,.711,22,97,119,137,44,7,73,77,320,2007
Desmon Farmer,SG,25,SEA,8,0,32,5,15,.333,2,8,.250,3,7,.429,.400,1,1,1.000,0,1,1,9,1,0,1,2,13,2007
Raymond Felton,PG,22,CHA,78,75,2832,393,1024,.384,103,312,.330,290,712,.407,.434,204,256,.797,51,216,267,545,118,10,230,180,1093,2007
Michael Finley,SF,33,SAS,82,16,1823,273,663,.412,104,286,.364,169,377,.448,.490,90,98,.918,34,189,223,108,32,16,46,76,740,2007
Derek Fisher,SG,32,UTA,82,61,2287,258,675,.382,48,156,.308,210,519,.405,.418,262,307,.853,30,119,149,274,83,6,120,234,826,2007
T.J. Ford,PG,23,TOR,75,71,2243,393,902,.436,21,69,.304,372,833,.447,.447,240,293,.819,53,183,236,595,101,8,231,186,1047,2007
Danny Fortson,C,30,SEA,14,6,158,15,30,.500,0,1,.000,15,29,.517,.500,10,13,.769,13,30,43,1,1,0,15,38,40,2007
Jeff Foster,C,30,IND,75,43,1740,122,260,.469,0,1,.000,122,259,.471,.469,78,122,.639,253,356,609,57,62,37,70,202,322,2007
Randy Foye,PG,23,MIN,82,12,1879,300,691,.434,68,185,.368,232,506,.458,.483,164,192,.854,49,169,218,232,53,21,152,184,832,2007
Adonal Foyle,C,31,GSW,48,6,475,48,85,.565,0,0,.000,48,85,.565,.565,11,25,.440,51,75,126,19,11,50,23,61,107,2007
Steve Francis,SG,29,NYK,44,30,1237,140,343,.408,42,111,.378,98,232,.422,.469,175,211,.829,33,124,157,170,41,12,100,126,497,2007
Matt Freije,PF,25,ATL,19,0,147,16,54,.296,3,22,.136,13,32,.406,.324,5,6,.833,8,16,24,7,3,1,3,13,40,2007
Channing Frye,PF,23,NYK,72,59,1896,298,689,.433,3,18,.167,295,671,.440,.435,85,108,.787,91,304,395,67,36,42,100,216,684,2007
Dan Gadzuric,C,28,MIL,54,8,840,108,228,.474,0,1,.000,108,227,.476,.474,42,90,.467,94,152,246,29,22,32,49,141,258,2007
Jorge Garbajosa,PF,29,TOR,67,60,1909,222,529,.420,66,193,.342,156,336,.464,.482,57,78,.731,48,282,330,125,78,15,64,90,567,2007
Francisco Garcia,SF,25,SAC,79,5,1410,163,380,.429,53,149,.356,110,231,.476,.499,95,114,.833,53,152,205,87,45,43,70,190,474,2007
Kevin Garnett,PF,30,MIN,76,76,2995,638,1341,.476,12,56,.214,626,1285,.487,.480,416,498,.835,183,792,975,313,89,126,205,184,1704,2007
Pat Garrity,PF,30,ORL,33,0,277,22,70,.314,11,32,.344,11,38,.289,.393,16,18,.889,12,30,42,14,7,0,14,37,71,2007
Pau Gasol,C,26,MEM,59,59,2133,462,858,.538,3,11,.273,459,847,.542,.540,299,400,.748,149,432,581,201,29,126,162,137,1226,2007
Rudy Gay,SF,20,MEM,78,43,2103,321,760,.422,52,143,.364,269,617,.436,.457,152,209,.727,93,255,348,100,71,74,140,192,846,2007
Mickael Gelabale,SF,23,SEA,70,14,1239,122,264,.462,11,47,.234,111,217,.512,.483,66,82,.805,59,114,173,56,24,22,49,108,321,2007
Devean George,SF,29,DAL,60,17,1283,146,370,.395,53,150,.353,93,220,.423,.466,36,48,.750,57,156,213,33,46,23,51,143,381,2007
Daniel Gibson,PG,20,CLE,60,16,988,98,231,.424,52,124,.419,46,107,.430,.537,28,39,.718,28,64,92,69,23,8,44,94,276,2007
Manu Ginobili,SG,29,SAS,75,36,2060,396,854,.464,128,323,.396,268,531,.505,.539,320,372,.860,59,268,327,263,109,27,157,155,1240,2007
Gordan Giricek,SG,29,UTA,61,6,1188,176,381,.462,52,122,.426,124,259,.479,.530,71,87,.816,24,105,129,63,28,5,64,122,475,2007
Andreas Glyniadakis,C,25,SEA,13,4,81,8,17,.471,0,0,.000,8,17,.471,.471,1,2,.500,2,6,8,1,0,0,9,19,17,2007
Ryan Gomes,PF,24,BOS,73,60,2275,338,723,.467,16,42,.381,322,681,.473,.479,189,233,.811,125,282,407,119,48,13,105,169,881,2007
Drew Gooden,PF,25,CLE,80,80,2238,371,784,.473,1,6,.167,370,778,.476,.474,142,199,.714,263,418,681,88,70,28,115,210,885,2007
Ben Gordon,SG,23,CHI,82,51,2704,609,1338,.455,155,375,.413,454,963,.471,.513,380,440,.864,35,223,258,296,64,17,249,252,1753,2007
Joey Graham,SF,24,TOR,79,21,1319,192,388,.495,9,31,.290,183,357,.513,.506,110,131,.840,55,193,248,44,30,4,49,161,503,2007
Stephen Graham,SG,24,POR,14,1,165,17,40,.425,3,11,.273,14,29,.483,.463,8,9,.889,6,15,21,5,4,1,13,25,45,2007
Danny Granger,SF,23,IND,82,57,2785,398,868,.459,110,288,.382,288,580,.497,.522,236,294,.803,114,267,381,114,67,61,135,245,1142,2007
Gerald Green,SF,21,BOS,81,26,1780,310,739,.419,95,258,.368,215,481,.447,.484,128,159,.805,68,140,208,83,41,24,120,198,843,2007
Willie Green,SG,25,PHI,74,36,1842,357,868,.411,51,157,.325,306,711,.430,.441,74,111,.667,42,116,158,112,56,4,106,144,839,2007
Orien Greene,SG,24,IND,41,0,254,23,62,.371,2,11,.182,21,51,.412,.387,15,25,.600,12,32,44,22,17,4,28,38,63,2007
Lynn Greer,SG,27,MIL,41,0,432,61,141,.433,18,52,.346,43,89,.483,.496,27,32,.844,2,25,27,53,17,1,18,32,167,2007
Adrian Griffin,SF,32,CHI,54,1,585,61,129,.473,0,6,.000,61,123,.496,.473,15,19,.789,40,69,109,59,32,4,38,78,137,2007
Eddie Griffin,PF,24,MIN,13,0,92,7,27,.259,0,1,.000,7,26,.269,.259,4,5,.800,7,18,25,4,0,7,6,8,18,2007
Mike Hall,SF,22,WAS,2,0,13,1,4,.250,0,0,.000,1,4,.250,.250,0,0,.000,1,1,2,1,0,0,0,1,2,2007
Richard Hamilton,SG,28,DET,75,75,2763,547,1170,.468,44,129,.341,503,1041,.483,.486,347,403,.861,75,207,282,285,59,15,159,232,1485,2007
Matt Harpring,SF,30,UTA,77,2,1965,322,656,.491,13,39,.333,309,617,.501,.501,237,309,.767,117,236,353,99,52,11,118,232,894,2007
Al Harrington,PF,26,TOT,78,78,2563,495,1083,.457,127,293,.433,368,790,.466,.516,168,242,.694,151,345,496,149,65,24,169,269,1285,2007
Al Harrington,PF,26,IND,36,36,1208,223,487,.458,54,118,.458,169,369,.458,.513,72,101,.713,71,155,226,51,25,10,91,116,572,2007
Al Harrington,PF,26,GSW,42,42,1355,272,596,.456,73,175,.417,199,421,.473,.518,96,141,.681,80,190,270,98,40,14,78,153,713,2007
Junior Harrington,PG,26,MEM,29,8,543,57,137,.416,7,26,.269,50,111,.450,.442,31,46,.674,12,56,68,89,21,5,52,79,152,2007
Othella Harrington,PF,33,CHA,26,0,220,25,56,.446,0,0,.000,25,56,.446,.446,17,22,.773,13,25,38,6,1,1,15,49,67,2007
Devin Harris,PG,23,DAL,80,61,2081,292,593,.492,14,50,.280,278,543,.512,.504,215,261,.824,45,151,196,296,96,21,146,242,813,2007
David Harrison,C,24,IND,24,2,190,30,58,.517,0,0,.000,30,58,.517,.517,11,22,.500,9,33,42,6,5,12,26,47,71,2007
Jason Hart,PG,28,TOT,36,22,846,100,224,.446,7,29,.241,93,195,.477,.462,42,47,.894,14,84,98,103,44,1,38,83,249,2007
Jason Hart,PG,28,SAC,13,0,100,15,30,.500,3,6,.500,12,24,.500,.550,10,11,.909,2,13,15,10,3,0,4,23,43,2007
Jason Hart,PG,28,LAC,23,22,746,85,194,.438,4,23,.174,81,171,.474,.448,32,36,.889,12,71,83,93,41,1,34,60,206,2007
Udonis Haslem,PF,26,MIA,79,79,2483,353,717,.492,0,4,.000,353,713,.495,.492,138,203,.680,188,466,654,97,49,26,110,236,844,2007
Trenton Hassell,SG,27,MIN,76,68,2223,217,443,.490,6,25,.240,211,418,.505,.497,72,92,.783,83,160,243,203,22,26,80,144,512,2007
Chuck Hayes,PF,23,HOU,78,43,1714,192,335,.573,0,0,.000,192,335,.573,.573,55,89,.618,204,317,521,47,70,18,64,281,439,2007
Jarvis Hayes,SF,25,WAS,81,17,1626,224,546,.410,66,183,.361,158,363,.435,.471,71,84,.845,42,168,210,80,48,13,56,160,585,2007
Brendan Haywood,C,27,WAS,77,49,1740,198,355,.558,0,0,.000,198,355,.558,.558,115,210,.548,195,282,477,47,34,88,90,208,511,2007
Luther Head,SG,24,HOU,80,10,2211,306,700,.437,177,401,.441,129,299,.431,.564,83,105,.790,31,221,252,194,76,5,137,133,872,2007
Alan Henderson,PF,34,PHI,38,5,418,43,67,.642,0,0,.000,43,67,.642,.642,33,47,.702,48,59,107,10,9,12,12,62,119,2007
Walter Herrmann,PF,27,CHA,48,12,936,174,330,.527,53,115,.461,121,215,.563,.608,41,53,.774,28,111,139,26,17,7,32,76,442,2007
Nene Hilario,C,24,DEN,64,42,1715,294,516,.570,0,1,.000,294,515,.571,.570,195,283,.689,150,299,449,77,62,59,127,209,783,2007
Grant Hill,SG,34,ORL,65,64,2009,342,660,.518,2,12,.167,340,648,.525,.520,248,324,.765,53,184,237,138,61,25,144,146,934,2007
Kirk Hinrich,PG,26,CHI,80,80,2839,475,1061,.448,140,337,.415,335,724,.463,.514,237,284,.835,32,242,274,500,100,23,191,274,1327,2007
Robert Hite,SG,23,MIA,12,0,136,19,60,.317,5,23,.217,14,37,.378,.358,8,12,.667,4,12,16,8,3,2,6,8,51,2007
Julius Hodge,SG,23,TOT,9,1,65,6,12,.500,0,0,.000,6,12,.500,.500,3,4,.750,2,6,8,12,4,0,3,6,15,2007
Julius Hodge,SG,23,DEN,4,1,37,2,5,.400,0,0,.000,2,5,.400,.400,2,2,1.000,1,2,3,10,3,0,1,3,6,2007
Julius Hodge,SG,23,MIL,5,0,28,4,7,.571,0,0,.000,4,7,.571,.571,1,2,.500,1,4,5,2,1,0,2,3,9,2007
Ryan Hollins,C,22,CHA,27,0,185,20,36,.556,0,0,.000,20,36,.556,.556,24,40,.600,11,20,31,1,4,7,16,40,64,2007
Robert Horry,PF,36,SAS,68,8,1124,90,251,.359,50,149,.336,40,102,.392,.458,38,64,.594,73,156,229,77,45,41,44,105,268,2007
Eddie House,SG,28,NJN,56,1,946,180,421,.428,75,175,.429,105,246,.427,.517,33,36,.917,14,78,92,67,27,3,27,69,468,2007
Dwight Howard,C,21,ORL,82,82,3023,526,873,.603,1,2,.500,525,871,.603,.603,390,666,.586,283,725,1008,158,70,156,317,245,1443,2007
Josh Howard,SF,26,DAL,70,69,2455,493,1075,.459,92,239,.385,401,836,.480,.501,243,294,.827,130,345,475,127,82,56,123,180,1321,2007
Juwan Howard,PF,33,HOU,80,38,2123,309,665,.465,0,0,.000,309,665,.465,.465,155,188,.824,138,332,470,131,29,8,112,205,773,2007
Troy Hudson,PG,30,MIN,34,6,554,74,195,.379,28,80,.350,46,115,.400,.451,26,32,.813,8,40,48,73,14,2,40,23,202,2007
Larry Hughes,SG,28,CLE,70,68,2596,381,953,.400,74,222,.333,307,731,.420,.439,209,309,.676,41,226,267,256,89,26,154,164,1045,2007
Kris Humphries,PF,21,TOR,60,2,670,87,185,.470,0,0,.000,87,185,.470,.470,53,79,.671,78,109,187,18,14,21,32,98,227,2007
Lindsey Hunter,PG,36,DET,52,0,745,94,244,.385,38,119,.319,56,125,.448,.463,30,33,.909,9,38,47,93,34,7,35,56,256,2007
Steven Hunter,PF,25,PHI,70,41,1605,188,326,.577,0,0,.000,188,326,.577,.577,74,151,.490,114,221,335,26,13,76,65,137,450,2007
Andre Iguodala,SG,23,PHI,76,76,3062,443,991,.447,48,155,.310,395,836,.472,.471,452,551,.820,77,357,434,432,152,33,261,200,1386,2007
Zydrunas Ilgauskas,C,31,CLE,78,78,2130,385,793,.485,0,1,.000,385,792,.486,.485,155,192,.807,242,357,599,123,48,98,141,257,925,2007
Mile Ilic,C,22,NJN,5,0,6,0,3,.000,0,0,.000,0,3,.000,.000,0,0,.000,0,1,1,0,0,0,3,1,0,2007
Didier Ilunga-Mbenga,C,26,DAL,21,0,79,5,16,.313,0,0,.000,5,16,.313,.313,7,8,.875,3,8,11,6,3,5,5,17,17,2007
Ersan Ilyasova,PF,19,MIL,66,14,973,139,363,.383,54,148,.365,85,215,.395,.457,70,89,.787,58,131,189,49,27,17,51,147,402,2007
Allen Iverson,SG-PG,31,TOT,65,64,2761,581,1313,.442,62,197,.315,519,1116,.465,.466,485,610,.795,23,170,193,468,123,13,268,95,1709,2007
Allen Iverson,PG,31,PHI,15,15,640,151,366,.413,12,53,.226,139,313,.444,.429,154,174,.885,7,34,41,109,33,1,66,21,468,2007
Allen Iverson,SG,31,DEN,50,49,2121,430,947,.454,50,144,.347,380,803,.473,.480,331,436,.759,16,136,152,359,90,12,202,74,1241,2007
Royal Ivey,PG,25,ATL,53,18,539,64,143,.448,5,16,.313,59,127,.465,.465,24,35,.686,15,36,51,45,24,4,31,62,157,2007
Jarrett Jack,PG,23,POR,79,79,2651,320,705,.454,63,180,.350,257,525,.490,.499,243,279,.871,18,190,208,417,86,9,187,202,946,2007
Bobby Jackson,SG,33,NOK,56,2,1330,204,518,.394,54,165,.327,150,353,.425,.446,130,168,.774,42,136,178,141,50,6,78,98,592,2007
Luke Jackson,SF,25,TOT,13,2,138,19,43,.442,5,17,.294,14,26,.538,.500,5,9,.556,2,8,10,13,5,1,7,15,48,2007
Luke Jackson,SF,25,LAC,3,0,16,1,8,.125,1,4,.250,0,4,.000,.188,0,0,.000,0,1,1,4,0,0,1,3,3,2007
Luke Jackson,SF,25,TOR,10,2,122,18,35,.514,4,13,.308,14,22,.636,.571,5,9,.556,2,7,9,9,5,1,6,12,45,2007
Marc Jackson,PF,32,NOK,56,25,1025,159,388,.410,0,1,.000,159,387,.411,.410,90,103,.874,62,130,192,58,21,7,65,89,408,2007
Stephen Jackson,SF-SG,28,TOT,75,69,2479,409,944,.433,100,311,.322,309,633,.488,.486,243,299,.813,61,161,222,287,84,34,183,200,1161,2007
Stephen Jackson,SG,28,IND,37,32,1186,180,430,.419,41,138,.297,139,292,.476,.466,120,146,.822,17,78,95,114,33,20,81,87,521,2007
Stephen Jackson,SF,28,GSW,38,37,1293,229,514,.446,59,173,.341,170,341,.499,.503,123,153,.804,44,83,127,173,51,14,102,113,640,2007
Jerome James,C,31,NYK,41,11,273,33,79,.418,0,0,.000,33,79,.418,.418,10,18,.556,21,45,66,3,6,15,23,73,76,2007
LeBron James,SF,22,CLE,78,78,3190,772,1621,.476,99,310,.319,673,1311,.513,.507,489,701,.698,83,443,526,470,125,55,250,171,2132,2007
Mike James,PG,31,MIN,82,65,2069,297,703,.422,80,215,.372,217,488,.445,.479,154,184,.837,25,138,163,297,55,7,129,171,828,2007
Antawn Jamison,PF,30,WAS,70,70,2662,512,1139,.450,138,379,.364,374,760,.492,.510,226,307,.736,134,428,562,136,80,36,104,194,1388,2007
Marko Jaric,SG,28,MIN,70,13,1555,136,325,.418,32,85,.376,104,240,.433,.468,67,88,.761,54,130,184,145,75,16,88,172,371,2007
Sarunas Jasikevicius,SG-PG,30,TOT,63,3,973,128,322,.398,44,130,.338,84,192,.438,.466,86,95,.905,15,54,69,172,26,1,90,75,386,2007
Sarunas Jasikevicius,SG,30,IND,37,1,664,91,221,.412,32,86,.372,59,135,.437,.484,59,64,.922,10,38,48,111,13,0,59,53,273,2007
Sarunas Jasikevicius,PG,30,GSW,26,2,309,37,101,.366,12,44,.273,25,57,.439,.426,27,31,.871,5,16,21,61,13,1,31,22,113,2007
Al Jefferson,C,22,BOS,69,60,2319,453,882,.514,0,1,.000,453,881,.514,.514,201,295,.681,237,519,756,88,48,106,136,232,1107,2007
Richard Jefferson,SF,26,NJN,55,53,1956,303,665,.456,52,145,.359,251,520,.483,.495,239,326,.733,48,192,240,148,34,8,120,123,897,2007
Jared Jeffries,SF,25,NYK,55,43,1307,95,206,.461,2,20,.100,93,186,.500,.466,31,68,.456,111,127,238,67,44,30,61,150,223,2007
Alexander Johnson,PF,23,MEM,59,19,753,91,169,.538,0,0,.000,91,169,.538,.538,78,118,.661,50,131,181,17,25,35,47,137,260,2007
Amir Johnson,PF,19,DET,8,0,124,18,33,.545,0,3,.000,18,30,.600,.545,11,14,.786,15,22,37,3,5,13,9,19,47,2007
Anthony Johnson,PG,32,TOT,67,17,1301,142,343,.414,25,73,.342,117,270,.433,.450,46,61,.754,22,79,101,201,33,3,76,119,355,2007
Anthony Johnson,PG,32,DAL,40,0,562,60,146,.411,11,29,.379,49,117,.419,.449,21,29,.724,13,35,48,78,16,1,31,68,152,2007
Anthony Johnson,PG,32,ATL,27,17,739,82,197,.416,14,44,.318,68,153,.444,.452,25,32,.781,9,44,53,123,17,2,45,51,203,2007
DerMarr Johnson,SF,26,DEN,39,7,419,50,154,.325,19,88,.216,31,66,.470,.386,16,21,.762,10,47,57,17,16,12,27,39,135,2007
Joe Johnson,SG,25,ATL,57,57,2359,536,1139,.471,119,312,.381,417,827,.504,.523,235,314,.748,53,186,239,249,60,11,176,115,1426,2007
Linton Johnson,PF,26,NOK,54,0,720,93,190,.489,10,30,.333,83,160,.519,.516,30,37,.811,52,111,163,18,33,18,27,101,226,2007
Bobby Jones,SF,23,PHI,44,5,336,43,93,.462,1,9,.111,42,84,.500,.468,23,41,.561,22,35,57,16,11,1,18,59,110,2007
Dahntay Jones,SG,26,MEM,78,25,1671,220,461,.477,5,12,.417,215,449,.479,.483,138,174,.793,47,106,153,68,39,22,92,192,583,2007
Damon Jones,PG,30,CLE,60,0,1173,137,355,.386,89,231,.385,48,124,.387,.511,30,44,.682,9,57,66,94,16,2,36,53,393,2007
Dwayne Jones,PF,23,CLE,4,0,18,0,1,.000,0,0,.000,0,1,.000,.000,3,6,.500,1,5,6,0,0,0,2,3,3,2007
Eddie Jones,SG,35,TOT,64,41,1594,178,422,.422,78,222,.351,100,200,.500,.514,59,75,.787,31,159,190,109,68,10,47,124,493,2007
Eddie Jones,SG,35,MEM,29,14,561,57,151,.377,22,74,.297,35,77,.455,.450,25,34,.735,14,47,61,33,22,2,23,54,161,2007
Eddie Jones,SG,35,MIA,35,27,1033,121,271,.446,56,148,.378,65,123,.528,.550,34,41,.829,17,112,129,76,46,8,24,70,332,2007
Fred Jones,SG,27,TOT,63,12,1319,139,361,.385,39,128,.305,100,233,.429,.439,95,114,.833,23,92,115,108,48,16,67,121,412,2007
Fred Jones,SG,27,TOR,39,9,870,96,249,.386,32,101,.317,64,148,.432,.450,73,88,.830,16,66,82,55,30,12,50,80,297,2007
Fred Jones,SG,27,POR,24,3,449,43,112,.384,7,27,.259,36,85,.424,.415,22,26,.846,7,26,33,53,18,4,17,41,115,2007
James Jones,SF,26,PHO,76,7,1376,162,440,.368,90,238,.378,72,202,.356,.470,71,81,.877,33,143,176,45,28,42,28,115,485,2007
Jumaine Jones,SF,27,PHO,18,0,138,14,51,.275,10,32,.313,4,19,.211,.373,2,2,1.000,6,17,23,1,5,1,7,19,40,2007
Solomon Jones,PF,22,ATL,58,8,666,65,128,.508,0,1,.000,65,127,.512,.508,59,75,.787,49,87,136,11,11,42,25,124,189,2007
Chris Kaman,C,24,LAC,75,66,2176,294,652,.451,0,1,.000,294,651,.452,.451,166,224,.741,160,428,588,79,41,116,147,251,754,2007
Jason Kapono,SF,25,MIA,67,35,1767,278,563,.494,108,210,.514,170,353,.482,.590,66,74,.892,26,154,180,81,38,2,70,135,730,2007
Viktor Khryapa,PF,24,CHI,33,0,231,27,70,.386,0,6,.000,27,64,.422,.386,19,26,.731,20,37,57,21,10,1,16,53,73,2007
Jason Kidd,PG,33,NJN,80,80,2933,369,908,.406,124,361,.343,245,547,.448,.475,179,230,.778,135,520,655,736,127,23,213,146,1041,2007
Tarence Kinsey,SG,22,MEM,48,12,967,139,304,.457,13,46,.283,126,258,.488,.479,78,98,.796,29,68,97,41,53,1,46,57,369,2007
Andrei Kirilenko,SF,25,UTA,70,70,2049,197,418,.471,16,75,.213,181,343,.528,.490,174,239,.728,88,241,329,202,74,144,135,172,584,2007
Linas Kleiza,PF,22,DEN,79,14,1488,200,474,.422,83,221,.376,117,253,.462,.509,115,135,.852,77,189,266,45,28,14,79,200,598,2007
Brevin Knight,PG,31,CHA,45,25,1273,152,363,.419,1,18,.056,151,345,.438,.420,103,128,.805,14,101,115,296,67,3,95,113,408,2007
Yaroslav Korolev,SF,19,LAC,10,0,41,4,16,.250,1,5,.200,3,11,.273,.281,3,6,.500,1,2,3,4,3,0,1,0,12,2007
Kyle Korver,SF,25,PHI,74,1,2288,372,845,.440,132,307,.430,240,538,.446,.518,191,209,.914,30,229,259,105,57,20,117,188,1067,2007
Nenad Krstic,C,23,NJN,26,26,848,170,323,.526,0,1,.000,170,322,.528,.526,86,121,.711,51,125,176,46,10,24,52,88,426,2007
Raef LaFrentz,PF,30,POR,27,9,352,39,102,.382,2,23,.087,37,79,.468,.392,20,26,.769,25,45,70,8,7,11,13,57,100,2007
James Lang,C,23,WAS,11,0,55,4,9,.444,0,0,.000,4,9,.444,.444,3,5,.600,5,6,11,2,0,3,2,14,11,2007
David Lee,PF,23,NYK,58,12,1731,240,400,.600,0,0,.000,240,400,.600,.600,141,173,.815,196,406,602,104,48,23,92,155,621,2007
Rashard Lewis,SF,27,SEA,60,60,2348,463,1005,.461,151,387,.390,312,618,.505,.536,265,315,.841,91,305,396,145,68,39,118,143,1342,2007
Randy Livingston,PG,31,SEA,4,0,26,0,3,.000,0,0,.000,0,3,.000,.000,0,0,.000,1,0,1,4,0,0,1,2,0,2007
Shaun Livingston,PG,21,LAC,54,31,1611,208,449,.463,5,16,.313,203,433,.469,.469,82,116,.707,56,128,184,274,59,29,108,135,503,2007
Kyle Lowry,PG,20,MEM,10,0,175,14,38,.368,3,8,.375,11,30,.367,.408,25,28,.893,12,19,31,32,14,1,12,20,56,2007
John Lucas III,PG,24,HOU,47,0,383,62,156,.397,15,59,.254,47,97,.485,.446,15,19,.789,9,27,36,33,17,0,15,38,154,2007
Tyronn Lue,PG,29,ATL,56,17,1488,218,524,.416,56,161,.348,162,363,.446,.469,144,163,.883,19,85,104,201,24,0,85,101,636,2007
Mark Madsen,C,31,MIN,56,0,473,23,43,.535,0,0,.000,23,43,.535,.535,15,29,.517,35,52,87,10,10,10,21,100,61,2007
Corey Maggette,SF,27,LAC,75,31,2291,367,808,.454,13,65,.200,354,743,.476,.462,519,633,.820,90,352,442,208,65,14,201,244,1266,2007
Jamaal Magloire,C,28,POR,81,23,1703,199,395,.504,0,0,.000,199,395,.504,.504,131,242,.541,151,341,492,30,21,66,129,226,529,2007
Renaldo Major,PF,24,GSW,1,0,27,2,10,.200,0,0,.000,2,10,.200,.200,1,2,.500,0,2,2,0,2,0,1,4,5,2007
Stephon Marbury,PG,29,NYK,74,74,2748,395,952,.415,123,345,.357,272,607,.448,.480,297,386,.769,36,177,213,403,71,10,179,185,1210,2007
Shawn Marion,SF,28,PHO,80,80,3010,561,1071,.524,80,252,.317,481,819,.587,.561,201,248,.810,172,613,785,134,156,122,114,216,1403,2007
Damir Markota,PF,21,MIL,30,0,170,19,52,.365,6,16,.375,13,36,.361,.423,7,11,.636,11,20,31,6,3,1,15,22,51,2007
Sean Marks,PF,31,PHO,3,0,17,2,6,.333,0,1,.000,2,5,.400,.333,2,2,1.000,0,3,3,0,0,1,0,4,6,2007
Donyell Marshall,PF,33,CLE,81,0,1360,209,493,.424,95,271,.351,114,222,.514,.520,53,80,.663,86,237,323,46,39,43,67,130,566,2007
Rawle Marshall,SG,24,IND,40,2,361,32,89,.360,4,18,.222,28,71,.394,.382,31,45,.689,8,21,29,13,12,5,19,22,99,2007
Darrick Martin,PG,35,TOR,31,0,220,33,94,.351,13,37,.351,20,57,.351,.420,15,21,.714,2,10,12,43,3,0,12,22,94,2007
Kenyon Martin,PF,29,DEN,2,2,63,8,16,.500,0,1,.000,8,15,.533,.500,3,12,.250,6,14,20,1,0,0,5,10,19,2007
Kevin Martin,SG,23,SAC,80,80,2818,505,1067,.473,127,333,.381,378,734,.515,.533,481,570,.844,69,273,342,173,98,11,135,181,1618,2007
Desmond Mason,SF,29,NOK,75,75,2575,407,900,.452,0,0,.000,407,900,.452,.452,214,323,.663,124,221,345,115,52,22,192,174,1028,2007
Roger Mason,SG,26,WAS,62,0,492,59,179,.330,33,102,.324,26,77,.338,.422,14,16,.875,7,38,45,35,13,6,19,66,165,2007
Jason Maxiell,C,23,DET,67,8,943,131,262,.500,0,0,.000,131,262,.500,.500,72,137,.526,88,98,186,14,30,60,53,110,334,2007
Sean May,PF,22,CHA,35,8,838,164,328,.500,2,3,.667,162,325,.498,.503,86,112,.768,73,160,233,66,19,24,56,100,416,2007
Rashad McCants,SG,22,MIN,37,0,554,62,177,.350,20,75,.267,42,102,.412,.407,40,58,.690,14,33,47,38,26,7,40,71,184,2007
Chris McCray,SG,22,MIL,5,0,12,0,3,.000,0,0,.000,0,3,.000,.000,0,0,.000,0,0,0,0,0,0,2,1,0,2007
Antonio McDyess,PF,32,DET,82,3,1729,284,540,.526,0,0,.000,284,540,.526,.526,96,139,.691,165,331,496,72,61,65,75,240,664,2007
Ivan McFarlin,PF,24,PHI,11,0,41,5,13,.385,0,1,.000,5,12,.417,.385,5,7,.714,7,4,11,1,0,0,1,8,15,2007
Tracy McGrady,SG,27,HOU,71,71,2539,638,1480,.431,126,381,.331,512,1099,.466,.474,345,488,.707,56,322,378,458,92,36,213,136,1747,2007
Jeff McInnis,PG,32,CHA,38,3,702,71,181,.392,1,8,.125,70,173,.405,.395,22,32,.688,14,48,62,124,14,0,42,72,165,2007
Aaron McKie,SF,34,LAL,10,0,131,11,17,.647,0,0,.000,11,17,.647,.647,0,0,.000,1,17,18,13,4,0,8,14,22,2007
Keith McLeod,PG,27,TOT,48,9,718,73,188,.388,16,45,.356,57,143,.399,.431,69,78,.885,4,39,43,90,24,5,46,51,231,2007
Keith McLeod,PG,27,GSW,26,2,379,41,105,.390,9,23,.391,32,82,.390,.433,47,53,.887,3,18,21,45,17,3,23,21,138,2007
Keith McLeod,PG,27,IND,22,7,339,32,83,.386,7,22,.318,25,61,.410,.428,22,25,.880,1,21,22,45,7,2,23,30,93,2007
Stanislav Medvedenko,C,27,ATL,14,0,81,12,29,.414,1,2,.500,11,27,.407,.431,17,20,.850,4,10,14,2,0,2,5,16,42,2007
Pops Mensah-Bonsu,PF,23,DAL,12,0,71,11,17,.647,0,0,.000,11,17,.647,.647,7,18,.389,9,12,21,0,1,0,9,8,29,2007
C.J. Miles,SG,19,UTA,37,13,373,40,116,.345,7,32,.219,33,84,.393,.375,14,23,.609,11,24,35,25,11,4,28,60,101,2007
Darko Milicic,PF,21,ORL,80,16,1913,249,548,.454,0,1,.000,249,547,.455,.454,141,230,.613,145,292,437,90,44,140,124,219,639,2007
Andre Miller,PG,30,TOT,80,79,2966,424,909,.466,5,35,.143,419,874,.479,.469,222,283,.784,97,255,352,625,110,10,222,184,1075,2007
Andre Miller,PG,30,DEN,23,23,822,117,248,.472,4,16,.250,113,232,.487,.480,62,85,.729,25,79,104,209,37,4,70,58,300,2007
Andre Miller,PG,30,PHI,57,56,2144,307,661,.464,1,19,.053,306,642,.477,.465,160,198,.808,72,176,248,416,73,6,152,126,775,2007
Brad Miller,C,30,SAC,63,56,1783,224,494,.453,5,33,.152,219,461,.475,.459,115,149,.772,79,322,401,224,38,39,108,155,568,2007
Mike Miller,SG,26,MEM,70,69,2740,465,1010,.460,202,498,.406,263,512,.514,.560,161,203,.793,52,326,378,298,54,18,179,138,1293,2007
Paul Millsap,PF,21,UTA,82,1,1472,209,398,.525,1,3,.333,208,395,.527,.526,140,208,.673,183,240,423,62,67,74,94,236,559,2007
Yao Ming,C,26,HOU,48,48,1624,423,819,.516,0,2,.000,423,817,.518,.516,356,413,.862,101,351,452,94,17,94,167,159,1202,2007
Cuttino Mobley,SG,31,LAC,78,73,2841,388,882,.440,101,246,.411,287,636,.451,.497,200,239,.837,52,215,267,198,92,24,145,186,1077,2007
Nazr Mohammed,C,29,DET,51,33,773,118,222,.532,0,0,.000,118,222,.532,.532,50,82,.610,89,140,229,9,27,40,43,133,286,2007
Mikki Moore,C,31,NJN,79,55,2082,308,506,.609,0,1,.000,308,505,.610,.609,160,235,.681,145,258,403,74,46,60,113,261,776,2007
Randolph Morris,C,21,NYK,5,0,44,1,6,.167,0,0,.000,1,6,.167,.167,2,6,.333,1,8,9,1,2,1,2,4,4,2007
Adam Morrison,PF,22,CHA,78,23,2326,355,944,.376,87,258,.337,268,686,.391,.422,120,169,.710,54,176,230,163,28,6,130,179,917,2007
Alonzo Mourning,C,36,MIA,77,43,1572,238,425,.560,0,0,.000,238,425,.560,.560,185,308,.601,126,224,350,18,13,178,129,219,661,2007
Troy Murphy,PF,26,TOT,68,48,1852,266,581,.458,58,147,.395,208,434,.479,.508,108,145,.745,100,314,414,126,46,42,78,196,698,2007
Troy Murphy,PF,26,GSW,26,17,667,81,180,.450,22,59,.373,59,121,.488,.511,47,66,.712,37,120,157,60,21,17,29,63,231,2007
Troy Murphy,PF,26,IND,42,31,1185,185,401,.461,36,88,.409,149,313,.476,.506,61,79,.772,63,194,257,66,25,25,49,133,467,2007
Ronald Murray,SG,27,DET,69,18,1477,177,438,.404,24,83,.289,153,355,.431,.432,87,120,.725,26,87,113,187,49,13,90,96,465,2007
Dikembe Mutombo,C,40,HOU,75,33,1289,85,153,.556,0,0,.000,85,153,.556,.556,60,87,.690,164,324,488,13,22,76,38,156,230,2007
Bostjan Nachbar,SF,26,NJN,76,1,1532,226,495,.457,112,265,.423,114,230,.496,.570,132,164,.805,27,226,253,61,30,26,69,183,696,2007
Eduardo Najera,PF,30,DEN,75,36,1658,204,354,.576,1,12,.083,203,342,.594,.578,88,123,.715,131,179,310,64,73,26,56,207,497,2007
Steve Nash,PG,32,PHO,76,76,2682,517,971,.532,156,343,.455,361,628,.575,.613,222,247,.899,30,239,269,884,57,6,287,117,1412,2007
Jameer Nelson,PG,24,ORL,77,77,2331,376,875,.430,65,194,.335,311,681,.457,.467,183,221,.828,50,186,236,330,73,5,184,225,1000,2007
Rasho Nesterovic,C,30,TOR,80,73,1676,230,421,.546,0,1,.000,230,420,.548,.546,34,50,.680,115,245,360,74,37,84,56,193,494,2007
Ira Newble,SF,32,CLE,15,1,129,16,37,.432,8,15,.533,8,22,.364,.541,6,10,.600,13,17,30,2,6,0,3,17,46,2007
Andres Nocioni,PF,27,CHI,53,31,1406,273,584,.467,80,209,.383,193,375,.515,.536,123,145,.848,42,259,301,57,27,24,104,164,749,2007
David Noel,PF,22,MIL,68,0,792,65,177,.367,17,53,.321,48,124,.387,.415,37,43,.860,42,81,123,65,25,9,40,77,184,2007
Steve Novak,SF,23,HOU,35,1,191,18,50,.360,13,39,.333,5,11,.455,.490,2,2,1.000,4,22,26,6,5,0,4,21,51,2007
Dirk Nowitzki,PF,28,DAL,78,78,2820,673,1341,.502,72,173,.416,601,1168,.515,.529,498,551,.904,122,571,693,263,52,62,167,171,1916,2007
Patrick O'Bryant,C,20,GSW,16,0,119,10,32,.313,0,0,.000,10,32,.313,.313,11,17,.647,7,14,21,9,6,8,8,26,31,2007
Jermaine O'Neal,C,28,IND,69,69,2459,498,1141,.436,0,7,.000,498,1134,.439,.436,343,447,.767,153,508,661,167,50,182,203,232,1339,2007
Shaquille O'Neal,C,34,MIA,40,39,1135,283,479,.591,0,0,.000,283,479,.591,.591,124,294,.422,97,200,297,79,8,55,95,139,690,2007
Fabricio Oberto,PF,31,SAS,79,33,1365,158,281,.562,0,0,.000,158,281,.562,.562,33,51,.647,131,237,368,68,25,24,69,213,349,2007
Lamar Odom,PF,27,LAL,56,56,2202,319,681,.468,54,182,.297,265,499,.531,.508,198,283,.700,102,445,547,270,53,32,163,182,890,2007
Emeka Okafor,C,24,CHA,67,65,2329,394,740,.532,0,0,.000,394,740,.532,.532,175,295,.593,258,499,757,80,57,172,111,210,963,2007
Mehmet Okur,C,27,UTA,80,80,2664,490,1061,.462,129,336,.384,361,725,.498,.523,296,387,.765,160,419,579,156,36,38,125,257,1405,2007
Kevin Ollie,PG,34,PHI,53,23,919,81,187,.433,0,2,.000,81,185,.438,.433,37,45,.822,8,66,74,130,21,1,47,76,199,2007
Michael Olowokandi,C,31,BOS,24,0,234,19,46,.413,0,0,.000,19,46,.413,.413,2,3,.667,14,34,48,5,8,13,17,48,40,2007
Bo Outlaw,PF,35,ORL,41,0,460,34,51,.667,0,0,.000,34,51,.667,.667,13,22,.591,47,59,106,16,17,6,21,57,81,2007
Travis Outlaw,PF,22,POR,67,1,1532,246,567,.434,10,37,.270,236,530,.445,.443,143,181,.790,65,152,217,52,61,74,66,150,645,2007
Zaza Pachulia,C,22,ATL,72,47,2026,291,614,.474,0,1,.000,291,613,.475,.474,293,373,.786,199,301,500,106,77,36,162,267,875,2007
Scott Padgett,PF,30,TOT,31,0,231,16,56,.286,8,33,.242,8,23,.348,.357,6,13,.462,16,38,54,8,5,3,9,35,46,2007
Scott Padgett,PF,30,HOU,24,0,198,15,49,.306,8,29,.276,7,20,.350,.388,6,11,.545,11,34,45,8,4,3,8,33,44,2007
Scott Padgett,PF,30,MEM,7,0,33,1,7,.143,0,4,.000,1,3,.333,.143,0,2,.000,5,4,9,0,1,0,1,2,2,2007
Jannero Pargo,PG,27,NOK,82,7,1710,283,692,.409,81,209,.388,202,483,.418,.467,104,122,.852,20,160,180,203,53,4,122,121,751,2007
Anthony Parker,SG,31,TOR,73,73,2437,328,687,.477,115,261,.441,213,426,.500,.561,132,158,.835,60,223,283,153,73,11,71,135,903,2007
Smush Parker,PG,25,LAL,82,80,2457,342,785,.436,110,301,.365,232,484,.479,.506,113,175,.646,45,161,206,228,119,10,153,211,907,2007
Tony Parker,PG,24,SAS,77,77,2499,570,1096,.520,15,38,.395,555,1058,.525,.527,274,350,.783,34,216,250,420,82,6,191,137,1429,2007
Ruben Patterson,SF,31,MIL,81,53,2508,475,867,.548,3,19,.158,472,848,.557,.550,241,376,.641,190,250,440,232,110,25,199,232,1194,2007
Chris Paul,PG,21,NOK,64,64,2353,381,871,.437,50,143,.350,331,728,.455,.466,292,357,.818,54,226,280,569,118,3,161,154,1104,2007
Sasha Pavlovic,SG,23,CLE,67,28,1534,222,490,.453,60,148,.405,162,342,.474,.514,100,126,.794,23,135,158,105,55,17,102,145,604,2007
Gary Payton,PG,38,MIA,68,28,1503,144,366,.393,32,123,.260,112,243,.461,.437,38,57,.667,18,114,132,201,43,3,66,117,358,2007
Kendrick Perkins,C,22,BOS,72,53,1576,132,269,.491,0,3,.000,132,266,.496,.491,60,100,.600,113,259,372,94,23,96,113,214,324,2007
Morris Peterson,SF,29,TOR,71,12,1515,222,517,.429,106,295,.359,116,222,.523,.532,84,123,.683,32,205,237,47,45,12,53,126,634,2007
Johan Petro,C,21,SEA,81,13,1510,226,438,.516,0,0,.000,226,438,.516,.516,50,77,.649,92,243,335,45,39,47,82,237,502,2007
Eric Piatkowski,SG,36,PHO,11,0,73,9,25,.360,7,18,.389,2,7,.286,.500,2,2,1.000,2,7,9,4,0,1,5,6,27,2007
Paul Pierce,SG,29,BOS,47,46,1740,373,850,.439,107,275,.389,266,575,.463,.502,320,402,.796,39,238,277,194,48,13,152,122,1173,2007
Mickael Pietrus,SF,24,GSW,72,38,1937,286,586,.488,93,240,.388,193,346,.558,.567,136,210,.648,81,246,327,62,48,55,105,220,801,2007
Kevinn Pinkney,PF,23,BOS,6,0,100,12,27,.444,1,2,.500,11,25,.440,.463,6,9,.667,7,8,15,5,3,3,4,12,31,2007
Scot Pollard,C,31,CLE,24,0,109,11,26,.423,0,0,.000,11,26,.423,.423,2,4,.500,15,16,31,3,4,1,4,27,24,2007
James Posey,SF,30,MIA,71,19,1919,186,432,.431,97,259,.375,89,173,.514,.543,81,98,.827,66,291,357,94,71,23,55,193,550,2007
Vitaly Potapenko,C,31,SAC,3,0,13,0,4,.000,0,0,.000,0,4,.000,.000,0,0,.000,0,2,2,0,0,0,2,3,0,2007
Leon Powe,C,23,BOS,63,2,720,79,177,.446,0,2,.000,79,175,.451,.446,106,144,.736,97,118,215,10,14,22,47,104,264,2007
Josh Powell,PF,24,TOT,37,0,353,43,93,.462,0,0,.000,43,93,.462,.462,30,42,.714,24,64,88,21,5,12,29,61,116,2007
Josh Powell,PF,24,IND,7,0,64,2,15,.133,0,0,.000,2,15,.133,.133,8,12,.667,7,12,19,3,0,0,5,18,12,2007
Josh Powell,PF,24,GSW,30,0,289,41,78,.526,0,0,.000,41,78,.526,.526,22,30,.733,17,52,69,18,5,12,24,43,104,2007
Roger Powell,SF,24,UTA,3,0,13,0,3,.000,0,1,.000,0,2,.000,.000,2,2,1.000,3,0,3,0,0,0,3,2,2,2007
Ronnie Price,PG,23,SAC,58,1,563,67,172,.390,21,65,.323,46,107,.430,.451,37,55,.673,15,56,71,48,28,4,33,64,192,2007
Tayshaun Prince,SF,26,DET,82,82,3001,459,997,.460,81,210,.386,378,787,.480,.501,172,224,.768,144,285,429,227,51,55,98,116,1171,2007
Joel Przybilla,C,27,POR,43,43,701,37,78,.474,0,0,.000,37,78,.474,.474,10,27,.370,59,109,168,12,10,67,40,124,84,2007
Chris Quinn,PG,23,MIA,42,1,408,48,131,.366,20,57,.351,28,74,.378,.443,25,37,.676,6,24,30,65,15,0,21,32,141,2007
Vladimir Radmanovic,PF,26,LAL,55,15,986,134,316,.424,40,118,.339,94,198,.475,.487,53,73,.726,53,127,180,66,25,18,69,125,361,2007
Shavlik Randolph,PF,23,PHI,13,6,179,23,48,.479,0,0,.000,23,48,.479,.479,12,22,.545,19,35,54,4,7,10,9,23,58,2007
Zach Randolph,PF,25,POR,68,67,2425,600,1286,.467,14,48,.292,586,1238,.473,.472,394,481,.819,199,489,688,147,53,15,215,184,1608,2007
Theo Ratliff,C,33,BOS,2,2,44,1,3,.333,0,0,.000,1,3,.333,.333,3,4,.750,2,5,7,0,1,3,1,6,5,2007
Allan Ray,SG,22,BOS,47,5,710,100,259,.386,48,116,.414,52,143,.364,.479,42,55,.764,18,51,69,43,20,3,42,85,290,2007
Michael Redd,SF,27,MIL,53,53,2036,477,1025,.465,117,306,.382,360,719,.501,.522,345,416,.829,42,154,196,124,63,9,122,78,1416,2007
J.J. Redick,PG,22,ORL,42,0,622,80,195,.410,38,98,.388,42,97,.433,.508,54,60,.900,10,42,52,36,12,0,21,52,252,2007
Justin Reed,PF,25,MIN,41,3,318,40,107,.374,0,0,.000,40,107,.374,.374,26,30,.867,15,31,46,17,5,3,22,44,106,2007
Jared Reiner,C,24,MIL,27,2,244,15,43,.349,0,0,.000,15,43,.349,.349,3,10,.300,21,50,71,13,5,6,14,45,33,2007
Jason Richardson,SG,26,GSW,51,49,1675,306,734,.417,110,301,.365,196,433,.453,.492,92,140,.657,71,188,259,172,54,32,82,129,814,2007
Jeremy Richardson,SG-SF,22,TOT,6,0,20,3,6,.500,2,3,.667,1,3,.333,.667,0,0,.000,1,1,2,0,1,0,1,2,8,2007
Jeremy Richardson,SG,22,ATL,5,0,19,3,6,.500,2,3,.667,1,3,.333,.667,0,0,.000,1,1,2,0,1,0,1,2,8,2007
Jeremy Richardson,SF,22,POR,1,0,1,0,0,.000,0,0,.000,0,0,.000,.000,0,0,.000,0,0,0,0,0,0,0,0,0,2007
Quentin Richardson,SF,26,NYK,49,47,1621,228,545,.418,97,258,.376,131,287,.456,.507,83,120,.692,65,287,352,108,36,7,70,133,636,2007
Luke Ridnour,PG,25,SEA,71,58,2091,301,695,.433,49,139,.353,252,556,.453,.468,128,159,.805,28,136,164,368,83,19,156,181,779,2007
Anthony Roberson,PG,23,GSW,20,1,227,44,104,.423,21,55,.382,23,49,.469,.524,2,3,.667,2,19,21,10,12,0,13,27,111,2007
Lawrence Roberts,PF,24,MEM,54,18,969,94,208,.452,0,2,.000,94,206,.456,.452,95,131,.725,101,160,261,30,36,13,36,133,283,2007
Bernard Robinson,SG-SF,26,TOT,31,0,278,19,62,.306,0,2,.000,19,60,.317,.306,23,27,.852,10,38,48,19,17,2,16,32,61,2007
Bernard Robinson,SG,26,CHA,21,0,241,16,54,.296,0,2,.000,16,52,.308,.296,19,22,.864,9,33,42,17,13,1,16,28,51,2007
Bernard Robinson,SF,26,NJN,10,0,37,3,8,.375,0,0,.000,3,8,.375,.375,4,5,.800,1,5,6,2,4,1,0,4,10,2007
Clifford Robinson,C,40,NJN,50,1,955,81,218,.372,25,66,.379,56,152,.368,.429,16,36,.444,31,91,122,51,12,23,30,98,203,2007
Nate Robinson,PG,22,NYK,64,5,1356,227,523,.434,83,213,.390,144,310,.465,.513,108,139,.777,55,97,152,90,50,6,72,160,645,2007
Sergio Rodriguez,PG,20,POR,67,1,862,101,239,.423,24,85,.282,77,154,.500,.473,21,26,.808,20,71,91,218,35,2,77,72,247,2007
Rajon Rondo,PG,20,BOS,78,25,1831,188,450,.418,6,29,.207,182,421,.432,.424,119,184,.647,74,218,292,297,128,8,137,181,501,2007
Jalen Rose,SF,34,PHO,29,0,246,38,86,.442,21,47,.447,17,39,.436,.564,11,12,.917,3,20,23,16,5,2,9,22,108,2007
Malik Rose,PF,32,NYK,65,2,810,74,186,.398,2,8,.250,72,178,.404,.403,42,52,.808,47,128,175,65,26,9,65,120,192,2007
Quinton Ross,SG,25,LAC,81,43,1700,177,379,.467,2,10,.200,175,369,.474,.470,68,87,.782,60,130,190,86,70,32,33,179,424,2007
Brandon Roy,SG,22,POR,57,55,2015,349,765,.456,55,146,.377,294,619,.475,.492,202,241,.838,58,192,250,230,67,10,116,139,955,2007
Michael Ruffin,PF,30,WAS,30,0,271,5,18,.278,0,0,.000,5,18,.278,.278,7,19,.368,35,27,62,6,6,8,12,43,17,2007
John Salmons,SG,27,SAC,79,19,2135,236,517,.456,40,112,.357,196,405,.484,.495,159,204,.779,47,217,264,254,73,27,119,177,671,2007
Jamal Sampson,C,23,DEN,22,3,125,9,14,.643,0,1,.000,9,13,.692,.643,6,14,.429,15,33,48,5,2,7,10,17,24,2007
Brian Scalabrine,PF,28,BOS,54,17,1027,77,191,.403,44,110,.400,33,81,.407,.518,18,23,.783,24,81,105,59,23,18,44,130,216,2007
Luke Schenscher,C,24,POR,11,0,118,7,23,.304,0,0,.000,7,23,.304,.304,5,7,.714,10,15,25,1,2,4,4,25,19,2007
Thabo Sefolosha,SG,22,CHI,71,4,868,109,256,.426,15,42,.357,94,214,.439,.455,23,45,.511,35,118,153,60,33,11,60,100,256,2007
Mouhamed Sene,C,20,SEA,28,3,169,18,49,.367,0,0,.000,18,49,.367,.367,17,29,.586,16,29,45,0,3,12,11,33,53,2007
Wayne Simien,PF,23,MIA,8,0,93,9,23,.391,0,0,.000,9,23,.391,.391,5,7,.714,5,6,11,4,2,0,3,13,23,2007
Cedric Simmons,PF,21,NOK,43,4,534,55,132,.417,0,0,.000,55,132,.417,.417,16,33,.485,44,63,107,12,8,23,22,75,126,2007
James Singleton,PF,25,LAC,53,0,376,30,82,.366,3,14,.214,27,68,.397,.384,22,29,.759,36,70,106,17,15,17,17,45,85,2007
Brian Skinner,PF,30,MIL,67,44,1523,124,253,.490,0,0,.000,124,253,.490,.490,46,79,.582,106,279,385,58,18,64,75,195,294,2007
Uros Slokar,C,23,TOR,20,0,72,14,26,.538,1,2,.500,13,24,.542,.558,9,13,.692,7,7,14,1,1,2,9,11,38,2007
Craig Smith,PF,23,MIN,82,5,1537,246,463,.531,0,6,.000,246,457,.538,.531,116,186,.624,149,267,416,49,51,18,74,223,608,2007
J.R. Smith,SG,21,DEN,63,24,1471,284,644,.441,149,382,.390,135,262,.515,.557,102,126,.810,30,113,143,91,49,9,85,147,819,2007
Joe Smith,PF,31,TOT,65,11,1503,214,477,.449,0,5,.000,214,472,.453,.449,125,148,.845,120,280,400,49,37,27,76,148,553,2007
Joe Smith,PF,31,DEN,11,0,148,23,48,.479,0,1,.000,23,47,.489,.479,10,12,.833,13,27,40,3,6,7,13,23,56,2007
Joe Smith,PF,31,PHI,54,11,1355,191,429,.445,0,4,.000,191,425,.449,.445,115,136,.846,107,253,360,46,31,20,63,125,497,2007
Josh Smith,SF,21,ATL,72,72,2647,436,993,.439,38,152,.250,398,841,.473,.458,268,387,.693,165,456,621,236,101,207,227,241,1178,2007
Steven Smith,PF,23,PHI,8,0,28,2,8,.250,0,0,.000,2,8,.250,.250,1,2,.500,1,5,6,0,1,0,2,4,5,2007
Eric Snow,PG,33,CLE,82,45,1929,135,324,.417,0,4,.000,135,320,.422,.417,72,113,.637,35,153,188,330,55,16,111,185,342,2007
Kirk Snyder,SF,23,HOU,39,1,563,66,146,.452,11,44,.250,55,102,.539,.490,49,75,.653,17,66,83,39,11,12,26,51,192,2007
Darius Songaila,PF,28,WAS,37,1,700,118,225,.524,0,2,.000,118,223,.529,.524,46,54,.852,44,90,134,38,17,10,43,105,282,2007
Pape Sow,C,25,TOR,7,0,34,3,9,.333,0,0,.000,3,9,.333,.333,4,6,.667,6,5,11,2,1,1,1,2,10,2007
Vassilis Spanoulis,SG,24,HOU,31,0,272,23,72,.319,5,29,.172,18,43,.419,.354,34,42,.810,5,17,22,28,7,1,29,33,85,2007
Jerry Stackhouse,SF,32,DAL,67,8,1615,280,654,.428,62,162,.383,218,492,.443,.476,182,215,.847,39,106,145,187,51,10,117,78,804,2007
DeShawn Stevenson,SG,25,WAS,82,82,2419,347,753,.461,74,183,.404,273,570,.479,.510,152,216,.704,55,161,216,218,65,19,119,155,920,2007
Peja Stojakovic,SF,29,NOK,13,13,425,83,196,.423,34,84,.405,49,112,.438,.510,31,38,.816,11,43,54,11,8,4,19,29,231,2007
Damon Stoudamire,PG,33,MEM,62,51,1501,171,437,.391,59,175,.337,112,262,.427,.459,66,83,.795,31,108,139,299,47,2,101,95,467,2007
Salim Stoudamire,SG,24,ATL,61,0,1034,177,425,.416,56,155,.361,121,270,.448,.482,61,68,.897,6,68,74,61,21,2,55,88,471,2007
Amar'e Stoudemire,C,24,PHO,82,78,2689,607,1055,.575,0,3,.000,607,1052,.577,.575,457,585,.781,222,564,786,84,78,110,232,295,1671,2007
Mike Sweetney,C,24,CHI,48,0,385,58,134,.433,0,0,.000,58,134,.433,.433,37,66,.561,45,75,120,28,9,11,42,79,153,2007
Stromile Swift,C,27,MEM,54,18,1029,161,346,.465,0,5,.000,161,341,.472,.465,97,134,.724,85,165,250,17,30,62,69,146,419,2007
Wally Szczerbiak,SF,29,BOS,32,19,900,161,388,.415,44,106,.415,117,282,.415,.472,113,126,.897,16,82,98,55,18,3,54,65,479,2007
Donell Taylor,SG,24,WAS,47,1,369,56,140,.400,3,17,.176,53,123,.431,.411,11,21,.524,14,39,53,45,17,3,25,34,126,2007
Maurice Taylor,PF,30,SAC,12,2,103,8,28,.286,0,0,.000,8,28,.286,.286,8,13,.615,10,18,28,5,4,1,6,16,24,2007
Sebastian Telfair,PG,21,BOS,78,30,1578,176,474,.371,37,128,.289,139,346,.402,.410,90,110,.818,17,91,108,218,43,11,98,166,479,2007
Jason Terry,SG,29,DAL,81,80,2846,514,1063,.484,162,370,.438,352,693,.508,.560,160,199,.804,41,190,231,422,81,17,152,170,1350,2007
Etan Thomas,C,28,WAS,65,32,1246,159,277,.574,0,0,.000,159,277,.574,.574,77,138,.558,136,241,377,29,22,89,71,162,395,2007
Kenny Thomas,PF,29,SAC,62,53,1412,146,303,.482,0,1,.000,146,302,.483,.482,39,76,.513,134,243,377,76,43,16,90,141,331,2007
Kurt Thomas,C,34,PHO,67,13,1208,126,259,.486,0,1,.000,126,258,.488,.486,56,71,.789,86,293,379,24,24,29,35,156,308,2007
Tim Thomas,PF,29,LAC,76,24,2054,299,723,.414,136,356,.382,163,367,.444,.508,102,144,.708,63,315,378,171,55,28,106,228,836,2007
Tyrus Thomas,PF,20,CHI,72,4,966,134,282,.475,0,2,.000,134,280,.479,.475,106,175,.606,89,180,269,40,46,76,94,162,374,2007
Dijon Thompson,SF,23,ATL,6,0,50,6,15,.400,0,2,.000,6,13,.462,.400,5,6,.833,3,5,8,2,0,0,1,2,17,2007
Jamaal Tinsley,PG,28,IND,72,72,2243,346,889,.389,61,193,.316,285,696,.409,.424,172,239,.720,60,180,240,494,117,25,200,190,925,2007
Jake Tsakalidis,C,27,TOT,36,7,390,29,72,.403,0,0,.000,29,72,.403,.403,26,39,.667,42,62,104,5,8,12,24,51,84,2007
Jake Tsakalidis,C,27,MEM,23,7,258,20,50,.400,0,0,.000,20,50,.400,.400,14,24,.583,24,40,64,2,7,11,21,34,54,2007
Jake Tsakalidis,C,27,HOU,13,0,132,9,22,.409,0,0,.000,9,22,.409,.409,12,15,.800,18,22,40,3,1,1,3,17,30,2007
P.J. Tucker,SF,21,TOR,17,0,83,11,22,.500,0,0,.000,11,22,.500,.500,8,14,.571,11,12,23,3,2,0,6,12,30,2007
Ronny Turiaf,C,24,LAL,72,1,1087,147,268,.549,0,1,.000,147,267,.551,.549,89,134,.664,88,171,259,63,17,78,52,202,383,2007
Hedo Turkoglu,SF,27,ORL,73,73,2268,345,823,.419,109,281,.388,236,542,.435,.485,171,219,.781,57,236,293,233,70,16,143,221,970,2007
Ime Udoka,SF,29,POR,75,75,2144,237,514,.461,89,219,.406,148,295,.502,.548,66,89,.742,95,184,279,112,71,17,73,207,629,2007
Beno Udrih,PG,24,SAS,73,1,948,127,344,.369,33,115,.287,94,229,.410,.417,53,60,.883,11,71,82,122,27,1,56,70,340,2007
Anderson Varejao,C,24,CLE,81,6,1932,191,401,.476,0,9,.000,191,392,.487,.476,165,268,.616,191,354,545,75,76,52,67,269,547,2007
Jacque Vaughn,PG,31,SAS,64,4,760,71,167,.425,1,2,.500,70,165,.424,.428,49,65,.754,8,60,68,131,24,2,40,74,192,2007
Charlie Villanueva,PF,22,MIL,39,17,984,180,383,.470,29,86,.337,151,297,.508,.508,73,89,.820,62,166,228,36,24,12,54,108,462,2007
Marcus Vinicius,SF,22,NOK,13,0,103,7,15,.467,3,7,.429,4,8,.500,.567,5,7,.714,2,9,11,5,2,1,6,10,22,2007
Jake Voskuhl,C,29,CHA,73,9,1043,121,255,.475,0,0,.000,121,255,.475,.475,77,113,.681,84,172,256,44,30,24,56,199,319,2007
Sasha Vujacic,SG,22,LAL,73,4,935,105,268,.392,60,161,.373,45,107,.421,.504,43,49,.878,28,79,107,64,41,1,30,103,313,2007
Dwyane Wade,SG,25,MIA,51,50,1931,472,962,.491,21,79,.266,451,883,.511,.502,432,535,.807,51,188,239,384,107,62,216,117,1397,2007
Von Wafer,SF,21,LAC,1,0,1,0,1,.000,0,1,.000,0,0,.000,.000,0,0,.000,0,0,0,0,0,0,0,0,0,2007
Dajuan Wagner,SG,23,GSW,1,0,7,1,1,1.000,1,1,1.000,0,0,1.500,.000,1,2,.500,0,0,0,1,0,0,1,1,4,2007
Antoine Walker,PF,30,MIA,78,15,1818,265,668,.397,84,305,.275,181,363,.499,.460,46,105,.438,92,247,339,130,48,17,141,173,660,2007
Ben Wallace,C,32,CHI,77,77,2697,192,424,.453,1,5,.200,191,419,.456,.454,109,267,.408,303,518,821,186,111,156,101,153,494,2007
Gerald Wallace,SF,24,CHA,72,71,2640,478,952,.502,39,120,.325,439,832,.528,.523,309,447,.691,142,376,518,185,144,69,160,209,1304,2007
Rasheed Wallace,C,32,DET,75,72,2419,357,843,.423,104,296,.351,253,547,.463,.485,108,137,.788,90,453,543,127,75,118,94,225,926,2007
Luke Walton,SF,26,LAL,60,60,1982,264,557,.474,48,124,.387,216,433,.499,.517,108,145,.745,87,215,302,257,60,21,118,117,684,2007
Hakim Warrick,PF,24,MEM,82,43,2152,373,712,.524,0,8,.000,373,704,.530,.524,299,388,.771,130,290,420,75,43,30,161,232,1045,2007
Earl Watson,PG,27,SEA,77,25,2152,263,687,.383,92,280,.329,171,407,.420,.450,108,147,.735,34,151,185,437,99,23,167,152,726,2007
Chris Webber,PF,33,TOT,61,60,1821,289,639,.452,4,11,.364,285,628,.454,.455,102,160,.638,124,313,437,188,60,41,107,143,684,2007
Chris Webber,PF,33,PHI,18,18,544,89,230,.387,2,5,.400,87,225,.387,.391,18,28,.643,37,112,149,61,18,15,33,36,198,2007
Chris Webber,PF,33,DET,43,42,1277,200,409,.489,2,6,.333,198,403,.491,.491,84,132,.636,87,201,288,127,42,26,74,107,486,2007
Martell Webster,SF,20,POR,82,27,1759,195,492,.396,91,250,.364,104,242,.430,.489,93,132,.705,43,197,240,52,35,19,76,126,574,2007
Bonzi Wells,SF,30,HOU,28,1,590,85,207,.411,1,7,.143,84,200,.420,.413,46,82,.561,26,94,120,31,24,13,57,62,217,2007
David Wesley,SG,36,CLE,35,5,352,22,75,.293,9,38,.237,13,37,.351,.353,20,28,.714,3,32,35,37,12,4,17,32,73,2007
David West,PF,26,NOK,52,52,1900,377,792,.476,8,25,.320,369,767,.481,.481,187,227,.824,126,298,424,114,42,38,98,143,949,2007
Delonte West,SG,23,BOS,69,47,2219,306,717,.427,65,178,.365,241,539,.447,.472,168,197,.853,32,176,208,304,74,34,140,152,845,2007
James White,SG,24,SAS,6,2,137,18,41,.439,2,7,.286,16,34,.471,.463,12,15,.800,3,17,20,5,3,1,5,7,50,2007
Chris Wilcox,PF,24,SEA,82,81,2586,433,819,.529,0,6,.000,433,813,.533,.529,240,351,.684,178,451,629,82,70,38,127,248,1106,2007
Damien Wilkins,SF,27,SEA,82,31,2037,262,602,.435,50,122,.410,212,480,.442,.477,150,170,.882,87,142,229,156,92,16,116,157,724,2007
Mike Wilks,PG,27,SEA,47,4,534,66,141,.468,5,15,.333,61,126,.484,.486,33,42,.786,15,39,54,79,15,4,31,53,170,2007
Aaron Williams,PF,35,LAC,38,7,374,29,53,.547,0,1,.000,29,52,.558,.547,18,22,.818,27,58,85,7,7,14,18,56,76,2007
Alvin Williams,PG,32,LAC,2,0,10,0,2,.000,0,1,.000,0,1,.000,.000,2,4,.500,1,0,1,3,2,0,3,0,2,2007
Deron Williams,PG,22,UTA,80,80,2950,494,1083,.456,82,255,.322,412,828,.498,.494,227,296,.767,41,226,267,745,78,13,246,254,1297,2007
Eric Williams,SF,34,TOT,21,0,121,19,47,.404,8,19,.421,11,28,.393,.489,8,14,.571,3,14,17,7,3,0,7,12,54,2007
Eric Williams,SF,34,SAS,16,0,88,15,34,.441,8,17,.471,7,17,.412,.559,4,7,.571,1,13,14,6,2,0,5,6,42,2007
Eric Williams,SF,34,CHA,5,0,33,4,13,.308,0,2,.000,4,11,.364,.308,4,7,.571,2,1,3,1,1,0,2,6,12,2007
Jason Williams,PG,31,MIA,61,55,1865,235,569,.413,100,295,.339,135,274,.493,.501,94,103,.913,18,123,141,322,58,1,100,68,664,2007
Justin Williams,C,22,SAC,26,1,333,54,88,.614,0,1,.000,54,87,.621,.614,23,63,.365,51,64,115,2,5,16,15,51,131,2007
Lou Williams,PG,20,PHI,61,0,688,93,211,.441,12,37,.324,81,174,.466,.469,64,92,.696,17,53,70,110,22,1,46,42,262,2007
Marcus Williams,PG,21,NJN,79,2,1315,208,526,.395,46,163,.282,162,363,.446,.439,72,85,.847,29,134,163,260,29,2,142,96,534,2007
Marvin Williams,PF,20,ATL,64,63,2179,306,706,.433,11,45,.244,295,661,.446,.441,216,265,.815,84,253,337,121,52,30,127,191,839,2007
Mo Williams,PG,24,MIL,68,68,2472,468,1049,.446,79,228,.346,389,821,.474,.484,159,186,.855,54,275,329,416,85,6,203,201,1174,2007
Shammond Williams,PG,31,LAL,30,0,345,35,86,.407,20,50,.400,15,36,.417,.523,4,6,.667,11,29,40,31,12,0,13,20,94,2007
Shawne Williams,SG,20,IND,46,3,556,75,160,.469,19,52,.365,56,108,.519,.528,11,20,.550,33,50,83,22,6,8,24,69,180,2007
Shelden Williams,PF,23,ATL,81,31,1514,166,365,.455,2,4,.500,164,361,.454,.458,110,144,.764,131,304,435,44,52,39,96,199,444,2007
Corliss Williamson,PF,33,SAC,68,1,1337,236,463,.510,0,2,.000,236,461,.512,.510,148,207,.715,63,158,221,39,29,15,97,183,620,2007
Kevin Willis,PF,44,DAL,5,0,43,5,13,.385,0,0,.000,5,13,.385,.385,2,2,1.000,2,6,8,1,2,1,2,11,12,2007
Metta World Peace,SF,27,SAC,70,65,2641,458,1040,.440,93,260,.358,365,780,.468,.485,307,415,.740,102,352,454,235,149,43,146,205,1316,2007
Antoine Wright,SG,22,NJN,63,23,1137,110,251,.438,19,59,.322,91,192,.474,.476,44,73,.603,38,137,175,55,30,10,43,120,283,2007
Bracey Wright,SG,22,MIN,19,0,190,24,60,.400,6,20,.300,18,40,.450,.450,13,18,.722,7,14,21,15,9,1,6,6,67,2007
Dorell Wright,SF,21,MIA,66,19,1292,162,364,.445,5,34,.147,157,330,.476,.452,64,86,.744,40,232,272,95,41,46,65,112,393,2007
Lorenzen Wright,C,31,ATL,67,31,1035,82,183,.448,0,0,.000,82,183,.448,.448,9,32,.281,85,131,216,40,28,28,39,204,173,2007
Shareef Abdur-Rahim,PF,29,SAC,72,30,1961,332,632,.525,5,22,.227,327,610,.536,.529,218,278,.784,106,251,357,149,48,42,108,227,887,2006
Alex Acker,SG,23,DET,5,0,35,4,16,.250,1,5,.200,3,11,.273,.281,0,0,.000,1,4,5,4,1,0,4,4,9,2006
Malik Allen,PF,27,CHI,54,20,701,121,247,.490,1,1,1.000,120,246,.488,.492,23,38,.605,44,96,140,20,14,16,34,92,266,2006
Ray Allen,SG,30,SEA,78,78,3022,681,1500,.454,269,653,.412,412,847,.486,.544,324,359,.903,71,261,332,286,105,16,188,151,1955,2006
Tony Allen,PG,24,BOS,51,9,978,129,274,.471,11,34,.324,118,240,.492,.491,100,134,.746,32,79,111,67,51,18,67,126,369,2006
Rafer Alston,PG,29,HOU,63,63,2431,280,738,.379,102,312,.327,178,426,.418,.449,99,143,.692,36,219,255,425,101,15,157,194,761,2006
Chris Andersen,C,27,NOK,32,2,570,56,98,.571,0,0,.000,56,98,.571,.571,49,103,.476,61,94,155,6,8,41,26,84,161,2006
Alan Anderson,SF,23,CHA,36,7,564,75,181,.414,24,58,.414,51,123,.415,.481,33,41,.805,23,47,70,32,11,4,32,48,207,2006
Derek Anderson,SG,31,TOT,43,11,1047,108,303,.356,40,134,.299,68,169,.402,.422,93,111,.838,21,122,143,101,23,6,54,98,349,2006
Derek Anderson,SG,31,HOU,20,8,582,68,173,.393,19,67,.284,49,106,.462,.448,61,73,.836,12,71,83,53,15,4,37,49,216,2006
Derek Anderson,SG,31,MIA,23,3,465,40,130,.308,21,67,.313,19,63,.302,.388,32,38,.842,9,51,60,48,8,2,17,49,133,2006
Shandon Anderson,SF,32,MIA,48,1,638,54,126,.429,5,19,.263,49,107,.458,.448,13,18,.722,18,63,81,30,17,6,24,75,126,2006
Martynas Andriuskevicius,C,19,CLE,6,0,9,0,1,.000,0,0,.000,0,1,.000,.000,0,0,.000,1,3,4,0,2,0,0,1,0,2006
Carmelo Anthony,SF,21,DEN,80,80,2941,756,1572,.481,37,152,.243,719,1420,.506,.493,573,709,.808,122,272,394,216,88,42,218,229,2122,2006
Rafael Araujo,C,25,TOR,52,34,601,53,145,.366,0,1,.000,53,144,.368,.366,15,28,.536,43,101,144,15,24,6,42,104,121,2006
Gilbert Arenas,PG,24,WAS,80,80,3384,746,1668,.447,199,540,.369,547,1128,.485,.507,655,799,.820,59,221,280,484,161,25,297,286,2346,2006
Trevor Ariza,SF,20,TOT,57,10,999,93,226,.412,1,5,.200,92,221,.416,.414,77,127,.606,78,140,218,61,57,11,62,100,264,2006
Trevor Ariza,SF,20,NYK,36,10,709,61,146,.418,1,3,.333,60,143,.420,.421,42,77,.545,49,88,137,46,43,9,46,78,165,2006
Trevor Ariza,SF,20,ORL,21,0,290,32,80,.400,0,2,.000,32,78,.410,.400,35,50,.700,29,52,81,15,14,2,16,22,99,2006
Darrell Armstrong,PG,37,DAL,62,2,622,43,128,.336,11,48,.229,32,80,.400,.379,33,42,.786,18,63,81,86,27,3,58,71,130,2006
Carlos Arroyo,PG-SG,26,TOT,77,0,1194,168,378,.444,7,20,.350,161,358,.450,.454,106,137,.774,33,97,130,232,38,4,83,119,449,2006
Carlos Arroyo,PG,26,DET,50,0,600,57,157,.363,2,6,.333,55,151,.364,.369,42,58,.724,24,46,70,155,19,3,45,77,158,2006
Carlos Arroyo,SG,26,ORL,27,0,594,111,221,.502,5,14,.357,106,207,.512,.514,64,79,.810,9,51,60,77,19,1,38,42,291,2006
Chucky Atkins,PG-SG,31,TOT,71,41,1713,226,573,.394,97,274,.354,129,299,.431,.479,129,163,.791,23,97,120,198,43,2,87,152,678,2006
Chucky Atkins,SG,31,WAS,28,2,552,66,174,.379,33,92,.359,33,82,.402,.474,22,31,.710,12,33,45,69,14,0,30,58,187,2006
Chucky Atkins,PG,31,MEM,43,39,1161,160,399,.401,64,182,.352,96,217,.442,.481,107,132,.811,11,64,75,129,29,2,57,94,491,2006
Stacey Augmon,SF,37,ORL,36,3,385,25,73,.342,0,0,.000,25,73,.342,.342,21,30,.700,18,35,53,23,12,6,11,40,71,2006
Vin Baker,C,34,LAC,8,1,85,7,15,.467,0,0,.000,7,15,.467,.467,13,18,.722,2,17,19,4,4,4,9,13,27,2006
Marcus Banks,PG,24,TOT,58,29,1497,219,468,.468,22,63,.349,197,405,.486,.491,118,147,.803,23,112,135,220,54,11,119,162,578,2006
Marcus Banks,PG,24,BOS,18,1,269,33,80,.413,6,19,.316,27,61,.443,.450,27,30,.900,4,15,19,32,7,0,23,38,99,2006
Marcus Banks,PG,24,MIN,40,28,1228,186,388,.479,16,44,.364,170,344,.494,.500,91,117,.778,19,97,116,188,47,11,96,124,479,2006
Leandro Barbosa,SG,23,PHO,57,11,1592,273,567,.481,87,196,.444,186,371,.501,.558,111,147,.755,31,119,150,158,48,6,89,145,744,2006
Matt Barnes,PF-SF,25,TOT,56,5,631,70,140,.500,3,15,.200,67,125,.536,.511,32,47,.681,48,73,121,28,20,7,30,100,175,2006
Matt Barnes,SF,25,NYK,6,5,93,11,30,.367,1,4,.250,10,26,.385,.383,3,4,.750,7,17,24,6,4,0,6,8,26,2006
Matt Barnes,PF,25,PHI,50,0,538,59,110,.536,2,11,.182,57,99,.576,.545,29,43,.674,41,56,97,22,16,7,24,92,149,2006
Andre Barrett,PG,23,TOT,19,0,282,38,104,.365,2,14,.143,36,90,.400,.375,9,12,.750,9,16,25,52,10,0,15,13,87,2006
Andre Barrett,PG,23,PHO,2,0,21,3,7,.429,0,1,.000,3,6,.500,.429,3,3,1.000,1,2,3,2,0,0,1,1,9,2006
Andre Barrett,PG,23,TOR,17,0,261,35,97,.361,2,13,.154,33,84,.393,.371,6,9,.667,8,14,22,50,10,0,14,12,78,2006
Earl Barron,C,24,MIA,8,0,45,5,16,.313,0,0,.000,5,16,.313,.313,3,4,.750,2,8,10,0,0,0,5,10,13,2006
Brent Barry,SG,34,SAS,74,5,1259,156,345,.452,80,202,.396,76,143,.531,.568,39,59,.661,29,130,159,123,39,27,52,99,431,2006
Jon Barry,SG,36,HOU,20,0,342,25,65,.385,12,32,.375,13,33,.394,.477,24,29,.828,1,30,31,26,13,1,22,25,86,2006
Eddie Basden,SF,22,CHI,19,0,141,15,37,.405,1,7,.143,14,30,.467,.419,8,10,.800,7,21,28,8,9,2,9,17,39,2006
Brandon Bass,PF,20,NOK,29,1,268,28,70,.400,0,0,.000,28,70,.400,.400,12,19,.632,18,50,68,3,3,7,11,18,68,2006
Esteban Batista,PF,22,ATL,57,3,495,34,80,.425,0,1,.000,34,79,.430,.425,33,53,.623,61,83,144,7,15,11,38,111,101,2006
Tony Battie,C,29,ORL,82,82,2215,280,552,.507,0,6,.000,280,546,.513,.507,89,134,.664,145,312,457,49,46,69,88,250,649,2006
Shane Battier,SF,27,MEM,81,81,2839,303,621,.488,65,165,.394,238,456,.522,.540,147,208,.707,164,265,429,136,92,114,90,223,818,2006
Lonny Baxter,C-PF,27,TOT,41,0,400,45,104,.433,0,0,.000,45,104,.433,.433,28,35,.800,45,72,117,4,11,8,20,56,118,2006
Lonny Baxter,C,27,HOU,23,0,281,33,72,.458,0,0,.000,33,72,.458,.458,16,19,.842,38,46,84,2,9,7,13,48,82,2006
Lonny Baxter,PF,27,CHA,18,0,119,12,32,.375,0,0,.000,12,32,.375,.375,12,16,.750,7,26,33,2,2,1,7,8,36,2006
Charlie Bell,SG,26,MIL,59,6,1283,180,410,.439,71,168,.423,109,242,.450,.526,63,89,.708,21,99,120,130,59,5,41,126,494,2006
Raja Bell,SG,29,PHO,79,79,2959,425,930,.457,197,446,.442,228,484,.471,.563,115,146,.788,44,209,253,207,76,22,89,248,1162,2006
Jonathan Bender,SF,25,IND,2,0,21,4,5,.800,0,0,.000,4,5,.800,.800,2,2,1.000,0,4,4,2,0,1,0,2,10,2006
Mike Bibby,PG,27,SAC,82,82,3167,597,1382,.432,192,497,.386,405,885,.458,.501,342,403,.849,29,211,240,444,82,10,199,169,1728,2006
Andris Biedrins,C,19,GSW,68,2,1000,118,185,.638,0,0,.000,118,185,.638,.638,22,72,.306,124,159,283,24,23,47,34,190,258,2006
Chauncey Billups,PG,29,DET,81,81,2925,423,1012,.418,184,425,.433,239,587,.407,.509,465,520,.894,41,211,252,699,71,8,170,160,1495,2006
Steve Blake,PG,25,POR,68,57,1781,206,470,.438,76,184,.413,130,286,.455,.519,72,91,.791,26,120,146,306,42,5,83,107,560,2006
Andray Blatche,PF,19,WAS,29,0,175,26,67,.388,3,13,.231,23,54,.426,.410,10,12,.833,12,26,38,10,5,7,12,36,65,2006
Mark Blount,C,30,TOT,81,55,2240,373,734,.508,0,0,.000,373,734,.508,.508,168,222,.757,96,269,365,99,40,76,194,254,914,2006
Mark Blount,C,30,BOS,39,25,1083,194,380,.511,0,0,.000,194,380,.511,.511,97,127,.764,36,126,162,66,15,36,120,107,485,2006
Mark Blount,C,30,MIN,42,30,1157,179,354,.506,0,0,.000,179,354,.506,.506,71,95,.747,60,143,203,33,25,40,74,147,429,2006
Keith Bogans,SG-SF,25,TOT,72,31,1912,215,544,.395,65,200,.325,150,344,.436,.455,127,186,.683,55,200,255,128,71,9,90,167,622,2006
Keith Bogans,SG,25,CHA,39,9,848,114,288,.396,33,98,.337,81,190,.426,.453,80,105,.762,29,77,106,45,39,3,41,78,341,2006
Keith Bogans,SF,25,HOU,33,22,1064,101,256,.395,32,102,.314,69,154,.448,.457,47,81,.580,26,123,149,83,32,6,49,89,281,2006
Andrew Bogut,PF,21,MIL,82,77,2348,323,606,.533,0,3,.000,323,603,.536,.533,122,194,.629,189,384,573,192,49,68,125,259,768,2006
Matt Bonner,PF,25,TOR,78,6,1710,209,467,.448,102,243,.420,107,224,.478,.557,63,76,.829,86,198,284,56,49,31,32,216,583,2006
Calvin Booth,C,29,WAS,33,2,250,20,47,.426,1,2,.500,19,45,.422,.436,5,9,.556,19,33,52,12,9,9,8,44,46,2006
Carlos Boozer,PF,24,UTA,33,19,1025,219,399,.549,0,0,.000,219,399,.549,.549,99,137,.723,73,212,285,88,30,8,69,105,537,2006
Chris Bosh,C,21,TOR,70,70,2751,549,1087,.505,0,13,.000,549,1074,.511,.505,474,581,.816,204,443,647,181,50,79,157,209,1572,2006
Bruce Bowen,SF,34,SAS,82,82,2755,232,536,.433,104,245,.424,128,291,.440,.530,51,84,.607,35,285,320,126,79,30,67,191,619,2006
Ryan Bowen,SF,30,HOU,68,19,652,37,124,.298,3,22,.136,34,102,.333,.310,11,14,.786,31,57,88,24,21,6,13,85,88,2006
Earl Boykins,PG,29,DEN,60,0,1542,271,661,.410,62,179,.346,209,482,.434,.457,152,174,.874,21,60,81,230,48,4,83,73,756,2006
Michael Bradley,PF,26,PHI,46,1,367,32,79,.405,1,5,.200,31,74,.419,.411,2,3,.667,40,67,107,17,5,7,19,39,67,2006
Elton Brand,PF,26,LAC,79,79,3099,756,1435,.527,1,3,.333,755,1432,.527,.527,440,568,.775,236,554,790,208,81,201,173,227,1953,2006
Primoz Brezec,C,26,CHA,79,79,2165,409,791,.517,0,2,.000,409,789,.518,.517,164,224,.732,181,259,440,45,19,32,85,227,982,2006
Devin Brown,SG,27,UTA,81,14,1711,207,527,.393,39,118,.331,168,409,.411,.430,158,212,.745,73,134,207,104,44,14,99,153,611,2006
Kwame Brown,C,23,LAL,72,49,1978,204,388,.526,0,1,.000,204,387,.527,.526,128,235,.545,182,291,473,72,27,46,100,196,536,2006
P.J. Brown,C,36,NOK,75,73,2380,269,583,.461,0,0,.000,269,583,.461,.461,139,168,.827,182,365,547,90,46,50,90,216,677,2006
Rick Brunson,PG,33,TOT,27,0,246,21,54,.389,5,13,.385,16,41,.390,.435,7,12,.583,1,21,22,35,8,1,22,22,54,2006
Rick Brunson,PG,33,SEA,4,0,31,5,8,.625,0,1,.000,5,7,.714,.625,0,0,.000,0,2,2,2,0,0,3,1,10,2006
Rick Brunson,PG,33,HOU,23,0,215,16,46,.348,5,12,.417,11,34,.324,.402,7,12,.583,1,19,20,33,8,1,19,21,44,2006
Kobe Bryant,SG,27,LAL,80,80,3277,978,2173,.450,180,518,.347,798,1655,.482,.491,696,819,.850,71,354,425,360,147,30,250,233,2832,2006
Greg Buckner,SG,29,DEN,73,27,1758,181,417,.434,86,243,.354,95,174,.546,.537,43,55,.782,31,178,209,127,87,20,52,180,491,2006
Pat Burke,C,32,PHO,42,0,346,63,127,.496,2,7,.286,61,120,.508,.504,13,21,.619,21,52,73,16,6,13,33,62,141,2006
Antonio Burks,PG,25,MEM,57,1,570,51,144,.354,1,6,.167,50,138,.362,.358,10,23,.435,4,33,37,76,20,0,36,45,113,2006
Kevin Burleson,PG,26,CHA,39,1,340,22,88,.250,10,54,.185,12,34,.353,.307,16,17,.941,4,22,26,48,26,2,25,63,70,2006
Caron Butler,SF,25,WAS,75,54,2708,494,1086,.455,41,120,.342,453,966,.469,.474,289,332,.870,114,352,466,186,127,18,175,238,1318,2006
Jackie Butler,C,20,NYK,55,0,740,117,215,.544,0,0,.000,117,215,.544,.544,58,77,.753,67,116,183,25,17,31,62,127,292,2006
Rasual Butler,SF,26,NOK,79,20,1875,257,633,.406,92,242,.380,165,391,.422,.479,79,114,.693,51,181,232,40,33,45,65,142,685,2006
Andrew Bynum,C,18,LAL,46,0,338,33,82,.402,0,0,.000,33,82,.402,.402,8,27,.296,34,46,80,9,4,22,17,56,74,2006
Will Bynum,PG,23,GSW,15,0,162,21,52,.404,2,9,.222,19,43,.442,.423,10,16,.625,3,9,12,19,7,0,14,10,54,2006
Zarko Cabarkapa,PF,24,GSW,61,0,505,67,174,.385,5,20,.250,62,154,.403,.399,60,84,.714,37,74,111,20,13,7,35,87,199,2006
Jose Calderon,SG,24,TOR,64,11,1487,132,312,.423,7,43,.163,125,269,.465,.434,78,92,.848,30,111,141,288,42,4,101,93,349,2006
Marcus Camby,C,31,DEN,56,54,1857,302,649,.465,1,11,.091,301,638,.472,.466,111,156,.712,132,536,668,115,79,184,92,158,716,2006
Brian Cardinal,PF,28,MEM,36,0,402,46,111,.414,13,29,.448,33,82,.402,.473,19,27,.704,11,44,55,33,23,0,27,65,124,2006
Matt Carroll,SG,25,CHA,78,6,1275,192,476,.403,72,185,.389,120,291,.412,.479,138,168,.821,34,123,157,35,47,11,48,120,594,2006
Anthony Carter,PG,30,MIN,45,8,589,53,137,.387,4,15,.267,49,122,.402,.401,40,55,.727,9,53,62,101,24,9,40,71,150,2006
Vince Carter,SG,29,NJN,79,79,2906,653,1518,.430,125,367,.341,528,1151,.459,.471,480,601,.799,135,327,462,338,94,53,213,235,1911,2006
Sam Cassell,PG,36,LAC,78,75,2653,493,1112,.443,70,190,.368,423,922,.459,.475,289,335,.863,40,247,287,491,74,11,175,225,1345,2006
Kelvin Cato,C,31,TOT,27,0,333,36,84,.429,0,0,.000,36,84,.429,.429,26,35,.743,20,50,70,4,6,12,18,52,98,2006
Kelvin Cato,C,31,ORL,23,0,299,31,72,.431,0,0,.000,31,72,.431,.431,26,35,.743,19,44,63,2,6,10,16,48,88,2006
Kelvin Cato,C,31,DET,4,0,34,5,12,.417,0,0,.000,5,12,.417,.417,0,0,.000,1,6,7,2,0,2,2,4,10,2006
Tyson Chandler,C,23,CHI,79,50,2121,160,283,.565,0,1,.000,160,282,.567,.565,97,193,.503,265,449,714,81,41,104,123,298,417,2006
Calbert Cheaney,SF,34,GSW,42,0,448,42,108,.389,0,8,.000,42,100,.420,.389,8,8,1.000,20,41,61,19,13,2,17,38,92,2006
Josh Childress,SF,22,ATL,74,10,2249,278,504,.552,32,65,.492,246,439,.560,.583,154,201,.766,134,253,387,131,86,39,101,184,742,2006
Doug Christie,SG,35,DAL,7,7,185,9,26,.346,0,1,.000,9,25,.360,.346,8,12,.667,2,11,13,14,9,1,6,10,26,2006
Speedy Claxton,PG,27,NOK,71,3,2019,304,736,.413,17,63,.270,287,673,.426,.425,246,320,.769,39,154,193,339,108,6,154,177,871,2006
Mateen Cleaves,PG,28,SEA,27,0,230,25,71,.352,4,16,.250,21,55,.382,.380,19,24,.792,2,12,14,42,3,2,14,30,73,2006
Jarron Collins,C,27,UTA,79,41,1730,129,280,.461,0,0,.000,129,280,.461,.461,157,219,.717,134,199,333,97,36,27,61,252,415,2006
Jason Collins,C,27,NJN,71,70,1895,104,262,.397,3,12,.250,101,250,.404,.403,44,86,.512,93,249,342,70,46,40,61,251,255,2006
Nick Collison,PF,25,SEA,66,27,1448,207,394,.525,0,3,.000,207,391,.529,.525,79,113,.699,143,225,368,74,21,35,77,213,493,2006
Brian Cook,PF,25,LAL,81,46,1535,261,511,.511,36,84,.429,225,427,.527,.546,84,101,.832,88,186,274,74,37,32,61,205,642,2006
Jamal Crawford,SG,25,NYK,79,27,2555,366,879,.416,101,293,.345,265,586,.452,.474,295,357,.826,36,212,248,301,87,15,175,150,1128,2006
Austin Croshere,PF,30,IND,50,26,1148,132,285,.463,54,140,.386,78,145,.538,.558,90,102,.882,62,203,265,62,22,7,48,105,408,2006
Eddy Curry,C,23,NYK,72,69,1865,336,597,.563,0,0,.000,336,597,.563,.563,307,486,.632,145,287,432,19,28,56,179,239,979,2006
Samuel Dalembert,C,24,PHI,66,52,1761,196,369,.531,0,1,.000,196,368,.533,.531,93,132,.705,159,382,541,25,34,160,107,244,485,2006
Erick Dampier,C,30,DAL,82,36,1934,171,347,.493,0,0,.000,171,347,.493,.493,127,215,.591,273,367,640,51,27,106,115,263,469,2006
Antonio Daniels,SG,30,WAS,80,17,2283,230,550,.418,23,101,.228,207,449,.461,.439,284,336,.845,19,153,172,284,52,8,89,96,767,2006
Marquis Daniels,SG,25,DAL,62,29,1766,246,512,.480,4,19,.211,242,493,.491,.484,138,183,.754,81,143,224,172,67,13,100,143,634,2006
Antonio Davis,PF-C,37,TOT,44,39,940,82,190,.432,0,1,.000,82,189,.434,.432,52,81,.642,90,118,208,21,23,10,51,125,216,2006
Antonio Davis,PF,37,NYK,36,31,749,68,159,.428,0,1,.000,68,158,.430,.428,45,61,.738,75,97,172,14,20,9,43,99,181,2006
Antonio Davis,C,37,TOR,8,8,191,14,31,.452,0,0,.000,14,31,.452,.452,7,20,.350,15,21,36,7,3,1,8,26,35,2006
Baron Davis,PG,26,GSW,54,48,1971,335,861,.389,102,324,.315,233,537,.434,.448,195,289,.675,45,191,236,480,89,14,159,165,967,2006
Dale Davis,C,36,DET,28,2,178,9,24,.375,0,1,.000,9,23,.391,.375,8,15,.533,21,32,53,6,0,9,4,23,26,2006
Josh Davis,PF,25,TOT,6,0,17,2,7,.286,0,2,.000,2,5,.400,.286,2,3,.667,3,1,4,1,2,0,1,3,6,2006
Josh Davis,PF,25,MIL,4,0,12,1,4,.250,0,1,.000,1,3,.333,.250,0,0,.000,2,1,3,1,1,0,1,2,2,2006
Josh Davis,PF,25,HOU,1,0,0,0,0,.000,0,0,.000,0,0,.000,.000,0,0,.000,0,0,0,0,0,0,0,1,0,2006
Josh Davis,PF,25,PHO,1,0,5,1,3,.333,0,1,.000,1,2,.500,.333,2,3,.667,1,0,1,0,1,0,0,0,4,2006
Ricky Davis,SG-SF,26,TOT,78,78,3207,584,1304,.448,73,242,.302,511,1062,.481,.476,275,345,.797,65,286,351,394,91,17,213,190,1516,2006
Ricky Davis,SG,26,BOS,42,42,1747,329,709,.464,40,125,.320,289,584,.495,.492,129,164,.787,40,147,187,221,49,9,115,91,827,2006
Ricky Davis,SF,26,MIN,36,36,1460,255,595,.429,33,117,.282,222,478,.464,.456,146,181,.807,25,139,164,173,42,8,98,99,689,2006
Carlos Delfino,SG,23,DET,68,1,726,91,226,.403,20,60,.333,71,166,.428,.447,45,67,.672,28,85,113,44,21,15,36,86,247,2006
Tony Delk,PG-SG,32,TOT,24,0,385,71,161,.441,20,47,.426,51,114,.447,.503,20,27,.741,14,39,53,33,13,1,19,28,182,2006
Tony Delk,SG,32,ATL,1,0,7,0,1,.000,0,0,.000,0,1,.000,.000,2,2,1.000,1,1,2,0,0,0,0,0,2,2006
Tony Delk,PG,32,DET,23,0,378,71,160,.444,20,47,.426,51,113,.451,.506,18,25,.720,13,38,51,33,13,1,19,28,180,2006
Luol Deng,SF,20,CHI,78,56,2604,442,954,.463,21,78,.269,421,876,.481,.474,207,276,.750,127,389,516,147,72,50,105,128,1112,2006
Boris Diaw,PF,23,PHO,81,70,2874,449,853,.526,8,30,.267,441,823,.536,.531,174,238,.731,159,399,558,503,58,85,189,260,1080,2006
Dan Dickau,PG,27,BOS,19,0,234,17,46,.370,10,20,.500,7,26,.269,.478,18,18,1.000,5,11,16,40,11,1,18,40,62,2006
Travis Diener,PG,23,ORL,23,0,246,29,69,.420,25,57,.439,4,12,.333,.601,5,6,.833,4,17,21,16,7,0,10,22,88,2006
Ike Diogu,PF,22,GSW,69,14,1031,175,334,.524,0,0,.000,175,334,.524,.524,136,168,.810,95,134,229,29,15,30,78,164,486,2006
DeSagana Diop,C,24,DAL,81,45,1510,75,154,.487,1,2,.500,74,152,.487,.490,39,72,.542,145,229,374,23,44,146,36,253,190,2006
Juan Dixon,SG,27,POR,76,42,1920,357,821,.435,65,170,.382,292,651,.449,.474,156,194,.804,30,147,177,149,58,6,113,157,935,2006
Michael Doleac,C,28,MIA,31,3,371,37,88,.420,0,0,.000,37,88,.420,.420,24,30,.800,23,62,85,8,10,7,14,45,98,2006
Keyon Dooling,PG,25,ORL,50,7,1137,178,405,.440,13,43,.302,165,362,.456,.456,101,121,.835,11,67,78,109,49,4,82,116,470,2006
Chris Duhon,PG,23,CHI,74,38,2155,215,538,.400,100,278,.360,115,260,.442,.493,117,143,.818,28,192,220,373,70,3,117,152,647,2006
Tim Duncan,PF,29,SAS,80,80,2784,574,1185,.484,2,5,.400,572,1180,.485,.485,335,533,.629,231,650,881,253,70,162,198,219,1485,2006
Mike Dunleavy,SF,25,GSW,81,68,2578,331,816,.406,74,260,.285,257,556,.462,.451,196,252,.778,78,321,399,237,60,32,120,199,932,2006
Ronald Dupree,SF,25,MIN,36,0,265,33,63,.524,0,1,.000,33,62,.532,.524,14,41,.341,21,28,49,14,12,0,14,44,80,2006
John Edwards,C,24,ATL,40,4,296,31,64,.484,0,0,.000,31,64,.484,.484,8,11,.727,18,30,48,5,3,15,12,76,70,2006
Howard Eisley,PG,33,TOT,32,0,394,34,103,.330,13,42,.310,21,61,.344,.393,20,24,.833,3,30,33,69,11,2,21,34,101,2006
Howard Eisley,PG,33,LAC,13,0,112,4,17,.235,1,4,.250,3,13,.231,.265,0,0,.000,1,13,14,25,3,0,3,11,9,2006
Howard Eisley,PG,33,DEN,19,0,282,30,86,.349,12,38,.316,18,48,.375,.419,20,24,.833,2,17,19,44,8,2,18,23,92,2006
Monta Ellis,SG,20,GSW,49,3,886,132,318,.415,28,82,.341,104,236,.441,.459,42,59,.712,22,83,105,78,32,11,58,69,334,2006
Francisco Elson,C,29,DEN,72,54,1579,151,284,.532,1,5,.200,150,279,.538,.533,49,74,.662,99,240,339,47,54,45,65,211,352,2006
Melvin Ely,PF,27,CHA,57,22,1348,216,425,.508,0,2,.000,216,423,.511,.508,128,192,.667,94,183,277,76,29,44,100,160,560,2006
Maurice Evans,SG,27,DET,80,1,1139,154,341,.452,43,116,.371,111,225,.493,.515,52,65,.800,76,87,163,60,41,15,39,122,403,2006
Reggie Evans,PF,25,TOT,67,25,1393,131,268,.489,0,1,.000,131,267,.491,.489,115,217,.530,171,331,502,38,40,10,85,166,377,2006
Reggie Evans,PF,25,SEA,41,23,788,88,173,.509,0,1,.000,88,172,.512,.509,66,120,.550,114,162,276,23,24,5,41,95,242,2006
Reggie Evans,PF,25,DEN,26,2,605,43,95,.453,0,0,.000,43,95,.453,.453,49,97,.505,57,169,226,15,16,5,44,71,135,2006
Daniel Ewing,SG,22,LAC,66,5,971,97,255,.380,22,78,.282,75,177,.424,.424,36,46,.783,23,62,85,84,37,6,57,86,252,2006
Noel Felix,SF,24,SEA,12,0,82,6,25,.240,1,3,.333,5,22,.227,.260,5,8,.625,3,10,13,2,2,3,8,13,18,2006
Raymond Felton,PG,21,CHA,80,54,2406,345,883,.391,97,271,.358,248,612,.405,.446,161,222,.725,77,188,265,446,102,8,182,181,948,2006
Michael Finley,SG,32,SAS,77,18,2038,286,695,.412,110,279,.394,176,416,.423,.491,98,115,.852,31,216,247,116,37,7,62,97,780,2006
Derek Fisher,PG,31,GSW,82,36,2589,364,887,.410,117,295,.397,247,592,.417,.476,244,293,.833,36,175,211,352,125,8,156,237,1089,2006
Gerald Fitch,PG,23,MIA,18,1,239,30,89,.337,7,26,.269,23,63,.365,.376,17,23,.739,7,23,30,33,7,5,15,28,84,2006
Marcus Fizer,PF,27,NOK,3,0,39,9,17,.529,1,1,1.000,8,16,.500,.559,1,2,.500,1,6,7,1,0,0,2,5,20,2006
Sharrod Ford,PF,24,PHO,3,0,13,2,3,.667,0,0,.000,2,3,.667,.667,0,0,.000,1,2,3,0,0,1,2,7,4,2006
T.J. Ford,PG,22,MIL,72,70,2557,328,789,.416,35,104,.337,293,685,.428,.438,187,248,.754,63,248,311,473,104,7,219,196,878,2006
Danny Fortson,C,29,SEA,23,1,276,27,51,.529,0,0,.000,27,51,.529,.529,33,43,.767,31,47,78,2,4,2,26,76,87,2006
Jeff Foster,C,29,IND,63,37,1581,138,250,.552,0,4,.000,138,246,.561,.552,96,159,.604,224,350,574,50,41,27,64,191,372,2006
Adonal Foyle,C,30,GSW,77,72,1824,152,300,.507,0,0,.000,152,300,.507,.507,41,67,.612,143,281,424,33,44,125,80,215,345,2006
Richie Frahm,SG,28,TOT,33,0,342,39,100,.390,23,70,.329,16,30,.533,.505,7,10,.700,3,30,33,21,4,2,8,30,108,2006
Richie Frahm,SG,28,MIN,25,0,225,24,65,.369,15,48,.313,9,17,.529,.485,3,5,.600,3,20,23,15,3,2,4,22,66,2006
Richie Frahm,SG,28,HOU,8,0,117,15,35,.429,8,22,.364,7,13,.538,.543,4,5,.800,0,10,10,6,1,0,4,8,42,2006
Steve Francis,PG-SG,28,TOT,70,60,2393,333,765,.435,25,83,.301,308,682,.452,.452,314,399,.787,74,216,290,345,74,17,214,204,1005,2006
Steve Francis,PG,28,ORL,46,45,1734,249,575,.433,18,70,.257,231,505,.457,.449,231,290,.797,60,159,219,262,51,11,156,142,747,2006
Steve Francis,SG,28,NYK,24,15,659,84,190,.442,7,13,.538,77,177,.435,.461,83,109,.761,14,57,71,83,23,6,58,62,258,2006
Channing Frye,C,22,NYK,65,14,1572,305,640,.477,3,9,.333,302,631,.479,.479,189,229,.825,138,236,374,53,30,47,97,200,802,2006
Dan Gadzuric,C,27,MIL,74,0,885,171,309,.553,0,1,.000,171,308,.555,.553,41,89,.461,91,141,232,24,25,43,35,171,383,2006
Deng Gai,C,23,PHI,2,0,5,0,0,.000,0,0,.000,0,0,.000,.000,0,0,.000,0,0,0,0,0,0,0,0,0,2006
Reece Gaines,PG,25,MIL,12,0,54,6,12,.500,0,2,.000,6,10,.600,.500,1,4,.250,0,0,0,3,1,0,1,1,13,2006
Francisco Garcia,SF,24,SAC,67,11,1301,130,325,.400,39,137,.285,91,188,.484,.460,78,101,.772,39,146,185,94,41,47,75,135,377,2006
Kevin Garnett,PF,29,MIN,76,76,2957,626,1191,.526,8,30,.267,618,1161,.532,.529,396,489,.810,214,752,966,308,104,107,180,206,1656,2006
Pat Garrity,PF,29,ORL,57,0,938,101,242,.417,50,129,.388,51,113,.451,.521,30,37,.811,31,77,108,38,12,9,38,108,282,2006
Pau Gasol,PF,25,MEM,80,80,3135,600,1194,.503,3,12,.250,597,1182,.505,.504,425,617,.689,191,522,713,371,46,153,235,184,1628,2006
Devean George,SF,28,LAL,71,5,1542,170,425,.400,50,160,.313,120,265,.453,.459,58,86,.674,82,192,274,68,66,34,54,159,448,2006
Eddie Gill,PG,27,IND,41,0,122,10,45,.222,7,23,.304,3,22,.136,.300,18,23,.783,0,15,15,12,11,1,9,13,45,2006
Manu Ginobili,SG,28,SAS,65,56,1813,309,669,.462,83,217,.382,226,452,.500,.524,280,360,.778,42,188,230,235,101,26,121,156,981,2006
Gordan Giricek,SG,28,UTA,37,36,956,166,383,.433,18,59,.305,148,324,.457,.457,43,57,.754,15,55,70,63,16,4,63,87,393,2006
Anthony Goldwire,PG,34,LAC,3,0,22,1,7,.143,0,2,.000,1,5,.200,.143,0,0,.000,0,1,1,2,0,0,1,0,2,2006
Ryan Gomes,PF,23,BOS,61,33,1376,173,355,.487,3,9,.333,170,346,.491,.492,112,149,.752,102,196,298,58,35,5,55,83,461,2006
Drew Gooden,PF,24,CLE,79,79,2174,334,652,.512,1,3,.333,333,649,.513,.513,176,258,.682,237,428,665,56,52,49,106,190,845,2006
Ben Gordon,SG,22,CHI,80,47,2482,486,1152,.422,166,382,.435,320,770,.416,.494,211,268,.787,43,176,219,240,75,5,180,238,1349,2006
Joey Graham,SF,23,TOR,80,24,1581,198,414,.478,29,87,.333,169,327,.517,.513,108,133,.812,57,187,244,60,37,13,92,228,533,2006
Stephen Graham,SG,23,TOT,22,0,175,21,54,.389,2,10,.200,19,44,.432,.407,14,15,.933,5,22,27,7,5,2,13,31,58,2006
Stephen Graham,SG,23,HOU,6,0,38,6,16,.375,1,5,.200,5,11,.455,.406,4,4,1.000,1,6,7,3,2,0,5,5,17,2006
Stephen Graham,SG,23,CHI,3,0,20,1,5,.200,1,4,.250,0,1,.000,.300,2,2,1.000,0,3,3,1,0,0,1,3,5,2006
Stephen Graham,SG,23,CLE,13,0,117,14,33,.424,0,1,.000,14,32,.438,.424,8,9,.889,4,13,17,3,3,2,7,23,36,2006
Danny Granger,SF,22,IND,78,17,1765,221,478,.462,30,93,.323,191,385,.496,.494,115,148,.777,131,253,384,90,58,62,80,211,587,2006
Brian Grant,C,33,PHO,21,2,248,27,65,.415,0,0,.000,27,65,.415,.415,7,8,.875,11,46,57,7,5,3,7,45,61,2006
Devin Green,SG,23,LAL,27,0,135,6,28,.214,0,2,.000,6,26,.231,.214,13,21,.619,10,14,24,7,3,0,5,13,25,2006
Gerald Green,SG,20,BOS,32,3,374,66,138,.478,6,20,.300,60,118,.508,.500,29,37,.784,10,31,41,18,13,4,22,41,167,2006
Willie Green,SG,24,PHI,10,2,153,28,66,.424,10,19,.526,18,47,.383,.500,4,5,.800,1,14,15,5,2,0,12,13,70,2006
Orien Greene,PG,23,BOS,80,5,1235,100,253,.395,9,40,.225,91,213,.427,.413,45,68,.662,37,108,145,129,77,10,109,181,254,2006
Adrian Griffin,SG,31,DAL,52,45,1245,98,204,.480,0,2,.000,98,202,.485,.480,41,53,.774,75,152,227,89,51,9,39,113,237,2006
Eddie Griffin,C,23,MIN,70,27,1359,130,370,.351,16,82,.195,114,288,.396,.373,44,74,.595,107,282,389,40,13,148,43,125,320,2006
Anthony Grundy,SG,26,ATL,12,0,108,19,38,.500,5,15,.333,14,23,.609,.566,9,14,.643,1,16,17,9,7,0,9,14,52,2006
Richard Hamilton,SG,27,DET,80,80,2825,649,1322,.491,55,120,.458,594,1202,.494,.512,256,303,.845,84,172,256,275,52,16,173,207,1609,2006
Zendon Hamilton,C,30,TOT,12,0,49,7,14,.500,0,0,.000,7,14,.500,.500,12,18,.667,3,8,11,0,4,0,6,5,26,2006
Zendon Hamilton,C,30,CLE,11,0,46,7,13,.538,0,0,.000,7,13,.538,.538,11,16,.688,3,8,11,0,3,0,6,4,25,2006
Zendon Hamilton,C,30,PHI,1,0,3,0,1,.000,0,0,.000,0,1,.000,.000,1,2,.500,0,0,0,0,1,0,0,1,1,2006
Anfernee Hardaway,SF,34,NYK,4,0,72,4,14,.286,0,1,.000,4,13,.308,.286,2,2,1.000,0,10,10,8,2,0,6,7,10,2006
Matt Harpring,SF,29,UTA,71,32,1944,322,678,.475,14,39,.359,308,639,.482,.485,227,313,.725,158,210,368,98,59,14,109,202,885,2006
Al Harrington,PF,25,ATL,76,76,2782,551,1220,.452,66,191,.346,485,1029,.471,.479,243,350,.694,132,391,523,238,85,14,195,301,1411,2006
Othella Harrington,C,32,CHI,72,23,824,135,273,.495,0,0,.000,135,273,.495,.495,77,123,.626,54,100,154,39,7,13,61,131,347,2006
Devin Harris,PG,22,DAL,56,4,1275,190,405,.469,5,21,.238,185,384,.482,.475,169,236,.716,26,99,125,177,53,16,84,121,554,2006
David Harrison,C,23,IND,67,17,1034,148,294,.503,0,0,.000,148,294,.503,.503,89,174,.511,84,170,254,14,23,59,79,193,385,2006
Jason Hart,PG,27,SAC,66,0,818,86,221,.389,9,31,.290,77,190,.405,.410,37,56,.661,12,59,71,70,31,5,43,85,218,2006
Udonis Haslem,PF,25,MIA,81,80,2491,300,591,.508,0,2,.000,300,589,.509,.508,157,199,.789,167,467,634,95,50,17,80,216,757,2006
Trenton Hassell,SG,26,MIN,77,67,2514,286,616,.464,7,23,.304,279,593,.470,.470,131,176,.744,82,134,216,203,43,29,124,201,710,2006
Chuck Hayes,PF,22,HOU,40,0,535,59,105,.562,0,1,.000,59,104,.567,.562,29,45,.644,67,112,179,14,26,14,12,76,147,2006
Jarvis Hayes,SG,24,WAS,21,13,516,77,183,.421,17,47,.362,60,136,.441,.467,25,30,.833,19,57,76,27,16,1,22,38,196,2006
Brendan Haywood,C,26,WAS,79,70,1879,222,432,.514,0,0,.000,222,432,.514,.514,131,224,.585,200,267,467,46,30,104,97,232,575,2006
Luther Head,SG,23,HOU,80,27,2310,254,630,.403,113,313,.361,141,317,.445,.493,86,123,.699,33,233,266,215,89,9,119,169,707,2006
Alan Henderson,C,33,CLE,51,3,531,47,91,.516,0,0,.000,47,91,.516,.516,33,49,.673,60,77,137,10,9,12,22,58,127,2006
Nene Hilario,PF,23,DEN,1,0,3,0,1,.000,0,0,.000,0,1,.000,.000,0,0,.000,0,0,0,0,0,0,2,1,0,2006
Grant Hill,SF,33,ORL,21,17,613,119,243,.490,2,8,.250,117,235,.498,.494,78,102,.765,15,65,80,48,24,6,35,50,318,2006
Kirk Hinrich,PG,25,CHI,81,81,2955,451,1078,.418,126,341,.370,325,737,.441,.477,256,314,.815,29,259,288,514,94,21,188,251,1284,2006
Julius Hodge,SG,22,DEN,14,0,33,5,13,.385,0,0,.000,5,13,.385,.385,3,8,.375,5,2,7,6,2,0,8,7,13,2006
Randy Holcomb,SF,26,CHI,4,0,11,1,1,1.000,0,0,.000,1,1,1.000,1.000,0,0,.000,1,0,1,0,0,0,0,2,2,2006
Robert Horry,PF,35,SAS,63,3,1182,112,292,.384,53,144,.368,59,148,.399,.474,44,68,.647,71,171,242,79,43,51,41,115,321,2006
Eddie House,PG,27,PHO,81,0,1421,320,759,.422,123,316,.389,197,443,.445,.503,33,41,.805,15,117,132,148,42,12,76,96,796,2006
Dwight Howard,PF,20,ORL,82,81,3021,468,881,.531,0,2,.000,468,879,.532,.531,356,598,.595,288,734,1022,125,65,115,217,277,1292,2006
Josh Howard,SF,25,DAL,59,58,1915,350,743,.471,27,63,.429,323,680,.475,.489,196,267,.734,123,248,371,111,68,26,79,167,923,2006
Juwan Howard,PF,32,HOU,80,80,2537,394,859,.459,0,4,.000,394,855,.461,.459,154,191,.806,168,367,535,112,49,8,133,235,942,2006
Troy Hudson,PG,29,MIN,36,0,800,127,333,.381,40,101,.396,87,232,.375,.441,48,52,.923,8,36,44,106,12,4,40,55,342,2006
Larry Hughes,SG,27,CLE,36,31,1281,192,469,.409,28,76,.368,164,393,.417,.439,146,193,.756,26,135,161,131,53,21,99,117,558,2006
Kris Humphries,PF,20,UTA,62,2,619,77,203,.379,0,5,.000,77,198,.389,.379,34,65,.523,56,101,157,30,23,16,31,82,188,2006
Lindsey Hunter,PG,35,DET,30,1,353,37,100,.370,11,43,.256,26,57,.456,.425,2,4,.500,10,30,40,62,19,1,20,44,87,2006
Steven Hunter,C,24,PHI,69,35,1312,175,291,.601,0,0,.000,175,291,.601,.601,71,138,.514,110,161,271,17,12,76,64,120,421,2006
Andre Iguodala,SF,22,PHI,82,82,3086,344,688,.500,56,158,.354,288,530,.543,.541,263,349,.754,117,364,481,255,135,21,153,198,1007,2006
Zydrunas Ilgauskas,C,30,CLE,78,78,2283,450,889,.506,0,5,.000,450,884,.509,.506,317,380,.834,245,346,591,91,38,136,155,280,1217,2006
Didier Ilunga-Mbenga,C,25,DAL,43,1,237,32,60,.533,0,1,.000,32,59,.542,.533,10,20,.500,19,37,56,2,6,25,16,47,74,2006
Allen Iverson,PG,30,PHI,72,72,3103,815,1822,.447,72,223,.323,743,1599,.465,.467,675,829,.814,44,188,232,532,140,10,248,121,2377,2006
Royal Ivey,PG,24,ATL,73,66,978,116,264,.439,4,10,.400,112,254,.441,.447,24,33,.727,31,65,96,74,24,7,23,147,260,2006
Jarrett Jack,SG,22,POR,79,4,1599,189,428,.442,20,76,.263,169,352,.480,.465,128,160,.800,18,142,160,219,41,2,102,138,526,2006
Bobby Jackson,PG,32,MEM,71,15,1775,286,748,.382,129,332,.389,157,416,.377,.469,107,146,.733,44,179,223,195,61,1,101,155,808,2006
Jermaine Jackson,PG,29,MIL,30,2,202,11,26,.423,1,4,.250,10,22,.455,.442,12,14,.857,8,19,27,25,4,1,13,19,35,2006
Jim Jackson,SF,35,TOT,40,1,512,47,160,.294,18,74,.243,29,86,.337,.350,9,13,.692,11,65,76,35,12,6,35,51,121,2006
Jim Jackson,SF,35,PHO,27,1,420,38,129,.295,14,63,.222,24,66,.364,.349,9,13,.692,11,53,64,31,10,6,30,46,99,2006
Jim Jackson,SF,35,LAL,13,0,92,9,31,.290,4,11,.364,5,20,.250,.355,0,0,.000,0,12,12,4,2,0,5,5,22,2006
Luke Jackson,SF,24,CLE,36,0,315,29,85,.341,12,36,.333,17,49,.347,.412,26,33,.788,16,24,40,25,11,2,31,30,96,2006
Marc Jackson,C,31,TOT,64,10,1027,174,369,.472,1,2,.500,173,367,.471,.473,66,82,.805,86,131,217,44,13,8,65,126,415,2006
Marc Jackson,C,31,NJN,37,0,433,66,148,.446,0,0,.000,66,148,.446,.446,38,48,.792,30,59,89,22,5,6,28,70,170,2006
Marc Jackson,C,31,NOK,27,10,594,108,221,.489,1,2,.500,107,219,.489,.491,28,34,.824,56,72,128,22,8,2,37,56,245,2006
Stephen Jackson,SG,27,IND,81,81,2910,472,1148,.411,117,339,.345,355,809,.439,.462,268,341,.786,48,264,312,225,104,43,203,195,1329,2006
Jerome James,C,30,NYK,45,9,406,56,121,.463,0,0,.000,56,121,.463,.463,25,40,.625,39,52,91,12,3,23,51,104,137,2006
LeBron James,SF,21,CLE,79,79,3361,875,1823,.480,127,379,.335,748,1444,.518,.515,601,814,.738,75,481,556,521,123,66,260,181,2478,2006
Mike James,PG,30,TOR,79,79,2925,576,1228,.469,169,382,.442,407,846,.481,.538,283,338,.837,45,217,262,460,72,3,206,214,1604,2006
Antawn Jamison,SF,29,WAS,82,80,3288,660,1494,.442,147,373,.394,513,1121,.458,.491,217,297,.731,167,598,765,158,90,12,137,189,1684,2006
Marko Jaric,PG,27,MIN,75,49,2102,226,566,.399,40,133,.301,186,433,.430,.435,95,138,.688,60,173,233,293,108,21,127,189,587,2006
Sarunas Jasikevicius,PG,29,IND,75,15,1557,170,429,.396,86,236,.364,84,193,.435,.497,121,133,.910,19,134,153,227,40,4,116,108,547,2006
Al Jefferson,PF,21,BOS,59,7,1062,189,379,.499,0,4,.000,189,375,.504,.499,86,134,.642,97,202,299,30,30,46,62,166,464,2006
Richard Jefferson,SF,25,NJN,78,78,3059,495,1005,.493,60,188,.319,435,817,.532,.522,471,580,.812,95,439,534,297,59,17,174,193,1521,2006
Jared Jeffries,PF,24,WAS,77,77,1951,187,415,.451,16,50,.320,171,365,.468,.470,99,168,.589,164,215,379,148,58,50,99,223,489,2006
Amir Johnson,SF,18,DET,3,0,39,7,10,.700,2,3,.667,5,7,.714,.800,4,4,1.000,3,1,4,3,0,2,4,7,20,2006
Anthony Johnson,PG,31,IND,75,53,1981,267,603,.443,51,155,.329,216,448,.482,.485,106,141,.752,31,137,168,324,63,22,115,132,691,2006
DerMarr Johnson,SG,25,DEN,58,21,924,132,306,.431,56,160,.350,76,146,.521,.523,34,42,.810,19,77,96,55,25,26,46,86,354,2006
Ervin Johnson,C,38,MIL,18,0,81,7,17,.412,0,0,.000,7,17,.412,.412,1,2,.500,5,19,24,2,1,2,5,23,15,2006
Joe Johnson,SG,24,ATL,82,82,3340,632,1395,.453,128,360,.356,504,1035,.487,.499,261,330,.791,98,237,335,536,103,31,267,187,1653,2006
Linton Johnson,SF,25,TOT,36,7,524,61,149,.409,13,36,.361,48,113,.425,.453,18,27,.667,40,82,122,14,12,12,28,61,153,2006
Linton Johnson,SF,25,NJN,9,0,35,5,10,.500,0,0,.000,5,10,.500,.500,1,4,.250,0,7,7,2,2,0,4,7,11,2006
Linton Johnson,SF,25,NOK,27,7,489,56,139,.403,13,36,.361,43,103,.417,.450,17,23,.739,40,75,115,12,10,12,24,54,142,2006
Dahntay Jones,SF,25,MEM,71,4,967,109,263,.414,3,21,.143,106,242,.438,.420,60,93,.645,20,84,104,39,38,15,50,108,281,2006
Damon Jones,PG,29,CLE,82,7,2089,190,491,.387,140,371,.377,50,120,.417,.530,32,50,.640,14,119,133,169,37,1,55,112,552,2006
Dwayne Jones,PF,22,BOS,14,0,87,4,10,.400,0,0,.000,4,10,.400,.400,6,13,.462,10,21,31,2,1,3,3,14,14,2006
Eddie Jones,SG,34,MEM,75,75,2437,292,722,.404,133,374,.356,159,348,.457,.497,168,215,.781,35,244,279,177,131,27,93,201,885,2006
Fred Jones,SG,26,IND,68,2,1837,233,559,.417,63,187,.337,170,372,.457,.473,122,160,.763,18,152,170,154,55,20,107,142,651,2006
James Jones,SF,25,PHO,75,24,1772,243,581,.418,110,285,.386,133,296,.449,.513,103,121,.851,44,209,253,57,38,49,35,142,699,2006
Jumaine Jones,PF,26,CHA,76,42,2089,298,736,.405,115,335,.343,183,401,.456,.483,88,121,.727,105,271,376,63,68,22,74,200,799,2006
Chris Kaman,C,23,LAC,78,78,2560,369,706,.523,0,2,.000,369,704,.524,.523,194,252,.770,187,563,750,79,45,108,176,269,932,2006
Jason Kapono,SF,24,MIA,51,2,665,79,177,.446,21,53,.396,58,124,.468,.506,28,33,.848,12,59,71,37,7,3,20,89,207,2006
Mario Kasun,C,25,ORL,28,0,213,31,69,.449,0,0,.000,31,69,.449,.449,18,23,.783,24,36,60,3,2,3,15,69,80,2006
Viktor Khryapa,SF,23,POR,69,53,1492,158,342,.462,10,30,.333,148,312,.474,.477,77,111,.694,114,193,307,88,50,29,84,209,403,2006
Jason Kidd,PG,32,NJN,80,80,2975,366,905,.404,139,395,.352,227,510,.445,.481,194,244,.795,86,494,580,672,150,29,192,157,1065,2006
Andrei Kirilenko,SF,24,UTA,69,63,2604,336,730,.460,36,117,.308,300,613,.489,.485,346,495,.699,161,391,552,299,102,220,203,162,1054,2006
Linas Kleiza,PF,21,DEN,61,2,519,77,173,.445,2,13,.154,75,160,.469,.451,57,81,.704,38,78,116,15,10,13,16,87,213,2006
Brevin Knight,PG,30,CHA,69,67,2351,308,772,.399,3,13,.231,305,759,.402,.401,252,314,.803,35,188,223,610,157,4,164,202,871,2006
Yaroslav Korolev,SF,18,LAC,24,0,127,9,30,.300,2,7,.286,7,23,.304,.333,7,10,.700,5,8,13,9,3,0,6,11,27,2006
Kyle Korver,SF,24,PHI,82,43,2563,327,761,.430,184,438,.420,143,323,.443,.551,101,119,.849,27,243,270,163,65,26,98,224,939,2006
Nenad Krstic,PF,22,NJN,80,80,2469,447,881,.507,1,4,.250,446,877,.509,.508,185,265,.698,182,331,513,88,32,63,133,297,1080,2006
Toni Kukoc,PF,37,MIL,65,0,1018,116,298,.389,45,147,.306,71,151,.470,.465,40,56,.714,26,124,150,139,33,17,66,87,317,2006
Raef LaFrentz,PF,29,BOS,82,63,2033,238,552,.431,112,286,.392,126,266,.474,.533,51,75,.680,80,326,406,115,29,72,65,273,639,2006
Maciej Lampe,C,20,TOT,6,0,28,2,11,.182,0,0,.000,2,11,.182,.182,0,2,.000,4,5,9,2,0,0,3,2,4,2006
Maciej Lampe,C,20,NOK,2,0,16,0,4,.000,0,0,.000,0,4,.000,.000,0,0,.000,1,3,4,2,0,0,1,2,0,2006
Maciej Lampe,C,20,HOU,4,0,12,2,7,.286,0,0,.000,2,7,.286,.286,0,2,.000,3,2,5,0,0,0,2,0,4,2006
David Lee,SF,22,NYK,67,14,1129,137,230,.596,0,0,.000,137,230,.596,.596,71,123,.577,109,194,303,43,30,20,51,124,345,2006
Voshon Lenard,SG,32,TOT,26,6,458,75,191,.393,25,78,.321,50,113,.442,.458,16,31,.516,5,42,47,41,21,4,31,39,191,2006
Voshon Lenard,SG,32,DEN,12,6,238,42,103,.408,10,35,.286,32,68,.471,.456,5,13,.385,2,26,28,18,8,2,11,21,99,2006
Voshon Lenard,SG,32,POR,14,0,220,33,88,.375,15,43,.349,18,45,.400,.460,11,18,.611,3,16,19,23,13,2,20,18,92,2006
Rashard Lewis,SF,26,SEA,78,77,2876,538,1151,.467,142,370,.384,396,781,.507,.529,350,428,.818,111,279,390,182,102,50,141,191,1568,2006
Randy Livingston,PG,30,CHI,5,0,22,0,2,.000,0,0,.000,0,2,.000,.000,0,0,.000,1,3,4,1,1,0,1,6,0,2006
Shaun Livingston,PG,20,LAC,61,14,1525,149,349,.427,1,8,.125,148,341,.434,.428,53,77,.688,41,142,183,273,46,32,111,160,352,2006
John Lucas III,PG,23,HOU,13,0,107,14,36,.389,2,9,.222,12,27,.444,.417,0,0,.000,2,3,5,12,5,0,7,6,30,2006
Tyronn Lue,PG,28,ATL,51,10,1234,192,418,.459,58,127,.457,134,291,.460,.529,118,138,.855,13,69,82,157,26,3,75,113,560,2006
Arvydas Macijauskas,SG,26,NOK,19,0,135,14,41,.341,3,12,.250,11,29,.379,.378,13,15,.867,3,7,10,5,7,0,8,10,44,2006
Mark Madsen,C,30,MIN,62,7,676,27,66,.409,0,7,.000,27,59,.458,.409,20,47,.426,50,91,141,11,23,17,26,114,74,2006
Corey Maggette,SF,26,LAC,32,13,943,167,375,.445,24,71,.338,143,304,.470,.477,212,256,.828,28,141,169,66,19,4,78,95,570,2006
Jamaal Magloire,C,27,MIL,82,82,2465,287,615,.467,0,0,.000,287,615,.467,.467,178,333,.535,220,558,778,56,29,80,166,276,752,2006
Stephon Marbury,PG,28,NYK,60,60,2193,349,774,.451,33,104,.317,316,670,.472,.472,246,326,.755,25,150,175,382,63,4,157,143,977,2006
Shawn Marion,PF,27,PHO,81,81,3263,716,1365,.525,96,290,.331,620,1075,.577,.560,241,298,.809,249,710,959,143,160,137,125,223,1769,2006
Sean Marks,PF,30,SAS,25,0,181,37,71,.521,0,3,.000,37,68,.544,.521,7,12,.583,12,31,43,7,5,7,7,21,81,2006
Donyell Marshall,PF,32,CLE,81,0,2077,265,671,.395,128,395,.324,137,276,.496,.490,92,123,.748,105,387,492,60,59,41,90,160,750,2006
Rawle Marshall,SF,23,DAL,23,9,241,24,60,.400,1,3,.333,23,57,.404,.408,22,29,.759,8,23,31,10,8,7,15,17,71,2006
Darrick Martin,PG,34,TOR,40,0,339,34,97,.351,16,40,.400,18,57,.316,.433,18,24,.750,2,18,20,57,17,0,15,42,102,2006
Kenyon Martin,PF,28,DEN,56,49,1546,297,600,.495,5,22,.227,292,578,.505,.499,121,170,.712,93,260,353,79,43,52,72,171,720,2006
Kevin Martin,SG,22,SAC,72,41,1913,262,546,.480,66,179,.369,196,367,.534,.540,188,222,.847,58,203,261,97,55,9,81,138,778,2006
Desmond Mason,SF,28,NOK,70,55,2102,275,690,.399,1,6,.167,274,684,.401,.399,206,302,.682,64,234,298,66,42,17,113,136,757,2006
Jason Maxiell,PF,22,DET,26,0,159,23,54,.426,0,0,.000,23,54,.426,.426,14,42,.333,12,16,28,3,4,5,11,14,60,2006
Sean May,PF,21,CHA,23,1,398,70,171,.409,0,5,.000,70,166,.422,.409,49,64,.766,42,67,109,22,17,12,33,58,189,2006
Rashad McCants,SG,21,MIN,79,12,1362,241,535,.450,67,180,.372,174,355,.490,.513,78,106,.736,29,114,143,63,44,22,86,176,627,2006
Walter McCarty,SF,31,LAC,36,1,353,33,99,.333,10,45,.222,23,54,.426,.384,12,21,.571,15,53,68,23,8,5,19,52,88,2006
Antonio McDyess,PF,31,DET,82,0,1733,285,560,.509,0,2,.000,285,558,.511,.509,68,122,.557,156,280,436,90,46,48,76,220,638,2006
Tracy McGrady,SF,26,HOU,47,47,1745,410,1011,.406,73,234,.312,337,777,.434,.442,254,340,.747,46,261,307,225,59,41,120,88,1147,2006
Jeff McInnis,SG,31,NJN,28,1,486,63,143,.441,3,16,.188,60,127,.472,.451,20,29,.690,11,39,50,52,11,2,29,37,149,2006
Aaron McKie,PG,33,LAL,14,0,121,3,12,.250,0,2,.000,3,10,.300,.250,1,2,.500,3,17,20,11,5,0,2,7,7,2006
Keith McLeod,PG,26,UTA,66,32,1232,120,340,.353,24,82,.293,96,258,.372,.388,106,133,.797,11,67,78,151,42,9,76,131,370,2006
Stanislav Medvedenko,PF,26,LAL,2,0,6,1,2,.500,0,0,.000,1,2,.500,.500,0,0,.000,0,0,0,1,0,0,0,1,2,2006
Chris Mihm,C,26,LAL,59,56,1541,230,459,.501,0,0,.000,230,459,.501,.501,144,201,.716,137,236,373,61,16,73,83,214,604,2006
Aaron Miles,PG,22,GSW,19,0,118,6,18,.333,0,0,.000,6,18,.333,.333,4,4,1.000,0,14,14,24,4,1,11,13,16,2006
C.J. Miles,PG,18,UTA,23,0,203,28,76,.368,5,20,.250,23,56,.411,.401,18,24,.750,18,20,38,16,7,2,9,20,79,2006
Darius Miles,SF,24,POR,40,23,1286,235,510,.461,2,10,.200,233,500,.466,.463,87,163,.534,24,158,182,73,42,39,99,100,559,2006
Darko Milicic,C,20,TOT,55,1,767,119,234,.509,0,2,.000,119,232,.513,.509,28,50,.560,44,107,151,41,14,77,51,92,266,2006
Darko Milicic,C,20,DET,25,0,140,17,33,.515,0,2,.000,17,31,.548,.515,3,8,.375,10,18,28,9,3,15,15,25,37,2006
Darko Milicic,C,20,ORL,30,1,627,102,201,.507,0,0,.000,102,201,.507,.507,25,42,.595,34,89,123,32,11,62,36,67,229,2006
Andre Miller,PG,29,DEN,82,82,2937,404,872,.463,5,27,.185,399,845,.472,.466,313,424,.738,92,259,351,674,106,18,256,213,1126,2006
Brad Miller,C,29,SAC,79,79,2923,434,877,.495,34,88,.386,400,789,.507,.514,280,338,.828,122,493,615,374,61,62,180,234,1182,2006
Mike Miller,SG,25,MEM,74,9,2268,354,760,.466,138,339,.407,216,421,.513,.557,168,210,.800,42,355,397,200,52,27,140,173,1014,2006
Yao Ming,C,25,HOU,57,57,1949,467,900,.519,0,1,.000,467,899,.519,.519,337,395,.853,148,433,581,85,30,94,147,195,1271,2006
Cuttino Mobley,SF,30,LAC,79,74,2979,429,1008,.426,83,245,.339,346,763,.453,.467,229,273,.839,50,291,341,238,93,36,145,208,1170,2006
Nazr Mohammed,C,28,SAS,80,30,1389,190,377,.504,0,0,.000,190,377,.504,.504,113,144,.785,163,255,418,40,21,49,91,220,493,2006
Sergei Monia,SF,22,TOT,26,15,343,29,87,.333,9,34,.265,20,53,.377,.385,10,14,.714,11,41,52,19,7,5,12,41,77,2006
Sergei Monia,SF,22,POR,23,15,336,29,85,.341,9,33,.273,20,52,.385,.394,8,12,.667,11,40,51,19,6,5,12,41,75,2006
Sergei Monia,SF,22,SAC,3,0,7,0,2,.000,0,1,.000,0,1,.000,.000,2,2,1.000,0,1,1,0,1,0,0,0,2,2006
Mikki Moore,C,30,SEA,47,1,583,54,124,.435,0,2,.000,54,122,.443,.435,46,62,.742,44,86,130,27,7,15,40,92,154,2006
Terence Morris,SF,27,ORL,22,0,192,16,49,.327,0,2,.000,16,47,.340,.327,3,3,1.000,6,32,38,4,6,5,7,19,35,2006
Alonzo Mourning,C,35,MIA,65,20,1302,188,315,.597,0,1,.000,188,314,.599,.597,133,224,.594,125,234,359,11,13,173,79,177,509,2006
Troy Murphy,PF,25,GSW,74,74,2516,363,838,.433,58,181,.320,305,657,.464,.468,251,319,.787,195,548,743,101,47,26,108,191,1035,2006
Lamond Murray,SF,32,NJN,57,1,576,72,181,.398,27,78,.346,45,103,.437,.472,25,40,.625,29,103,132,13,17,7,22,66,196,2006
Ronald Murray,SG,26,TOT,76,27,2112,321,768,.418,37,141,.262,284,627,.453,.442,172,242,.711,33,120,153,197,68,11,135,133,851,2006
Ronald Murray,SG,26,SEA,48,2,1085,179,451,.397,17,76,.224,162,375,.432,.416,99,138,.717,18,68,86,120,30,4,79,69,474,2006
Ronald Murray,SG,26,CLE,28,25,1027,142,317,.448,20,65,.308,122,252,.484,.479,73,104,.702,15,52,67,77,38,7,56,64,377,2006
Dikembe Mutombo,C,39,HOU,64,23,955,50,95,.526,0,0,.000,50,95,.526,.526,69,91,.758,100,206,306,4,17,57,35,128,169,2006
Boniface N'Dong,C,28,LAC,23,1,152,22,53,.415,0,1,.000,22,52,.423,.415,6,9,.667,15,22,37,7,2,5,6,23,50,2006
Bostjan Nachbar,PF-SF,25,TOT,36,13,502,54,156,.346,19,71,.268,35,85,.412,.407,30,44,.682,8,52,60,27,16,5,24,65,157,2006
Bostjan Nachbar,PF,25,NOK,25,13,405,42,124,.339,17,57,.298,25,67,.373,.407,25,36,.694,4,45,49,22,13,5,20,52,126,2006
Bostjan Nachbar,SF,25,NJN,11,0,97,12,32,.375,2,14,.143,10,18,.556,.406,5,8,.625,4,7,11,5,3,0,4,13,31,2006
Lee Nailon,PF,30,PHI,22,0,237,40,80,.500,0,0,.000,40,80,.500,.500,13,15,.867,23,19,42,7,8,4,10,32,93,2006
Eduardo Najera,PF,29,DEN,64,3,1449,127,301,.422,4,12,.333,123,289,.426,.429,89,114,.781,128,197,325,52,53,34,54,165,347,2006
Steve Nash,PG,31,PHO,79,79,2796,541,1056,.512,150,342,.439,391,714,.548,.583,257,279,.921,47,286,333,826,61,12,276,120,1489,2006
Jameer Nelson,PG,23,ORL,62,33,1784,347,719,.483,70,165,.424,277,554,.500,.531,141,181,.779,39,141,180,302,70,9,148,174,905,2006
Rasho Nesterovic,C,29,SAS,80,51,1515,172,334,.515,0,2,.000,172,332,.518,.515,18,30,.600,114,195,309,33,21,88,53,209,362,2006
Ira Newble,SG,31,CLE,36,3,353,17,57,.298,3,13,.231,14,44,.318,.325,11,16,.688,21,35,56,9,5,10,12,47,48,2006
Andres Nocioni,PF,26,CHI,82,43,2239,383,831,.461,93,238,.391,290,593,.489,.517,204,242,.843,89,411,500,117,40,52,120,252,1063,2006
Moochie Norris,PG,32,TOT,45,0,424,46,112,.411,4,14,.286,42,98,.429,.429,29,42,.690,12,42,54,50,20,1,33,49,125,2006
Moochie Norris,PG,32,HOU,29,0,241,26,65,.400,0,5,.000,26,60,.433,.400,13,17,.765,9,25,34,29,14,1,16,31,65,2006
Moochie Norris,PG,32,NOK,16,0,183,20,47,.426,4,9,.444,16,38,.421,.468,16,25,.640,3,17,20,21,6,0,17,18,60,2006
Dirk Nowitzki,PF,27,DAL,81,81,3089,751,1564,.480,110,271,.406,641,1293,.496,.515,539,598,.901,115,613,728,226,58,83,156,164,2151,2006
Jermaine O'Neal,PF,27,IND,51,47,1802,380,805,.472,3,10,.300,377,795,.474,.474,261,368,.709,102,374,476,133,27,117,151,177,1024,2006
Shaquille O'Neal,C,33,MIA,59,58,1806,480,800,.600,0,0,.000,480,800,.600,.600,221,471,.469,172,369,541,113,23,104,168,230,1181,2006
Fabricio Oberto,C,30,SAS,59,0,490,44,93,.473,0,2,.000,44,91,.484,.473,15,27,.556,57,66,123,27,9,11,28,91,103,2006
Lamar Odom,PF,26,LAL,80,80,3221,445,925,.481,80,215,.372,365,710,.514,.524,216,313,.690,181,557,738,443,75,64,213,256,1186,2006
Emeka Okafor,PF,23,CHA,26,25,874,131,316,.415,0,0,.000,131,316,.415,.415,82,125,.656,94,167,261,31,22,50,53,88,344,2006
Mehmet Okur,PF,26,UTA,82,82,2945,519,1128,.460,80,234,.342,439,894,.491,.496,354,454,.780,211,535,746,194,40,73,163,285,1472,2006
Kevin Ollie,SG,33,PHI,70,23,1069,75,174,.431,1,3,.333,74,171,.433,.434,41,49,.837,13,85,98,101,33,3,29,103,192,2006
Michael Olowokandi,C,30,TOT,48,24,919,107,240,.446,0,0,.000,107,240,.446,.446,24,47,.511,50,170,220,23,22,33,55,122,238,2006
Michael Olowokandi,C,30,MIN,32,24,752,87,195,.446,0,0,.000,87,195,.446,.446,19,39,.487,45,134,179,17,19,27,41,100,193,2006
Michael Olowokandi,C,30,BOS,16,0,167,20,45,.444,0,0,.000,20,45,.444,.444,5,8,.625,5,36,41,6,3,6,14,22,45,2006
Greg Ostertag,C,32,UTA,60,22,807,61,124,.492,0,0,.000,61,124,.492,.492,24,48,.500,82,143,225,58,6,66,46,129,146,2006
Bo Outlaw,PF,34,ORL,32,0,355,35,58,.603,0,0,.000,35,58,.603,.603,5,8,.625,31,46,77,14,10,12,17,50,75,2006
Travis Outlaw,PF,21,POR,69,11,1153,162,368,.440,14,53,.264,148,315,.470,.459,62,89,.697,48,141,189,34,31,46,37,112,400,2006
Andre Owens,PG,25,UTA,23,2,210,27,74,.365,3,16,.188,24,58,.414,.385,12,18,.667,11,10,21,8,5,0,13,25,69,2006
Zaza Pachulia,C,21,ATL,78,78,2452,307,681,.451,0,2,.000,307,679,.452,.451,297,404,.735,264,349,613,129,89,39,180,286,911,2006
Scott Padgett,PF,29,NJN,62,1,718,71,201,.353,42,121,.347,29,80,.363,.458,27,34,.794,56,109,165,41,28,12,21,90,211,2006
Milt Palacio,PG,27,UTA,71,18,1376,171,403,.424,1,16,.063,170,387,.439,.426,98,150,.653,17,117,134,190,47,14,110,125,441,2006
Jannero Pargo,PG,26,CHI,57,0,646,109,292,.373,39,103,.379,70,189,.370,.440,17,21,.810,8,53,61,94,24,2,61,57,274,2006
Smush Parker,PG,24,LAL,82,82,2773,348,779,.447,120,328,.366,228,451,.506,.524,125,180,.694,37,234,271,302,140,16,147,213,941,2006
Tony Parker,PG,23,SAS,80,80,2715,623,1136,.548,11,36,.306,612,1100,.556,.553,253,358,.707,38,223,261,460,83,4,249,161,1510,2006
Ruben Patterson,SF-SG,30,TOT,71,22,1792,327,635,.515,1,13,.077,326,622,.524,.516,203,338,.601,118,126,244,127,76,21,150,150,858,2006
Ruben Patterson,SF,30,POR,45,2,1056,188,379,.496,0,7,.000,188,372,.505,.496,138,226,.611,73,81,154,60,42,12,82,79,514,2006
Ruben Patterson,SG,30,DEN,26,20,736,139,256,.543,1,6,.167,138,250,.552,.545,65,112,.580,45,45,90,67,34,9,68,71,344,2006
Chris Paul,PG,20,NOK,78,78,2808,407,947,.430,50,177,.282,357,770,.464,.456,394,465,.847,61,339,400,611,175,6,183,218,1258,2006
Sasha Pavlovic,SG,22,CLE,53,19,813,87,212,.410,35,96,.365,52,116,.448,.493,32,49,.653,16,64,80,25,19,6,42,103,241,2006
Gary Payton,PG,37,MIA,81,25,2305,230,547,.420,66,230,.287,164,317,.517,.481,100,126,.794,34,199,233,257,71,10,102,169,626,2006
Kendrick Perkins,C,21,BOS,68,40,1332,137,266,.515,0,2,.000,137,264,.519,.515,80,130,.615,140,264,404,69,21,105,107,199,354,2006
Morris Peterson,SG,28,TOR,82,77,3140,478,1096,.436,177,448,.395,301,648,.465,.517,241,294,.820,65,316,381,190,104,15,126,223,1374,2006
Johan Petro,C,20,SEA,68,41,1282,153,300,.510,0,0,.000,153,300,.510,.510,47,75,.627,109,187,296,15,25,51,60,213,353,2006
Eric Piatkowski,SG,35,CHI,29,1,228,24,61,.393,9,33,.273,15,28,.536,.467,2,5,.400,4,19,23,13,6,1,11,20,59,2006
Paul Pierce,SF,28,BOS,79,79,3084,689,1462,.471,111,314,.354,578,1148,.503,.509,627,812,.772,77,453,530,375,107,34,273,223,2116,2006
Mickael Pietrus,SF,23,GSW,52,18,1179,169,418,.404,56,176,.318,113,242,.467,.471,87,143,.608,58,105,163,44,33,10,78,132,481,2006
Zoran Planinic,PG,23,NJN,56,1,596,66,183,.361,13,56,.232,53,127,.417,.396,46,66,.697,14,60,74,53,20,4,43,91,191,2006
Pavel Podkolzin,C,21,DAL,1,0,18,0,2,.000,0,0,.000,0,2,.000,.000,3,6,.500,0,7,7,0,0,1,2,0,3,2006
Scot Pollard,C,30,IND,45,32,771,70,154,.455,0,0,.000,70,154,.455,.455,29,38,.763,73,145,218,24,37,20,26,115,169,2006
James Posey,SF,29,MIA,67,63,1914,159,395,.403,117,290,.403,42,105,.400,.551,48,61,.787,33,286,319,89,54,20,58,196,483,2006
Vitaly Potapenko,C,30,TOT,33,12,353,37,71,.521,0,0,.000,37,71,.521,.521,10,17,.588,27,37,64,9,2,2,16,50,84,2006
Vitaly Potapenko,C,30,SEA,24,12,321,32,64,.500,0,0,.000,32,64,.500,.500,10,17,.588,26,36,62,7,2,2,14,44,74,2006
Vitaly Potapenko,C,30,SAC,9,0,32,5,7,.714,0,0,.000,5,7,.714,.714,0,0,.000,1,1,2,2,0,0,2,6,10,2006
Josh Powell,PF,23,DAL,37,2,429,37,81,.457,0,0,.000,37,81,.457,.457,36,45,.800,28,53,81,9,7,4,22,52,110,2006
Ronnie Price,PG,22,SAC,29,0,150,21,58,.362,6,27,.222,15,31,.484,.414,12,12,1.000,5,10,15,11,6,0,10,10,60,2006
Tayshaun Prince,SF,25,DET,82,82,2898,455,999,.455,64,183,.350,391,816,.479,.487,182,238,.765,104,242,346,186,62,39,91,96,1156,2006
Laron Profit,SG,28,LAL,25,1,279,40,84,.476,3,18,.167,37,66,.561,.494,21,24,.875,8,35,43,15,11,5,24,25,104,2006
Joel Przybilla,C,26,POR,56,52,1395,131,239,.548,0,0,.000,131,239,.548,.548,82,154,.532,146,245,391,43,20,130,76,149,344,2006
Vladimir Radmanovic,PF,25,TOT,77,27,1974,262,643,.407,138,354,.390,124,289,.429,.515,93,114,.816,64,294,358,136,61,29,93,210,755,2006
Vladimir Radmanovic,PF,25,SEA,47,16,1089,154,384,.401,72,196,.367,82,188,.436,.495,55,62,.887,39,148,187,72,32,15,53,130,435,2006
Vladimir Radmanovic,PF,25,LAC,30,11,885,108,259,.417,66,158,.418,42,101,.416,.544,38,52,.731,25,146,171,64,29,14,40,80,320,2006
Shavlik Randolph,PF,22,PHI,57,1,487,44,97,.454,0,0,.000,44,97,.454,.454,43,71,.606,55,78,133,19,19,12,21,83,131,2006
Zach Randolph,PF,24,POR,74,71,2545,536,1229,.436,16,55,.291,520,1174,.443,.443,245,343,.714,193,399,592,144,57,14,165,185,1333,2006
Theo Ratliff,C,32,POR,55,19,1301,108,189,.571,0,0,.000,108,189,.571,.571,54,83,.651,89,190,279,28,18,88,47,143,270,2006
Zeljko Rebraca,C,33,LAC,29,2,412,52,96,.542,0,0,.000,52,96,.542,.542,31,41,.756,13,51,64,9,5,19,24,59,135,2006
Michael Redd,SG,26,MIL,80,80,3130,682,1516,.450,163,413,.395,519,1103,.471,.504,501,571,.877,78,264,342,229,95,5,170,157,2028,2006
Justin Reed,SF,24,TOT,72,6,997,119,295,.403,0,1,.000,119,294,.405,.403,87,120,.725,53,71,124,41,23,15,52,163,325,2006
Justin Reed,SF,24,BOS,32,0,291,25,74,.338,0,0,.000,25,74,.338,.338,25,40,.625,13,16,29,7,5,4,15,45,75,2006
Justin Reed,SF,24,MIN,40,6,706,94,221,.425,0,1,.000,94,220,.427,.425,62,80,.775,40,55,95,34,18,11,37,118,250,2006
Jason Richardson,SG,25,GSW,75,75,2877,641,1438,.446,183,477,.384,458,961,.477,.509,276,410,.673,105,333,438,232,97,37,167,206,1741,2006
Quentin Richardson,SF,25,NYK,55,43,1442,163,459,.355,64,188,.340,99,271,.365,.425,61,91,.670,65,165,230,88,39,6,56,134,451,2006
Luke Ridnour,PG,24,SEA,79,77,2625,334,799,.418,43,149,.289,291,650,.448,.445,199,227,.877,47,188,235,550,123,22,162,178,910,2006
Anthony Roberson,PG,22,MEM,16,0,88,14,31,.452,5,10,.500,9,21,.429,.532,2,2,1.000,0,6,6,5,1,0,3,6,35,2006
Lawrence Roberts,C,23,MEM,33,0,181,20,44,.455,0,2,.000,20,42,.476,.455,11,23,.478,26,23,49,5,8,2,5,30,51,2006
Bernard Robinson,SF,25,CHA,66,18,1303,157,365,.430,2,21,.095,155,344,.451,.433,106,134,.791,62,157,219,77,81,10,74,141,422,2006
Clifford Robinson,PF,39,NJN,80,13,1863,219,513,.427,60,175,.343,159,338,.470,.485,52,79,.658,55,212,267,89,44,40,62,206,550,2006
Nate Robinson,PG,21,NYK,72,26,1544,230,565,.407,58,146,.397,172,419,.411,.458,152,202,.752,56,111,167,147,59,1,114,201,670,2006
Jalen Rose,SF-SG,33,TOT,72,45,1983,290,685,.423,59,172,.343,231,513,.450,.466,248,318,.780,28,183,211,181,30,13,115,156,887,2006
Jalen Rose,SF,33,TOR,46,22,1236,180,446,.404,31,115,.270,149,331,.450,.438,166,217,.765,15,114,129,113,20,10,65,101,557,2006
Jalen Rose,SG,33,NYK,26,23,747,110,239,.460,28,57,.491,82,182,.451,.519,82,101,.812,13,69,82,68,10,3,50,55,330,2006
Malik Rose,PF,31,NYK,72,35,1119,105,281,.374,1,1,1.000,104,280,.371,.375,107,137,.781,84,175,259,67,43,14,80,145,318,2006
Quinton Ross,SG,24,LAC,67,45,1515,130,308,.422,0,7,.000,130,301,.432,.422,57,75,.760,38,132,170,79,51,16,47,155,317,2006
Michael Ruffin,C,29,WAS,76,4,1010,34,77,.442,0,2,.000,34,75,.453,.442,37,74,.500,122,149,271,27,33,31,38,179,105,2006
Kareem Rush,SG,25,CHA,47,25,1111,181,469,.386,57,164,.348,124,305,.407,.447,55,77,.714,18,85,103,50,38,13,65,79,474,2006
Bryon Russell,SF,35,DEN,1,0,3,0,0,.000,0,0,.000,0,0,.000,.000,0,0,.000,0,1,1,1,0,0,0,0,0,2006
John Salmons,SG,26,PHI,82,24,2059,219,521,.420,26,87,.299,193,434,.445,.445,155,200,.775,48,172,220,223,73,13,125,178,619,2006
Jamal Sampson,PF,22,SAC,12,0,39,5,7,.714,0,0,.000,5,7,.714,.714,0,2,.000,5,13,18,5,0,4,0,5,10,2006
Melvin Sanders,SG,25,SAS,16,0,113,16,33,.485,2,3,.667,14,30,.467,.515,7,10,.700,4,19,23,3,5,0,8,20,41,2006
Brian Scalabrine,PF,27,BOS,71,1,938,74,193,.383,31,87,.356,43,106,.406,.464,26,36,.722,27,87,114,51,21,19,50,127,205,2006
Alex Scales,SG,27,SAS,1,0,0,0,0,.000,0,0,.000,0,0,.000,.000,0,0,.000,0,0,0,0,0,0,0,0,0,2006
Luke Schenscher,C,23,CHI,20,0,149,16,26,.615,0,0,.000,16,26,.615,.615,4,13,.308,8,21,29,7,1,3,5,21,36,2006
Ha Seung-Jin,C,20,POR,27,4,212,18,31,.581,0,0,.000,18,31,.581,.581,8,17,.471,14,35,49,1,3,8,14,41,44,2006
Wayne Simien,PF,22,MIA,43,2,414,58,120,.483,0,0,.000,58,120,.483,.483,30,34,.882,38,50,88,7,13,1,24,70,146,2006
Bobby Simmons,SF,25,MIL,75,74,2538,366,808,.453,105,250,.420,261,558,.468,.518,165,200,.825,91,242,333,172,86,21,123,254,1002,2006
James Singleton,SF,24,LAC,59,10,753,77,151,.510,10,20,.500,67,131,.511,.543,39,50,.780,63,134,197,29,19,21,28,95,203,2006
Brian Skinner,PF-C,29,TOT,65,5,944,82,160,.513,0,0,.000,82,160,.513,.513,27,56,.482,76,152,228,30,25,43,45,119,191,2006
Brian Skinner,PF,29,SAC,38,0,429,38,69,.551,0,0,.000,38,69,.551,.551,12,27,.444,30,71,101,17,11,20,18,54,88,2006
Brian Skinner,C,29,POR,27,5,515,44,91,.484,0,0,.000,44,91,.484,.484,15,29,.517,46,81,127,13,14,23,27,65,103,2006
Charles Smith,SG,30,TOT,22,4,210,30,72,.417,15,38,.395,15,34,.441,.521,5,8,.625,3,13,16,9,5,6,4,28,80,2006
Charles Smith,SG,30,POR,21,4,208,30,71,.423,15,37,.405,15,34,.441,.528,5,8,.625,3,13,16,9,5,6,4,27,80,2006
Charles Smith,SG,30,DEN,1,0,2,0,1,.000,0,1,.000,0,0,.000,.000,0,0,.000,0,0,0,0,0,0,0,1,0,2006
Donta Smith,SG,22,ATL,23,0,127,15,27,.556,2,4,.500,13,23,.565,.593,6,12,.500,3,11,14,9,8,0,4,20,38,2006
J.R. Smith,SG,20,NOK,55,25,989,144,366,.393,52,140,.371,92,226,.407,.464,83,101,.822,19,91,110,58,37,4,54,90,423,2006
Joe Smith,PF,30,MIL,44,5,887,145,305,.475,0,2,.000,145,303,.479,.475,89,115,.774,83,147,230,31,24,13,40,120,379,2006
Josh Smith,SF,20,ATL,80,73,2559,329,774,.425,34,110,.309,295,664,.444,.447,210,292,.719,176,355,531,191,64,208,162,260,902,2006
Eric Snow,PG,32,CLE,82,82,2351,163,399,.409,1,10,.100,162,389,.416,.410,64,93,.688,38,160,198,346,76,19,116,218,391,2006
Kirk Snyder,SG,22,NOK,68,45,1310,205,453,.453,46,129,.357,159,324,.491,.503,86,117,.735,55,106,161,102,29,23,70,106,542,2006
Darius Songaila,PF,27,CHI,62,7,1329,236,491,.481,2,5,.400,234,486,.481,.483,94,115,.817,76,170,246,88,35,16,85,157,568,2006
Pape Sow,C,24,TOR,42,25,590,53,123,.431,0,0,.000,53,123,.431,.431,41,57,.719,54,92,146,8,21,19,30,118,147,2006
Jerry Stackhouse,SG,31,DAL,55,11,1525,242,603,.401,36,130,.277,206,473,.436,.431,195,221,.882,32,121,153,160,37,10,121,96,715,2006
DeShawn Stevenson,SG,24,ORL,82,82,2648,359,781,.460,2,15,.133,357,766,.466,.461,180,242,.744,59,182,241,160,58,17,123,178,900,2006
Peja Stojakovic,SF,28,TOT,71,71,2601,445,1018,.437,162,404,.401,283,614,.461,.517,238,260,.915,79,336,415,136,45,10,103,171,1290,2006
Peja Stojakovic,SF,28,SAC,31,31,1147,171,424,.403,71,179,.397,100,245,.408,.487,98,105,.933,34,131,165,68,19,2,51,82,511,2006
Peja Stojakovic,SF,28,IND,40,40,1454,274,594,.461,91,225,.404,183,369,.496,.538,140,155,.903,45,205,250,68,26,8,52,89,779,2006
Awvee Storey,SF,28,WAS,25,1,116,16,41,.390,3,7,.429,13,34,.382,.427,8,14,.571,8,14,22,4,3,1,5,22,43,2006
Damon Stoudamire,PG,32,MEM,27,27,862,114,287,.397,36,104,.346,78,183,.426,.460,53,62,.855,23,72,95,128,19,1,55,49,317,2006
Salim Stoudamire,SG,23,ATL,61,1,1236,204,492,.415,82,216,.380,122,276,.442,.498,99,110,.900,12,104,116,75,27,3,82,118,589,2006
Amar'e Stoudemire,C,23,PHO,3,3,50,9,27,.333,0,1,.000,9,26,.346,.333,8,9,.889,6,10,16,2,1,3,1,4,26,2006
Mike Sweetney,C,23,CHI,66,44,1222,200,444,.450,0,0,.000,200,444,.450,.450,133,204,.652,118,232,350,59,19,56,95,209,533,2006
Robert Swift,C,20,SEA,47,20,987,124,241,.515,0,0,.000,124,241,.515,.515,53,91,.582,94,170,264,8,15,56,49,142,301,2006
Stromile Swift,C,26,HOU,66,5,1344,225,458,.491,0,2,.000,225,456,.493,.491,136,209,.651,103,188,291,25,38,50,91,198,586,2006
Wally Szczerbiak,SF,28,TOT,72,71,2729,493,1012,.487,102,255,.400,391,757,.517,.538,278,310,.897,77,236,313,213,40,19,136,150,1366,2006
Wally Szczerbiak,SF,28,MIN,40,40,1555,292,590,.495,58,143,.406,234,447,.523,.544,163,182,.896,36,154,190,112,21,15,86,90,805,2006
Wally Szczerbiak,SF,28,BOS,32,31,1174,201,422,.476,44,112,.393,157,310,.506,.528,115,128,.898,41,82,123,101,19,4,50,60,561,2006
Chris Taft,C,20,GSW,17,0,144,23,38,.605,0,0,.000,23,38,.605,.605,1,6,.167,19,17,36,2,2,7,2,25,47,2006
Donell Taylor,SG,23,WAS,51,1,465,53,136,.390,4,17,.235,49,119,.412,.404,30,43,.698,16,37,53,45,30,4,34,47,140,2006
Maurice Taylor,PF,29,NYK,67,13,1210,182,389,.468,0,1,.000,182,388,.469,.468,58,83,.699,65,164,229,53,21,14,103,177,422,2006
Sebastian Telfair,PG,20,POR,68,30,1641,228,578,.394,57,162,.352,171,416,.411,.444,130,175,.743,19,101,120,247,66,6,115,167,643,2006
Jason Terry,PG,28,DAL,80,80,2798,516,1099,.470,171,416,.411,345,683,.505,.547,168,210,.800,31,127,158,306,100,27,135,196,1371,2006
Billy Thomas,SG,30,WAS,17,0,131,13,40,.325,10,30,.333,3,10,.300,.450,2,2,1.000,5,9,14,9,10,1,6,19,38,2006
Etan Thomas,C,27,WAS,71,9,1121,131,246,.533,0,0,.000,131,246,.533,.533,75,125,.600,99,180,279,14,20,68,51,148,337,2006
James Thomas,PF,25,TOT,22,0,150,10,19,.526,0,0,.000,10,19,.526,.526,8,14,.571,12,27,39,1,0,3,7,35,28,2006
James Thomas,PF,25,PHI,15,0,124,7,13,.538,0,0,.000,7,13,.538,.538,8,14,.571,8,23,31,1,0,3,7,32,22,2006
James Thomas,PF,25,CHI,7,0,26,3,6,.500,0,0,.000,3,6,.500,.500,0,0,.000,4,4,8,0,0,0,0,3,6,2006
John Thomas,C,30,TOT,16,0,127,6,15,.400,0,0,.000,6,15,.400,.400,3,4,.750,10,10,20,2,3,2,8,17,15,2006
John Thomas,C,30,MEM,3,0,25,2,2,1.000,0,0,.000,2,2,1.000,1.000,0,0,.000,0,0,0,1,0,1,2,3,4,2006
John Thomas,C,30,ATL,11,0,66,3,7,.429,0,0,.000,3,7,.429,.429,3,4,.750,3,7,10,1,2,0,4,10,9,2006
John Thomas,C,30,NJN,2,0,36,1,6,.167,0,0,.000,1,6,.167,.167,0,0,.000,7,3,10,0,1,1,2,4,2,2006
Kenny Thomas,PF,28,SAC,82,55,2293,305,604,.505,0,1,.000,305,603,.506,.505,138,204,.676,199,419,618,168,72,39,135,196,748,2006
Kurt Thomas,C,33,PHO,53,50,1411,190,391,.486,0,0,.000,190,391,.486,.486,75,92,.815,102,313,415,57,23,54,57,193,455,2006
Tim Thomas,PF-SF,28,TOT,29,10,666,113,262,.431,46,111,.414,67,151,.444,.519,28,42,.667,22,109,131,20,16,7,33,78,300,2006
Tim Thomas,SF,28,CHI,3,0,32,6,16,.375,1,6,.167,5,10,.500,.406,0,0,.000,0,4,4,2,0,1,1,1,13,2006
Tim Thomas,PF,28,PHO,26,10,634,107,246,.435,45,105,.429,62,141,.440,.526,28,42,.667,22,105,127,18,16,6,32,77,287,2006
Dijon Thompson,SG,22,PHO,10,0,43,11,25,.440,4,11,.364,7,14,.500,.520,2,2,1.000,4,7,11,1,3,1,2,6,28,2006
Jamaal Tinsley,PG,27,IND,42,27,1122,158,386,.409,16,70,.229,142,316,.449,.430,58,91,.637,35,98,133,211,49,6,109,96,390,2006
Jake Tsakalidis,C,26,MEM,51,19,732,100,165,.606,0,0,.000,100,165,.606,.606,57,87,.655,78,134,212,13,14,32,39,107,257,2006
Nikoloz Tskitishvili,SF-PF,22,TOT,17,0,99,13,37,.351,1,3,.333,12,34,.353,.365,9,14,.643,9,13,22,3,1,2,6,8,36,2006
Nikoloz Tskitishvili,PF,22,MIN,5,0,13,1,4,.250,0,0,.000,1,4,.250,.250,1,2,.500,0,2,2,0,0,0,2,0,3,2006
Nikoloz Tskitishvili,SF,22,PHO,12,0,86,12,33,.364,1,3,.333,11,30,.367,.379,8,12,.667,9,11,20,3,1,2,4,8,33,2006
Ronny Turiaf,C,23,LAL,23,1,161,15,30,.500,0,0,.000,15,30,.500,.500,15,27,.556,11,26,37,8,3,10,7,30,45,2006
Hedo Turkoglu,SF,26,ORL,78,59,2615,398,877,.454,114,283,.403,284,594,.478,.519,255,296,.861,70,263,333,216,70,21,130,234,1165,2006
Ime Udoka,SF,28,NYK,8,0,114,9,24,.375,1,3,.333,8,21,.381,.396,3,6,.500,3,14,17,6,1,0,2,8,22,2006
Beno Udrih,PG,23,SAS,54,3,586,106,233,.455,24,70,.343,82,163,.503,.506,39,50,.780,18,34,52,92,14,2,53,55,275,2006
Nick Van Exel,PG,34,SAS,65,2,986,136,343,.397,55,154,.357,81,189,.429,.477,28,41,.683,6,85,91,123,16,3,57,60,355,2006
Keith Van Horn,SF,30,DAL,53,0,1090,164,387,.424,50,136,.368,114,251,.454,.488,94,113,.832,54,138,192,37,31,11,71,121,472,2006
Anderson Varejao,C,23,CLE,48,4,760,79,150,.527,0,1,.000,79,149,.530,.527,61,119,.513,77,158,235,19,31,19,27,118,219,2006
Jacque Vaughn,SG,30,NJN,80,6,1234,107,245,.437,1,6,.167,106,239,.444,.439,59,81,.728,16,75,91,123,42,1,52,140,274,2006
Charlie Villanueva,PF,21,TOR,81,36,2361,435,940,.463,70,214,.327,365,726,.503,.500,113,160,.706,181,340,521,88,60,63,99,247,1053,2006
Jake Voskuhl,C,28,CHA,51,2,818,114,261,.437,1,3,.333,113,258,.438,.439,41,60,.683,62,121,183,39,26,23,33,157,270,2006
Jackson Vroman,PF,24,NOK,41,2,406,26,66,.394,0,0,.000,26,66,.394,.394,21,44,.477,33,53,86,11,12,11,21,78,73,2006
Sasha Vujacic,PG,21,LAL,82,4,1449,108,312,.346,59,172,.343,49,140,.350,.441,46,52,.885,33,126,159,139,48,3,50,150,321,2006
Dwyane Wade,SG,24,MIA,75,75,2892,699,1413,.495,13,76,.171,686,1337,.513,.499,629,803,.783,107,323,430,503,146,58,268,217,2040,2006
Von Wafer,SG,20,LAL,16,0,73,6,38,.158,2,17,.118,4,21,.190,.184,6,8,.750,5,3,8,4,3,0,1,12,20,2006
Antoine Walker,PF,29,MIA,82,19,2199,391,898,.435,137,383,.358,254,515,.493,.512,81,129,.628,103,318,421,166,47,30,150,187,1000,2006
Samaki Walker,PF,29,IND,7,0,22,0,2,.000,0,0,.000,0,2,.000,.000,2,2,1.000,0,3,3,0,0,1,2,7,2,2006
Ben Wallace,C,31,DET,82,82,2890,237,465,.510,0,4,.000,237,461,.514,.510,123,296,.416,301,622,923,158,146,181,88,164,597,2006
Gerald Wallace,SF,23,CHA,55,52,1895,317,589,.538,14,50,.280,303,539,.562,.550,188,306,.614,123,289,412,96,138,115,99,150,836,2006
Rasheed Wallace,PF,31,DET,80,80,2780,459,1067,.430,155,434,.357,304,633,.480,.503,136,183,.743,90,457,547,182,82,130,85,232,1209,2006
Matt Walsh,SG,23,MIA,2,0,3,1,1,1.000,0,0,.000,1,1,1.000,1.000,0,2,.000,0,0,0,0,0,0,1,0,2,2006
Luke Walton,SF,25,LAL,69,6,1333,135,328,.412,18,55,.327,117,273,.429,.439,57,76,.750,88,159,247,156,41,15,78,119,345,2006
Hakim Warrick,PF,23,MEM,68,2,724,101,228,.443,0,0,.000,101,228,.443,.443,76,115,.661,43,101,144,30,14,21,56,113,278,2006
Earl Watson,PG,26,TOT,70,10,1578,219,509,.430,110,272,.404,109,237,.460,.538,75,111,.676,24,134,158,289,68,10,136,159,623,2006
Earl Watson,PG,26,DEN,46,10,975,121,282,.429,68,172,.395,53,110,.482,.550,37,59,.627,17,69,86,160,37,7,75,95,347,2006
Earl Watson,PG,26,SEA,24,0,603,98,227,.432,42,100,.420,56,127,.441,.524,38,52,.731,7,65,72,129,31,3,61,64,276,2006
Chris Webber,PF,32,PHI,75,75,2893,617,1422,.434,21,77,.273,596,1345,.443,.441,263,348,.756,184,557,741,256,103,62,182,219,1518,2006
Martell Webster,SF,19,POR,61,18,1070,139,348,.399,65,182,.357,74,166,.446,.493,61,71,.859,29,101,130,34,21,14,43,90,404,2006
Bonzi Wells,SG,29,SAC,52,41,1684,284,613,.463,10,45,.222,274,568,.482,.471,129,190,.679,142,259,401,144,94,25,126,156,707,2006
Jiri Welsch,SF,26,MIL,58,2,866,86,222,.387,14,49,.286,72,173,.416,.419,65,87,.747,22,89,111,62,34,1,41,65,251,2006
David Wesley,SG,35,HOU,71,59,2372,226,561,.403,99,271,.365,127,290,.438,.491,151,187,.807,24,154,178,204,59,6,120,212,702,2006
David West,PF,25,NOK,74,74,2526,530,1036,.512,3,11,.273,527,1025,.514,.513,199,236,.843,168,380,548,92,61,64,105,214,1262,2006
Delonte West,PG,22,BOS,71,71,2418,333,684,.487,84,218,.385,249,466,.534,.548,86,101,.851,57,232,289,329,84,46,133,197,836,2006
Robert Whaley,C,23,UTA,23,0,212,23,57,.404,0,0,.000,23,57,.404,.404,3,6,.500,16,27,43,17,7,8,14,41,49,2006
Chris Wilcox,C-PF,23,TOT,77,24,1529,257,450,.571,0,2,.000,257,448,.574,.571,112,153,.732,118,292,410,52,33,34,72,183,626,2006
Chris Wilcox,C,23,LAC,48,1,657,90,168,.536,0,2,.000,90,166,.542,.536,38,59,.644,46,127,173,18,15,21,32,103,218,2006
Chris Wilcox,PF,23,SEA,29,23,872,167,282,.592,0,0,.000,167,282,.592,.592,74,94,.787,72,165,237,34,18,13,40,80,408,2006
Damien Wilkins,SF,26,SEA,82,12,1525,193,435,.444,14,56,.250,179,379,.472,.460,136,162,.840,79,113,192,107,72,12,85,144,536,2006
Mike Wilks,PG,26,TOT,47,0,348,29,90,.322,3,19,.158,26,71,.366,.339,25,41,.610,9,30,39,32,14,1,24,34,86,2006
Mike Wilks,PG,26,CLE,37,0,243,17,59,.288,2,14,.143,15,45,.333,.305,6,12,.500,6,21,27,18,8,1,15,27,42,2006
Mike Wilks,PG,26,SEA,10,0,105,12,31,.387,1,5,.200,11,26,.423,.403,19,29,.655,3,9,12,14,6,0,9,7,44,2006
Aaron Williams,C,34,TOT,48,5,791,91,176,.517,0,0,.000,91,176,.517,.517,40,58,.690,64,117,181,17,17,21,30,138,222,2006
Aaron Williams,C,34,TOR,14,3,99,10,19,.526,0,0,.000,10,19,.526,.526,5,6,.833,5,10,15,1,4,3,5,28,25,2006
Aaron Williams,C,34,NOK,34,2,692,81,157,.516,0,0,.000,81,157,.516,.516,35,52,.673,59,107,166,16,13,18,25,110,197,2006
Alvin Williams,PG,31,TOR,1,0,10,0,3,.000,0,2,.000,0,1,.000,.000,1,2,.500,0,3,3,0,0,0,0,0,1,2006
Deron Williams,PG,21,UTA,80,47,2307,339,805,.421,91,219,.416,248,586,.423,.478,95,135,.704,35,159,194,359,60,17,145,233,864,2006
Eric Williams,SF,33,TOR,28,11,352,29,75,.387,5,18,.278,24,57,.421,.420,28,38,.737,10,40,50,15,7,2,15,55,91,2006
Jason Williams,PG,30,MIA,59,56,1874,268,606,.442,107,288,.372,161,318,.506,.531,85,98,.867,6,133,139,287,53,5,100,101,728,2006
Lou Williams,PG,19,PHI,30,0,145,23,52,.442,2,9,.222,21,43,.488,.462,8,13,.615,3,16,19,10,5,0,13,13,56,2006
Marvin Williams,PF,19,ATL,79,7,1952,235,531,.443,13,53,.245,222,478,.464,.455,189,253,.747,122,261,383,63,48,24,83,227,672,2006
Mo Williams,PG,23,MIL,58,12,1531,267,629,.424,73,191,.382,194,438,.443,.483,96,113,.850,30,113,143,230,52,7,105,146,703,2006
Corliss Williamson,SF,32,SAC,37,0,362,43,103,.417,2,2,1.000,41,101,.406,.427,38,49,.776,21,46,67,14,7,4,30,56,126,2006
Loren Woods,C,27,TOR,27,4,324,28,59,.475,0,1,.000,28,58,.483,.475,6,14,.429,44,66,110,4,9,23,16,49,62,2006
Qyntel Woods,SF,24,NYK,49,16,1013,129,254,.508,22,60,.367,107,194,.552,.551,49,76,.645,44,146,190,47,32,13,61,96,329,2006
Metta World Peace,SF,26,TOT,56,56,2207,350,867,.404,78,253,.308,272,614,.443,.449,206,305,.675,75,211,286,203,122,41,131,164,984,2006
Metta World Peace,SF,26,IND,16,16,603,109,237,.460,18,54,.333,91,183,.497,.498,74,121,.612,26,52,78,35,42,11,43,45,310,2006
Metta World Peace,SF,26,SAC,40,40,1604,241,630,.383,60,199,.302,181,431,.420,.430,132,184,.717,49,159,208,168,80,30,88,119,674,2006
Antoine Wright,SG,21,NJN,39,0,370,29,81,.358,1,15,.067,28,66,.424,.364,11,22,.500,8,22,30,12,4,3,21,42,70,2006
Bracey Wright,SG,21,MIN,7,0,135,21,51,.412,6,17,.353,15,34,.441,.471,14,16,.875,3,15,18,5,1,0,8,8,62,2006
Dorell Wright,SF,20,MIA,20,2,132,20,43,.465,3,6,.500,17,37,.459,.500,15,17,.882,2,30,32,8,3,1,14,12,58,2006
Lorenzen Wright,C,30,MEM,78,58,1689,194,406,.478,0,2,.000,194,404,.480,.478,66,117,.564,142,253,395,48,52,46,67,201,454,2006
Derrick Zimmerman,PG,24,NJN,2,0,32,2,3,.667,0,0,.000,2,3,.667,.667,0,0,.000,1,3,4,7,0,0,4,4,4,2006
Shareef Abdur-Rahim,PF,28,POR,54,49,1867,337,670,.503,15,39,.385,322,631,.510,.514,220,254,.866,123,269,392,111,49,26,117,150,909,2005
Cory Alexander,SG,31,CHA,16,1,201,16,49,.327,8,19,.421,8,30,.267,.408,9,12,.750,8,21,29,37,9,1,19,29,49,2005
Malik Allen,PF,26,TOT,36,1,519,84,177,.475,0,0,.000,84,177,.475,.475,26,28,.929,40,59,99,18,9,22,18,53,194,2005
Malik Allen,PF,26,MIA,14,0,248,35,76,.461,0,0,.000,35,76,.461,.461,13,14,.929,24,28,52,11,4,11,11,29,83,2005
Malik Allen,PF,26,CHA,22,1,271,49,101,.485,0,0,.000,49,101,.485,.485,13,14,.929,16,31,47,7,5,11,7,24,111,2005
Ray Allen,SG,29,SEA,78,78,3064,640,1494,.428,209,556,.376,431,938,.459,.498,378,428,.883,79,268,347,289,84,5,171,167,1867,2005
Tony Allen,SG,23,BOS,77,34,1262,184,387,.475,12,31,.387,172,356,.483,.491,112,152,.737,85,136,221,64,76,24,77,156,492,2005
Rafer Alston,PG,28,TOR,80,78,2717,403,974,.414,139,389,.357,264,585,.451,.485,191,258,.740,42,237,279,514,118,7,170,212,1136,2005
Chris Andersen,C,26,NOH,67,2,1430,191,358,.534,0,3,.000,191,355,.538,.534,131,190,.689,137,273,410,71,14,100,64,144,513,2005
Derek Anderson,SG,30,POR,47,32,1239,152,391,.389,58,151,.384,94,240,.392,.463,70,87,.805,25,103,128,143,36,4,70,89,432,2005
Kenny Anderson,PG,34,TOT,43,20,743,85,201,.423,6,13,.462,79,188,.420,.438,27,37,.730,24,64,88,103,33,0,49,87,203,2005
Kenny Anderson,PG,34,ATL,39,20,717,81,190,.426,6,13,.462,75,177,.424,.442,27,37,.730,23,60,83,98,33,0,46,81,195,2005
Kenny Anderson,PG,34,LAC,4,0,26,4,11,.364,0,0,.000,4,11,.364,.364,0,0,.000,1,4,5,5,0,0,3,6,8,2005
Shandon Anderson,SF-SG,31,TOT,66,5,1171,98,217,.452,5,29,.172,93,188,.495,.463,54,66,.818,41,150,191,70,40,14,50,138,255,2005
Shandon Anderson,SG,31,NYK,1,0,20,0,2,.000,0,1,.000,0,1,.000,.000,0,0,.000,1,0,1,0,0,0,1,2,0,2005
Shandon Anderson,SF,31,MIA,65,5,1151,98,215,.456,5,28,.179,93,187,.497,.467,54,66,.818,40,150,190,70,40,14,49,136,255,2005
Carmelo Anthony,SF,20,DEN,75,75,2608,530,1230,.431,42,158,.266,488,1072,.455,.448,456,573,.796,141,285,426,194,68,30,224,229,1558,2005
Rafael Araujo,C,24,TOR,59,41,736,76,175,.434,1,3,.333,75,172,.436,.437,43,55,.782,59,126,185,16,21,8,52,157,196,2005
Gilbert Arenas,PG,23,WAS,80,80,3274,656,1523,.431,205,562,.365,451,961,.469,.498,521,640,.814,83,295,378,411,139,23,242,245,2038,2005
Trevor Ariza,SF,19,NYK,80,12,1382,172,389,.442,3,13,.231,169,376,.449,.446,121,174,.695,89,153,242,85,70,18,73,150,468,2005
Darrell Armstrong,PG,36,TOT,66,16,988,89,277,.321,28,111,.252,61,166,.367,.372,58,68,.853,35,80,115,178,45,8,67,92,264,2005
Darrell Armstrong,PG,36,NOH,14,9,412,53,159,.333,17,70,.243,36,89,.404,.387,19,21,.905,16,32,48,65,15,2,28,30,142,2005
Darrell Armstrong,PG,36,DAL,52,7,576,36,118,.305,11,41,.268,25,77,.325,.352,39,47,.830,19,48,67,113,30,6,39,62,122,2005
Carlos Arroyo,PG,25,TOT,70,16,1448,167,429,.389,8,30,.267,159,399,.398,.399,119,149,.799,26,78,104,280,44,4,107,143,461,2005
Carlos Arroyo,PG,25,UTA,30,16,742,93,232,.401,7,18,.389,86,214,.402,.416,53,63,.841,11,35,46,152,20,3,55,67,246,2005
Carlos Arroyo,PG,25,DET,40,0,706,74,197,.376,1,12,.083,73,185,.395,.378,66,86,.767,15,43,58,128,24,1,52,76,215,2005
Chucky Atkins,PG,30,LAL,82,82,2903,388,910,.426,176,455,.387,212,455,.466,.523,163,203,.803,31,166,197,358,73,2,151,181,1115,2005
Stacey Augmon,SF,36,ORL,55,7,663,68,167,.407,0,0,.000,68,167,.407,.407,57,77,.740,45,54,99,36,23,8,31,83,193,2005
Maurice Baker,PG,25,TOT,5,0,19,0,1,.000,0,0,.000,0,1,.000,.000,0,0,.000,1,1,2,1,1,0,1,3,0,2005
Maurice Baker,PG,25,LAC,1,0,1,0,0,.000,0,0,.000,0,0,.000,.000,0,0,.000,0,0,0,0,0,0,0,0,0,2005
Maurice Baker,PG,25,POR,4,0,18,0,1,.000,0,0,.000,0,1,.000,.000,0,0,.000,1,1,2,1,1,0,1,3,0,2005
Vin Baker,PF-C,33,TOT,27,0,204,13,42,.310,0,1,.000,13,41,.317,.310,9,17,.529,17,22,39,10,2,4,17,38,35,2005
Vin Baker,PF,33,NYK,24,0,191,13,38,.342,0,1,.000,13,37,.351,.342,7,15,.467,17,20,37,9,2,4,15,31,33,2005
Vin Baker,C,33,HOU,3,0,13,0,4,.000,0,0,.000,0,4,.000,.000,2,2,1.000,0,2,2,1,0,0,2,7,2,2005
Marcus Banks,PG,23,BOS,81,2,1145,115,286,.402,21,59,.356,94,227,.414,.439,121,163,.742,29,97,126,155,63,13,79,146,372,2005
Leandro Barbosa,PG,22,PHO,63,6,1087,168,354,.475,51,139,.367,117,215,.544,.547,55,69,.797,32,98,130,126,30,7,87,127,442,2005
Matt Barnes,SF,24,SAC,43,9,715,62,151,.411,5,22,.227,57,129,.442,.427,35,58,.603,49,84,133,57,30,7,45,80,164,2005
Andre Barrett,PG,22,TOT,38,1,483,45,124,.363,14,52,.269,31,72,.431,.419,14,19,.737,11,29,40,69,19,1,27,51,118,2005
Andre Barrett,PG,22,HOU,27,0,314,20,69,.290,9,37,.243,11,32,.344,.355,7,10,.700,5,14,19,42,14,0,16,35,56,2005
Andre Barrett,PG,22,ORL,11,1,169,25,55,.455,5,15,.333,20,40,.500,.500,7,9,.778,6,15,21,27,5,1,11,16,62,2005
Brent Barry,SG,33,SAS,81,8,1742,194,459,.423,100,280,.357,94,179,.525,.532,113,135,.837,29,161,190,178,39,20,64,123,601,2005
Jon Barry,SG,35,TOT,69,2,1505,161,368,.438,71,165,.430,90,203,.443,.534,62,71,.873,26,133,159,167,60,9,67,95,455,2005
Jon Barry,SG,35,ATL,16,0,275,31,77,.403,11,32,.344,20,45,.444,.474,10,13,.769,4,17,21,28,14,2,14,28,83,2005
Jon Barry,SG,35,HOU,53,2,1230,130,291,.447,60,133,.451,70,158,.443,.550,52,58,.897,22,116,138,139,46,7,53,67,372,2005
Tony Battie,C,28,ORL,81,32,1894,163,354,.460,0,6,.000,163,348,.468,.460,68,94,.723,109,343,452,42,30,81,81,244,394,2005
Shane Battier,SG,26,MEM,80,72,2516,271,613,.442,70,177,.395,201,436,.461,.499,180,228,.789,158,255,413,126,91,77,75,201,792,2005
Lonny Baxter,PF,26,NOH,4,0,36,3,11,.273,0,0,.000,3,11,.273,.273,0,2,.000,4,4,8,0,0,0,4,10,6,2005
Raja Bell,SG,28,UTA,63,32,1790,303,667,.454,54,134,.403,249,533,.467,.495,112,150,.747,48,153,201,91,44,8,79,205,772,2005
Jonathan Bender,SF,24,IND,7,0,93,16,40,.400,1,5,.200,15,35,.429,.413,3,6,.500,5,9,14,4,1,2,10,9,36,2005
Travis Best,PG,32,NJN,76,6,1461,190,452,.420,26,85,.306,164,367,.447,.449,108,122,.885,19,88,107,143,66,9,67,148,514,2005
Mike Bibby,PG,26,SAC,80,80,3084,560,1264,.443,131,364,.360,429,900,.477,.495,320,413,.775,77,255,332,541,124,30,203,191,1571,2005
Andris Biedrins,C,18,GSW,30,1,384,45,78,.577,0,1,.000,45,77,.584,.577,19,40,.475,47,71,118,12,12,24,12,87,109,2005
Chauncey Billups,PG,28,DET,80,80,2866,404,913,.442,165,387,.426,239,526,.454,.533,343,382,.898,48,223,271,464,81,9,180,194,1316,2005
Steve Blake,PG,24,WAS,44,1,648,61,186,.328,36,93,.387,25,93,.269,.425,33,41,.805,18,53,71,69,13,0,39,47,191,2005
Mark Blount,C,29,BOS,82,57,2130,327,618,.529,0,1,.000,327,617,.530,.529,117,164,.713,143,254,397,129,33,64,158,229,771,2005
Tony Bobbitt,SG,25,LAL,2,0,12,2,5,.400,1,2,.500,1,3,.333,.500,0,0,.000,0,3,3,0,0,0,0,1,5,2005
Keith Bogans,SG,24,CHA,74,42,1791,262,688,.381,57,173,.329,205,515,.398,.422,133,183,.727,76,150,226,135,68,8,122,167,714,2005
Matt Bonner,C,24,TOR,82,0,1553,247,463,.533,39,92,.424,208,371,.561,.576,56,71,.789,108,177,285,48,39,19,40,220,589,2005
Calvin Booth,C,28,TOT,51,1,451,49,108,.454,0,1,.000,49,107,.458,.454,26,32,.813,29,78,107,8,15,28,16,78,124,2005
Calvin Booth,C,28,DAL,34,1,262,34,79,.430,0,1,.000,34,78,.436,.430,14,16,.875,16,42,58,4,11,16,8,55,82,2005
Calvin Booth,C,28,MIL,17,0,189,15,29,.517,0,0,.000,15,29,.517,.517,12,16,.750,13,36,49,4,4,12,8,23,42,2005
Carlos Boozer,PF,23,UTA,51,51,1772,361,693,.521,0,1,.000,361,692,.522,.521,187,268,.698,141,316,457,144,41,24,137,179,909,2005
Curtis Borchardt,C,24,UTA,67,23,859,74,172,.430,0,0,.000,74,172,.430,.430,52,71,.732,86,138,224,49,10,32,52,160,200,2005
Chris Bosh,PF,20,TOR,81,81,3017,473,1005,.471,3,10,.300,470,995,.472,.472,412,542,.760,194,524,718,153,76,113,187,226,1361,2005
Bruce Bowen,SF,33,SAS,82,82,2627,251,598,.420,102,253,.403,149,345,.432,.505,71,112,.634,50,235,285,126,55,39,57,175,675,2005
Ryan Bowen,SF,29,HOU,66,6,604,47,111,.423,3,6,.500,44,105,.419,.437,14,21,.667,21,55,76,18,23,5,7,61,111,2005
Earl Boykins,PG,28,DEN,82,5,2162,340,824,.413,56,166,.337,284,658,.432,.447,279,303,.921,37,106,143,372,78,12,121,122,1015,2005
Michael Bradley,PF,25,TOT,18,0,119,15,24,.625,0,1,.000,15,23,.652,.625,3,8,.375,8,20,28,5,1,2,5,12,33,2005
Michael Bradley,PF,25,ORL,8,0,55,3,7,.429,0,0,.000,3,7,.429,.429,0,0,.000,3,11,14,2,1,2,1,4,6,2005
Michael Bradley,PF,25,SAC,8,0,48,8,12,.667,0,0,.000,8,12,.667,.667,2,6,.333,5,6,11,2,0,0,3,8,18,2005
Michael Bradley,PF,25,PHI,2,0,16,4,5,.800,0,1,.000,4,4,1.000,.800,1,2,.500,0,3,3,1,0,0,1,0,9,2005
Shawn Bradley,C,32,DAL,77,14,885,84,186,.452,0,0,.000,84,186,.452,.452,43,63,.683,70,144,214,15,25,63,33,153,211,2005
Torraye Braggs,PF,28,HOU,7,0,24,3,7,.429,0,0,.000,3,7,.429,.429,0,0,.000,7,5,12,0,0,0,2,4,6,2005
Elton Brand,PF,25,LAC,81,81,3001,629,1251,.503,0,3,.000,629,1248,.504,.503,364,484,.752,296,474,770,208,62,169,183,240,1622,2005
Jamison Brewer,PG,24,NYK,18,0,185,11,37,.297,3,15,.200,8,22,.364,.338,6,13,.462,6,16,22,12,8,1,13,11,31,2005
Primoz Brezec,C,25,CHA,72,72,2276,387,756,.512,0,0,.000,387,756,.512,.512,164,220,.745,226,305,531,86,33,55,106,183,938,2005
Damone Brown,SF,25,WAS,14,0,152,23,62,.371,4,11,.364,19,51,.373,.403,4,9,.444,10,18,28,14,1,6,15,17,54,2005
Devin Brown,SG,26,SAS,67,0,1238,173,409,.423,45,121,.372,128,288,.444,.478,103,130,.792,37,139,176,92,39,12,53,83,494,2005
Kedrick Brown,SF,23,PHI,8,0,55,2,6,.333,0,3,.000,2,3,.667,.333,8,10,.800,1,10,11,4,3,1,5,4,12,2005
Kwame Brown,PF,22,WAS,42,14,908,109,237,.460,0,0,.000,109,237,.460,.460,74,129,.574,72,134,206,39,25,15,67,112,292,2005
P.J. Brown,PF,35,NOH,82,78,2817,338,758,.446,0,0,.000,338,758,.446,.446,210,243,.864,266,471,737,178,74,50,101,233,886,2005
Tierre Brown,PG,25,LAL,76,0,1066,124,348,.356,26,72,.361,98,276,.355,.394,59,75,.787,21,72,93,155,32,1,74,59,333,2005
Rick Brunson,PG,32,LAC,80,39,1945,166,442,.376,48,130,.369,118,312,.378,.430,57,74,.770,23,164,187,410,82,7,125,106,437,2005
Kobe Bryant,SG,26,LAL,66,66,2689,573,1324,.433,131,387,.339,442,937,.472,.482,542,664,.816,95,297,392,398,86,53,270,174,1819,2005
Greg Buckner,SG,28,DEN,70,41,1522,160,303,.528,49,121,.405,111,182,.610,.609,63,81,.778,66,142,208,133,75,6,49,169,432,2005
Rodney Buford,SF,27,NJN,64,17,1313,187,489,.382,34,108,.315,153,381,.402,.417,37,45,.822,33,156,189,63,40,4,35,101,445,2005
Antonio Burks,PG,24,MEM,24,0,219,28,60,.467,3,11,.273,25,49,.510,.492,14,19,.737,1,11,12,28,13,1,12,25,73,2005
Caron Butler,SF,24,LAL,77,77,2746,441,991,.445,38,125,.304,403,866,.465,.464,275,319,.862,146,304,450,146,110,23,125,213,1195,2005
Jackie Butler,C,19,NYK,3,0,5,4,4,1.000,0,0,.000,4,4,1.000,1.000,2,2,1.000,0,0,0,0,1,0,1,0,10,2005
Rasual Butler,SF,25,MIA,65,15,1203,163,409,.399,57,153,.373,106,256,.414,.468,37,48,.771,15,136,151,62,18,29,37,104,420,2005
Zarko Cabarkapa,PF,23,TOT,40,0,475,86,177,.486,13,36,.361,73,141,.518,.523,53,65,.815,35,67,102,25,10,5,30,59,238,2005
Zarko Cabarkapa,PF,23,PHO,3,0,11,4,7,.571,0,0,.000,4,7,.571,.571,1,1,1.000,2,1,3,0,0,0,0,0,9,2005
Zarko Cabarkapa,PF,23,GSW,37,0,464,82,170,.482,13,36,.361,69,134,.515,.521,52,64,.813,33,66,99,25,10,5,30,59,229,2005
Marcus Camby,C,30,DEN,66,66,2015,279,600,.465,0,4,.000,279,596,.468,.465,125,173,.723,131,530,661,152,61,199,103,177,683,2005
Elden Campbell,C,36,TOT,40,1,390,39,123,.317,0,2,.000,39,121,.322,.317,42,55,.764,28,65,93,19,8,7,29,57,120,2005
Elden Campbell,C,36,NJN,10,0,50,0,7,.000,0,0,.000,0,7,.000,.000,2,4,.500,3,8,11,3,0,1,1,10,2,2005
Elden Campbell,C,36,DET,30,1,340,39,116,.336,0,2,.000,39,114,.342,.336,40,51,.784,25,57,82,16,8,6,28,47,118,2005
Brian Cardinal,PF,27,MEM,58,16,1433,160,432,.370,44,125,.352,116,307,.378,.421,158,181,.873,63,162,225,114,88,19,83,172,522,2005
Geno Carlisle,SG,28,POR,6,0,16,2,3,.667,0,0,.000,2,3,.667,.667,4,6,.667,1,0,1,1,0,0,1,1,8,2005
Matt Carroll,SG,24,CHA,25,0,430,70,180,.389,13,39,.333,57,141,.404,.425,71,83,.855,13,47,60,17,17,2,25,37,224,2005
Anthony Carter,PG,29,MIN,66,12,742,72,177,.407,2,17,.118,70,160,.438,.412,35,51,.686,12,57,69,161,35,18,62,88,181,2005
Vince Carter,SF-SG,28,TOT,77,76,2828,696,1541,.452,127,313,.406,569,1228,.463,.493,367,460,.798,106,295,401,327,109,48,168,243,1886,2005
Vince Carter,SG,28,TOR,20,20,608,124,302,.411,19,59,.322,105,243,.432,.442,50,72,.694,28,38,66,61,25,15,22,56,317,2005
Vince Carter,SF,28,NJN,57,56,2220,572,1239,.462,108,254,.425,464,985,.471,.505,317,388,.817,78,257,335,266,84,33,146,187,1569,2005
Sam Cassell,PG,35,MIN,59,38,1522,319,687,.464,27,103,.262,292,584,.500,.484,134,155,.865,25,132,157,301,36,14,109,160,799,2005
Kelvin Cato,C,30,ORL,62,50,1525,160,297,.539,0,0,.000,160,297,.539,.539,112,143,.783,102,314,416,40,55,82,64,170,432,2005
Lionel Chalmers,PG,24,LAC,36,0,433,42,125,.336,12,49,.245,30,76,.395,.384,15,24,.625,4,27,31,51,13,0,24,30,111,2005
Tyson Chandler,C,22,CHI,80,10,2189,207,419,.494,0,2,.000,207,417,.496,.494,226,336,.673,261,514,775,65,69,141,118,268,640,2005
Calbert Cheaney,SG,33,GSW,55,5,951,113,265,.426,0,3,.000,113,262,.431,.426,24,37,.649,32,92,124,64,17,15,35,95,250,2005
Josh Childress,SG,21,ATL,80,44,2376,302,642,.470,13,56,.232,289,586,.493,.481,190,231,.823,195,287,482,151,74,35,106,184,807,2005
Doug Christie,SG,34,TOT,52,44,1525,130,332,.392,15,62,.242,115,270,.426,.414,70,78,.897,38,139,177,199,80,18,104,106,345,2005
Doug Christie,SG,34,SAC,31,31,996,83,204,.407,10,39,.256,73,165,.442,.431,50,56,.893,29,94,123,153,43,13,68,61,226,2005
Doug Christie,SG,34,ORL,21,13,529,47,128,.367,5,23,.217,42,105,.400,.387,20,22,.909,9,45,54,46,37,5,36,45,119,2005
Speedy Claxton,PG,26,TOT,62,47,1866,257,611,.421,11,61,.180,246,550,.447,.430,187,254,.736,37,147,184,374,109,8,119,184,712,2005
Speedy Claxton,PG,26,GSW,46,44,1501,216,501,.431,10,52,.192,206,449,.459,.441,162,213,.761,32,121,153,286,87,6,92,154,604,2005
Speedy Claxton,PG,26,NOH,16,3,365,41,110,.373,1,9,.111,40,101,.396,.377,25,41,.610,5,26,31,88,22,2,27,30,108,2005
Mateen Cleaves,PG,27,SEA,14,0,65,5,14,.357,0,2,.000,5,12,.417,.357,3,4,.750,2,4,6,7,2,0,2,2,13,2005
Derrick Coleman,C,37,DET,5,0,50,3,14,.214,0,2,.000,3,12,.250,.214,3,3,1.000,3,12,15,0,0,0,2,6,9,2005
Jason Collier,C,27,ATL,70,44,942,174,376,.463,6,14,.429,168,362,.464,.471,48,71,.676,84,100,184,18,15,13,63,147,402,2005
Jarron Collins,C,26,UTA,50,38,961,65,157,.414,0,1,.000,65,156,.417,.414,83,119,.697,57,107,164,61,11,6,34,146,213,2005
Jason Collins,C,26,NJN,80,80,2542,186,451,.412,2,6,.333,184,445,.413,.415,137,209,.656,153,335,488,105,71,71,91,322,511,2005
Nick Collison,C,24,SEA,82,4,1396,190,354,.537,0,3,.000,190,351,.541,.537,83,118,.703,156,220,376,32,34,50,62,252,463,2005
Brian Cook,C,24,LAL,72,0,1087,176,422,.417,78,199,.392,98,223,.439,.509,28,37,.757,63,153,216,35,23,26,29,139,458,2005
Omar Cook,PG,23,TOR,5,0,74,10,24,.417,0,4,.000,10,20,.500,.417,3,6,.500,2,5,7,22,6,1,6,6,23,2005
Jamal Crawford,SG,24,NYK,70,67,2688,437,1097,.398,185,512,.361,252,585,.431,.483,182,216,.843,33,170,203,302,92,19,148,135,1241,2005
Austin Croshere,PF,29,IND,73,22,1827,188,497,.378,45,174,.259,143,323,.443,.424,226,256,.883,103,272,375,98,48,17,104,154,647,2005
Eddy Curry,C,22,CHI,63,60,1808,393,730,.538,0,0,.000,393,730,.538,.538,226,314,.720,116,222,338,37,21,58,163,202,1012,2005
Michael Curry,SF,36,IND,18,7,249,13,29,.448,0,0,.000,13,29,.448,.448,4,8,.500,8,19,27,15,5,4,5,39,30,2005
Samuel Dalembert,C,23,PHI,72,60,1785,250,477,.524,0,0,.000,250,477,.524,.524,89,148,.601,187,355,542,35,46,121,114,241,589,2005
Erick Dampier,C,29,DAL,59,56,1609,202,367,.550,0,3,.000,202,364,.555,.550,138,228,.605,183,318,501,51,15,80,102,205,542,2005
Antonio Daniels,PG,29,SEA,75,2,2026,273,623,.438,49,165,.297,224,458,.489,.478,248,304,.816,20,149,169,309,51,3,78,78,843,2005
Erik Daniels,SF,22,SAC,21,0,72,6,18,.333,1,2,.500,5,16,.313,.361,0,0,.000,7,11,18,4,2,0,6,7,13,2005
Marquis Daniels,SG,24,DAL,60,17,1412,220,504,.437,7,35,.200,213,469,.454,.443,98,133,.737,87,129,216,128,83,14,86,124,545,2005
Antonio Davis,PF,36,CHI,72,62,1843,193,419,.461,0,0,.000,193,419,.461,.461,115,152,.757,152,276,428,80,27,41,96,147,501,2005
Baron Davis,PG,25,TOT,46,32,1581,291,752,.387,118,354,.333,173,398,.435,.465,185,243,.761,32,143,175,362,81,14,131,126,885,2005
Baron Davis,PG,25,NOH,18,13,593,111,303,.366,44,137,.321,67,166,.404,.439,74,96,.771,16,51,67,129,31,4,38,52,340,2005
Baron Davis,PG,25,GSW,28,19,988,180,449,.401,74,217,.341,106,232,.457,.483,111,147,.755,16,92,108,233,50,10,93,74,545,2005
Dale Davis,C,35,TOT,61,28,1307,112,234,.479,0,0,.000,112,234,.479,.479,60,99,.606,152,223,375,47,32,65,43,162,284,2005
Dale Davis,C,35,GSW,36,3,577,45,109,.413,0,0,.000,45,109,.413,.413,22,38,.579,61,92,153,23,13,32,20,79,112,2005
Dale Davis,C,35,IND,25,25,730,67,125,.536,0,0,.000,67,125,.536,.536,38,61,.623,91,131,222,24,19,33,23,83,172,2005
Josh Davis,PF,24,PHI,42,5,328,42,111,.378,19,53,.358,23,58,.397,.464,14,17,.824,29,50,79,12,8,4,15,45,117,2005
Ricky Davis,SG,25,BOS,82,11,2696,481,1041,.462,61,180,.339,420,861,.488,.491,286,351,.815,66,183,249,246,89,27,205,174,1309,2005
Andrew DeClercq,C,31,ORL,8,0,49,4,9,.444,0,0,.000,4,9,.444,.444,1,3,.333,7,3,10,0,2,0,1,14,9,2005
Carlos Delfino,SG,22,DET,30,4,459,42,117,.359,9,35,.257,33,82,.402,.397,23,40,.575,13,42,55,38,22,6,23,44,116,2005
Tony Delk,SG,31,ATL,56,1,1340,246,591,.416,72,202,.356,174,389,.447,.477,103,136,.757,28,102,130,104,47,3,54,123,667,2005
Luol Deng,SF,19,CHI,61,45,1663,280,645,.434,31,117,.265,249,528,.472,.458,120,162,.741,92,230,322,135,48,27,118,98,711,2005
Boris Diaw,SG,22,ATL,66,25,1201,124,294,.422,9,50,.180,115,244,.471,.437,57,77,.740,54,116,170,149,37,18,87,123,314,2005
Dan Dickau,PG,26,TOT,71,46,2090,306,756,.405,85,245,.347,221,511,.432,.461,190,228,.833,34,146,180,347,76,4,145,201,887,2005
Dan Dickau,PG,26,DAL,4,0,16,1,8,.125,1,3,.333,0,5,.000,.188,2,3,.667,0,1,1,1,0,0,1,1,5,2005
Dan Dickau,PG,26,NOH,67,46,2074,305,748,.408,84,242,.347,221,506,.437,.464,188,225,.836,34,145,179,346,76,4,144,200,882,2005
Kaniel Dickens,SF,26,NJN,11,0,61,4,14,.286,3,9,.333,1,5,.200,.393,2,2,1.000,3,6,9,1,2,1,2,5,13,2005
DeSagana Diop,C,23,CLE,39,0,306,20,69,.290,0,2,.000,20,67,.299,.290,0,5,.000,30,40,70,15,8,27,12,53,40,2005
Vlade Divac,C,36,LAL,15,0,130,13,31,.419,0,0,.000,13,31,.419,.419,8,12,.667,18,14,32,19,4,1,14,25,34,2005
Juan Dixon,SG,26,WAS,63,4,1054,186,447,.416,48,147,.327,138,300,.460,.470,87,97,.897,32,87,119,111,43,4,68,98,507,2005
Michael Doleac,C,27,MIA,80,8,1175,148,331,.447,0,2,.000,148,329,.450,.447,25,41,.610,74,185,259,47,23,22,36,160,321,2005
Keyon Dooling,PG,24,MIA,74,0,1184,139,345,.403,19,75,.253,120,270,.444,.430,85,109,.780,11,79,90,132,39,11,65,120,382,2005
Predrag Drobnjak,C,29,ATL,71,1,1435,238,543,.438,25,71,.352,213,472,.451,.461,96,120,.800,73,165,238,49,42,24,78,138,597,2005
Chris Duhon,PG,22,CHI,82,73,2177,172,488,.352,94,265,.355,78,223,.350,.449,49,67,.731,23,190,213,398,82,3,119,205,487,2005
Tim Duncan,PF,28,SAS,66,66,2203,517,1042,.496,3,9,.333,514,1033,.498,.498,305,455,.670,202,530,732,179,45,174,127,144,1342,2005
Mike Dunleavy,SF,24,GSW,79,79,2570,408,905,.451,107,276,.388,301,629,.479,.510,134,172,.779,97,338,435,203,79,26,132,198,1057,2005
Ronald Dupree,SF,24,DET,47,0,472,61,127,.480,1,2,.500,60,125,.480,.484,29,47,.617,34,61,95,24,7,10,22,60,152,2005
Ndudi Ebi,SG,20,MIN,2,0,54,11,21,.524,0,1,.000,11,20,.550,.524,5,9,.556,6,10,16,1,1,1,3,7,27,2005
Corsley Edwards,C,25,NOH,10,0,110,10,31,.323,0,0,.000,10,31,.323,.323,7,12,.583,12,13,25,3,3,4,2,19,27,2005
John Edwards,C,23,IND,25,1,139,11,30,.367,0,0,.000,11,30,.367,.367,7,14,.500,8,11,19,3,3,4,8,12,29,2005
Howard Eisley,PG,32,UTA,74,1,1428,161,405,.398,27,103,.262,134,302,.444,.431,66,83,.795,15,75,90,250,45,9,111,156,415,2005
Obinna Ekezie,C,29,ATL,42,31,732,79,182,.434,0,1,.000,79,181,.436,.434,72,93,.774,69,110,179,11,22,12,45,129,230,2005
Francisco Elson,C,28,DEN,67,11,939,101,216,.468,1,3,.333,100,213,.469,.470,45,79,.570,61,140,201,34,34,41,40,129,248,2005
Melvin Ely,PF,26,CHA,79,17,1649,227,526,.432,0,0,.000,227,526,.432,.432,122,212,.575,142,184,326,76,32,69,115,199,576,2005
Andre Emmett,SG,22,MEM,8,0,28,2,6,.333,0,0,.000,2,6,.333,.333,3,5,.600,0,2,2,0,0,0,1,4,7,2005
Maurice Evans,SG,26,SAC,65,11,1233,165,373,.442,27,82,.329,138,291,.474,.479,59,78,.756,88,113,201,45,37,8,34,104,416,2005
Reggie Evans,PF,24,SEA,79,79,1881,131,275,.476,0,2,.000,131,273,.480,.476,125,234,.534,254,482,736,58,58,15,104,202,387,2005
Michael Finley,SG,31,DAL,64,64,2358,387,907,.427,116,285,.407,271,622,.436,.491,113,136,.831,45,217,262,169,48,18,60,123,1003,2005
Derek Fisher,PG,30,GSW,74,32,2222,297,755,.393,108,291,.371,189,464,.407,.465,175,203,.862,38,180,218,301,76,4,129,176,877,2005
Marcus Fizer,PF,26,MIL,54,0,903,133,292,.455,0,6,.000,133,286,.465,.455,70,103,.680,29,146,175,64,25,13,63,96,336,2005
Luis Flores,PG,23,TOT,16,0,77,14,29,.483,5,10,.500,9,19,.474,.569,2,2,1.000,1,2,3,11,2,0,11,9,35,2005
Luis Flores,PG,23,GSW,15,0,73,13,27,.481,4,9,.444,9,18,.500,.556,2,2,1.000,0,2,2,11,2,0,11,9,32,2005
Luis Flores,PG,23,DEN,1,0,4,1,2,.500,1,1,1.000,0,1,.000,.750,0,0,.000,1,0,1,0,0,0,0,0,3,2005
Danny Fortson,C,28,SEA,62,0,1047,118,226,.522,0,0,.000,118,226,.522,.522,227,258,.880,157,191,348,8,15,7,91,265,463,2005
Jeff Foster,C,28,IND,61,43,1594,168,324,.519,0,5,.000,168,319,.527,.519,90,142,.634,205,345,550,43,46,12,55,186,426,2005
Tremaine Fowlkes,SF,28,IND,8,0,56,9,17,.529,1,3,.333,8,14,.571,.559,0,2,.000,3,5,8,0,2,0,5,7,19,2005
Adonal Foyle,C,29,GSW,78,50,1700,156,311,.502,0,0,.000,156,311,.502,.502,40,72,.556,165,264,429,56,26,159,58,201,352,2005
Richie Frahm,SG,27,POR,43,0,499,56,140,.400,31,80,.388,25,60,.417,.511,21,25,.840,17,44,61,30,15,4,14,35,164,2005
Steve Francis,PG,27,ORL,78,78,2978,563,1330,.423,38,127,.299,525,1203,.436,.438,499,606,.823,126,324,450,547,112,28,317,273,1663,2005
Matt Freije,PF,23,NOH,23,11,441,37,127,.291,14,54,.259,23,73,.315,.346,5,8,.625,16,45,61,20,13,2,17,40,93,2005
Lawrence Funderburke,PF,34,CHI,2,0,21,3,6,.500,0,0,.000,3,6,.500,.500,3,5,.600,1,2,3,0,0,0,0,2,9,2005
Dan Gadzuric,C,26,MIL,81,81,1783,243,451,.539,0,0,.000,243,451,.539,.539,107,199,.538,261,413,674,30,47,106,81,224,593,2005
Reece Gaines,PG,24,TOT,21,0,187,17,50,.340,4,14,.286,13,36,.361,.380,3,4,.750,1,13,14,7,5,1,7,17,41,2005
Reece Gaines,PG,24,HOU,10,0,108,10,27,.370,3,12,.250,7,15,.467,.426,3,4,.750,0,11,11,3,3,0,4,12,26,2005
Reece Gaines,PG,24,MIL,11,0,79,7,23,.304,1,2,.500,6,21,.286,.326,0,0,.000,1,2,3,4,2,1,3,5,15,2005
Alex Garcia,SG,24,NOH,8,3,146,18,52,.346,5,18,.278,13,34,.382,.394,3,4,.750,7,8,15,18,4,1,8,15,44,2005
Kevin Garnett,PF,28,MIN,82,82,3121,683,1360,.502,6,25,.240,677,1335,.507,.504,445,549,.811,247,861,1108,466,121,112,222,207,1817,2005
Pat Garrity,PF,28,ORL,71,0,955,123,306,.402,49,147,.333,74,159,.465,.482,29,33,.879,21,103,124,30,19,9,30,107,324,2005
Pau Gasol,PF,24,MEM,56,53,1790,357,695,.514,1,6,.167,356,689,.517,.514,282,367,.768,130,280,410,135,37,93,137,146,997,2005
Devean George,SF,27,LAL,15,3,306,37,104,.356,21,58,.362,16,46,.348,.457,15,20,.750,13,40,53,14,8,2,12,32,110,2005
Eddie Gill,PG,26,IND,73,3,1021,81,242,.335,36,117,.308,45,125,.360,.409,71,81,.877,16,96,112,83,59,5,60,105,269,2005
Kendall Gill,SG,36,MIL,14,0,284,32,80,.400,3,9,.333,29,71,.408,.419,18,20,.900,11,26,37,27,14,4,9,37,85,2005
Manu Ginobili,SG,27,SAS,74,74,2193,367,780,.471,97,258,.376,270,522,.517,.533,355,442,.803,75,254,329,288,119,27,172,190,1186,2005
Gordan Giricek,SG,27,UTA,81,44,1660,283,632,.448,38,105,.362,245,527,.465,.478,111,137,.810,25,157,182,137,46,11,90,155,715,2005
Dion Glover,SG,26,SAS,7,0,68,8,22,.364,1,8,.125,7,14,.500,.386,8,10,.800,3,8,11,4,3,3,2,9,25,2005
Anthony Goldwire,PG,33,TOT,33,2,537,57,136,.419,32,80,.400,25,56,.446,.537,26,31,.839,10,49,59,78,15,0,15,32,172,2005
Anthony Goldwire,PG,33,DET,9,0,55,4,15,.267,3,9,.333,1,6,.167,.367,7,8,.875,1,7,8,0,0,0,1,5,18,2005
Anthony Goldwire,PG,33,MIL,24,2,482,53,121,.438,29,71,.408,24,50,.480,.558,19,23,.826,9,42,51,78,15,0,14,27,154,2005
Drew Gooden,PF,23,CLE,82,80,2523,464,943,.492,5,28,.179,459,915,.502,.495,251,310,.810,207,546,753,130,77,76,133,233,1184,2005
Ben Gordon,SG,21,CHI,82,3,2002,434,1056,.411,134,331,.405,300,725,.414,.474,233,270,.863,55,160,215,164,53,10,186,224,1235,2005
Brian Grant,C,32,LAL,69,8,1136,103,209,.493,0,0,.000,103,209,.493,.493,57,79,.722,101,156,257,34,23,23,43,175,263,2005
Willie Green,SG,23,PHI,57,21,1066,155,423,.366,30,105,.286,125,318,.393,.402,97,125,.776,22,111,133,100,34,6,75,121,437,2005
Adrian Griffin,SF,30,CHI,69,1,667,58,161,.360,2,9,.222,56,152,.368,.366,33,44,.750,52,94,146,53,43,4,30,78,151,2005
Eddie Griffin,PF,22,MIN,70,0,1492,202,522,.387,67,204,.328,135,318,.425,.451,56,78,.718,128,325,453,53,23,118,55,120,527,2005
Tom Gugliotta,PF,35,TOT,47,9,966,99,241,.411,8,26,.308,91,215,.423,.427,33,43,.767,56,135,191,68,41,17,57,104,239,2005
Tom Gugliotta,PF,35,BOS,20,0,218,11,37,.297,0,0,.000,11,37,.297,.297,4,6,.667,15,28,43,12,9,4,9,23,26,2005
Tom Gugliotta,PF,35,ATL,27,9,748,88,204,.431,8,26,.308,80,178,.449,.451,29,37,.784,41,107,148,56,32,13,48,81,213,2005
Marcus Haislip,PF,24,IND,9,0,106,13,38,.342,0,1,.000,13,37,.351,.342,6,11,.545,5,10,15,3,2,2,6,15,32,2005
Darvin Ham,SF,31,DET,47,0,275,17,37,.459,0,0,.000,17,37,.459,.459,12,31,.387,19,16,35,5,6,7,8,39,46,2005
Richard Hamilton,SG,26,DET,76,76,2926,510,1160,.440,36,118,.305,474,1042,.455,.455,368,429,.858,74,221,295,372,77,13,217,232,1424,2005
Zendon Hamilton,C,29,MIL,16,0,159,11,32,.344,0,0,.000,11,32,.344,.344,29,48,.604,18,24,42,6,5,2,12,26,51,2005
Ben Handlogten,C,31,UTA,21,5,297,43,83,.518,0,1,.000,43,82,.524,.518,9,17,.529,23,42,65,13,7,5,18,55,95,2005
Anfernee Hardaway,SF,33,NYK,37,0,894,110,260,.423,15,50,.300,95,210,.452,.452,34,46,.739,19,70,89,74,28,3,50,79,269,2005
Matt Harpring,SF,28,UTA,78,55,2584,418,855,.489,9,43,.209,409,812,.504,.494,245,315,.778,196,284,480,142,70,16,133,250,1090,2005
Al Harrington,SF,24,ATL,66,66,2550,453,986,.459,16,74,.216,437,912,.479,.468,236,351,.672,145,316,461,208,85,16,204,249,1158,2005
Junior Harrington,SG,24,NOH,29,7,550,64,178,.360,6,19,.316,58,159,.365,.376,29,35,.829,13,50,63,62,25,5,41,72,163,2005
Othella Harrington,PF,31,CHI,70,28,1271,217,424,.512,0,0,.000,217,424,.512,.512,127,177,.718,106,186,292,56,24,18,84,188,561,2005
Devin Harris,PG,21,DAL,76,19,1173,157,366,.429,44,131,.336,113,235,.481,.489,78,103,.757,28,74,102,169,77,19,82,139,436,2005
Lucious Harris,SG,34,CLE,73,4,1128,118,299,.395,21,65,.323,97,234,.415,.430,56,69,.812,39,82,121,49,27,6,29,68,313,2005
David Harrison,C,22,IND,43,14,760,106,184,.576,0,0,.000,106,184,.576,.576,52,91,.571,48,87,135,13,16,55,53,134,264,2005
Jason Hart,PG,26,CHA,74,27,1887,257,573,.449,35,95,.368,222,478,.464,.479,157,200,.785,18,185,203,367,99,14,102,167,706,2005
Donnell Harvey,PF,24,NJN,3,0,16,2,2,1.000,0,0,.000,2,2,1.000,1.000,4,4,1.000,2,5,7,1,1,1,1,2,8,2005
Udonis Haslem,PF,24,MIA,80,80,2675,346,641,.540,0,4,.000,346,637,.543,.540,178,225,.791,239,487,726,108,63,41,113,260,870,2005
Trenton Hassell,SG,25,MIN,82,51,2068,225,475,.474,1,11,.091,224,464,.483,.475,90,114,.789,80,139,219,128,30,30,64,200,541,2005
Jarvis Hayes,SF,23,WAS,54,22,1560,206,530,.389,42,123,.341,164,407,.403,.428,99,118,.839,41,186,227,90,49,9,62,107,553,2005
Brendan Haywood,C,25,WAS,68,68,1865,239,427,.560,0,0,.000,239,427,.560,.560,159,261,.609,202,262,464,57,52,114,96,218,637,2005
Alan Henderson,PF,32,DAL,78,10,1203,116,220,.527,0,2,.000,116,218,.532,.527,41,76,.539,164,184,348,21,29,37,49,149,273,2005
Nene Hilario,C,22,DEN,55,18,1317,194,386,.503,0,2,.000,194,384,.505,.503,140,212,.660,104,221,325,84,50,48,94,167,528,2005
Grant Hill,SF,32,ORL,67,67,2338,517,1015,.509,3,13,.231,514,1002,.513,.511,280,341,.821,77,241,318,220,97,28,161,144,1317,2005
Kirk Hinrich,PG,24,CHI,77,77,2800,445,1122,.397,145,408,.355,300,714,.420,.461,171,216,.792,32,272,304,494,122,21,176,244,1206,2005
Fred Hoiberg,SG,32,MIN,76,0,1272,139,284,.489,70,145,.483,69,139,.496,.613,89,102,.873,32,149,181,85,50,15,20,105,437,2005
Robert Horry,PF,34,SAS,75,16,1396,157,375,.419,51,138,.370,106,237,.447,.487,86,109,.789,91,177,268,80,67,60,69,138,451,2005
Eddie House,PG-SG,26,TOT,68,7,891,165,366,.451,44,97,.454,121,269,.450,.511,23,27,.852,16,67,83,96,44,6,35,65,397,2005
Eddie House,SG,26,CHA,13,5,300,61,135,.452,12,29,.414,49,106,.462,.496,10,13,.769,2,17,19,24,24,3,13,23,144,2005
Eddie House,SG,26,MIL,5,0,41,6,17,.353,4,6,.667,2,11,.182,.471,0,0,.000,0,3,3,5,2,0,0,3,16,2005
Eddie House,PG,26,SAC,50,2,550,98,214,.458,28,62,.452,70,152,.461,.523,13,14,.929,14,47,61,67,18,3,22,39,237,2005
Allan Houston,SG,33,NYK,20,11,532,85,205,.415,31,80,.388,54,125,.432,.490,36,43,.837,4,19,23,42,8,2,21,40,237,2005
Dwight Howard,PF,19,ORL,82,82,2670,352,677,.520,0,2,.000,352,675,.521,.520,277,413,.671,287,536,823,75,77,136,165,232,981,2005
Josh Howard,SF,24,DAL,76,76,2446,377,793,.475,34,115,.296,343,678,.506,.497,170,232,.733,169,315,484,109,116,49,122,211,958,2005
Juwan Howard,PF,31,HOU,61,47,1624,244,541,.451,0,1,.000,244,540,.452,.451,97,115,.843,126,220,346,94,32,5,79,143,585,2005
Troy Hudson,PG,28,MIN,79,32,1729,266,664,.401,89,258,.345,177,406,.436,.468,70,90,.778,19,86,105,283,27,6,113,121,691,2005
Larry Hughes,SG,26,WAS,61,61,2358,467,1086,.430,59,209,.282,408,877,.465,.457,352,453,.777,74,308,382,285,176,18,153,168,1345,2005
Ryan Humphrey,SF,25,MEM,35,0,317,42,103,.408,0,2,.000,42,101,.416,.408,18,37,.486,50,37,87,6,10,1,23,35,102,2005
Kris Humphries,PF,19,UTA,67,4,873,116,287,.404,2,6,.333,114,281,.406,.408,44,101,.436,73,124,197,43,25,18,52,96,278,2005
Brandon Hunter,PF,24,ORL,31,0,224,37,73,.507,0,0,.000,37,73,.507,.507,21,39,.538,25,44,69,3,4,7,22,42,95,2005
Lindsey Hunter,SG,34,DET,76,3,1144,108,302,.358,23,84,.274,85,218,.390,.396,46,58,.793,38,85,123,130,68,13,68,125,285,2005
Steven Hunter,C,23,PHO,76,3,1046,135,220,.614,0,1,.000,135,219,.616,.614,78,163,.479,98,129,227,13,4,102,44,131,348,2005
Andre Iguodala,SG,21,PHI,82,82,2686,269,546,.493,47,142,.331,222,404,.550,.536,156,210,.743,89,375,464,246,138,48,139,204,741,2005
Zydrunas Ilgauskas,C,29,CLE,78,78,2615,458,979,.468,2,7,.286,456,972,.469,.469,402,503,.799,299,373,672,100,53,165,191,313,1320,2005
Didier Ilunga-Mbenga,C,24,DAL,15,1,58,6,14,.429,0,0,.000,6,14,.429,.429,3,4,.750,3,5,8,0,0,5,5,13,15,2005
Allen Iverson,PG,29,PHI,75,75,3174,771,1818,.424,104,338,.308,667,1480,.451,.453,656,786,.835,51,248,299,596,180,9,344,140,2302,2005
Royal Ivey,PG,23,ATL,62,5,809,85,198,.429,3,9,.333,82,189,.434,.437,47,67,.701,19,65,84,103,39,7,58,140,220,2005
Bobby Jackson,SG,31,SAC,25,0,536,109,255,.427,33,96,.344,76,159,.478,.492,50,58,.862,23,62,85,59,14,2,28,58,301,2005
Jermaine Jackson,SG,28,NYK,21,0,230,17,33,.515,0,2,.000,17,31,.548,.515,8,13,.615,3,20,23,24,7,1,10,26,42,2005
Jim Jackson,SF,34,TOT,64,27,1987,248,582,.426,122,295,.414,126,287,.439,.531,54,58,.931,33,236,269,183,35,5,115,153,672,2005
Jim Jackson,SF,34,HOU,24,24,990,118,283,.417,54,147,.367,64,136,.471,.512,30,33,.909,10,105,115,86,23,1,56,67,320,2005
Jim Jackson,SF,34,PHO,40,3,997,130,299,.435,68,148,.459,62,151,.411,.548,24,25,.960,23,131,154,97,12,4,59,86,352,2005
Luke Jackson,SF,23,CLE,10,0,43,10,27,.370,4,6,.667,6,21,.286,.444,5,6,.833,2,4,6,3,0,0,2,4,29,2005
Marc Jackson,C,30,PHI,81,23,1976,340,731,.465,0,2,.000,340,729,.466,.465,289,349,.828,184,222,406,81,32,18,131,171,969,2005
Stephen Jackson,SF,26,IND,51,49,1806,330,819,.403,103,286,.360,227,533,.426,.466,190,229,.830,44,206,250,119,64,14,123,154,953,2005
Casey Jacobsen,SG-SF,23,TOT,84,1,1798,165,408,.404,66,177,.373,99,231,.429,.485,151,192,.786,35,132,167,113,33,8,71,104,547,2005
Casey Jacobsen,SF,23,PHO,40,0,768,65,157,.414,34,89,.382,31,68,.456,.522,48,62,.774,17,50,67,37,11,1,27,56,212,2005
Casey Jacobsen,SG,23,NOH,44,1,1030,100,251,.398,32,88,.364,68,163,.417,.462,103,130,.792,18,82,100,76,22,7,44,48,335,2005
Jerome James,C,29,SEA,80,80,1330,174,342,.509,0,2,.000,174,340,.512,.509,47,65,.723,81,160,241,19,23,111,88,279,395,2005
LeBron James,SF,20,CLE,80,80,3388,795,1684,.472,108,308,.351,687,1376,.499,.504,477,636,.750,111,477,588,577,177,52,262,146,2175,2005
Mike James,PG,29,TOT,74,5,1859,331,751,.441,100,259,.386,231,492,.470,.507,109,145,.752,35,173,208,263,65,6,106,174,871,2005
Mike James,PG,29,MIL,47,0,1167,205,460,.446,58,152,.382,147,308,.477,.509,67,90,.744,23,99,122,185,40,4,80,114,535,2005
Mike James,PG,29,HOU,27,5,692,126,291,.433,42,107,.393,84,184,.457,.505,42,55,.764,12,74,86,78,25,2,26,60,336,2005
Antawn Jamison,PF,28,WAS,68,68,2605,519,1189,.437,71,208,.341,448,981,.457,.466,225,296,.760,160,359,519,154,55,16,118,151,1334,2005
Marko Jaric,PG,26,LAC,50,41,1656,189,457,.414,56,151,.371,133,306,.435,.475,59,82,.720,20,141,161,303,84,17,98,107,493,2005
Al Jefferson,PF,20,BOS,71,1,1051,195,369,.528,0,3,.000,195,366,.533,.528,85,135,.630,119,193,312,24,22,55,66,195,475,2005
Richard Jefferson,SF,24,NJN,33,33,1355,238,564,.422,30,89,.337,208,475,.438,.449,227,269,.844,49,191,240,133,33,17,132,109,733,2005
Jared Jeffries,SF,23,WAS,77,71,2007,203,434,.468,16,51,.314,187,383,.488,.486,101,173,.584,152,222,374,151,66,35,114,206,523,2005
Horace Jenkins,PG,30,DET,15,0,104,15,45,.333,0,9,.000,15,36,.417,.333,12,13,.923,3,6,9,9,5,1,7,6,42,2005
Britton Johnsen,SF,25,IND,6,1,87,6,22,.273,0,4,.000,6,18,.333,.273,0,0,.000,5,5,10,4,1,0,3,10,12,2005
Anthony Johnson,PG,30,IND,63,36,1747,203,456,.445,41,108,.380,162,348,.466,.490,85,113,.752,32,147,179,302,59,15,96,144,532,2005
DerMarr Johnson,SG,24,DEN,71,40,1232,185,371,.499,53,148,.358,132,223,.592,.570,80,101,.792,43,108,151,75,43,18,65,140,503,2005
Ervin Johnson,C,37,MIN,46,23,410,28,54,.519,1,1,1.000,27,53,.509,.528,16,25,.640,43,70,113,6,7,13,18,86,73,2005
Joe Johnson,SF,23,PHO,82,82,3240,544,1179,.461,177,370,.478,367,809,.454,.536,135,180,.750,120,302,422,291,79,24,148,167,1400,2005
Linton Johnson,SF,24,SAS,2,0,15,0,2,.000,0,1,.000,0,1,.000,.000,0,0,.000,0,3,3,0,1,0,1,1,0,2005
Dahntay Jones,SG,24,MEM,52,7,649,83,190,.437,23,60,.383,60,130,.462,.497,44,64,.688,11,58,69,21,13,11,29,81,233,2005
Damon Jones,PG,28,MIA,82,66,2576,331,726,.456,225,521,.432,106,205,.517,.611,68,86,.791,14,217,231,350,44,5,98,121,955,2005
Eddie Jones,SF,33,MIA,80,80,2839,351,820,.428,142,382,.372,209,438,.477,.515,174,216,.806,38,367,405,212,86,38,99,251,1018,2005
Fred Jones,SG,25,IND,77,14,2268,275,647,.425,87,229,.380,188,418,.450,.492,176,207,.850,34,208,242,196,61,31,114,171,813,2005
James Jones,SF,24,IND,75,24,1330,126,318,.396,66,166,.398,60,152,.395,.500,53,62,.855,39,135,174,57,31,28,43,123,371,2005
Jumaine Jones,SF,25,LAL,76,23,1830,210,486,.432,102,261,.391,108,225,.480,.537,55,75,.733,107,291,398,65,44,24,49,165,577,2005
Mark Jones,SF,29,ORL,10,0,116,9,31,.290,0,4,.000,9,27,.333,.290,5,10,.500,6,7,13,6,5,2,3,16,23,2005
Chris Kaman,C,22,LAC,63,50,1632,246,495,.497,0,1,.000,246,494,.498,.497,80,121,.661,135,288,423,73,26,68,115,182,572,2005
Jason Kapono,SF,23,CHA,81,14,1491,269,671,.401,80,194,.412,189,477,.396,.461,70,85,.824,32,132,164,61,40,6,46,132,688,2005
Mario Kasun,C,24,ORL,45,0,356,47,98,.480,0,1,.000,47,97,.485,.480,24,43,.558,52,76,128,8,8,13,26,86,118,2005
Viktor Khryapa,SF,22,POR,32,5,523,54,124,.435,4,11,.364,50,113,.442,.452,23,42,.548,28,80,108,25,20,18,33,80,135,2005
Jason Kidd,PG,31,NJN,66,65,2435,340,855,.398,129,358,.360,211,497,.425,.473,142,192,.740,94,394,488,545,123,9,167,110,951,2005
Andrei Kirilenko,PF,23,UTA,41,37,1349,207,420,.493,23,77,.299,184,343,.536,.520,203,259,.784,89,166,255,132,67,136,90,101,640,2005
Kerry Kittles,SG,30,LAC,11,0,243,28,73,.384,7,21,.333,21,52,.404,.432,6,10,.600,1,31,32,20,8,3,7,12,69,2005
Brandin Knight,PG,23,HOU,1,0,3,0,1,.000,0,0,.000,0,1,.000,.000,0,0,.000,0,0,0,1,0,0,0,0,0,2005
Brevin Knight,PG,29,CHA,66,61,1944,248,587,.422,3,20,.150,245,567,.432,.425,167,196,.852,21,149,170,591,131,5,147,192,666,2005
Kyle Korver,SF,23,PHI,82,57,2667,317,759,.418,226,558,.405,91,201,.453,.567,82,96,.854,40,339,379,182,103,33,106,265,942,2005
Nenad Krstic,PF,21,NJN,75,57,1965,281,570,.493,0,2,.000,281,568,.495,.493,185,255,.725,161,240,401,77,32,63,112,280,747,2005
Toni Kukoc,SF,36,MIL,53,6,1099,105,256,.410,42,116,.362,63,140,.450,.492,44,61,.721,31,129,160,160,39,13,64,70,296,2005
Ibo Kutluay,SG,30,SEA,5,0,12,0,1,.000,0,0,.000,0,1,.000,.000,0,0,.000,0,1,1,0,0,0,2,1,0,2005
Christian Laettner,PF,35,MIA,49,0,739,107,184,.582,1,7,.143,106,177,.599,.584,45,59,.763,36,95,131,41,32,15,29,78,260,2005
Raef LaFrentz,PF,28,BOS,80,80,2196,341,688,.496,82,225,.364,259,463,.559,.555,120,148,.811,154,399,553,98,42,99,70,262,884,2005
Maciej Lampe,C,19,TOT,37,0,380,49,132,.371,2,4,.500,47,128,.367,.379,15,22,.682,24,65,89,11,5,7,17,51,115,2005
Maciej Lampe,C,19,PHO,16,0,119,17,49,.347,2,3,.667,15,46,.326,.367,8,12,.667,9,23,32,1,1,2,10,20,44,2005
Maciej Lampe,C,19,NOH,21,0,261,32,83,.386,0,1,.000,32,82,.390,.386,7,10,.700,15,42,57,10,4,5,7,31,71,2005
Voshon Lenard,SG,31,DEN,3,1,54,10,26,.385,4,12,.333,6,14,.429,.462,5,8,.625,0,6,6,6,1,0,2,2,29,2005
Rashard Lewis,SF,25,SEA,71,71,2697,532,1151,.462,173,432,.400,359,719,.499,.537,220,283,.777,110,278,388,94,75,62,123,158,1457,2005
Randy Livingston,PG,29,UTA,17,4,227,22,52,.423,5,8,.625,17,44,.386,.471,15,17,.882,3,9,12,45,12,2,14,28,64,2005
Shaun Livingston,PG,19,LAC,30,15,814,89,215,.414,0,2,.000,89,213,.418,.414,44,59,.746,22,67,89,151,32,11,75,82,222,2005
Raul Lopez,PG,24,UTA,31,15,518,57,135,.422,20,45,.444,37,90,.411,.496,27,33,.818,7,32,39,123,22,3,47,78,161,2005
Tyronn Lue,PG,27,TOT,70,49,2007,295,654,.451,55,155,.355,240,499,.481,.493,142,165,.861,14,135,149,322,33,0,105,168,787,2005
Tyronn Lue,PG,27,HOU,21,3,479,48,122,.393,15,45,.333,33,77,.429,.455,14,18,.778,0,40,40,58,8,0,24,48,125,2005
Tyronn Lue,PG,27,ATL,49,46,1528,247,532,.464,40,110,.364,207,422,.491,.502,128,147,.871,14,95,109,264,25,0,81,120,662,2005
George Lynch,SF,34,NOH,44,27,933,68,189,.360,11,37,.297,57,152,.375,.389,17,23,.739,55,119,174,88,32,12,57,83,164,2005
Mark Madsen,C,29,MIN,41,14,601,34,66,.515,0,0,.000,34,66,.515,.515,20,40,.500,63,65,128,18,7,14,24,103,88,2005
Corey Maggette,SG,25,LAC,66,60,2436,425,986,.431,51,168,.304,374,818,.457,.457,563,657,.857,70,324,394,225,70,8,195,191,1464,2005
Jamaal Magloire,C,26,NOH,23,22,703,98,227,.432,0,0,.000,98,227,.432,.432,74,123,.602,79,126,205,29,8,23,59,74,270,2005
Stephon Marbury,PG,27,NYK,82,82,3281,604,1308,.462,115,325,.354,489,983,.497,.506,458,549,.834,50,198,248,668,122,6,233,186,1781,2005
Shawn Marion,PF,26,PHO,81,81,3146,613,1289,.476,114,341,.334,499,948,.526,.520,229,275,.833,235,680,915,154,163,119,125,199,1569,2005
Sean Marks,PF,29,SAS,23,0,244,27,80,.338,0,3,.000,27,77,.351,.338,22,28,.786,18,38,56,8,3,11,14,29,76,2005
Donyell Marshall,PF,31,TOR,65,2,1645,262,592,.443,151,363,.416,111,229,.485,.570,72,91,.791,95,333,428,81,57,46,42,136,747,2005
Darrick Martin,PG,33,LAC,11,0,190,16,50,.320,5,18,.278,11,32,.344,.370,5,8,.625,3,7,10,28,6,0,6,19,42,2005
Kenyon Martin,PF,27,DEN,70,67,2272,444,907,.490,0,12,.000,444,895,.496,.490,199,308,.646,146,365,511,170,100,78,149,228,1087,2005
Kevin Martin,PG,21,SAC,45,0,455,45,117,.385,5,25,.200,40,92,.435,.406,36,55,.655,29,29,58,22,16,3,24,35,131,2005
Desmond Mason,SF,27,MIL,80,71,2893,478,1079,.443,1,8,.125,477,1071,.445,.443,420,524,.802,85,227,312,217,58,27,164,198,1377,2005
Tony Massenburg,PF,37,SAS,61,6,699,74,182,.407,0,0,.000,74,182,.407,.407,48,63,.762,54,109,163,14,18,20,40,122,196,2005
Walter McCarty,PF,30,TOT,72,0,906,95,235,.404,55,155,.355,40,80,.500,.521,15,29,.517,29,109,138,37,25,15,36,144,260,2005
Walter McCarty,PF,30,BOS,44,0,553,62,150,.413,30,90,.333,32,60,.533,.513,8,15,.533,21,56,77,26,15,9,17,85,162,2005
Walter McCarty,PF,30,PHO,28,0,353,33,85,.388,25,65,.385,8,20,.400,.535,7,14,.500,8,53,61,11,10,6,19,59,98,2005
Jelani McCoy,C,27,ATL,10,0,88,7,13,.538,0,0,.000,7,13,.538,.538,1,5,.200,7,14,21,0,3,8,6,24,15,2005
Antonio McDyess,PF,30,DET,77,8,1797,307,598,.513,0,1,.000,307,597,.514,.513,126,192,.656,177,305,482,71,46,52,93,204,740,2005
Tracy McGrady,SF,25,HOU,78,78,3182,715,1660,.431,142,435,.326,573,1225,.468,.473,431,557,.774,71,413,484,448,135,52,201,167,2003,2005
Jeff McInnis,PG,30,CLE,76,69,2651,377,915,.412,91,264,.345,286,651,.439,.462,130,160,.813,32,125,157,391,56,1,117,177,975,2005
Aaron McKie,SG,32,PHI,68,3,1118,61,142,.430,20,62,.323,41,80,.513,.500,10,16,.625,20,152,172,103,48,17,31,116,152,2005
Keith McLeod,PG,25,UTA,53,47,1382,143,408,.350,18,72,.250,125,336,.372,.373,112,146,.767,20,93,113,236,63,12,99,138,416,2005
Stanislav Medvedenko,PF,25,LAL,43,4,423,71,156,.455,0,1,.000,71,155,.458,.455,23,28,.821,31,48,79,13,9,2,13,64,165,2005
Ron Mercer,SF,28,NJN,18,3,390,65,158,.411,0,3,.000,65,155,.419,.411,7,10,.700,9,31,40,20,16,2,14,20,137,2005
Chris Mihm,C,25,LAL,75,75,1870,280,552,.507,0,2,.000,280,550,.509,.507,175,258,.678,197,305,502,50,14,108,110,237,735,2005
Darius Miles,SF,23,POR,63,22,1699,336,697,.482,8,23,.348,328,674,.487,.488,129,215,.600,71,228,299,129,75,78,157,189,809,2005
Darko Milicic,C,19,DET,37,2,254,25,76,.329,0,0,.000,25,76,.329,.329,17,24,.708,3,40,43,7,2,17,16,31,67,2005
Andre Miller,PG,28,DEN,82,82,2852,427,895,.477,6,39,.154,421,856,.492,.480,253,302,.838,100,238,338,569,121,8,220,204,1113,2005
Anthony Miller,PF,33,ATL,2,0,9,2,3,.667,0,0,.000,2,3,.667,.667,0,0,.000,0,1,1,1,1,0,1,2,4,2005
Brad Miller,C,28,SAC,56,56,2089,319,609,.524,5,19,.263,314,590,.532,.528,233,287,.812,139,382,521,220,69,68,82,181,876,2005
Mike Miller,SF,24,MEM,76,51,2278,387,766,.505,140,323,.433,247,443,.558,.597,108,150,.720,36,264,300,220,54,23,127,197,1022,2005
Reggie Miller,SG,39,IND,66,66,2105,314,719,.437,96,298,.322,218,421,.518,.503,250,268,.933,18,138,156,146,50,5,77,109,974,2005
Yao Ming,C,24,HOU,80,80,2447,538,975,.552,0,0,.000,538,975,.552,.552,389,497,.783,208,461,669,61,34,160,196,298,1465,2005
Cuttino Mobley,SG,29,TOT,66,64,2388,408,932,.438,150,342,.439,258,590,.437,.518,168,205,.820,45,184,229,188,74,30,133,152,1134,2005
Cuttino Mobley,SG,29,ORL,23,21,726,128,296,.432,58,125,.464,70,171,.409,.530,55,69,.797,11,52,63,42,23,9,41,49,369,2005
Cuttino Mobley,SG,29,SAC,43,43,1662,280,636,.440,92,217,.424,188,419,.449,.513,113,136,.831,34,132,166,146,51,21,92,103,765,2005
Nazr Mohammed,C,27,TOT,77,59,1933,289,602,.480,0,1,.000,289,601,.481,.480,153,227,.674,247,339,586,34,58,86,108,236,731,2005
Nazr Mohammed,C,27,NYK,54,54,1519,234,460,.509,0,1,.000,234,459,.510,.509,121,171,.708,169,270,439,26,53,53,81,172,589,2005
Nazr Mohammed,C,27,SAS,23,5,414,55,142,.387,0,0,.000,55,142,.387,.387,32,56,.571,78,69,147,8,5,33,27,64,142,2005
Jerome Moiso,C-PF,26,TOT,20,1,120,9,18,.500,0,1,.000,9,17,.529,.500,10,13,.769,10,27,37,1,3,6,7,13,28,2005
Jerome Moiso,C,26,TOR,8,1,69,3,9,.333,0,1,.000,3,8,.375,.333,8,9,.889,6,17,23,0,2,3,6,7,14,2005
Jerome Moiso,C,26,NJN,8,0,24,3,4,.750,0,0,.000,3,4,.750,.750,2,4,.500,3,4,7,0,0,1,1,2,8,2005
Jerome Moiso,PF,26,CLE,4,0,27,3,5,.600,0,0,.000,3,5,.600,.600,0,0,.000,1,6,7,1,1,2,0,4,6,2005
Mikki Moore,PF,29,LAC,74,4,1178,144,287,.502,1,5,.200,143,282,.507,.503,107,136,.787,97,149,246,47,19,32,63,173,396,2005
Alonzo Mourning,C-PF,34,TOT,37,17,702,100,212,.472,0,0,.000,100,212,.472,.472,82,141,.582,53,145,198,18,8,74,57,82,282,2005
Alonzo Mourning,PF,34,NJN,18,14,457,68,150,.453,0,0,.000,68,150,.453,.453,51,86,.593,31,96,127,14,5,41,45,50,187,2005
Alonzo Mourning,C,34,MIA,19,3,245,32,62,.516,0,0,.000,32,62,.516,.516,31,55,.564,22,49,71,4,3,33,12,32,95,2005
Troy Murphy,PF,24,GSW,70,69,2375,392,947,.414,59,148,.399,333,799,.417,.445,233,319,.730,251,505,756,97,53,33,108,190,1076,2005
Lamond Murray,SF,31,TOR,62,1,918,132,310,.426,46,105,.438,86,205,.420,.500,61,80,.763,44,120,164,47,32,16,54,85,371,2005
Ronald Murray,SG,25,SEA,49,6,883,131,363,.361,24,95,.253,107,268,.399,.394,59,80,.738,15,83,98,65,30,11,57,59,345,2005
Dikembe Mutombo,C,38,HOU,80,2,1212,108,217,.498,0,0,.000,108,217,.498,.498,106,143,.741,150,276,426,10,16,101,51,135,322,2005
Mamadou N'Diaye,C,29,LAC,11,0,72,8,20,.400,0,1,.000,8,19,.421,.400,4,7,.571,9,9,18,1,1,5,0,20,20,2005
Bostjan Nachbar,PF-SF,24,TOT,71,6,1341,161,411,.392,75,196,.383,86,215,.400,.483,97,117,.829,24,158,182,74,29,16,73,183,494,2005
Bostjan Nachbar,SF,24,HOU,16,2,204,15,43,.349,10,21,.476,5,22,.227,.465,9,12,.750,4,26,30,9,1,0,5,30,49,2005
Bostjan Nachbar,PF,24,NOH,55,4,1137,146,368,.397,65,175,.371,81,193,.420,.485,88,105,.838,20,132,152,65,28,16,68,153,445,2005
Lee Nailon,SF,29,NOH,68,51,2017,415,869,.478,0,2,.000,415,867,.479,.478,133,165,.806,128,170,298,109,36,16,110,190,963,2005
Eduardo Najera,PF,28,TOT,68,4,1185,145,322,.450,6,21,.286,139,301,.462,.460,58,91,.637,102,141,243,65,41,24,61,148,354,2005
Eduardo Najera,PF,28,GSW,42,4,610,70,172,.407,6,15,.400,64,157,.408,.424,29,45,.644,53,65,118,37,18,10,32,71,175,2005
Eduardo Najera,PF,28,DEN,26,0,575,75,150,.500,0,6,.000,75,144,.521,.500,29,46,.630,49,76,125,28,23,14,29,77,179,2005
Steve Nash,PG,30,PHO,75,75,2573,430,857,.502,94,218,.431,336,639,.526,.557,211,238,.887,57,192,249,861,74,6,245,136,1165,2005
Jameer Nelson,PG,22,ORL,79,21,1612,286,628,.455,44,141,.312,242,487,.497,.490,73,107,.682,52,141,193,237,78,3,117,199,689,2005
Rasho Nesterovic,C,28,SAS,70,70,1785,198,430,.460,0,0,.000,198,430,.460,.460,14,30,.467,184,275,459,71,31,117,73,207,410,2005
Ira Newble,SG,30,CLE,74,69,1832,182,424,.429,19,53,.358,163,371,.439,.452,55,69,.797,78,142,220,91,50,18,61,144,438,2005
Andres Nocioni,SF,25,CHI,81,38,1892,241,601,.401,25,97,.258,216,504,.429,.422,170,222,.766,69,317,386,122,37,34,135,208,677,2005
Moochie Norris,PG,31,TOT,38,0,360,35,109,.321,0,12,.000,35,97,.361,.321,20,24,.833,10,36,46,39,18,2,27,44,90,2005
Moochie Norris,PG,31,NYK,32,0,321,32,93,.344,0,12,.000,32,81,.395,.344,18,22,.818,9,33,42,34,17,2,25,42,82,2005
Moochie Norris,PG,31,HOU,6,0,39,3,16,.188,0,0,.000,3,16,.188,.188,2,2,1.000,1,3,4,5,1,0,2,2,8,2005
Dirk Nowitzki,PF,26,DAL,78,78,3020,663,1445,.459,91,228,.399,572,1217,.470,.490,615,708,.869,96,661,757,240,97,119,176,219,2032,2005
Jermaine O'Neal,PF,26,IND,44,41,1530,386,854,.452,1,6,.167,385,848,.454,.453,295,391,.754,85,303,388,82,25,88,131,173,1068,2005
Shaquille O'Neal,C,32,MIA,73,73,2492,658,1095,.601,0,0,.000,658,1095,.601,.601,353,765,.461,253,507,760,200,36,171,203,262,1669,2005
Lamar Odom,PF,25,LAL,64,64,2320,366,774,.473,36,117,.308,330,657,.502,.496,207,298,.695,134,519,653,238,42,65,161,211,975,2005
Emeka Okafor,PF,22,CHA,73,73,2600,448,1003,.447,0,1,.000,448,1002,.447,.447,209,343,.609,275,520,795,64,62,125,125,214,1105,2005
Mehmet Okur,C,25,UTA,82,25,2304,354,756,.468,17,63,.270,337,693,.486,.479,329,387,.850,194,422,616,166,32,68,141,227,1054,2005
Kevin Ollie,PG,32,PHI,26,0,158,11,31,.355,0,0,.000,11,31,.355,.355,6,9,.667,3,16,19,19,5,0,6,16,28,2005
Michael Olowokandi,C,29,MIN,62,34,1215,161,353,.456,0,0,.000,161,353,.456,.456,46,69,.667,106,218,324,29,15,56,68,193,368,2005
Greg Ostertag,C,31,SAC,56,3,556,37,84,.440,0,2,.000,37,82,.451,.440,13,38,.342,55,112,167,37,7,40,24,88,87,2005
Bo Outlaw,PF,33,PHO,39,0,214,12,34,.353,0,0,.000,12,34,.353,.353,5,9,.556,16,37,53,13,6,12,8,29,29,2005
Travis Outlaw,SF,20,POR,59,2,793,133,267,.498,4,10,.400,129,257,.502,.506,49,75,.653,40,81,121,35,30,40,39,77,319,2005
Zaza Pachulia,C,20,MIL,74,4,1397,160,354,.452,0,1,.000,160,353,.453,.452,138,185,.746,131,247,378,60,44,34,70,166,458,2005
Scott Padgett,PF,28,HOU,66,0,942,98,233,.421,50,126,.397,48,107,.449,.528,29,40,.725,47,138,185,55,33,10,30,119,275,2005
Milt Palacio,PG,26,TOR,80,4,1533,175,392,.446,2,12,.167,173,380,.455,.449,115,155,.742,26,108,134,279,48,13,104,126,467,2005
Jannero Pargo,PG,25,CHI,32,0,453,82,213,.385,23,66,.348,59,147,.401,.439,17,23,.739,12,35,47,76,16,1,45,53,204,2005
Smush Parker,PG,23,TOT,16,1,144,18,43,.419,3,13,.231,15,30,.500,.453,9,13,.692,4,8,12,15,5,0,19,16,48,2005
Smush Parker,PG,23,DET,11,1,110,11,28,.393,2,9,.222,9,19,.474,.429,9,13,.692,2,7,9,11,3,0,10,13,33,2005
Smush Parker,PG,23,PHO,5,0,34,7,15,.467,1,4,.250,6,11,.545,.500,0,0,.000,2,1,3,4,2,0,9,3,15,2005
Tony Parker,PG,22,SAS,80,80,2735,539,1118,.482,43,156,.276,496,962,.516,.501,210,323,.650,47,251,298,491,98,4,215,167,1331,2005
Ruben Patterson,SF,29,POR,70,36,1957,319,601,.531,2,25,.080,317,576,.550,.532,169,282,.599,126,147,273,138,106,21,143,164,809,2005
Sasha Pavlovic,SG,21,CLE,65,9,862,120,276,.435,30,78,.385,90,198,.455,.489,44,64,.688,15,56,71,49,29,4,47,121,314,2005
Gary Payton,PG,36,BOS,77,77,2541,339,725,.468,42,129,.326,297,596,.498,.497,153,201,.761,48,188,236,469,88,12,148,121,873,2005
Anthony Peeler,SG,35,WAS,40,0,529,56,150,.373,25,65,.385,31,85,.365,.457,16,18,.889,14,51,65,57,18,2,28,39,153,2005
Kirk Penney,SG,24,LAC,4,0,12,1,3,.333,0,1,.000,1,2,.500,.333,0,0,.000,0,1,1,1,0,0,2,0,2,2005
Kendrick Perkins,C,20,BOS,60,3,548,56,119,.471,0,0,.000,56,119,.471,.471,37,58,.638,53,123,176,21,9,37,43,98,149,2005
Wesley Person,SF,33,TOT,41,3,667,107,226,.473,41,89,.461,66,137,.482,.564,9,13,.692,3,80,83,39,19,4,17,30,264,2005
Wesley Person,SF,33,MIA,16,3,206,25,57,.439,8,21,.381,17,36,.472,.509,4,4,1.000,1,21,22,11,6,0,7,6,62,2005
Wesley Person,SF,33,DEN,25,0,461,82,169,.485,33,68,.485,49,101,.485,.583,5,9,.556,2,59,61,28,13,4,10,24,202,2005
Morris Peterson,SG,27,TOR,82,61,2510,356,848,.420,129,335,.385,227,513,.442,.496,188,226,.832,71,269,340,169,91,18,93,219,1029,2005
Eric Piatkowski,SG,34,CHI,68,11,841,111,258,.430,57,134,.425,54,124,.435,.541,45,56,.804,15,64,79,51,29,1,37,67,324,2005
Paul Pierce,SF,27,BOS,82,82,2960,556,1223,.455,108,292,.370,448,931,.481,.499,549,668,.822,78,461,539,348,133,39,230,255,1769,2005
Mickael Pietrus,SF,22,GSW,67,3,1340,214,501,.427,67,195,.344,147,306,.480,.494,141,202,.698,65,124,189,82,46,18,92,139,636,2005
Zoran Planinic,PG,22,NJN,43,8,515,78,174,.448,15,40,.375,63,134,.470,.491,46,66,.697,19,50,69,44,25,0,41,76,217,2005
Pavel Podkolzin,C,20,DAL,5,0,10,0,0,.000,0,0,.000,0,0,.000,.000,1,2,.500,0,2,2,0,0,0,2,4,1,2005
Scot Pollard,C,29,IND,49,17,865,79,167,.473,0,0,.000,79,167,.473,.473,33,49,.673,85,120,205,18,30,24,31,123,191,2005
Mark Pope,PF,32,DEN,9,0,27,2,6,.333,0,0,.000,2,6,.333,.333,0,0,.000,5,3,8,1,1,2,1,5,4,2005
James Posey,SF,28,MEM,50,18,1382,127,356,.357,55,178,.309,72,178,.404,.434,96,111,.865,45,174,219,88,48,23,69,134,405,2005
Vitaly Potapenko,C,29,SEA,33,1,335,45,87,.517,0,1,.000,45,86,.523,.517,27,31,.871,30,48,78,9,7,3,12,53,117,2005
Tayshaun Prince,SF,24,DET,82,82,3039,469,963,.487,47,138,.341,422,825,.512,.511,221,274,.807,133,302,435,247,56,71,135,161,1206,2005
Laron Profit,SF,27,WAS,42,4,428,56,128,.438,8,28,.286,48,100,.480,.469,16,25,.640,24,52,76,37,16,5,27,44,136,2005
Joel Przybilla,C,25,POR,76,50,1858,199,333,.598,0,0,.000,199,333,.598,.598,90,174,.517,178,410,588,74,24,163,98,239,488,2005
Vladimir Radmanovic,PF,24,SEA,63,0,1856,266,650,.409,128,329,.389,138,321,.430,.508,81,103,.786,52,237,289,86,57,31,80,172,741,2005
Aleksandar Radojevic,C,28,UTA,12,6,128,6,19,.316,0,0,.000,6,19,.316,.316,7,10,.700,9,19,28,6,0,2,15,32,19,2005
Peter John Ramos,C,19,WAS,6,0,20,5,10,.500,0,0,.000,5,10,.500,.500,1,2,.500,1,3,4,0,0,1,3,4,11,2005
Zach Randolph,PF,23,POR,46,37,1603,332,741,.448,0,6,.000,332,735,.452,.448,207,254,.815,142,300,442,86,34,17,112,112,871,2005
Theo Ratliff,C,31,POR,63,45,1731,115,257,.447,0,0,.000,115,257,.447,.447,74,107,.692,111,220,331,34,23,158,56,183,304,2005
Zeljko Rebraca,C,32,LAC,58,2,928,133,234,.568,0,0,.000,133,234,.568,.568,73,85,.859,49,135,184,26,13,40,49,130,339,2005
Michael Redd,SG,25,MIL,75,75,2848,625,1418,.441,104,293,.355,521,1125,.463,.477,369,432,.854,72,240,312,172,63,8,133,152,1723,2005
Justin Reed,SF,23,BOS,23,0,121,15,29,.517,0,3,.000,15,26,.577,.517,11,15,.733,8,8,16,10,3,1,5,12,41,2005
Jared Reiner,C,22,CHI,19,2,132,10,30,.333,0,0,.000,10,30,.333,.333,1,4,.250,13,25,38,1,3,7,9,35,21,2005
Jason Richardson,SG,24,GSW,72,72,2724,610,1368,.446,125,370,.338,485,998,.486,.492,214,309,.693,125,299,424,281,105,32,169,156,1559,2005
Quentin Richardson,SG,24,PHO,79,78,2839,407,1045,.389,226,631,.358,181,414,.437,.498,136,184,.739,91,388,479,158,96,27,102,197,1176,2005
Luke Ridnour,PG,23,SEA,82,82,2571,299,739,.405,67,178,.376,232,561,.414,.450,159,180,.883,55,149,204,483,94,23,149,185,824,2005
Bernard Robinson,SG,24,CHA,31,1,328,36,81,.444,3,8,.375,33,73,.452,.463,18,26,.692,14,34,48,30,11,4,20,42,93,2005
Clifford Robinson,C-PF,38,TOT,71,29,1689,202,523,.386,67,193,.347,135,330,.409,.450,62,97,.639,54,155,209,104,62,53,66,181,533,2005
Clifford Robinson,C,38,GSW,42,29,1090,141,354,.398,42,127,.331,99,227,.436,.458,35,58,.603,31,83,114,74,44,39,41,107,359,2005
Clifford Robinson,PF,38,NJN,29,0,599,61,169,.361,25,66,.379,36,103,.350,.435,27,39,.692,23,72,95,30,18,14,25,74,174,2005
Glenn Robinson,SF,32,SAS,9,0,157,34,77,.442,2,6,.333,32,71,.451,.455,20,23,.870,4,20,24,8,4,3,7,19,90,2005
Rodney Rogers,SF-PF,33,TOT,58,33,1367,172,450,.382,48,168,.286,124,282,.440,.436,52,70,.743,61,185,246,86,41,20,86,172,444,2005
Rodney Rogers,SF,33,NOH,30,26,882,109,289,.377,25,92,.272,84,197,.426,.420,32,42,.762,28,114,142,60,19,12,66,103,275,2005
Rodney Rogers,PF,33,PHI,28,7,485,63,161,.391,23,76,.303,40,85,.471,.463,20,28,.714,33,71,104,26,22,8,20,69,169,2005
Jalen Rose,SF,32,TOR,81,65,2710,527,1159,.455,108,274,.394,419,885,.473,.501,333,390,.854,44,232,276,209,63,10,180,190,1495,2005
Malik Rose,PF,30,TOT,76,5,1475,198,441,.449,1,10,.100,197,431,.457,.450,137,186,.737,129,212,341,59,46,16,102,208,534,2005
Malik Rose,PF,30,SAS,50,1,862,124,267,.464,0,4,.000,124,263,.471,.464,69,99,.697,95,132,227,41,31,9,56,124,317,2005
Malik Rose,PF,30,NYK,26,4,613,74,174,.425,1,6,.167,73,168,.435,.428,68,87,.782,34,80,114,18,15,7,46,84,217,2005
Quinton Ross,SG,23,LAC,78,19,1659,161,373,.432,1,4,.250,160,369,.434,.433,74,110,.673,59,151,210,109,51,22,54,165,397,2005
Michael Ruffin,C,28,WAS,79,7,1262,41,99,.414,0,1,.000,41,98,.418,.414,29,67,.433,157,175,332,64,43,41,44,193,111,2005
Kareem Rush,SG,24,TOT,48,22,968,157,406,.387,51,137,.372,106,269,.394,.450,37,48,.771,20,69,89,68,20,7,47,74,402,2005
Kareem Rush,SG,24,LAL,14,0,91,4,20,.200,2,10,.200,2,10,.200,.250,2,2,1.000,3,7,10,3,2,1,3,7,12,2005
Kareem Rush,SG,24,CHA,34,22,877,153,386,.396,49,127,.386,104,259,.402,.460,35,46,.761,17,62,79,65,18,6,44,67,390,2005
Bryon Russell,SF,34,DEN,70,2,1026,95,252,.377,56,149,.376,39,103,.379,.488,61,77,.792,50,122,172,72,44,11,35,130,307,2005
John Salmons,SG,25,PHI,58,8,993,85,210,.405,31,91,.341,54,119,.454,.479,35,48,.729,12,109,121,114,40,13,51,92,236,2005
Jamal Sampson,PF,21,CHA,23,0,329,28,62,.452,0,0,.000,28,62,.452,.452,23,39,.590,36,86,122,8,4,17,17,53,79,2005
Daniel Santiago,C,28,MIL,11,0,105,7,21,.333,0,0,.000,7,21,.333,.333,8,11,.727,6,13,19,1,3,4,4,28,22,2005
Brian Scalabrine,PF,26,NJN,54,14,1167,132,332,.398,22,68,.324,110,264,.417,.431,53,69,.768,83,161,244,88,34,18,66,111,339,2005
Ansu Sesay,SF,28,GSW,16,0,128,17,42,.405,2,8,.250,15,34,.441,.429,13,24,.542,18,20,38,12,2,3,8,16,49,2005
Ha Seung-Jin,C,19,POR,19,0,104,10,23,.435,0,0,.000,10,23,.435,.435,6,11,.545,6,12,18,2,1,5,12,21,26,2005
Paul Shirley,PF,27,PHO,9,0,30,5,11,.455,0,0,.000,5,11,.455,.455,2,4,.500,1,1,2,3,0,0,1,3,12,2005
Bobby Simmons,SF,24,LAC,75,74,2799,474,1017,.466,50,115,.435,424,902,.470,.491,231,273,.846,128,318,446,205,106,16,135,227,1229,2005
Brian Skinner,C-PF,28,TOT,49,23,941,104,205,.507,0,1,.000,104,204,.510,.507,25,70,.357,107,173,280,43,31,49,40,102,233,2005
Brian Skinner,PF,28,PHI,24,0,246,22,57,.386,0,1,.000,22,56,.393,.386,5,17,.294,23,39,62,5,5,6,13,29,49,2005
Brian Skinner,C,28,SAC,25,23,695,82,148,.554,0,0,.000,82,148,.554,.554,20,53,.377,84,134,218,38,26,43,27,73,184,2005
Tamar Slay,SG,24,CHA,8,0,78,13,39,.333,2,12,.167,11,27,.407,.359,0,2,.000,6,8,14,3,5,0,8,20,28,2005
Donta Smith,SG,21,ATL,38,0,433,44,113,.389,6,22,.273,38,91,.418,.416,33,48,.688,19,33,52,39,23,5,25,50,127,2005
J.R. Smith,SG,19,NOH,76,56,1859,295,748,.394,81,281,.288,214,467,.458,.449,111,161,.689,39,113,152,142,55,11,109,135,782,2005
Jabari Smith,PF,27,NJN,45,2,648,62,148,.419,1,2,.500,61,146,.418,.422,41,55,.745,29,82,111,38,25,14,39,103,166,2005
Joe Smith,PF,29,MIL,74,73,2265,319,621,.514,0,1,.000,319,620,.515,.514,175,228,.768,179,362,541,67,43,38,79,222,813,2005
Josh Smith,SF,19,ATL,74,59,2050,274,602,.455,4,23,.174,270,579,.466,.458,163,237,.688,147,310,457,127,59,144,135,157,715,2005
Steve Smith,SG,35,TOT,50,1,750,102,248,.411,41,105,.390,61,143,.427,.494,69,80,.863,15,50,65,71,14,7,27,82,314,2005
Steve Smith,SG,35,CHA,37,1,636,93,218,.427,38,90,.422,55,128,.430,.514,67,77,.870,13,36,49,57,12,7,24,74,291,2005
Steve Smith,SG,35,MIA,13,0,114,9,30,.300,3,15,.200,6,15,.400,.350,2,3,.667,2,14,16,14,2,0,3,8,23,2005
Theron Smith,SF,24,CHA,33,5,510,44,136,.324,3,12,.250,41,124,.331,.335,14,16,.875,39,77,116,28,6,4,27,58,105,2005
Eric Snow,SG,31,CLE,81,15,1844,125,327,.382,13,45,.289,112,282,.397,.402,59,80,.738,37,118,155,317,67,16,89,189,322,2005
Kirk Snyder,SG,21,UTA,68,7,906,122,328,.372,30,85,.353,92,243,.379,.418,64,96,.667,50,71,121,36,26,19,58,116,338,2005
Darius Songaila,PF,26,SAC,81,21,1668,257,488,.527,0,3,.000,257,485,.530,.527,94,111,.847,125,219,344,114,51,18,70,206,608,2005
Pape Sow,C,23,TOR,27,4,255,23,58,.397,0,0,.000,23,58,.397,.397,16,27,.593,18,39,57,2,12,4,10,46,62,2005
Latrell Sprewell,SF,34,MIN,80,79,2450,398,961,.414,69,211,.327,329,750,.439,.450,156,188,.830,65,189,254,179,53,21,127,124,1021,2005
Jerry Stackhouse,SG,30,DAL,56,7,1617,274,662,.414,32,120,.267,242,542,.446,.438,253,298,.849,38,145,183,127,53,10,106,104,833,2005
DeShawn Stevenson,SG,23,ORL,55,27,1089,174,426,.408,25,67,.373,149,359,.415,.438,56,101,.554,38,64,102,69,16,9,57,73,429,2005
Michael Stewart,PF,29,ATL,12,1,145,11,21,.524,0,0,.000,11,21,.524,.524,3,7,.429,21,19,40,5,6,5,6,32,25,2005
Peja Stojakovic,SF,27,SAC,66,66,2534,451,1016,.444,174,433,.402,277,583,.475,.530,253,275,.920,62,223,285,138,79,12,102,157,1329,2005
Awvee Storey,SG,27,NJN,9,0,32,3,10,.300,1,2,.500,2,8,.250,.350,1,2,.500,4,1,5,1,0,0,0,3,8,2005
Damon Stoudamire,PG,31,POR,81,70,2762,457,1165,.392,181,490,.369,276,675,.409,.470,182,199,.915,56,254,310,458,86,2,164,158,1277,2005
Amar'e Stoudemire,C,22,PHO,80,80,2889,747,1336,.559,3,16,.188,744,1320,.564,.560,583,795,.733,219,494,713,131,77,130,189,278,2080,2005
Erick Strickland,SG,31,MIL,62,5,1014,114,304,.375,21,83,.253,93,221,.421,.410,52,64,.813,11,92,103,115,30,1,64,103,301,2005
Rod Strickland,PG,38,HOU,16,2,196,9,43,.209,1,2,.500,8,41,.195,.221,9,10,.900,3,24,27,39,3,2,16,15,28,2005
Bruno Sundov,C,24,NYK,21,0,73,11,37,.297,1,3,.333,10,34,.294,.311,2,2,1.000,6,7,13,2,2,2,6,16,25,2005
Bob Sura,PG,31,HOU,61,59,1922,215,504,.427,55,155,.355,160,349,.458,.481,141,188,.750,79,258,337,317,65,7,147,168,626,2005
Mike Sweetney,C,22,NYK,77,28,1509,237,446,.531,0,1,.000,237,445,.533,.531,176,235,.749,169,249,418,44,27,28,108,224,650,2005
Robert Swift,C,19,SEA,16,0,72,5,11,.455,0,0,.000,5,11,.455,.455,5,9,.556,1,4,5,2,1,7,4,16,15,2005
Stromile Swift,PF,25,MEM,60,14,1279,219,488,.449,0,4,.000,219,484,.452,.449,166,219,.758,92,181,273,43,41,92,90,182,604,2005
Wally Szczerbiak,SF,27,MIN,81,37,2558,465,919,.506,63,169,.373,402,750,.536,.540,260,304,.855,82,221,303,191,40,16,132,178,1253,2005
Yuta Tabuse,PG,24,PHO,4,0,17,1,6,.167,1,1,1.000,0,5,.000,.250,4,4,1.000,2,2,4,3,0,0,1,1,7,2005
Maurice Taylor,PF-C,28,TOT,65,16,1336,203,446,.455,3,9,.333,200,437,.458,.459,63,103,.612,67,190,257,67,27,20,94,180,472,2005
Maurice Taylor,PF,28,HOU,38,16,905,127,292,.435,3,8,.375,124,284,.437,.440,39,60,.650,41,123,164,53,16,12,63,123,296,2005
Maurice Taylor,C,28,NYK,27,0,431,76,154,.494,0,1,.000,76,153,.497,.494,24,43,.558,26,67,93,14,11,8,31,57,176,2005
Sebastian Telfair,PG,19,POR,68,26,1330,169,430,.393,17,69,.246,152,361,.421,.413,105,133,.789,10,94,104,224,35,4,125,120,460,2005
Jason Terry,PG,27,DAL,80,57,2401,372,743,.501,103,245,.420,269,498,.540,.570,146,173,.844,38,150,188,429,109,15,147,177,993,2005
Billy Thomas,SF,29,NJN,25,0,356,34,94,.362,17,56,.304,17,38,.447,.452,7,9,.778,7,29,36,17,14,1,9,29,92,2005
Etan Thomas,C,26,WAS,47,10,976,128,255,.502,0,0,.000,128,255,.502,.502,76,144,.528,85,159,244,20,17,51,50,133,332,2005
James Thomas,PF,24,TOT,11,2,117,12,20,.600,0,0,.000,12,20,.600,.600,2,6,.333,17,20,37,4,4,4,7,13,26,2005
James Thomas,PF,24,POR,9,2,112,11,18,.611,0,0,.000,11,18,.611,.611,2,6,.333,15,20,35,4,4,4,7,12,24,2005
James Thomas,PF,24,ATL,2,0,5,1,2,.500,0,0,.000,1,2,.500,.500,0,0,.000,2,0,2,0,0,0,0,1,2,2005
John Thomas,C,29,MIN,44,8,521,42,86,.488,0,0,.000,42,86,.488,.488,27,46,.587,39,58,97,17,15,13,18,82,111,2005
Kenny Thomas,PF,27,TOT,73,58,2167,367,781,.470,1,5,.200,366,776,.472,.471,173,227,.762,184,351,535,152,67,17,131,227,908,2005
Kenny Thomas,PF,27,PHI,47,43,1344,217,476,.456,1,4,.250,216,472,.458,.457,95,119,.798,106,202,308,77,40,6,83,151,530,2005
Kenny Thomas,PF,27,SAC,26,15,823,150,305,.492,0,1,.000,150,304,.493,.492,78,108,.722,78,149,227,75,27,11,48,76,378,2005
Kurt Thomas,PF,32,NYK,80,80,2855,424,901,.471,2,4,.500,422,897,.470,.472,66,84,.786,170,661,831,160,70,79,99,310,916,2005
Tim Thomas,SF,27,NYK,71,68,1940,315,718,.439,85,208,.409,230,510,.451,.498,136,173,.786,45,192,237,110,41,17,113,222,851,2005
Jamaal Tinsley,PG,26,IND,40,40,1301,218,522,.418,58,156,.372,160,366,.437,.473,122,164,.744,26,134,160,257,81,12,134,112,616,2005
Robert Traylor,C,27,CLE,74,6,1327,177,399,.444,0,8,.000,177,391,.453,.444,55,102,.539,136,196,332,61,54,50,73,215,409,2005
Jake Tsakalidis,C,25,MEM,31,1,278,32,64,.500,0,0,.000,32,64,.500,.500,14,18,.778,21,35,56,10,3,16,12,42,78,2005
Nikoloz Tskitishvili,PF,21,TOT,35,0,220,22,74,.297,2,17,.118,20,57,.351,.311,4,7,.571,12,29,41,10,8,11,19,33,50,2005
Nikoloz Tskitishvili,PF,21,DEN,23,0,158,15,51,.294,0,7,.000,15,44,.341,.294,4,7,.571,11,18,29,4,8,8,14,24,34,2005
Nikoloz Tskitishvili,PF,21,GSW,12,0,62,7,23,.304,2,10,.200,5,13,.385,.348,0,0,.000,1,11,12,6,0,3,5,9,16,2005
Hedo Turkoglu,SF,25,ORL,67,11,1757,328,782,.419,93,245,.380,235,537,.438,.479,188,225,.836,62,171,233,153,41,18,119,140,937,2005
Beno Udrih,PG,22,SAS,80,2,1149,173,390,.444,58,142,.408,115,248,.464,.518,67,89,.753,16,67,83,150,41,10,77,96,471,2005
Nick Van Exel,SG,33,POR,53,34,1619,214,561,.381,100,257,.389,114,304,.375,.471,58,74,.784,20,141,161,227,44,0,92,70,586,2005
Keith Van Horn,SF-PF,29,TOT,62,16,1502,257,564,.456,54,142,.380,203,422,.481,.504,128,157,.815,89,205,294,75,36,21,81,170,696,2005
Keith Van Horn,SF,29,MIL,33,13,818,128,285,.449,30,78,.385,98,207,.473,.502,56,65,.862,55,110,165,41,21,11,47,82,342,2005
Keith Van Horn,PF,29,DAL,29,3,684,129,279,.462,24,64,.375,105,215,.488,.505,72,92,.783,34,95,129,34,15,10,34,88,354,2005
Anderson Varejao,PF,22,CLE,54,0,863,99,193,.513,0,2,.000,99,191,.518,.513,68,127,.535,109,148,257,27,41,38,26,122,266,2005
Jacque Vaughn,SG,29,NJN,71,34,1410,146,325,.449,5,15,.333,141,310,.455,.457,76,91,.835,17,90,107,135,41,1,62,138,373,2005
Jake Voskuhl,C,27,PHO,38,1,360,27,59,.458,0,0,.000,27,59,.458,.458,26,38,.684,30,62,92,17,4,11,20,60,80,2005
Jackson Vroman,C-PF,23,TOT,46,18,705,82,199,.412,0,3,.000,82,196,.418,.412,48,75,.640,64,111,175,40,25,19,64,105,212,2005
Jackson Vroman,PF,23,PHO,10,1,57,6,16,.375,0,0,.000,6,16,.375,.375,4,7,.571,5,8,13,7,3,2,7,11,16,2005
Jackson Vroman,C,23,NOH,36,17,648,76,183,.415,0,3,.000,76,180,.422,.415,44,68,.647,59,103,162,33,22,17,57,94,196,2005
Sasha Vujacic,SG,20,LAL,35,3,403,33,117,.282,17,63,.270,16,54,.296,.355,18,19,.947,13,49,62,51,12,2,15,41,101,2005
Dwyane Wade,SG,23,MIA,77,77,2974,630,1318,.478,13,45,.289,617,1273,.485,.483,581,762,.762,110,287,397,520,121,82,321,230,1854,2005
Dajuan Wagner,SG,21,CLE,11,0,102,18,55,.327,5,26,.192,13,29,.448,.373,3,4,.750,0,2,2,13,5,0,9,15,44,2005
Antoine Walker,PF,28,TOT,77,77,2955,581,1377,.422,110,341,.323,471,1036,.455,.462,201,373,.539,182,513,695,265,89,58,253,217,1473,2005
Antoine Walker,PF,28,ATL,53,53,2128,420,1013,.415,85,268,.317,335,745,.450,.457,157,294,.534,126,371,497,194,64,32,183,147,1082,2005
Antoine Walker,PF,28,BOS,24,24,827,161,364,.442,25,73,.342,136,291,.467,.477,44,79,.557,56,142,198,71,25,26,70,70,391,2005
Samaki Walker,PF,28,WAS,14,0,134,11,31,.355,0,0,.000,11,31,.355,.355,2,3,.667,8,10,18,4,3,7,8,25,24,2005
Ben Wallace,C,30,DET,74,74,2671,295,651,.453,1,9,.111,294,642,.458,.454,130,304,.428,292,610,902,123,106,176,82,159,721,2005
Gerald Wallace,SF,22,CHA,70,68,2147,286,637,.449,17,62,.274,269,575,.468,.462,191,289,.661,118,268,386,137,117,91,159,182,780,2005
Rasheed Wallace,PF,30,DET,79,79,2687,467,1062,.440,75,236,.318,392,826,.475,.475,136,195,.697,174,470,644,142,65,115,127,236,1145,2005
Luke Walton,SF,24,LAL,61,5,768,74,180,.411,16,61,.262,58,119,.487,.456,34,48,.708,55,87,142,93,26,11,58,70,198,2005
Charlie Ward,PG,34,HOU,14,13,360,24,77,.312,16,51,.314,8,26,.308,.416,11,13,.846,6,33,39,43,15,0,18,22,75,2005
Earl Watson,PG,25,MEM,80,14,1808,236,554,.426,52,163,.319,184,391,.471,.473,91,138,.659,35,129,164,359,83,19,167,184,615,2005
Clarence Weatherspoon,PF,34,HOU,40,18,525,47,114,.412,0,0,.000,47,114,.412,.412,29,35,.829,35,87,122,17,9,6,15,74,123,2005
Chris Webber,PF,31,TOT,67,67,2370,555,1283,.433,15,44,.341,540,1239,.436,.438,181,228,.794,130,482,612,318,94,53,182,214,1306,2005
Chris Webber,PF,31,SAC,46,46,1668,412,917,.449,11,29,.379,401,888,.452,.455,143,179,.799,94,353,447,252,68,34,133,144,978,2005
Chris Webber,PF,31,PHI,21,21,702,143,366,.391,4,15,.267,139,351,.396,.396,38,49,.776,36,129,165,66,26,19,49,70,328,2005
Bonzi Wells,SG,28,MEM,69,19,1489,272,617,.441,36,104,.346,236,513,.460,.470,141,188,.750,49,180,229,80,85,27,90,165,721,2005
Jiri Welsch,SG-SF,25,TOT,71,32,1317,149,371,.402,34,110,.309,115,261,.441,.447,129,169,.763,26,141,167,103,44,5,73,121,461,2005
Jiri Welsch,SG,25,BOS,55,32,1125,137,320,.428,32,99,.323,105,221,.475,.478,109,141,.773,20,119,139,84,39,5,58,105,415,2005
Jiri Welsch,SF,25,CLE,16,0,192,12,51,.235,2,11,.182,10,40,.250,.255,20,28,.714,6,22,28,19,5,0,15,16,46,2005
David Wesley,SG,34,TOT,80,79,2774,334,840,.398,118,315,.375,216,525,.411,.468,162,189,.857,38,190,228,265,96,9,113,215,948,2005
David Wesley,SG,34,NOH,26,26,934,133,342,.389,28,80,.350,105,262,.401,.430,67,76,.882,12,73,85,109,35,1,54,65,361,2005
David Wesley,SG,34,HOU,54,53,1840,201,498,.404,90,235,.383,111,263,.422,.494,95,113,.841,26,117,143,156,61,8,59,150,587,2005
David West,SF,24,NOH,30,8,552,75,172,.436,2,5,.400,73,167,.437,.442,34,50,.680,40,89,129,23,12,16,37,62,186,2005
Delonte West,SG,21,BOS,39,7,507,66,155,.426,24,67,.358,42,88,.477,.503,19,27,.704,14,51,65,53,21,8,24,69,175,2005
Jahidi White,C,28,CHA,17,0,135,14,31,.452,0,0,.000,14,31,.452,.452,14,40,.350,11,23,34,1,2,12,11,31,42,2005
Rodney White,SF,24,TOT,58,2,677,121,289,.419,24,60,.400,97,229,.424,.460,27,44,.614,24,65,89,44,32,11,37,64,293,2005
Rodney White,SF,24,DEN,42,2,531,98,227,.432,19,44,.432,79,183,.432,.474,21,34,.618,20,54,74,36,30,10,27,51,236,2005
Rodney White,SF,24,GSW,16,0,146,23,62,.371,5,16,.313,18,46,.391,.411,6,10,.600,4,11,15,8,2,1,10,13,57,2005
Chris Wilcox,C,22,LAC,54,25,1005,169,329,.514,0,0,.000,169,329,.514,.514,88,144,.611,63,165,228,38,26,24,77,129,426,2005
Damien Wilkins,SF,25,SEA,29,7,520,73,168,.435,16,59,.271,57,109,.523,.482,21,34,.618,29,37,66,26,22,10,16,55,183,2005
Mike Wilks,PG,25,SAS,48,0,278,32,77,.416,5,16,.313,27,61,.443,.448,12,16,.750,4,21,25,33,14,1,14,26,81,2005
Aaron Williams,C,33,TOT,42,4,315,29,63,.460,0,0,.000,29,63,.460,.460,15,17,.882,17,43,60,8,5,8,17,70,73,2005
Aaron Williams,C,33,NJN,19,0,150,14,27,.519,0,0,.000,14,27,.519,.519,9,10,.900,7,24,31,6,4,5,11,25,37,2005
Aaron Williams,C,33,TOR,23,4,165,15,36,.417,0,0,.000,15,36,.417,.417,6,7,.857,10,19,29,2,1,3,6,45,36,2005
Eric Williams,SG,32,TOT,55,39,1322,142,330,.430,28,73,.384,114,257,.444,.473,112,161,.696,44,128,172,92,38,4,60,147,424,2005
Eric Williams,SG,32,NJN,21,21,739,87,185,.470,17,40,.425,70,145,.483,.516,74,108,.685,28,67,95,42,16,2,34,80,265,2005
Eric Williams,SG,32,TOR,34,18,583,55,145,.379,11,33,.333,44,112,.393,.417,38,53,.717,16,61,77,50,22,2,26,67,159,2005
Frank Williams,SG,24,CHI,9,0,71,3,20,.150,0,4,.000,3,16,.188,.150,0,0,.000,2,4,6,11,2,3,3,9,6,2005
Jason Williams,PG,29,MEM,71,68,1952,266,644,.413,107,330,.324,159,314,.506,.496,80,101,.792,19,103,122,399,75,5,130,91,719,2005
Jerome Williams,SF,31,NYK,79,4,1211,122,243,.502,0,5,.000,122,238,.513,.502,115,172,.669,115,168,283,41,55,10,65,155,359,2005
Mo Williams,PG,22,MIL,80,80,2254,323,737,.438,32,99,.323,291,638,.456,.460,136,160,.850,50,194,244,484,74,11,196,221,814,2005
Scott Williams,C,36,CLE,19,0,152,12,41,.293,0,1,.000,12,40,.300,.293,9,11,.818,15,15,30,8,4,6,5,30,33,2005
Corliss Williamson,PF,31,TOT,72,9,1527,273,584,.467,0,2,.000,273,582,.469,.467,195,244,.799,104,155,259,78,38,15,86,218,741,2005
Corliss Williamson,PF,31,PHI,48,5,1056,194,417,.465,0,2,.000,194,415,.467,.465,130,165,.788,73,105,178,43,26,12,60,144,518,2005
Corliss Williamson,PF,31,SAC,24,4,471,79,167,.473,0,0,.000,79,167,.473,.473,65,79,.823,31,50,81,35,12,3,26,74,223,2005
Kevin Willis,C,42,ATL,29,5,344,35,90,.389,0,2,.000,35,88,.398,.389,17,23,.739,29,47,76,9,8,7,15,53,87,2005
Loren Woods,C,26,TOR,45,30,712,71,164,.433,0,1,.000,71,163,.436,.433,34,59,.576,81,139,220,17,8,39,37,78,176,2005
Qyntel Woods,SF,23,MIA,3,0,40,5,12,.417,0,0,.000,5,12,.417,.417,0,0,.000,2,4,6,0,4,0,2,6,10,2005
Metta World Peace,SF,25,IND,7,7,291,59,119,.496,7,17,.412,52,102,.510,.525,47,51,.922,8,37,45,22,12,6,17,27,172,2005
Dorell Wright,SF,19,MIA,3,0,27,3,11,.273,0,4,.000,3,7,.429,.273,1,1,1.000,0,1,1,3,4,0,3,2,7,2005
Lorenzen Wright,C,29,MEM,80,77,2287,320,683,.469,0,3,.000,320,680,.471,.469,131,198,.662,177,436,613,87,58,69,100,251,771,2005
Wang Zhizhi,C,27,MIA,20,0,92,17,36,.472,2,3,.667,15,33,.455,.500,7,12,.583,6,12,18,5,3,2,5,9,43,2005
Shareef Abdur-Rahim,PF,27,TOT,85,56,2684,501,1054,.475,9,34,.265,492,1020,.482,.480,373,429,.869,189,450,639,174,68,37,184,222,1384,2004
Shareef Abdur-Rahim,PF,27,ATL,53,53,1956,383,790,.485,5,23,.217,378,767,.493,.488,294,334,.880,141,354,495,127,44,19,131,147,1065,2004
Shareef Abdur-Rahim,PF,27,POR,32,3,728,118,264,.447,4,11,.364,114,253,.451,.455,79,95,.832,48,96,144,47,24,18,53,75,319,2004
Malik Allen,PF,25,MIA,45,6,616,83,198,.419,0,0,.000,83,198,.419,.419,25,33,.758,42,77,119,16,12,28,27,81,191,2004
Ray Allen,SG,28,SEA,56,56,2152,447,1017,.440,148,378,.392,299,639,.468,.512,245,271,.904,69,217,286,268,71,11,156,132,1287,2004
Rafer Alston,PG,27,MIA,82,28,2581,287,764,.376,161,434,.371,126,330,.382,.481,103,134,.769,26,200,226,372,114,18,128,212,838,2004
Chris Andersen,PF,25,DEN,71,0,1029,90,203,.443,0,1,.000,90,202,.446,.443,63,107,.589,89,209,298,35,34,114,48,119,243,2004
Derek Anderson,SG,29,POR,51,46,1810,230,612,.376,79,259,.305,151,353,.428,.440,155,188,.824,26,156,182,228,66,3,90,79,694,2004
Kenny Anderson,PG,33,IND,44,31,905,113,256,.441,1,4,.250,112,252,.444,.443,35,48,.729,19,62,81,125,26,5,50,73,262,2004
Shandon Anderson,SG,30,NYK,80,37,1974,238,564,.422,36,128,.281,202,436,.463,.454,123,161,.764,53,169,222,122,68,17,118,182,635,2004
Carmelo Anthony,SF,19,DEN,82,82,2995,624,1465,.426,69,214,.322,555,1251,.444,.449,408,525,.777,183,315,498,227,97,41,247,225,1725,2004
Robert Archibald,C-PF,23,TOT,32,3,256,9,33,.273,0,0,.000,9,33,.273,.273,14,31,.452,21,31,52,13,14,3,10,50,32,2004
Robert Archibald,PF,23,PHO,1,0,6,0,1,.000,0,0,.000,0,1,.000,.000,1,2,.500,0,1,1,1,0,0,1,1,1,2004
Robert Archibald,PF,23,ORL,1,0,4,1,2,.500,0,0,.000,1,2,.500,.500,0,2,.000,0,1,1,0,1,0,0,0,2,2004
Robert Archibald,C,23,TOR,30,3,246,8,30,.267,0,0,.000,8,30,.267,.267,13,27,.481,21,29,50,12,13,3,9,49,29,2004
Gilbert Arenas,PG,22,WAS,55,52,2066,358,914,.392,125,333,.375,233,581,.401,.460,237,317,.748,55,199,254,275,103,12,226,176,1078,2004
Brandon Armstrong,SG,23,NJN,56,0,434,65,175,.371,19,52,.365,46,123,.374,.426,2,4,.500,12,31,43,14,12,2,24,49,151,2004
Darrell Armstrong,PG,35,NOH,79,22,2247,291,736,.395,135,429,.315,156,307,.508,.487,123,144,.854,63,163,226,311,133,16,155,148,840,2004
Carlos Arroyo,PG,24,UTA,71,71,2008,339,768,.441,38,117,.325,301,651,.462,.466,181,225,.804,41,144,185,355,63,5,156,165,897,2004
Chucky Atkins,PG,29,TOT,64,24,1544,192,484,.397,81,241,.336,111,243,.457,.480,73,97,.753,9,84,93,223,45,2,92,102,538,2004
Chucky Atkins,PG,29,DET,40,0,751,88,235,.374,42,130,.323,46,105,.438,.464,31,43,.721,6,42,48,95,19,1,48,60,249,2004
Chucky Atkins,PG,29,BOS,24,24,793,104,249,.418,39,111,.351,65,138,.471,.496,42,54,.778,3,42,45,128,26,1,44,42,289,2004
Stacey Augmon,SF,35,NOH,69,24,1416,143,347,.412,1,7,.143,142,340,.418,.414,110,139,.791,52,122,174,85,55,15,76,114,397,2004
Vin Baker,PF,32,TOT,54,33,1313,208,432,.481,1,3,.333,207,429,.483,.483,114,157,.726,112,168,280,66,29,32,77,160,531,2004
Vin Baker,PF,32,BOS,37,33,1000,168,333,.505,0,1,.000,168,332,.506,.505,82,112,.732,76,134,210,54,22,23,52,98,418,2004
Vin Baker,PF,32,NYK,17,0,313,40,99,.404,1,2,.500,39,97,.402,.409,32,45,.711,36,34,70,12,7,9,25,62,113,2004
Marcus Banks,PG,22,BOS,81,2,1385,177,442,.400,27,86,.314,150,356,.421,.431,99,131,.756,30,103,133,175,88,13,125,171,480,2004
Leandro Barbosa,PG,21,PHO,70,46,1500,210,470,.447,83,210,.395,127,260,.488,.535,47,61,.770,23,100,123,165,93,7,120,184,550,2004
Matt Barnes,SF,23,LAC,38,9,724,63,138,.457,2,13,.154,61,125,.488,.464,43,61,.705,53,98,151,48,27,3,44,76,171,2004
Dana Barros,SG,36,BOS,1,0,11,2,3,.667,0,0,.000,2,3,.667,.667,2,2,1.000,0,0,0,0,0,0,0,2,6,2004
Brent Barry,SG,32,SEA,59,53,1803,215,427,.504,114,252,.452,101,175,.577,.637,91,110,.827,21,183,204,342,85,16,139,121,635,2004
Jon Barry,SG,34,DEN,57,9,1101,120,297,.404,51,138,.370,69,159,.434,.490,60,71,.845,25,98,123,147,57,8,53,66,351,2004
Mengke Bateer,C,28,TOR,7,0,40,4,7,.571,0,0,.000,4,7,.571,.571,0,0,.000,5,3,8,1,1,0,2,10,8,2004
Tony Battie,C,27,TOT,73,7,1478,170,384,.443,2,9,.222,168,375,.448,.445,66,89,.742,118,241,359,58,26,67,63,159,408,2004
Tony Battie,C,27,BOS,23,6,501,56,117,.479,1,1,1.000,55,116,.474,.483,23,33,.697,39,79,118,21,8,20,24,55,136,2004
Tony Battie,C,27,CLE,50,1,977,114,267,.427,1,8,.125,113,259,.436,.429,43,56,.768,79,162,241,37,18,47,39,104,272,2004
Shane Battier,SF,25,MEM,79,1,1947,242,543,.446,65,186,.349,177,357,.496,.506,120,164,.732,102,201,303,101,101,58,56,187,669,2004
Lonny Baxter,C-PF,25,TOT,62,5,766,103,209,.493,1,3,.333,102,206,.495,.495,44,76,.579,64,123,187,20,17,29,38,123,251,2004
Lonny Baxter,PF,25,CHI,14,1,147,27,49,.551,1,1,1.000,26,48,.542,.561,5,8,.625,11,24,35,5,1,6,11,31,60,2004
Lonny Baxter,C,25,TOR,36,4,487,60,128,.469,0,1,.000,60,127,.472,.469,30,56,.536,42,79,121,10,14,18,22,69,150,2004
Lonny Baxter,PF,25,WAS,12,0,132,16,32,.500,0,1,.000,16,31,.516,.500,9,12,.750,11,20,31,5,2,5,5,23,41,2004
Jerome Beasley,PF,23,MIA,2,0,5,1,3,.333,0,0,.000,1,3,.333,.333,0,0,.000,0,1,1,0,0,0,0,0,2,2004
Raja Bell,SG,27,UTA,82,4,2020,329,805,.409,62,166,.373,267,639,.418,.447,195,248,.786,60,181,241,107,63,13,111,262,915,2004
Troy Bell,PG,23,MEM,6,0,34,4,18,.222,0,4,.000,4,14,.286,.222,3,3,1.000,3,1,4,4,1,0,6,6,11,2004
Jonathan Bender,SF,23,IND,21,0,271,50,106,.472,9,22,.409,41,84,.488,.514,39,47,.830,9,31,40,9,5,11,33,23,148,2004
Travis Best,PG,31,DAL,61,1,762,64,172,.372,3,20,.150,61,152,.401,.381,40,46,.870,17,51,68,112,31,4,33,66,171,2004
Mike Bibby,PG,25,SAC,82,82,2980,527,1170,.450,148,378,.392,379,792,.479,.514,304,373,.815,67,210,277,444,112,18,175,146,1506,2004
Chauncey Billups,PG,27,DET,78,78,2758,392,996,.394,130,335,.388,262,661,.396,.459,404,460,.878,35,241,276,446,84,8,189,177,1318,2004
Steve Blake,PG,23,WAS,75,14,1392,157,407,.386,75,202,.371,82,205,.400,.478,55,67,.821,18,99,117,209,57,7,128,100,444,2004
Corie Blount,PF-C,35,TOT,62,3,1050,115,253,.455,0,3,.000,115,250,.460,.455,15,27,.556,98,177,275,55,49,24,43,135,245,2004
Corie Blount,PF,35,CHI,46,3,756,97,206,.471,0,3,.000,97,203,.478,.471,13,24,.542,76,130,206,45,38,19,35,86,207,2004
Corie Blount,C,35,TOR,16,0,294,18,47,.383,0,0,.000,18,47,.383,.383,2,3,.667,22,47,69,10,11,5,8,49,38,2004
Mark Blount,C,28,BOS,82,73,2402,342,604,.566,0,0,.000,342,604,.566,.566,159,221,.719,207,382,589,75,80,106,150,253,843,2004
Keith Bogans,SF,23,ORL,73,36,1787,183,454,.403,67,187,.358,116,267,.434,.477,65,103,.631,106,211,317,98,46,10,75,128,498,2004
Calvin Booth,C,27,SEA,71,35,1206,135,290,.466,0,2,.000,135,288,.469,.466,75,94,.798,86,194,280,28,17,101,45,150,345,2004
Carlos Boozer,PF,22,CLE,75,75,2592,471,900,.523,1,6,.167,470,894,.526,.524,219,285,.768,230,627,857,148,74,55,134,199,1162,2004
Curtis Borchardt,C,23,UTA,16,0,258,22,56,.393,0,1,.000,22,55,.400,.393,14,18,.778,13,41,54,15,4,14,18,40,58,2004
Chris Bosh,C,19,TOR,75,63,2510,327,712,.459,5,14,.357,322,698,.461,.463,202,288,.701,191,366,557,78,59,106,107,215,861,2004
Ruben Boumtje-Boumtje,C,25,POR,9,0,26,1,5,.200,0,0,.000,1,5,.200,.200,2,2,1.000,0,1,1,1,0,1,0,2,4,2004
Bruce Bowen,SF,32,SAS,82,82,2624,211,502,.420,77,212,.363,134,290,.462,.497,66,114,.579,45,208,253,113,84,33,90,166,565,2004
Ryan Bowen,PF,28,DEN,52,1,392,18,53,.340,0,0,.000,18,53,.340,.340,10,12,.833,39,48,87,18,18,16,6,47,46,2004
Earl Boykins,SG,27,DEN,82,3,1849,321,766,.419,55,171,.322,266,595,.447,.455,142,162,.877,42,101,143,295,51,3,100,84,839,2004
Michael Bradley,C-PF,24,TOT,16,1,98,7,15,.467,0,0,.000,7,15,.467,.467,1,2,.500,6,17,23,1,3,0,7,14,15,2004
Michael Bradley,PF,24,TOR,5,0,38,1,3,.333,0,0,.000,1,3,.333,.333,1,2,.500,1,10,11,1,1,0,3,6,3,2004
Michael Bradley,C,24,ATL,11,1,60,6,12,.500,0,0,.000,6,12,.500,.500,0,0,.000,5,7,12,0,2,0,4,8,12,2004
Shawn Bradley,C,31,DAL,66,5,773,89,188,.473,0,1,.000,89,187,.476,.473,41,49,.837,72,101,173,20,33,74,17,130,219,2004
Torraye Braggs,PF,27,TOT,15,0,154,16,33,.485,0,0,.000,16,33,.485,.485,8,12,.667,18,21,39,7,4,2,13,29,40,2004
Torraye Braggs,PF,27,HOU,11,0,132,13,28,.464,0,0,.000,13,28,.464,.464,8,12,.667,15,19,34,6,4,2,12,21,34,2004
Torraye Braggs,PF,27,WAS,4,0,22,3,5,.600,0,0,.000,3,5,.600,.600,0,0,.000,3,2,5,1,0,0,1,8,6,2004
Elton Brand,PF,24,LAC,69,68,2670,484,982,.493,0,1,.000,484,981,.493,.493,411,532,.773,269,445,714,227,64,154,193,229,1379,2004
J.R. Bremer,PG,23,TOT,36,2,443,43,158,.272,19,74,.257,24,84,.286,.332,13,20,.650,9,27,36,51,18,4,24,32,118,2004
J.R. Bremer,PG,23,CLE,31,2,403,39,137,.285,19,66,.288,20,71,.282,.354,13,20,.650,7,26,33,39,18,4,19,27,110,2004
J.R. Bremer,PG,23,GSW,5,0,40,4,21,.190,0,8,.000,4,13,.308,.190,0,0,.000,2,1,3,12,0,0,5,5,8,2004
Jamison Brewer,PG,23,IND,13,1,160,13,35,.371,5,14,.357,8,21,.381,.443,1,6,.167,2,9,11,17,7,0,10,9,32,2004
Primoz Brezec,C,24,IND,18,0,72,12,26,.462,0,0,.000,12,26,.462,.462,4,6,.667,5,10,15,3,0,3,6,13,28,2004
Damone Brown,PF,24,NJN,3,0,17,1,10,.100,0,0,.000,1,10,.100,.100,1,2,.500,3,2,5,0,2,0,1,2,3,2004
Devin Brown,SG,25,SAS,58,0,627,85,196,.434,4,14,.286,81,182,.445,.444,60,74,.811,38,92,130,33,15,4,38,61,234,2004
Kedrick Brown,SF,22,TOT,55,26,969,117,254,.461,38,99,.384,79,155,.510,.535,17,27,.630,41,105,146,64,30,7,29,80,289,2004
Kedrick Brown,SF,22,BOS,21,10,408,45,99,.455,12,32,.375,33,67,.493,.515,8,13,.615,18,50,68,25,17,2,12,38,110,2004
Kedrick Brown,SF,22,CLE,34,16,561,72,155,.465,26,67,.388,46,88,.523,.548,9,14,.643,23,55,78,39,13,5,17,42,179,2004
Kwame Brown,PF,21,WAS,74,57,2239,288,589,.489,1,2,.500,287,587,.489,.490,228,334,.683,178,372,550,112,66,52,140,144,805,2004
P.J. Brown,PF,34,NOH,80,80,2753,339,712,.476,0,1,.000,339,711,.477,.476,158,185,.854,237,453,690,155,78,73,101,203,836,2004
Tierre Brown,PG,24,NOH,3,0,17,2,4,.500,0,0,.000,2,4,.500,.500,2,4,.500,0,1,1,2,0,0,7,1,6,2004
Rick Brunson,PG,31,TOT,40,0,412,40,105,.381,11,23,.478,29,82,.354,.433,27,31,.871,9,28,37,82,25,3,33,44,118,2004
Rick Brunson,PG,31,TOR,3,0,10,2,4,.500,0,0,.000,2,4,.500,.500,0,0,.000,0,0,0,2,0,0,0,0,4,2004
Rick Brunson,PG,31,CHI,37,0,402,38,101,.376,11,23,.478,27,78,.346,.431,27,31,.871,9,28,37,80,25,3,33,44,114,2004
Kobe Bryant,SG,25,LAL,65,64,2447,516,1178,.438,71,217,.327,445,961,.463,.468,454,533,.852,103,256,359,330,112,28,171,176,1557,2004
Greg Buckner,SG,27,PHI,53,3,703,66,175,.377,12,44,.273,54,131,.412,.411,20,27,.741,28,75,103,45,21,4,34,77,164,2004
Rodney Buford,SF,26,SAC,22,0,141,19,56,.339,0,2,.000,19,54,.352,.339,3,6,.500,6,9,15,7,6,1,4,9,41,2004
Caron Butler,SF,23,MIA,68,56,2030,240,631,.380,10,42,.238,230,589,.390,.388,133,176,.756,92,234,326,126,75,13,91,162,623,2004
Mitchell Butler,SG,33,WAS,41,4,552,54,124,.435,11,30,.367,43,94,.457,.480,15,24,.625,24,47,71,32,22,4,24,54,134,2004
Rasual Butler,SF,24,MIA,45,0,675,119,250,.476,50,108,.463,69,142,.486,.576,16,21,.762,4,57,61,23,10,13,28,72,304,2004
Zarko Cabarkapa,PF,22,PHO,49,4,570,81,197,.411,6,32,.188,75,165,.455,.426,35,53,.660,26,73,99,40,10,13,54,75,203,2004
Marcus Camby,C,29,DEN,72,72,2162,262,549,.477,0,2,.000,262,547,.479,.477,98,136,.721,211,516,727,132,86,187,98,239,622,2004
Elden Campbell,C,35,DET,65,27,892,138,314,.439,0,0,.000,138,314,.439,.439,85,124,.685,52,157,209,45,21,50,63,137,361,2004
Brian Cardinal,PF,26,GSW,76,11,1634,220,466,.472,55,124,.444,165,342,.482,.531,238,271,.878,100,217,317,103,66,20,84,206,733,2004
Matt Carroll,SG,23,TOT,16,0,70,7,16,.438,1,3,.333,6,13,.462,.469,4,6,.667,1,5,6,2,1,0,6,8,19,2004
Matt Carroll,SG,23,POR,13,0,48,5,11,.455,1,3,.333,4,8,.500,.500,2,2,1.000,0,3,3,1,0,0,2,3,13,2004
Matt Carroll,SG,23,SAS,3,0,22,2,5,.400,0,0,.000,2,5,.400,.400,2,4,.500,1,2,3,1,1,0,4,5,6,2004
Anthony Carter,PG,28,SAS,5,2,87,11,37,.297,0,3,.000,11,34,.324,.297,0,0,.000,2,9,11,12,4,0,12,9,22,2004
Maurice Carter,SG,27,TOT,10,0,110,11,35,.314,4,11,.364,7,24,.292,.371,16,20,.800,2,9,11,4,0,0,9,10,42,2004
Maurice Carter,SG,27,LAL,4,0,50,5,14,.357,1,3,.333,4,11,.364,.393,11,12,.917,0,3,3,2,0,0,6,5,22,2004
Maurice Carter,SG,27,NOH,6,0,60,6,21,.286,3,8,.375,3,13,.231,.357,5,8,.625,2,6,8,2,0,0,3,5,20,2004
Vince Carter,SG,27,TOR,73,73,2785,608,1457,.417,93,243,.383,515,1214,.424,.449,336,417,.806,95,254,349,348,88,65,223,212,1645,2004
Sam Cassell,PG,34,MIN,81,81,2838,620,1270,.488,74,186,.398,546,1084,.504,.517,289,331,.873,44,227,271,592,102,18,220,247,1603,2004
Kelvin Cato,PF,29,HOU,69,67,1743,161,360,.447,0,0,.000,161,360,.447,.447,96,142,.676,153,319,472,72,52,96,84,203,418,2004
Tyson Chandler,PF,21,CHI,35,8,782,67,158,.424,0,1,.000,67,157,.427,.424,79,118,.669,82,188,270,23,17,43,38,87,213,2004
Calbert Cheaney,SF,32,GSW,79,7,2067,278,578,.481,0,10,.000,278,568,.489,.481,47,77,.610,77,183,260,136,60,12,85,184,603,2004
Doug Christie,SG,33,SAC,82,82,2780,317,688,.461,49,142,.345,268,546,.491,.496,148,172,.860,69,260,329,347,151,41,155,186,831,2004
Keon Clark,PF,28,UTA,2,0,27,2,6,.333,0,0,.000,2,6,.333,.333,0,0,.000,1,6,7,1,1,0,0,1,4,2004
Speedy Claxton,PG,25,GSW,60,29,1595,224,524,.427,4,22,.182,220,502,.438,.431,182,224,.813,38,118,156,267,97,9,102,146,634,2004
Mateen Cleaves,PG,26,CLE,4,2,92,7,23,.304,0,1,.000,7,22,.318,.304,1,2,.500,1,6,7,19,4,2,5,13,15,2004
Derrick Coleman,C,36,PHI,34,30,843,107,259,.413,8,36,.222,99,223,.444,.429,49,65,.754,45,147,192,46,23,26,57,79,271,2004
Bimbo Coles,PG,35,MIA,22,1,170,12,34,.353,0,0,.000,12,34,.353,.353,4,6,.667,2,8,10,15,3,0,9,27,28,2004
Jason Collier,C,26,ATL,20,16,545,79,165,.479,1,4,.250,78,161,.484,.482,67,85,.788,36,75,111,17,11,11,31,71,226,2004
Jarron Collins,C,25,UTA,81,31,1732,147,295,.498,0,1,.000,147,294,.500,.498,188,262,.718,117,199,316,77,26,18,79,255,482,2004
Jason Collins,C,25,NJN,78,78,2220,163,384,.424,0,2,.000,163,382,.427,.424,136,184,.739,143,257,400,153,67,56,97,251,462,2004
Brian Cook,C,23,LAL,35,2,442,67,141,.475,0,5,.000,67,136,.493,.475,21,28,.750,31,70,101,20,16,16,17,64,155,2004
Omar Cook,PG,22,POR,17,0,139,7,27,.259,0,1,.000,7,26,.269,.259,0,0,.000,3,3,6,24,10,0,10,14,14,2004
Chris Crawford,PF,28,ATL,56,25,1207,211,471,.448,44,113,.389,167,358,.466,.495,103,119,.866,58,117,175,45,37,20,55,131,569,2004
Jamal Crawford,SG,23,CHI,80,73,2811,509,1318,.386,165,521,.317,344,797,.432,.449,200,240,.833,46,237,283,405,111,29,193,161,1383,2004
Austin Croshere,PF,28,IND,77,0,1051,119,307,.388,56,144,.389,63,163,.387,.479,93,104,.894,60,183,243,52,24,14,55,101,387,2004
Eddy Curry,PF,21,CHI,73,63,2154,417,840,.496,1,1,1.000,416,839,.496,.497,235,350,.671,143,308,451,68,24,83,177,258,1070,2004
Michael Curry,SF,35,TOR,70,15,1229,76,196,.388,3,15,.200,73,181,.403,.395,49,58,.845,22,65,87,53,23,5,48,153,204,2004
Samuel Dalembert,C,22,PHI,82,53,2197,270,499,.541,0,1,.000,270,498,.542,.541,112,174,.644,194,432,626,21,44,189,86,273,652,2004
Erick Dampier,C,28,GSW,74,74,2403,348,650,.535,0,2,.000,348,648,.537,.535,217,332,.654,344,543,887,60,33,137,131,227,913,2004
Antonio Daniels,PG,28,SEA,71,32,1512,187,398,.470,42,116,.362,145,282,.514,.523,155,184,.842,23,119,142,298,45,6,61,64,571,2004
Marquis Daniels,SG,23,DAL,56,15,1039,203,411,.494,11,36,.306,192,375,.512,.507,60,78,.769,66,80,146,116,53,12,44,51,477,2004
Antonio Davis,C,35,TOT,80,79,2570,266,660,.403,0,0,.000,266,660,.403,.403,176,230,.765,207,464,671,137,37,65,114,206,708,2004
Antonio Davis,C,35,TOR,15,15,538,46,120,.383,0,0,.000,46,120,.383,.383,37,49,.755,49,94,143,14,8,8,21,45,129,2004
Antonio Davis,C,35,CHI,65,64,2032,220,540,.407,0,0,.000,220,540,.407,.407,139,181,.768,158,370,528,123,29,57,93,161,579,2004
Baron Davis,PG,24,NOH,67,66,2686,554,1402,.395,187,582,.321,367,820,.448,.462,237,352,.673,66,221,287,501,158,27,215,178,1532,2004
Dale Davis,C,34,POR,76,37,1682,133,281,.473,0,0,.000,133,281,.473,.473,65,106,.613,158,240,398,72,43,62,40,154,331,2004
Hubert Davis,SG,33,TOT,17,0,78,1,11,.091,0,1,.000,1,10,.100,.091,2,2,1.000,2,6,8,4,2,0,3,12,4,2004
Hubert Davis,SG,33,DET,3,0,23,0,2,.000,0,1,.000,0,1,.000,.000,0,0,.000,0,0,0,1,0,0,1,4,0,2004
Hubert Davis,SG,33,NJN,14,0,55,1,9,.111,0,0,.000,1,9,.111,.111,2,2,1.000,2,6,8,3,2,0,2,8,4,2004
Josh Davis,PF,23,ATL,4,1,23,2,5,.400,0,2,.000,2,3,.667,.400,1,1,1.000,1,4,5,0,0,0,2,3,5,2004
Ricky Davis,SF-SG,24,TOT,79,27,2474,446,950,.469,52,140,.371,394,810,.486,.497,196,273,.718,77,281,358,259,96,22,189,171,1140,2004
Ricky Davis,SG,24,CLE,22,22,796,134,311,.431,17,48,.354,117,263,.445,.458,51,75,.680,18,103,121,111,25,8,68,51,336,2004
Ricky Davis,SF,24,BOS,57,5,1678,312,639,.488,35,92,.380,277,547,.506,.516,145,198,.732,59,178,237,148,71,14,121,120,804,2004
Andrew DeClercq,C,30,ORL,71,53,1211,93,195,.477,0,0,.000,93,195,.477,.477,44,54,.815,131,186,317,44,47,32,54,217,230,2004
Tony Delk,SG,30,DAL,33,11,509,70,184,.380,20,66,.303,50,118,.424,.435,37,44,.841,16,43,59,28,27,7,17,46,197,2004
Derrick Dial,SG,28,ORL,9,0,86,9,28,.321,2,9,.222,7,19,.368,.357,6,8,.750,5,8,13,2,6,0,1,6,26,2004
Boris Diaw,SG,21,ATL,76,37,1919,140,313,.447,6,26,.231,134,287,.467,.457,56,93,.602,111,231,342,182,59,37,126,191,342,2004
Dan Dickau,PG,25,TOT,43,0,294,37,98,.378,10,30,.333,27,68,.397,.429,11,14,.786,7,19,26,38,17,0,26,44,95,2004
Dan Dickau,PG,25,ATL,23,0,143,21,49,.429,3,10,.300,18,39,.462,.459,4,6,.667,4,12,16,18,9,0,13,22,49,2004
Dan Dickau,PG,25,POR,20,0,151,16,49,.327,7,20,.350,9,29,.310,.398,7,8,.875,3,7,10,20,8,0,13,22,46,2004
Kaniel Dickens,PF,25,POR,3,0,12,3,3,1.000,0,0,.000,3,3,1.000,1.000,1,2,.500,2,0,2,0,0,0,1,3,7,2004
DeSagana Diop,C,22,CLE,56,3,730,57,147,.388,0,0,.000,57,147,.388,.388,12,20,.600,72,127,199,34,26,51,29,116,126,2004
Vlade Divac,C,35,SAC,81,81,2317,314,668,.470,2,13,.154,312,655,.476,.472,170,260,.654,136,327,463,432,57,77,173,222,800,2004
Juan Dixon,SG,25,WAS,71,16,1478,247,637,.388,59,198,.298,188,439,.428,.434,111,139,.799,30,118,148,137,82,4,104,111,664,2004
Michael Doleac,C,26,TOT,72,0,1029,140,322,.435,0,0,.000,140,322,.435,.435,45,52,.865,88,177,265,44,23,36,48,142,325,2004
Michael Doleac,C,26,NYK,46,0,685,100,225,.444,0,0,.000,100,225,.444,.444,31,36,.861,60,129,189,30,17,30,37,84,231,2004
Michael Doleac,C,26,DEN,26,0,344,40,97,.412,0,0,.000,40,97,.412,.412,14,16,.875,28,48,76,14,6,6,11,58,94,2004
Keyon Dooling,PG,23,LAC,58,24,1137,137,352,.389,8,46,.174,129,306,.422,.401,78,94,.830,17,62,79,130,45,6,65,108,360,2004
Bryce Drew,PG,29,NOH,15,0,78,4,18,.222,1,7,.143,3,11,.273,.250,3,3,1.000,0,6,6,13,4,0,8,1,12,2004
Predrag Drobnjak,C,28,LAC,61,14,949,149,379,.393,11,36,.306,138,343,.402,.408,73,86,.849,54,142,196,39,22,24,48,85,382,2004
Tim Duncan,PF,27,SAS,69,68,2527,592,1181,.501,2,12,.167,590,1169,.505,.502,352,588,.599,227,632,859,213,62,185,183,164,1538,2004
Mike Dunleavy,SF,23,GSW,75,69,2336,323,720,.449,94,254,.370,229,466,.491,.514,137,185,.741,87,355,442,220,68,13,143,169,877,2004
Ronald Dupree,SF,23,CHI,47,8,893,111,282,.394,4,9,.444,107,273,.392,.401,66,105,.629,55,112,167,55,32,18,51,134,292,2004
Ndudi Ebi,SF,19,MIN,17,0,32,6,14,.429,0,0,.000,6,14,.429,.429,1,4,.250,2,1,3,3,0,4,3,6,13,2004
Howard Eisley,PG,31,TOT,67,23,1457,166,451,.368,52,163,.319,114,288,.396,.426,76,89,.854,20,109,129,273,56,5,98,137,460,2004
Howard Eisley,PG,31,NYK,33,23,730,80,202,.396,28,85,.329,52,117,.444,.465,32,36,.889,7,59,66,156,30,3,50,85,220,2004
Howard Eisley,PG,31,PHO,34,0,727,86,249,.345,24,78,.308,62,171,.363,.394,44,53,.830,13,50,63,117,26,2,48,52,240,2004
Francisco Elson,C,27,DEN,62,14,875,94,199,.472,0,1,.000,94,198,.475,.472,30,45,.667,65,138,203,32,35,39,35,145,218,2004
Melvin Ely,PF,25,LAC,42,2,510,66,153,.431,0,1,.000,66,152,.434,.431,25,42,.595,48,53,101,22,9,17,20,68,157,2004
Reggie Evans,PF,23,SEA,75,27,1280,67,165,.406,0,3,.000,67,162,.414,.406,83,148,.561,156,252,408,33,54,10,65,176,217,2004
Desmond Ferguson,SF,26,POR,7,0,32,5,12,.417,3,8,.375,2,4,.500,.542,0,2,.000,0,4,4,1,0,0,1,0,13,2004
Michael Finley,SG,30,DAL,72,72,2778,514,1159,.443,150,370,.405,364,789,.461,.508,164,193,.850,78,247,325,212,84,39,83,118,1342,2004
Derek Fisher,SG,29,LAL,82,3,1769,203,576,.352,52,179,.291,151,397,.380,.398,122,153,.797,30,122,152,187,103,4,79,115,580,2004
Marcus Fizer,SF,25,CHI,46,2,738,134,350,.383,2,17,.118,132,333,.396,.386,90,120,.750,61,141,202,43,16,8,51,97,360,2004
Alton Ford,PF,22,HOU,9,0,41,6,11,.545,0,0,.000,6,11,.545,.545,3,6,.500,3,8,11,3,0,1,3,9,15,2004
T.J. Ford,PG,20,MIL,55,55,1472,153,398,.384,5,21,.238,148,377,.393,.391,80,98,.816,37,140,177,356,60,3,139,123,391,2004
Danny Fortson,C,27,DAL,56,20,625,71,139,.511,0,0,.000,71,139,.511,.511,75,92,.815,114,136,250,9,12,11,37,148,217,2004
Jeff Foster,C,27,IND,82,79,1961,197,362,.544,0,4,.000,197,358,.550,.544,103,154,.669,248,362,610,64,71,27,60,189,497,2004
Tremaine Fowlkes,SF,27,DET,36,0,261,15,48,.313,1,8,.125,14,40,.350,.323,13,18,.722,18,35,53,14,9,3,12,37,44,2004
Rick Fox,SF,34,LAL,38,34,846,73,186,.392,15,61,.246,58,125,.464,.433,22,30,.733,29,73,102,98,29,4,48,99,183,2004
Adonal Foyle,C,28,GSW,44,8,572,59,130,.454,0,0,.000,59,130,.454,.454,19,35,.543,54,113,167,17,6,46,21,68,137,2004
Richie Frahm,SF,26,SEA,54,0,469,63,139,.453,34,92,.370,29,47,.617,.576,23,26,.885,12,44,56,24,16,4,7,50,183,2004
Steve Francis,PG,26,HOU,79,79,3194,450,1117,.403,73,250,.292,377,867,.435,.436,337,435,.775,116,317,433,493,139,35,294,257,1310,2004
Hiram Fuller,PF,22,ATL,4,0,43,3,8,.375,0,0,.000,3,8,.375,.375,2,6,.333,4,7,11,2,0,1,4,5,8,2004
Dan Gadzuric,C,25,MIL,75,0,1260,183,349,.524,0,1,.000,183,348,.526,.524,58,118,.492,126,220,346,28,51,105,45,186,424,2004
Reece Gaines,PG,23,ORL,38,1,364,25,86,.291,3,10,.300,22,76,.289,.308,16,25,.640,8,31,39,40,11,2,18,22,69,2004
Alex Garcia,SG,23,SAS,2,0,13,1,7,.143,0,0,.000,1,7,.143,.143,1,2,.500,0,0,0,0,2,0,1,0,3,2004
Kevin Garnett,PF,27,MIN,82,82,3231,804,1611,.499,11,43,.256,793,1568,.506,.502,368,465,.791,245,894,1139,409,120,178,212,202,1987,2004
Pat Garrity,PF,27,ORL,2,0,22,1,3,.333,0,0,.000,1,3,.333,.333,0,0,.000,0,0,0,1,0,0,0,2,2,2004
Pau Gasol,PF,23,MEM,78,78,2458,506,1049,.482,4,15,.267,502,1034,.485,.484,365,511,.714,206,394,600,198,44,132,187,185,1381,2004
Devean George,SF,26,LAL,82,48,1951,233,571,.408,65,186,.349,168,385,.436,.465,73,96,.760,87,245,332,112,81,38,88,189,604,2004
Eddie Gill,PG,25,POR,22,0,157,15,36,.417,3,8,.375,12,28,.429,.458,17,20,.850,4,13,17,16,9,1,12,16,50,2004
Kendall Gill,SG,35,CHI,56,35,1411,215,548,.392,9,38,.237,206,510,.404,.401,100,136,.735,61,129,190,89,65,16,83,107,539,2004
Manu Ginobili,SG,26,SAS,77,38,2260,330,789,.418,88,245,.359,242,544,.445,.474,239,298,.802,86,258,344,291,136,16,161,181,987,2004
Gordan Giricek,SF-SG,26,TOT,73,43,2041,316,724,.436,60,152,.395,256,572,.448,.478,135,158,.854,51,175,226,122,56,15,103,144,827,2004
Gordan Giricek,SF,26,ORL,48,25,1435,188,427,.440,46,113,.407,142,314,.452,.494,67,81,.827,37,127,164,80,41,10,63,98,489,2004
Gordan Giricek,SG,26,UTA,25,18,606,128,297,.431,14,39,.359,114,258,.442,.455,68,77,.883,14,48,62,42,15,5,40,46,338,2004
Dion Glover,SG,25,TOT,69,30,1643,230,589,.390,40,119,.336,190,470,.404,.424,120,156,.769,58,208,266,130,50,19,102,123,620,2004
Dion Glover,SG,25,ATL,55,26,1465,205,524,.391,36,105,.343,169,419,.403,.426,110,142,.775,54,183,237,115,40,17,83,106,556,2004
Dion Glover,SG,25,TOR,14,4,178,25,65,.385,4,14,.286,21,51,.412,.415,10,14,.714,4,25,29,15,10,2,19,17,64,2004
Anthony Goldwire,PG,32,TOT,11,0,85,7,22,.318,2,8,.250,5,14,.357,.364,1,1,1.000,1,6,7,11,5,0,3,5,17,2004
Anthony Goldwire,PG,32,MIN,5,0,66,5,14,.357,2,6,.333,3,8,.375,.429,1,1,1.000,1,5,6,10,3,0,2,5,13,2004
Anthony Goldwire,PG,32,NJN,6,0,19,2,8,.250,0,2,.000,2,6,.333,.250,0,0,.000,0,1,1,1,2,0,1,0,4,2004
Drew Gooden,PF,22,ORL,79,17,2134,369,829,.445,9,42,.214,360,787,.457,.451,167,262,.637,160,356,516,89,62,72,126,196,914,2004
Brian Grant,C,31,MIA,76,76,2303,289,613,.471,0,1,.000,289,612,.472,.471,86,110,.782,174,350,524,69,51,35,82,254,664,2004
Horace Grant,PF,38,LAL,55,10,1106,92,224,.411,0,1,.000,92,223,.413,.411,39,54,.722,79,154,233,71,24,21,29,70,223,2004
Paul Grant,C,30,UTA,10,0,98,11,23,.478,0,0,.000,11,23,.478,.478,3,8,.375,7,10,17,3,1,1,7,17,25,2004
Willie Green,SG,22,PHI,53,0,767,143,357,.401,19,61,.311,124,296,.419,.427,59,81,.728,16,49,65,53,26,5,59,83,364,2004
Adrian Griffin,SG,29,HOU,19,1,133,5,18,.278,1,2,.500,4,16,.250,.306,0,4,.000,1,18,19,10,7,2,3,17,11,2004
Tom Gugliotta,PF,34,TOT,55,27,819,70,203,.345,1,4,.250,69,199,.347,.347,20,28,.714,65,122,187,63,31,12,39,81,161,2004
Tom Gugliotta,PF,34,PHO,30,3,304,31,99,.313,0,1,.000,31,98,.316,.313,6,8,.750,15,41,56,21,14,4,20,34,68,2004
Tom Gugliotta,PF,34,UTA,25,24,515,39,104,.375,1,3,.333,38,101,.376,.380,14,20,.700,50,81,131,42,17,8,19,47,93,2004
Marcus Haislip,PF,23,MIL,31,0,263,36,74,.486,1,2,.500,35,72,.486,.493,20,28,.714,21,32,53,4,6,12,9,25,93,2004
Darvin Ham,SF,30,DET,54,2,484,37,75,.493,1,2,.500,36,73,.493,.500,21,35,.600,47,46,93,16,13,8,31,63,96,2004
Richard Hamilton,SG,25,DET,78,78,2772,530,1166,.455,18,68,.265,512,1098,.466,.462,297,342,.868,78,201,279,310,103,17,210,222,1375,2004
Zendon Hamilton,C,28,PHI,46,0,473,51,95,.537,0,0,.000,51,95,.537,.537,67,96,.698,49,97,146,13,8,8,27,74,169,2004
Ben Handlogten,C,30,UTA,17,0,172,25,47,.532,0,0,.000,25,47,.532,.532,18,27,.667,22,33,55,6,3,4,10,32,68,2004
Travis Hansen,SF,25,ATL,41,4,507,46,130,.354,9,30,.300,37,100,.370,.388,22,27,.815,30,40,70,19,10,9,15,67,123,2004
Anfernee Hardaway,SG,32,TOT,76,14,2095,279,679,.411,30,79,.380,249,600,.415,.433,111,138,.804,69,218,287,176,70,20,107,146,699,2004
Anfernee Hardaway,SG,32,PHO,34,10,876,120,271,.443,14,35,.400,106,236,.449,.469,42,49,.857,27,71,98,97,28,8,42,65,296,2004
Anfernee Hardaway,SG,32,NYK,42,4,1219,159,408,.390,16,44,.364,143,364,.393,.409,69,89,.775,42,147,189,79,42,12,65,81,403,2004
Matt Harpring,SF,27,UTA,31,31,1134,193,410,.471,8,33,.242,185,377,.491,.480,108,157,.688,91,156,247,63,22,2,65,102,502,2004
Al Harrington,PF,23,IND,79,15,2441,421,909,.463,21,77,.273,400,832,.481,.475,185,252,.734,163,345,508,131,80,22,163,250,1048,2004
Othella Harrington,PF,30,NYK,56,3,872,100,202,.495,0,0,.000,100,202,.495,.495,58,78,.744,58,119,177,29,12,14,65,134,258,2004
Lucious Harris,PG,33,NJN,69,15,1504,187,463,.404,38,101,.376,149,362,.412,.445,66,78,.846,39,101,140,135,41,2,53,74,478,2004
Jason Hart,PG,25,SAS,53,5,660,71,159,.447,2,9,.222,69,150,.460,.453,33,43,.767,10,69,79,81,28,5,29,59,177,2004
Donnell Harvey,PF,23,TOT,60,8,783,89,201,.443,0,3,.000,89,198,.449,.443,61,83,.735,48,116,164,21,24,27,45,129,239,2004
Donnell Harvey,PF,23,ORL,24,1,345,36,89,.404,0,3,.000,36,86,.419,.404,26,39,.667,29,43,72,8,10,11,22,44,98,2004
Donnell Harvey,PF,23,PHO,36,7,438,53,112,.473,0,0,.000,53,112,.473,.473,35,44,.795,19,73,92,13,14,16,23,85,141,2004
Udonis Haslem,PF,23,MIA,75,24,1795,205,447,.459,0,3,.000,205,444,.462,.459,140,183,.765,189,284,473,51,33,24,74,197,550,2004
Trenton Hassell,SG,24,MIN,81,74,2264,177,381,.465,4,13,.308,173,368,.470,.470,48,61,.787,68,189,257,133,36,54,46,200,406,2004
Jarvis Hayes,SF,22,WAS,70,42,2044,278,695,.400,40,131,.305,238,564,.422,.429,77,98,.786,71,193,264,106,71,11,110,157,673,2004
Brendan Haywood,C,24,WAS,77,59,1484,200,388,.515,0,1,.000,200,387,.517,.515,137,234,.585,186,201,387,43,32,100,80,154,537,2004
Shane Heal,PG,33,SAS,6,0,72,7,24,.292,4,18,.222,3,6,.500,.375,4,5,.800,1,3,4,5,1,0,5,2,22,2004
Alan Henderson,PF,31,ATL,6,0,68,10,21,.476,0,0,.000,10,21,.476,.476,4,6,.667,11,10,21,2,1,2,3,1,24,2004
Nene Hilario,PF,21,DEN,77,77,2504,334,630,.530,0,2,.000,334,628,.532,.530,240,352,.682,154,349,503,168,116,41,183,280,908,2004
Tyrone Hill,PF,35,MIA,5,0,38,3,5,.600,0,0,.000,3,5,.600,.600,3,4,.750,5,3,8,0,0,1,2,10,9,2004
Kirk Hinrich,PG,23,CHI,76,66,2706,318,823,.386,144,369,.390,174,454,.383,.474,135,168,.804,42,217,259,517,101,21,204,276,915,2004
Fred Hoiberg,SG,31,MIN,79,3,1804,178,383,.465,76,172,.442,102,211,.483,.564,98,116,.845,21,247,268,109,66,10,44,136,530,2004
Robert Horry,PF,33,SAS,81,1,1290,141,348,.405,41,108,.380,100,240,.417,.464,69,107,.645,108,164,272,101,48,49,55,165,392,2004
Eddie House,SG,25,LAC,60,10,1188,161,449,.359,51,136,.375,110,313,.351,.415,36,45,.800,28,110,138,148,65,4,63,92,409,2004
Allan Houston,SG,32,NYK,50,50,1799,340,781,.435,87,202,.431,253,579,.437,.491,157,172,.913,20,101,121,99,38,2,102,105,924,2004
Josh Howard,SF,23,DAL,67,29,1589,229,532,.430,20,66,.303,209,466,.448,.449,97,138,.703,149,219,368,97,69,54,67,168,575,2004
Juwan Howard,PF,30,ORL,81,77,2877,529,1169,.453,0,1,.000,529,1168,.453,.453,318,393,.809,171,399,570,158,54,22,178,284,1376,2004
Troy Hudson,PG,27,MIN,29,1,503,80,207,.386,31,77,.403,49,130,.377,.461,27,33,.818,4,31,35,70,7,0,34,32,218,2004
Larry Hughes,SG,25,WAS,61,61,2061,401,1009,.397,79,232,.341,322,777,.414,.437,267,335,.797,96,230,326,148,95,26,152,147,1148,2004
Ryan Humphrey,PF,24,MEM,2,0,11,1,4,.250,0,1,.000,1,3,.333,.250,0,0,.000,2,1,3,1,1,0,2,3,2,2004
Brandon Hunter,PF,23,BOS,36,12,406,53,116,.457,0,3,.000,53,113,.469,.457,19,43,.442,50,68,118,19,13,1,22,40,125,2004
Lindsey Hunter,SG,33,DET,33,8,661,49,143,.343,14,50,.280,35,93,.376,.392,5,8,.625,13,54,67,85,39,6,34,45,117,2004
Steven Hunter,C,22,ORL,59,23,789,82,155,.529,0,0,.000,82,155,.529,.529,23,69,.333,54,116,170,12,5,73,29,101,187,2004
Zydrunas Ilgauskas,C,28,CLE,81,81,2539,466,965,.483,2,7,.286,464,958,.484,.484,303,406,.746,279,374,653,109,39,201,163,277,1237,2004
Allen Iverson,SG,28,PHI,48,47,2040,435,1125,.387,57,199,.286,378,926,.408,.412,339,455,.745,34,144,178,324,115,5,209,87,1266,2004
Bobby Jackson,SG,30,SAC,50,0,1185,263,592,.444,81,219,.370,182,373,.488,.513,82,109,.752,55,119,174,105,49,8,63,106,689,2004
Jim Jackson,SF,33,HOU,80,80,3119,382,900,.424,162,405,.400,220,495,.444,.514,107,127,.843,52,435,487,226,86,23,175,227,1033,2004
Marc Jackson,PF,29,PHI,22,13,598,71,171,.415,0,1,.000,71,170,.418,.415,64,81,.790,45,81,126,18,12,6,24,45,206,2004
Mark Jackson,PG,38,HOU,42,3,577,34,100,.340,7,41,.171,27,59,.458,.375,28,39,.718,10,60,70,119,17,1,53,41,103,2004
Stephen Jackson,SF,25,ATL,80,78,2940,536,1261,.425,145,427,.340,391,834,.469,.483,233,297,.785,97,273,370,244,142,20,223,216,1450,2004
Casey Jacobsen,SF,22,PHO,78,13,1828,150,360,.417,75,180,.417,75,180,.417,.521,91,111,.820,42,159,201,98,48,9,68,144,466,2004
Jerome James,C,28,SEA,65,24,990,129,259,.498,0,0,.000,129,259,.498,.498,66,100,.660,78,152,230,32,20,60,82,180,324,2004
LeBron James,SG,19,CLE,79,79,3122,622,1492,.417,63,217,.290,559,1275,.438,.438,347,460,.754,99,333,432,465,130,58,273,149,1654,2004
Mike James,PG,28,TOT,81,55,2196,272,657,.414,106,281,.377,166,376,.441,.495,103,127,.811,28,206,234,339,96,3,124,156,753,2004
Mike James,PG,28,BOS,55,55,1684,213,510,.418,86,226,.381,127,284,.447,.502,76,95,.800,20,156,176,244,70,2,83,113,588,2004
Mike James,PG,28,DET,26,0,512,59,147,.401,20,55,.364,39,92,.424,.469,27,32,.844,8,50,58,95,26,1,41,43,165,2004
Antawn Jamison,SF,27,DAL,82,2,2376,488,913,.535,16,40,.400,472,873,.541,.543,220,294,.748,233,287,520,70,83,30,81,174,1212,2004
Marko Jaric,PG,25,LAC,58,50,1760,185,477,.388,51,150,.340,134,327,.410,.441,74,101,.733,44,131,175,281,93,20,115,132,495,2004
Chris Jefferies,SF-SG,23,TOT,21,2,195,27,72,.375,17,42,.405,10,30,.333,.493,13,20,.650,5,24,29,7,4,7,19,36,84,2004
Chris Jefferies,SG,23,TOR,2,0,8,3,6,.500,1,3,.333,2,3,.667,.583,1,1,1.000,0,1,1,1,0,0,1,0,8,2004
Chris Jefferies,SF,23,CHI,19,2,187,24,66,.364,16,39,.410,8,27,.296,.485,12,19,.632,5,23,28,6,4,7,18,36,76,2004
Richard Jefferson,SF,23,NJN,82,82,3133,555,1115,.498,48,132,.364,507,983,.516,.519,357,468,.763,109,355,464,315,92,28,198,224,1515,2004
Jared Jeffries,PF,22,WAS,82,38,1913,177,469,.377,5,30,.167,172,439,.392,.383,105,171,.614,180,244,424,93,48,28,107,212,464,2004
Britton Johnsen,C,24,ORL,20,4,290,17,59,.288,1,12,.083,16,47,.340,.297,7,16,.438,15,30,45,12,7,1,14,28,42,2004
Anthony Johnson,PG,29,IND,73,7,1598,167,411,.406,41,122,.336,126,289,.436,.456,75,94,.798,28,102,130,202,64,8,75,138,450,2004
Avery Johnson,PG,38,GSW,46,1,637,80,199,.402,0,3,.000,80,196,.408,.402,52,78,.667,3,30,33,111,26,3,51,34,212,2004
DerMarr Johnson,SF,23,NYK,21,1,287,36,97,.371,13,36,.361,23,61,.377,.438,28,31,.903,5,34,39,11,8,7,16,32,113,2004
Ervin Johnson,C,36,MIN,66,47,965,55,103,.534,0,1,.000,55,102,.539,.534,17,28,.607,61,171,232,24,27,43,30,156,127,2004
Joe Johnson,SG,22,PHO,82,77,3331,555,1291,.430,83,272,.305,472,1019,.463,.462,174,232,.750,80,305,385,362,93,26,199,177,1367,2004
Linton Johnson,SF,23,CHI,41,20,734,72,203,.355,7,33,.212,65,170,.382,.372,22,37,.595,59,124,183,27,37,32,37,90,173,2004
Dahntay Jones,SG,23,MEM,20,0,154,15,53,.283,1,4,.250,14,49,.286,.292,5,11,.455,7,16,23,12,5,6,12,23,36,2004
Damon Jones,PG,27,MIL,82,26,2016,210,524,.401,98,273,.359,112,251,.446,.494,55,72,.764,15,155,170,478,30,4,103,92,573,2004
Eddie Jones,SG,32,MIA,81,81,2998,473,1156,.409,177,479,.370,296,677,.437,.486,278,333,.835,38,270,308,258,92,34,129,226,1401,2004
Fred Jones,SG,24,IND,81,2,1508,123,311,.395,27,89,.303,96,222,.432,.439,124,149,.832,25,101,126,173,65,18,73,132,397,2004
James Jones,SF,23,IND,6,0,26,2,9,.222,1,4,.250,1,5,.200,.278,2,2,1.000,0,2,2,0,1,0,0,1,7,2004
Jumaine Jones,SG,24,BOS,42,2,373,33,96,.344,13,44,.295,20,52,.385,.411,14,23,.609,24,44,68,14,12,9,19,48,93,2004
Popeye Jones,PF,33,GSW,5,0,10,0,2,.000,0,0,.000,0,2,.000,.000,0,0,.000,1,0,1,0,0,0,0,2,0,2004
Chris Kaman,C,21,LAC,82,61,1843,200,435,.460,0,2,.000,200,433,.462,.460,99,142,.697,126,335,461,85,23,73,155,211,499,2004
Jason Kapono,SF,22,CLE,41,3,427,52,129,.403,21,44,.477,31,85,.365,.484,20,24,.833,19,36,55,14,13,2,21,41,145,2004
Jason Kidd,PG,30,NJN,67,66,2450,368,959,.384,94,293,.321,274,666,.411,.433,206,249,.827,85,343,428,618,122,14,214,110,1036,2004
Andrei Kirilenko,PF,22,UTA,78,78,2895,412,931,.443,68,201,.338,344,730,.471,.479,392,496,.790,226,403,629,244,150,215,215,174,1284,2004
Kerry Kittles,SG,29,NJN,82,82,2842,434,959,.453,97,276,.351,337,683,.493,.503,107,136,.787,56,271,327,206,125,40,95,144,1072,2004
Brevin Knight,PG,28,TOT,56,13,1037,105,246,.427,2,8,.250,103,238,.433,.431,49,65,.754,14,98,112,204,84,1,72,107,261,2004
Brevin Knight,PG,28,PHO,3,0,19,1,3,.333,0,0,.000,1,3,.333,.333,0,0,.000,0,3,3,4,3,1,3,1,2,2004
Brevin Knight,PG,28,WAS,32,12,598,58,138,.420,1,5,.200,57,133,.429,.424,19,27,.704,11,50,61,102,52,0,44,50,136,2004
Brevin Knight,PG,28,MIL,21,1,420,46,105,.438,1,3,.333,45,102,.441,.443,30,38,.789,3,45,48,98,29,0,25,56,123,2004
Kyle Korver,SF,22,PHI,74,0,882,115,327,.352,81,207,.391,34,120,.283,.476,19,24,.792,30,81,111,40,25,8,41,102,330,2004
Toni Kukoc,PF,35,MIL,73,0,1522,211,506,.417,49,168,.292,162,338,.479,.465,145,199,.729,60,211,271,200,59,21,110,110,616,2004
Christian Laettner,PF,34,WAS,48,18,984,119,256,.465,6,21,.286,113,235,.481,.477,40,50,.800,50,182,232,89,37,28,42,102,284,2004
Raef LaFrentz,C,27,BOS,17,1,328,57,124,.460,8,40,.200,49,84,.583,.492,10,13,.769,30,49,79,24,8,13,11,47,132,2004
Maciej Lampe,C,18,PHO,21,0,224,43,88,.489,0,4,.000,43,84,.512,.489,10,13,.769,9,35,44,9,3,3,15,28,96,2004
Sean Lampley,SF,24,GSW,10,0,63,13,20,.650,0,0,.000,13,20,.650,.650,8,12,.667,2,9,11,2,0,1,3,2,34,2004
Dan Langhi,SF,26,TOT,6,0,37,5,14,.357,1,2,.500,4,12,.333,.393,2,2,1.000,0,4,4,0,0,0,2,7,13,2004
Dan Langhi,SF,26,GSW,4,0,17,2,6,.333,0,0,.000,2,6,.333,.333,2,2,1.000,0,3,3,0,0,0,2,5,6,2004
Dan Langhi,SF,26,MIL,2,0,20,3,8,.375,1,2,.500,2,6,.333,.438,0,0,.000,0,1,1,0,0,0,0,2,7,2004
Rusty LaRue,PG,30,GSW,4,0,22,1,3,.333,1,1,1.000,0,2,.000,.500,1,2,.500,0,3,3,2,2,0,4,2,4,2004
Voshon Lenard,SG,30,DEN,73,70,2233,394,933,.422,106,289,.367,288,644,.447,.479,144,182,.791,46,154,200,151,61,12,101,177,1038,2004
Quincy Lewis,SF,26,MIN,14,0,65,7,20,.350,2,5,.400,5,15,.333,.400,0,0,.000,1,6,7,2,2,2,3,10,16,2004
Rashard Lewis,SF,24,SEA,80,80,2931,535,1229,.435,145,386,.376,390,843,.463,.494,206,270,.763,133,385,518,175,99,54,135,233,1421,2004
Randy Livingston,PG,28,LAC,4,0,48,2,10,.200,0,3,.000,2,7,.286,.200,4,6,.667,2,5,7,4,2,0,4,7,8,2004
Raul Lopez,PG,23,UTA,82,11,1617,223,517,.431,25,85,.294,198,432,.458,.456,101,117,.863,24,131,155,305,62,2,174,200,572,2004
Tyronn Lue,PG,26,ORL,76,69,2332,309,714,.433,80,209,.383,229,505,.453,.489,101,131,.771,26,161,187,317,61,5,124,185,799,2004
George Lynch,SF,33,NOH,78,51,1701,149,375,.397,43,139,.309,106,236,.449,.455,34,51,.667,96,216,312,117,48,18,64,159,375,2004
Mark Madsen,C,28,MIN,72,12,1246,101,204,.495,0,6,.000,101,198,.510,.495,57,118,.483,134,138,272,28,33,18,47,175,259,2004
Corey Maggette,SF,24,LAC,73,72,2628,453,1013,.447,76,231,.329,377,782,.482,.485,526,620,.848,96,334,430,224,65,16,207,217,1508,2004
Jamaal Magloire,C,25,NOH,82,82,2777,383,809,.473,0,1,.000,383,808,.474,.473,353,470,.751,268,579,847,86,43,101,201,278,1119,2004
Karl Malone,PF,40,LAL,42,42,1373,193,400,.483,0,1,.000,193,399,.484,.483,168,225,.747,61,306,367,163,50,20,103,116,554,2004
Stephon Marbury,PG,26,TOT,81,81,3254,598,1386,.431,87,274,.318,511,1112,.460,.463,356,436,.817,58,205,263,719,129,9,249,172,1639,2004
Stephon Marbury,PG,26,PHO,34,34,1415,262,606,.432,37,118,.314,225,488,.461,.463,147,185,.795,19,98,117,281,64,5,97,74,708,2004
Stephon Marbury,PG,26,NYK,47,47,1839,336,780,.431,50,156,.321,286,624,.458,.463,209,251,.833,39,107,146,438,65,4,152,98,931,2004
Shawn Marion,SF,25,PHO,79,79,3217,590,1341,.440,90,265,.340,500,1076,.465,.474,228,268,.851,212,525,737,214,167,104,156,203,1498,2004
Donyell Marshall,PF,30,TOT,82,74,2988,470,1020,.461,131,325,.403,339,695,.488,.525,134,182,.736,210,598,808,122,93,124,117,247,1205,2004
Donyell Marshall,PF,30,CHI,16,8,408,57,136,.419,11,27,.407,46,109,.422,.460,14,20,.700,28,71,99,28,13,20,22,47,139,2004
Donyell Marshall,PF,30,TOR,66,66,2580,413,884,.467,120,298,.403,293,586,.500,.535,120,162,.741,182,527,709,94,80,104,95,200,1066,2004
Darrick Martin,PG,32,MIN,16,0,172,20,67,.299,6,26,.231,14,41,.341,.343,9,9,1.000,2,5,7,23,2,1,7,23,55,2004
Kenyon Martin,PF,26,NJN,65,62,2252,439,900,.488,7,25,.280,432,875,.494,.492,201,294,.684,133,484,617,160,95,82,168,230,1086,2004
Jamal Mashburn,SF,31,NOH,19,18,730,156,398,.392,19,67,.284,137,331,.414,.416,65,80,.813,19,98,117,47,14,5,37,42,396,2004
Desmond Mason,SF,26,MIL,82,31,2534,409,867,.472,9,39,.231,400,828,.483,.477,356,463,.769,93,266,359,152,60,24,148,191,1183,2004
Roger Mason,SG,23,TOT,26,3,328,32,98,.327,13,39,.333,19,59,.322,.393,19,22,.864,1,30,31,26,11,6,20,36,96,2004
Roger Mason,SG,23,CHI,3,0,43,1,11,.091,1,6,.167,0,5,.000,.136,0,0,.000,0,3,3,3,1,0,2,5,3,2004
Roger Mason,SG,23,TOR,23,3,285,31,87,.356,12,33,.364,19,54,.352,.425,19,22,.864,1,27,28,23,10,6,18,31,93,2004
Tony Massenburg,PF,36,SAC,59,0,789,104,219,.475,0,1,.000,104,218,.477,.475,43,63,.683,57,131,188,29,14,18,45,144,251,2004
Walter McCarty,PF,29,BOS,77,23,1900,203,523,.388,137,366,.374,66,157,.420,.519,62,82,.756,28,211,239,124,72,22,91,179,605,2004
Amal McCaskill,C,30,PHI,59,3,636,47,117,.402,0,1,.000,47,116,.405,.402,19,27,.704,48,85,133,20,12,20,25,89,113,2004
Jelani McCoy,C,26,CLE,2,0,12,0,0,.000,0,0,.000,0,0,.000,.000,0,0,.000,1,3,4,0,0,0,1,4,0,2004
Antonio McDyess,PF,29,TOT,42,20,927,126,268,.470,0,0,.000,126,268,.470,.470,38,69,.551,70,187,257,36,37,24,57,117,290,2004
Antonio McDyess,PF,29,NYK,18,6,421,65,142,.458,0,0,.000,65,142,.458,.458,22,38,.579,31,88,119,20,12,11,27,46,152,2004
Antonio McDyess,PF,29,PHO,24,14,506,61,126,.484,0,0,.000,61,126,.484,.484,16,31,.516,39,99,138,16,25,13,30,71,138,2004
Tracy McGrady,SG,24,ORL,67,67,2675,653,1566,.417,174,513,.339,479,1053,.455,.473,398,500,.796,95,307,402,370,93,42,179,129,1878,2004
Jeff McInnis,SG-PG,29,TOT,70,57,2365,334,747,.447,46,127,.362,288,620,.465,.478,114,143,.797,33,143,176,430,72,6,120,163,828,2004
Jeff McInnis,SG,29,POR,39,26,1269,196,416,.471,15,47,.319,181,369,.491,.489,58,76,.763,16,78,94,196,36,2,61,94,465,2004
Jeff McInnis,PG,29,CLE,31,31,1096,138,331,.417,31,80,.388,107,251,.426,.464,56,67,.836,17,65,82,234,36,4,59,69,363,2004
Aaron McKie,SF,31,PHI,75,41,2112,265,577,.459,75,172,.436,190,405,.469,.524,84,111,.757,45,208,253,195,85,23,103,142,689,2004
Keith McLeod,PG,24,MIN,33,0,391,27,82,.329,1,10,.100,26,72,.361,.335,33,43,.767,5,29,34,59,16,1,29,39,88,2004
Stanislav Medvedenko,PF,24,LAL,68,38,1442,237,537,.441,0,3,.000,237,534,.444,.441,89,116,.767,148,195,343,57,38,18,59,191,563,2004
Ron Mercer,SG,27,SAS,39,0,516,90,211,.427,2,7,.286,88,204,.431,.431,13,17,.765,10,39,49,22,14,5,26,37,195,2004
Chris Mihm,C-PF,24,TOT,76,17,1330,186,381,.488,0,0,.000,186,381,.488,.488,110,166,.663,156,257,413,21,37,63,90,208,482,2004
Chris Mihm,PF,24,CLE,22,1,391,59,127,.465,0,0,.000,59,127,.465,.465,34,48,.708,47,93,140,10,9,22,25,58,152,2004
Chris Mihm,C,24,BOS,54,16,939,127,254,.500,0,0,.000,127,254,.500,.500,76,118,.644,109,164,273,11,28,41,65,150,330,2004
Darius Miles,SF,22,TOT,79,56,2079,365,753,.485,7,40,.175,358,713,.502,.489,124,193,.642,112,247,359,162,67,61,130,168,861,2004
Darius Miles,SF,22,CLE,37,16,888,143,331,.432,5,30,.167,138,301,.458,.440,39,72,.542,48,119,167,80,25,27,56,84,330,2004
Darius Miles,SF,22,POR,42,40,1191,222,422,.526,2,10,.200,220,412,.534,.528,85,121,.702,64,128,192,82,42,34,74,84,531,2004
Darko Milicic,C,18,DET,34,0,159,17,65,.262,0,1,.000,17,64,.266,.262,14,24,.583,11,32,43,7,7,15,13,33,48,2004
Andre Miller,PG,27,DEN,82,82,2838,430,941,.457,12,65,.185,418,876,.477,.463,342,411,.832,127,239,366,501,142,25,215,194,1214,2004
Brad Miller,PF,27,SAC,72,53,2621,373,731,.510,12,38,.316,361,693,.521,.518,256,329,.778,191,552,743,312,68,86,144,247,1014,2004
Mike Miller,SF,23,MEM,65,65,1770,270,616,.438,80,215,.372,190,401,.474,.503,102,141,.723,42,174,216,232,59,14,107,162,722,2004
Oliver Miller,C,33,MIN,48,1,506,53,100,.530,0,1,.000,53,99,.535,.530,15,23,.652,46,84,130,36,19,26,33,91,121,2004
Reggie Miller,SG,38,IND,80,80,2254,260,594,.438,134,334,.401,126,260,.485,.551,146,165,.885,18,170,188,249,65,11,68,96,800,2004
Yao Ming,C,23,HOU,82,82,2692,535,1025,.522,0,2,.000,535,1023,.523,.522,361,446,.809,197,538,735,122,22,156,204,273,1431,2004
Cuttino Mobley,SG,28,HOU,80,80,3229,460,1081,.426,164,420,.390,296,661,.448,.501,176,217,.811,40,322,362,258,107,33,180,179,1260,2004
Nazr Mohammed,C,26,TOT,80,24,1611,246,472,.521,0,0,.000,246,472,.521,.521,100,169,.592,178,296,474,36,55,52,96,195,592,2004
Nazr Mohammed,C,26,ATL,53,1,938,138,280,.493,0,0,.000,138,280,.493,.493,69,110,.627,101,166,267,20,22,27,55,113,345,2004
Nazr Mohammed,C,26,NYK,27,23,673,108,192,.563,0,0,.000,108,192,.563,.563,31,59,.525,77,130,207,16,33,25,41,82,247,2004
Jerome Moiso,PF,25,TOR,35,1,417,40,84,.476,0,1,.000,40,83,.482,.476,22,38,.579,41,72,113,8,17,12,25,42,102,2004
Mikki Moore,PF-C,28,TOT,32,0,395,50,99,.505,0,0,.000,50,99,.505,.505,30,35,.857,29,55,84,19,7,13,22,65,130,2004
Mikki Moore,C,28,NJN,4,0,10,1,5,.200,0,0,.000,1,5,.200,.200,0,0,.000,1,1,2,0,0,0,0,1,2,2004
Mikki Moore,PF,28,UTA,28,0,385,49,94,.521,0,0,.000,49,94,.521,.521,30,35,.857,28,54,82,19,7,13,22,64,128,2004
Alonzo Mourning,C,33,NJN,12,0,215,33,71,.465,0,0,.000,33,71,.465,.465,30,34,.882,8,19,27,8,2,6,10,32,96,2004
Troy Murphy,PF,23,GSW,28,0,610,107,243,.440,5,17,.294,102,226,.451,.451,60,80,.750,48,125,173,20,12,17,34,58,279,2004
Lamond Murray,SF,30,TOR,33,4,518,76,215,.353,21,60,.350,55,155,.355,.402,24,35,.686,14,76,90,28,15,7,38,47,197,2004
Ronald Murray,PG,24,SEA,82,18,2021,389,915,.425,67,229,.293,322,686,.469,.462,168,235,.715,45,159,204,205,81,28,149,158,1013,2004
Tracy Murray,SF,32,POR,7,0,35,3,12,.250,2,5,.400,1,7,.143,.333,0,1,.000,3,2,5,1,1,0,2,3,8,2004
Dikembe Mutombo,C,37,NYK,65,56,1494,141,295,.478,0,0,.000,141,295,.478,.478,81,119,.681,145,292,437,25,17,123,54,141,363,2004
Mamadou N'Diaye,C,28,TOT,28,1,366,27,69,.391,0,0,.000,27,69,.391,.391,44,59,.746,43,69,112,0,8,25,18,59,98,2004
Mamadou N'Diaye,C,28,DAL,3,0,7,0,1,.000,0,0,.000,0,1,.000,.000,0,0,.000,0,1,1,0,0,1,1,1,0,2004
Mamadou N'Diaye,C,28,ATL,25,1,359,27,68,.397,0,0,.000,27,68,.397,.397,44,59,.746,43,68,111,0,8,24,17,58,98,2004
Bostjan Nachbar,SF,23,HOU,45,3,516,47,132,.356,23,63,.365,24,69,.348,.443,21,29,.724,8,62,70,30,14,14,23,72,138,2004
Lee Nailon,PF-SF,28,TOT,57,4,780,147,327,.450,0,3,.000,147,324,.454,.450,47,58,.810,64,79,143,38,15,8,45,93,341,2004
Lee Nailon,PF,28,ATL,27,0,300,63,138,.457,0,0,.000,63,138,.457,.457,16,19,.842,26,37,63,17,10,7,24,48,142,2004
Lee Nailon,SF,28,ORL,8,0,83,11,27,.407,0,0,.000,11,27,.407,.407,7,9,.778,8,6,14,4,1,0,0,9,29,2004
Lee Nailon,SF,28,CLE,22,4,397,73,162,.451,0,3,.000,73,159,.459,.451,24,30,.800,30,36,66,17,4,1,21,36,170,2004
Eduardo Najera,SF,27,DAL,58,7,720,72,162,.444,2,4,.500,70,158,.443,.451,30,46,.652,67,89,156,25,35,19,29,90,176,2004
Steve Nash,PG,29,DAL,78,78,2612,397,845,.470,104,257,.405,293,588,.498,.531,230,251,.916,59,173,232,687,67,8,209,139,1128,2004
Rasho Nesterovic,C,27,SAS,82,82,2353,328,700,.469,0,0,.000,328,700,.469,.469,54,114,.474,257,376,633,114,51,165,107,247,710,2004
Ira Newble,SF,29,CLE,64,25,1245,108,276,.391,2,19,.105,106,257,.412,.395,36,46,.783,65,90,155,72,25,19,54,109,254,2004
Moochie Norris,PG,30,TOT,66,0,847,80,217,.369,20,58,.345,60,159,.377,.415,54,71,.761,10,55,65,121,44,5,64,51,234,2004
Moochie Norris,PG,30,HOU,30,0,401,27,87,.310,8,23,.348,19,64,.297,.356,18,24,.750,2,28,30,48,16,2,30,16,80,2004
Moochie Norris,PG,30,NYK,36,0,446,53,130,.408,12,35,.343,41,95,.432,.454,36,47,.766,8,27,35,73,28,3,34,35,154,2004
Dirk Nowitzki,C,25,DAL,77,77,2915,605,1310,.462,99,290,.341,506,1020,.496,.500,371,423,.877,90,580,670,207,92,104,135,216,1680,2004
Jermaine O'Neal,PF,25,IND,78,78,2788,608,1400,.434,2,18,.111,606,1382,.438,.435,348,460,.757,193,585,778,164,59,199,181,248,1566,2004
Shaquille O'Neal,C,31,LAL,67,67,2464,554,948,.584,0,0,.000,554,948,.584,.584,331,676,.490,246,523,769,196,34,166,195,225,1439,2004
Charles Oakley,PF,40,HOU,7,0,25,2,6,.333,0,0,.000,2,6,.333,.333,5,6,.833,0,5,5,2,0,0,1,8,9,2004
Lamar Odom,PF,24,MIA,80,80,3003,485,1127,.430,61,205,.298,424,922,.460,.457,340,458,.742,160,616,776,327,85,71,236,273,1371,2004
Mehmet Okur,PF,24,DET,71,33,1580,251,542,.463,18,48,.375,233,494,.472,.480,162,209,.775,160,261,421,69,36,63,101,138,682,2004
Kevin Ollie,PG,31,CLE,82,7,1401,95,257,.370,4,9,.444,91,248,.367,.377,147,176,.835,23,147,170,234,51,8,81,119,341,2004
Michael Olowokandi,C,28,MIN,43,25,925,121,285,.425,0,0,.000,121,285,.425,.425,36,61,.590,78,167,245,24,16,68,54,137,278,2004
Greg Ostertag,C,30,UTA,78,51,2153,208,437,.476,0,1,.000,208,436,.477,.476,113,195,.579,221,357,578,123,30,139,99,228,529,2004
Bo Outlaw,PF,32,MEM,82,1,1606,159,312,.510,0,4,.000,159,308,.516,.510,61,116,.526,125,217,342,90,73,70,69,170,379,2004
Travis Outlaw,PF,19,POR,8,0,19,3,7,.429,0,0,.000,3,7,.429,.429,2,4,.500,2,2,4,1,1,0,1,1,8,2004
Doug Overton,PG,34,TOT,61,11,1033,99,245,.404,3,23,.130,96,222,.432,.410,23,31,.742,16,70,86,138,26,2,58,89,224,2004
Doug Overton,PG,34,NJN,6,0,22,3,8,.375,0,0,.000,3,8,.375,.375,2,2,1.000,0,1,1,4,1,0,2,4,8,2004
Doug Overton,PG,34,LAC,55,11,1011,96,237,.405,3,23,.130,93,214,.435,.411,21,29,.724,16,69,85,134,25,2,56,85,216,2004
Zaza Pachulia,C,19,ORL,59,2,664,68,175,.389,0,0,.000,68,175,.389,.389,58,90,.644,69,105,174,13,21,12,34,87,194,2004
Robert Pack,PG,34,NJN,26,0,220,22,52,.423,0,0,.000,22,52,.423,.423,5,6,.833,4,14,18,27,12,1,16,20,49,2004
Scott Padgett,PF,27,HOU,58,5,547,74,167,.443,28,65,.431,46,102,.451,.527,24,32,.750,46,93,139,23,12,13,22,73,200,2004
Milt Palacio,PG,25,TOR,59,13,1211,104,298,.349,4,26,.154,100,272,.368,.356,45,68,.662,15,87,102,184,41,11,87,90,257,2004
Jannero Pargo,PG,24,TOT,31,1,479,81,199,.407,22,62,.355,59,137,.431,.462,23,27,.852,8,29,37,70,13,6,47,50,207,2004
Jannero Pargo,PG,24,LAL,13,0,63,6,16,.375,2,4,.500,4,12,.333,.438,0,0,.000,0,6,6,11,2,0,12,5,14,2004
Jannero Pargo,PG,24,TOR,5,0,71,9,29,.310,0,5,.000,9,24,.375,.310,0,0,.000,0,4,4,12,4,1,5,7,18,2004
Jannero Pargo,PG,24,CHI,13,1,345,66,154,.429,20,53,.377,46,101,.455,.494,23,27,.852,8,19,27,47,7,5,30,38,175,2004
Tony Parker,PG,21,SAS,75,75,2577,423,946,.447,62,199,.312,361,747,.483,.480,191,272,.702,43,194,237,411,61,7,179,148,1099,2004
Cherokee Parks,C,31,GSW,12,0,64,4,10,.400,0,0,.000,4,10,.400,.400,4,6,.667,4,6,10,1,0,3,2,7,12,2004
Ruben Patterson,SF,28,POR,73,1,1651,200,395,.506,2,12,.167,198,383,.517,.509,105,190,.553,129,139,268,139,84,21,105,152,507,2004
Sasha Pavlovic,SF,20,UTA,79,14,1144,149,376,.396,19,70,.271,130,306,.425,.422,65,84,.774,44,115,159,60,41,16,67,187,382,2004
Gary Payton,PG,35,LAL,82,82,2825,482,1024,.471,55,165,.333,427,859,.497,.498,180,252,.714,72,270,342,449,96,19,151,169,1199,2004
Anthony Peeler,SG,34,SAC,75,0,1391,156,348,.448,68,141,.482,88,207,.425,.546,51,61,.836,31,122,153,120,56,10,77,103,431,2004
Desmond Penigar,PF,22,ORL,10,0,89,14,28,.500,0,0,.000,14,28,.500,.500,4,4,1.000,6,18,24,3,2,2,6,14,32,2004
Kirk Penney,SG,23,MIA,2,0,18,1,6,.167,1,3,.333,0,3,.000,.250,0,0,.000,0,1,1,1,1,0,3,1,3,2004
Kendrick Perkins,C,19,BOS,10,0,35,8,15,.533,0,0,.000,8,15,.533,.533,6,9,.667,5,9,14,3,0,2,5,6,22,2004
Wesley Person,SG,32,TOT,58,0,1037,126,314,.401,55,138,.399,71,176,.403,.489,31,39,.795,16,101,117,66,19,9,38,38,338,2004
Wesley Person,SG,32,MEM,16,0,284,33,107,.308,11,43,.256,22,64,.344,.360,6,8,.750,2,16,18,23,5,2,16,11,83,2004
Wesley Person,SG,32,POR,33,0,621,80,168,.476,36,76,.474,44,92,.478,.583,19,25,.760,12,62,74,38,11,6,18,22,215,2004
Wesley Person,SG,32,ATL,9,0,132,13,39,.333,8,19,.421,5,20,.250,.436,6,6,1.000,2,23,25,5,3,1,4,5,40,2004
Morris Peterson,SF,26,TOR,82,29,2148,238,587,.405,126,340,.371,112,247,.453,.513,76,94,.809,35,226,261,113,88,14,69,206,678,2004
Eric Piatkowski,SF,33,HOU,49,0,703,72,191,.377,43,122,.352,29,69,.420,.490,14,16,.875,10,63,73,26,16,5,29,42,201,2004
Paul Pierce,SG,26,BOS,80,80,3099,602,1497,.402,115,384,.299,487,1113,.438,.441,517,631,.819,69,453,522,410,131,52,303,234,1836,2004
Mickael Pietrus,PG,21,GSW,53,22,748,96,231,.416,35,105,.333,61,126,.484,.491,52,75,.693,48,71,119,27,32,12,40,100,279,2004
Scottie Pippen,SF,38,CHI,23,6,412,53,140,.379,13,48,.271,40,92,.435,.425,17,27,.630,20,48,68,50,21,9,29,38,136,2004
Zoran Planinic,SG,21,NJN,49,1,473,53,129,.411,9,32,.281,44,97,.454,.446,38,60,.633,14,41,55,68,13,3,36,70,153,2004
Scot Pollard,C,28,IND,61,3,678,47,114,.412,0,0,.000,47,114,.412,.412,12,21,.571,67,97,164,10,23,26,22,110,106,2004
Olden Polynice,C,39,LAC,2,0,12,0,0,.000,0,0,.000,0,0,.000,.000,0,0,.000,1,1,2,1,1,0,4,2,0,2004
Mark Pope,PF,31,DEN,4,0,20,1,2,.500,0,0,.000,1,2,.500,.500,0,1,.000,0,3,3,0,1,0,3,8,2,2004
James Posey,SG,27,MEM,82,82,2451,368,770,.478,112,290,.386,256,480,.533,.551,278,335,.830,92,311,403,122,137,40,112,248,1126,2004
Vitaly Potapenko,C,28,SEA,65,39,1419,200,409,.489,0,0,.000,200,409,.489,.489,59,92,.641,101,188,289,53,22,28,77,161,459,2004
Tayshaun Prince,SF,23,DET,82,80,2701,338,723,.467,57,157,.363,281,566,.496,.507,108,141,.766,93,297,390,191,63,69,119,149,841,2004
Joel Przybilla,C,24,TOT,17,12,347,18,50,.360,0,0,.000,18,50,.360,.360,13,31,.419,32,79,111,7,5,17,18,53,49,2004
Joel Przybilla,C,24,MIL,5,0,33,0,0,.000,0,0,.000,0,0,.000,.000,1,2,.500,1,9,10,3,0,0,2,5,1,2004
Joel Przybilla,C,24,ATL,12,12,314,18,50,.360,0,0,.000,18,50,.360,.360,12,29,.414,31,70,101,4,5,17,16,48,48,2004
Vladimir Radmanovic,PF,23,SEA,77,38,2321,345,812,.425,140,377,.371,205,435,.471,.511,95,127,.748,104,302,406,142,80,42,109,187,925,2004
Zach Randolph,PF,22,POR,81,80,3067,663,1368,.485,1,5,.200,662,1363,.486,.485,299,393,.761,242,609,851,163,68,41,247,227,1626,2004
Theo Ratliff,C,30,TOT,85,83,2664,266,549,.485,0,0,.000,266,549,.485,.485,140,217,.645,195,419,614,71,54,307,120,300,672,2004
Theo Ratliff,C,30,ATL,53,52,1648,171,373,.458,0,0,.000,171,373,.458,.458,96,147,.653,105,276,381,51,30,166,86,189,438,2004
Theo Ratliff,C,30,POR,32,31,1016,95,176,.540,0,0,.000,95,176,.540,.540,44,70,.629,90,143,233,20,24,141,34,111,234,2004
Zeljko Rebraca,C,31,TOT,24,2,273,34,77,.442,0,0,.000,34,77,.442,.442,23,30,.767,23,35,58,6,5,11,17,52,91,2004
Zeljko Rebraca,C,31,DET,21,2,222,22,54,.407,0,0,.000,22,54,.407,.407,22,28,.786,19,30,49,4,5,9,13,45,66,2004
Zeljko Rebraca,C,31,ATL,3,0,51,12,23,.522,0,0,.000,12,23,.522,.522,1,2,.500,4,5,9,2,0,2,4,7,25,2004
Michael Redd,SG,24,MIL,82,82,3021,633,1439,.440,127,363,.350,506,1076,.470,.484,383,441,.868,118,289,407,185,81,6,116,152,1776,2004
Glen Rice,SF,36,LAC,18,0,262,22,76,.289,5,28,.179,17,48,.354,.322,17,17,1.000,9,32,41,24,6,0,13,22,66,2004
Jason Richardson,SG,23,GSW,78,78,2936,563,1284,.438,77,273,.282,486,1011,.481,.468,258,377,.684,124,400,524,226,86,41,196,182,1461,2004
Quentin Richardson,SG,23,LAC,65,64,2338,425,1068,.398,120,341,.352,305,727,.420,.454,151,204,.740,146,268,414,139,67,19,141,130,1121,2004
Luke Ridnour,PG,22,SEA,69,6,1114,145,350,.414,27,80,.338,118,270,.437,.453,65,79,.823,35,73,108,163,52,7,80,105,382,2004
Clifford Robinson,PF,37,GSW,82,82,2846,366,945,.387,112,314,.357,254,631,.403,.447,123,173,.711,54,268,322,271,68,73,173,237,967,2004
Eddie Robinson,SF,27,CHI,51,4,1024,157,326,.482,1,5,.200,156,321,.486,.483,28,43,.651,27,77,104,58,33,10,45,57,343,2004
Glenn Robinson,SF,31,PHI,42,42,1336,275,614,.448,34,100,.340,241,514,.469,.476,114,137,.832,46,143,189,57,42,9,106,96,698,2004
Rodney Rogers,PF,32,NJN,69,15,1409,207,505,.410,50,152,.329,157,353,.445,.459,75,98,.765,100,207,307,137,59,27,98,183,539,2004
Sean Rooks,C,34,TOT,55,0,595,54,151,.358,0,1,.000,54,150,.360,.358,33,37,.892,24,73,97,29,14,10,22,89,141,2004
Sean Rooks,C,34,NOH,35,0,325,34,94,.362,0,0,.000,34,94,.362,.362,12,15,.800,10,40,50,11,9,5,15,48,80,2004
Sean Rooks,C,34,ORL,20,0,270,20,57,.351,0,1,.000,20,56,.357,.351,21,22,.955,14,33,47,18,5,5,7,41,61,2004
Jalen Rose,PG-SF,31,TOT,66,64,2497,383,952,.402,69,202,.342,314,750,.419,.439,187,231,.810,34,232,266,329,51,22,208,184,1022,2004
Jalen Rose,SF,31,CHI,16,14,529,75,200,.375,23,54,.426,52,146,.356,.433,39,51,.765,7,57,64,56,12,4,37,45,212,2004
Jalen Rose,PG,31,TOR,50,50,1968,308,752,.410,46,148,.311,262,604,.434,.440,148,180,.822,27,175,202,273,39,18,171,139,810,2004
Malik Rose,PF,29,SAS,67,13,1256,173,404,.428,0,3,.000,173,401,.431,.428,183,225,.813,110,210,320,69,36,24,112,164,529,2004
Michael Ruffin,PF,27,UTA,41,23,733,38,117,.325,0,0,.000,38,117,.325,.325,16,38,.421,78,129,207,41,22,21,42,103,92,2004
Kareem Rush,SG,23,LAL,72,15,1244,190,432,.440,48,138,.348,142,294,.483,.495,31,52,.596,20,77,97,59,33,20,48,109,459,2004
Bryon Russell,SF,33,LAL,72,1,945,98,244,.402,43,112,.384,55,132,.417,.490,50,65,.769,32,114,146,71,32,12,37,110,289,2004
John Salmons,SG,24,PHI,77,24,1603,161,416,.387,50,147,.340,111,269,.413,.447,71,92,.772,38,158,196,134,62,16,77,122,443,2004
Jamal Sampson,C,20,LAL,10,2,130,11,23,.478,0,0,.000,11,23,.478,.478,7,12,.583,23,29,52,7,2,4,6,16,29,2004
Daniel Santiago,C,27,MIL,54,28,708,78,163,.479,0,0,.000,78,163,.479,.479,61,90,.678,35,97,132,24,19,21,32,98,217,2004
Brian Scalabrine,PF,25,NJN,69,2,928,86,218,.394,10,41,.244,76,177,.429,.417,58,70,.829,42,131,173,65,21,14,42,113,240,2004
Ansu Sesay,SF,27,SEA,57,2,583,81,178,.455,6,21,.286,75,157,.478,.472,32,46,.696,43,49,92,19,19,20,23,66,200,2004
Paul Shirley,PF,26,CHI,7,0,86,10,23,.435,0,1,.000,10,22,.455,.435,1,3,.333,8,8,16,4,1,1,9,9,21,2004
Bobby Simmons,SF,23,LAC,56,8,1376,147,373,.394,2,12,.167,145,361,.402,.397,141,169,.834,115,147,262,96,51,17,73,169,437,2004
Brian Skinner,C,27,MIL,56,54,1577,255,513,.497,0,0,.000,255,513,.497,.497,79,138,.572,119,292,411,49,30,61,78,165,589,2004
Tamar Slay,SG,23,NJN,22,0,165,21,60,.350,4,12,.333,17,48,.354,.383,7,14,.500,10,15,25,14,7,1,11,20,53,2004
Jabari Smith,C,26,SAC,31,0,168,26,70,.371,0,3,.000,26,67,.388,.371,12,20,.600,11,20,31,11,2,6,7,25,64,2004
Joe Smith,PF,28,MIL,76,76,2254,311,708,.439,1,5,.200,310,703,.441,.440,207,241,.859,230,413,643,78,47,94,82,209,830,2004
Leon Smith,C,23,SEA,1,0,4,1,2,.500,0,0,.000,1,2,.500,.500,0,0,.000,1,1,2,0,0,0,0,1,2,2004
Steve Smith,SG,34,NOH,71,4,929,119,293,.406,43,107,.402,76,186,.409,.480,77,83,.928,27,54,81,56,15,6,42,91,358,2004
Theron Smith,SF,23,MEM,20,0,178,16,43,.372,6,12,.500,10,31,.323,.442,6,8,.750,13,28,41,7,5,5,14,18,44,2004
Eric Snow,PG,30,PHI,82,82,2966,295,715,.413,2,18,.111,293,697,.420,.414,252,316,.797,62,219,281,563,97,6,187,213,844,2004
Darius Songaila,PF,25,SAC,73,7,976,133,273,.487,0,0,.000,133,273,.487,.487,71,88,.807,91,134,225,48,42,12,43,126,337,2004
Latrell Sprewell,SF,33,MIN,82,82,3100,518,1266,.409,99,299,.331,419,967,.433,.448,240,295,.814,56,254,310,286,88,21,158,101,1375,2004
Jerry Stackhouse,SF,29,WAS,26,17,774,128,321,.399,23,65,.354,105,256,.410,.435,83,103,.806,16,78,94,103,24,3,88,49,362,2004
Vladimir Stepania,C,27,POR,42,2,453,43,103,.417,0,0,.000,43,103,.417,.417,22,36,.611,50,75,125,23,11,15,19,61,108,2004
DeShawn Stevenson,SG-SF,22,TOT,80,78,2444,376,871,.432,19,71,.268,357,800,.446,.443,138,204,.676,79,219,298,158,52,17,120,140,909,2004
DeShawn Stevenson,SG,22,UTA,54,54,1511,261,586,.445,7,30,.233,254,556,.457,.451,89,133,.669,43,135,178,92,28,16,80,86,618,2004
DeShawn Stevenson,SF,22,ORL,26,24,933,115,285,.404,12,41,.293,103,244,.422,.425,49,71,.690,36,84,120,66,24,1,40,54,291,2004
Michael Stewart,C-PF,28,TOT,25,2,147,5,12,.417,0,0,.000,5,12,.417,.417,3,4,.750,8,21,29,0,2,10,3,34,13,2004
Michael Stewart,PF,28,CLE,8,2,76,3,7,.429,0,0,.000,3,7,.429,.429,2,2,1.000,5,13,18,0,1,8,1,21,8,2004
Michael Stewart,C,28,BOS,17,0,71,2,5,.400,0,0,.000,2,5,.400,.400,1,2,.500,3,8,11,0,1,2,2,13,5,2004
Peja Stojakovic,SF,26,SAC,81,81,3264,665,1386,.480,240,554,.433,425,832,.511,.566,394,425,.927,91,417,508,173,108,14,153,159,1964,2004
Damon Stoudamire,PG,30,POR,82,82,3118,408,1018,.401,156,427,.365,252,591,.426,.477,127,145,.876,52,256,308,500,99,9,180,173,1099,2004
Amar'e Stoudemire,PF,21,PHO,55,53,2025,411,865,.475,1,5,.200,410,860,.477,.476,310,435,.713,157,339,496,78,64,89,177,188,1133,2004
Erick Strickland,PG,30,MIL,43,0,571,79,196,.403,29,66,.439,50,130,.385,.477,44,51,.863,13,58,71,90,26,2,54,63,231,2004
Rod Strickland,PG,37,TOT,61,10,1197,150,353,.425,10,36,.278,140,317,.442,.439,72,98,.735,34,121,155,244,35,11,85,76,382,2004
Rod Strickland,PG,37,ORL,46,9,915,122,269,.454,10,33,.303,112,236,.475,.472,57,76,.750,24,94,118,185,27,7,67,59,311,2004
Rod Strickland,PG,37,TOR,15,1,282,28,84,.333,0,3,.000,28,81,.346,.333,15,22,.682,10,27,37,59,8,4,18,17,71,2004
Bruno Sundov,C,23,TOT,5,0,33,4,10,.400,0,0,.000,4,10,.400,.400,3,6,.500,2,8,10,1,0,0,3,9,11,2004
Bruno Sundov,C,23,CLE,4,0,29,3,9,.333,0,0,.000,3,9,.333,.333,3,6,.500,2,8,10,0,0,0,3,7,9,2004
Bruno Sundov,C,23,NYK,1,0,4,1,1,1.000,0,0,.000,1,1,1.000,1.000,0,0,.000,0,0,0,1,0,0,0,2,2,2004
Bob Sura,SG,30,TOT,80,18,1663,202,485,.416,21,79,.266,181,406,.446,.438,171,226,.757,100,226,326,233,62,14,105,158,596,2004
Bob Sura,SG,30,DET,53,0,707,71,173,.410,9,36,.250,62,137,.453,.436,48,69,.696,30,73,103,89,37,9,39,86,199,2004
Bob Sura,SG,30,ATL,27,18,956,131,312,.420,12,43,.279,119,269,.442,.439,123,157,.783,70,153,223,144,25,5,66,72,397,2004
Mike Sweetney,PF,21,NYK,42,1,494,69,140,.493,0,1,.000,69,139,.496,.493,42,58,.724,68,89,157,14,18,12,32,57,180,2004
Stromile Swift,PF,24,MEM,77,10,1528,268,571,.469,1,4,.250,267,567,.471,.470,190,262,.725,141,237,378,38,56,118,88,188,727,2004
Wally Szczerbiak,SF,26,MIN,28,0,622,106,236,.449,20,46,.435,86,190,.453,.492,53,64,.828,24,64,88,33,12,1,28,42,285,2004
Maurice Taylor,PF,27,HOU,75,10,2081,367,765,.480,0,2,.000,367,763,.481,.480,128,174,.736,131,253,384,107,43,47,149,253,862,2004
Jason Terry,PG,26,ATL,81,78,3018,499,1196,.417,146,421,.347,353,775,.455,.478,215,260,.827,49,287,336,437,124,16,229,192,1359,2004
Etan Thomas,C,25,WAS,79,15,1901,257,526,.489,0,0,.000,257,526,.489,.489,191,295,.647,183,345,528,68,36,123,113,219,705,2004
Kenny Thomas,PF,26,PHI,74,72,2699,381,813,.469,1,5,.200,380,808,.470,.469,243,323,.752,261,489,750,111,82,33,172,219,1006,2004
Kurt Thomas,PF,31,NYK,80,75,2548,392,829,.473,0,3,.000,392,826,.475,.473,106,127,.835,145,517,662,149,56,80,132,298,890,2004
Tim Thomas,SF,26,TOT,66,65,2089,363,813,.446,73,194,.376,290,619,.468,.491,171,218,.784,64,256,320,124,64,20,116,196,970,2004
Tim Thomas,SF,26,MIL,42,42,1343,226,510,.443,47,130,.362,179,380,.471,.489,93,122,.762,38,167,205,90,40,15,73,127,592,2004
Tim Thomas,SF,26,NYK,24,23,746,137,303,.452,26,64,.406,111,239,.464,.495,78,96,.813,26,89,115,34,24,5,43,69,378,2004
Jamaal Tinsley,PG,25,IND,52,43,1378,153,370,.414,77,207,.372,76,163,.466,.518,49,67,.731,28,108,136,303,84,17,110,132,432,2004
Robert Traylor,C,26,NOH,71,0,942,145,287,.505,2,5,.400,143,282,.507,.509,70,128,.547,106,156,262,43,39,37,62,161,362,2004
Gary Trent,C,29,MIN,68,2,1025,155,328,.473,0,6,.000,155,322,.481,.473,69,91,.758,83,133,216,49,12,17,54,129,379,2004
Jeff Trepagnier,SG,24,DEN,11,0,96,10,38,.263,2,4,.500,8,34,.235,.289,3,6,.500,6,9,15,4,3,0,6,7,25,2004
Cezary Trybanski,C,24,TOT,7,0,15,0,4,.000,0,0,.000,0,4,.000,.000,1,2,.500,0,1,1,0,1,1,2,3,1,2004
Cezary Trybanski,C,24,PHO,4,0,10,0,2,.000,0,0,.000,0,2,.000,.000,0,0,.000,0,1,1,0,0,1,2,1,0,2004
Cezary Trybanski,C,24,NYK,3,0,5,0,2,.000,0,0,.000,0,2,.000,.000,1,2,.500,0,0,0,0,1,0,0,2,1,2004
Jake Tsakalidis,C,24,MEM,40,28,533,67,133,.504,0,0,.000,67,133,.504,.504,36,61,.590,37,91,128,18,9,22,23,79,170,2004
Nikoloz Tskitishvili,PF,20,DEN,39,0,307,40,122,.328,3,11,.273,37,111,.333,.340,23,29,.793,24,39,63,10,6,8,17,50,106,2004
Hedo Turkoglu,SF,24,SAS,80,44,2073,262,645,.406,101,241,.419,161,404,.399,.484,114,161,.708,52,306,358,154,80,32,94,165,739,2004
Ime Udoka,SF,26,LAL,4,0,28,3,9,.333,0,1,.000,3,8,.375,.333,2,4,.500,1,4,5,2,2,1,3,3,8,2004
Nick Van Exel,PG,32,GSW,39,29,1255,187,479,.390,46,150,.307,141,329,.429,.438,70,99,.707,16,88,104,206,20,2,78,57,490,2004
Keith Van Horn,SF,28,TOT,72,62,2340,410,903,.454,93,233,.399,317,670,.473,.506,249,290,.859,149,352,501,120,68,33,169,215,1162,2004
Keith Van Horn,SF,28,NYK,47,47,1574,273,613,.445,60,161,.373,213,452,.471,.494,163,199,.819,98,245,343,83,52,18,119,151,769,2004
Keith Van Horn,SF,28,MIL,25,15,766,137,290,.472,33,72,.458,104,218,.477,.529,86,91,.945,51,107,158,37,16,15,50,64,393,2004
Jacque Vaughn,PG,28,ATL,71,6,1271,107,277,.386,3,20,.150,104,257,.405,.392,53,68,.779,12,104,116,195,44,2,84,126,270,2004
Jake Voskuhl,C,26,PHO,66,43,1606,152,300,.507,0,0,.000,152,300,.507,.507,134,181,.740,123,220,343,57,42,25,77,258,438,2004
Slavko Vranes,C,21,POR,1,0,3,0,1,.000,0,0,.000,0,1,.000,.000,0,0,.000,0,0,0,0,0,0,0,1,0,2004
Dwyane Wade,PG,22,MIA,61,56,2126,371,798,.465,16,53,.302,355,745,.477,.475,233,312,.747,85,162,247,275,86,34,196,140,991,2004
Dajuan Wagner,SG,20,CLE,44,4,708,112,306,.366,31,86,.360,81,220,.368,.417,32,47,.681,9,49,58,51,26,7,41,89,287,2004
Antoine Walker,PF,27,DAL,82,82,2840,483,1129,.428,82,305,.269,401,824,.487,.464,103,186,.554,198,486,684,369,65,65,202,212,1151,2004
Samaki Walker,PF,27,MIA,33,0,418,38,99,.384,0,2,.000,38,97,.392,.384,29,44,.659,42,70,112,6,9,11,15,54,105,2004
Ben Wallace,C,29,DET,81,81,3050,315,748,.421,1,8,.125,314,740,.424,.422,142,290,.490,324,682,1006,138,143,246,123,162,773,2004
Gerald Wallace,SF,21,SAC,37,1,337,32,89,.360,0,2,.000,32,87,.368,.360,11,24,.458,35,39,74,19,14,14,8,37,75,2004
John Wallace,SF,29,MIA,37,0,368,61,145,.421,5,13,.385,56,132,.424,.438,31,40,.775,12,47,59,14,5,8,24,38,158,2004
Rasheed Wallace,PF,29,TOT,68,66,2390,425,974,.436,82,248,.331,343,726,.472,.478,156,212,.736,102,357,459,156,61,122,119,190,1088,2004
Rasheed Wallace,PF,29,POR,45,44,1675,296,669,.442,59,173,.341,237,496,.478,.487,115,155,.742,69,229,298,114,36,72,87,131,766,2004
Rasheed Wallace,PF,29,ATL,1,1,42,8,24,.333,1,6,.167,7,18,.389,.354,3,3,1.000,1,5,6,2,1,5,3,0,20,2004
Rasheed Wallace,PF,29,DET,22,21,673,121,281,.431,22,69,.319,99,212,.467,.470,38,54,.704,32,123,155,40,24,45,29,59,302,2004
Luke Walton,PF,23,LAL,72,2,730,65,153,.425,13,39,.333,52,114,.456,.467,31,44,.705,39,88,127,113,28,8,44,70,174,2004
Charlie Ward,PG,33,TOT,71,10,1252,160,390,.410,84,206,.408,76,184,.413,.518,20,27,.741,12,132,144,215,64,11,96,107,424,2004
Charlie Ward,PG,33,NYK,35,10,827,115,260,.442,59,138,.428,56,122,.459,.556,16,21,.762,10,86,96,170,47,8,69,74,305,2004
Charlie Ward,PG,33,SAS,36,0,425,45,130,.346,25,68,.368,20,62,.323,.442,4,6,.667,2,46,48,45,17,3,27,33,119,2004
Earl Watson,PG,24,MEM,81,14,1669,172,464,.371,26,106,.245,146,358,.408,.399,90,138,.652,49,129,178,402,91,19,146,175,460,2004
Clarence Weatherspoon,PF,33,TOT,52,1,868,104,211,.493,0,1,.000,104,210,.495,.493,53,72,.736,74,130,204,30,30,15,35,75,261,2004
Clarence Weatherspoon,PF,33,NYK,15,1,216,18,40,.450,0,0,.000,18,40,.450,.450,18,19,.947,14,36,50,13,8,2,9,19,54,2004
Clarence Weatherspoon,PF,33,HOU,37,0,652,86,171,.503,0,1,.000,86,170,.506,.503,35,53,.660,60,94,154,17,22,13,26,56,207,2004
Chris Webber,PF,30,SAC,23,23,831,174,421,.413,1,5,.200,173,416,.416,.414,81,114,.711,48,152,200,105,31,20,60,76,430,2004
Bonzi Wells,SG,27,TOT,72,27,1872,363,850,.427,22,69,.319,341,781,.437,.440,138,183,.754,78,182,260,139,91,19,161,197,886,2004
Bonzi Wells,SG,27,POR,13,10,404,68,175,.389,1,8,.125,67,167,.401,.391,21,27,.778,21,40,61,35,20,3,32,38,158,2004
Bonzi Wells,SG,27,MEM,59,17,1468,295,675,.437,21,61,.344,274,614,.446,.453,117,156,.750,57,142,199,104,71,16,129,159,728,2004
Jiri Welsch,SG,24,BOS,81,68,2179,262,612,.428,69,181,.381,193,431,.448,.484,153,206,.743,60,236,296,183,101,7,129,176,746,2004
David Wesley,SG,33,NOH,61,60,2001,311,800,.389,92,285,.323,219,515,.425,.446,137,182,.753,28,106,134,175,71,14,100,147,851,2004
David West,PF,23,NOH,71,1,930,108,228,.474,0,2,.000,108,226,.478,.474,57,80,.713,117,180,297,60,27,28,48,117,273,2004
Jahidi White,C,27,TOT,62,17,865,99,190,.521,0,0,.000,99,190,.521,.521,63,126,.500,97,164,261,7,25,51,66,176,261,2004
Jahidi White,C,27,WAS,1,0,4,0,1,.000,0,0,.000,0,1,.000,.000,0,0,.000,0,0,0,0,0,1,1,0,0,2004
Jahidi White,C,27,PHO,61,17,861,99,189,.524,0,0,.000,99,189,.524,.524,63,126,.500,97,164,261,7,25,50,65,176,261,2004
Rodney White,SF,23,DEN,72,0,985,215,468,.459,33,87,.379,182,381,.478,.495,78,104,.750,44,121,165,60,32,20,78,105,541,2004
Chris Whitney,PG,32,WAS,16,5,186,17,45,.378,8,18,.444,9,27,.333,.467,5,5,1.000,3,12,15,14,6,2,6,6,47,2004
Chris Wilcox,C,21,LAC,65,17,1340,227,436,.521,0,1,.000,227,435,.522,.521,105,150,.700,125,180,305,51,29,20,80,183,559,2004
Mike Wilks,PG,24,HOU,26,0,145,17,36,.472,6,10,.600,11,26,.423,.556,10,12,.833,3,13,16,17,3,0,7,15,50,2004
Aaron Williams,C,32,NJN,72,7,1337,172,342,.503,1,3,.333,171,339,.504,.504,105,155,.677,101,193,294,81,34,46,89,187,450,2004
Alvin Williams,SG,29,TOR,56,54,1730,201,496,.405,26,89,.292,175,407,.430,.431,66,85,.776,18,132,150,224,55,10,78,114,494,2004
Eric Williams,SF,31,TOT,71,36,1886,231,598,.386,35,127,.276,196,471,.416,.416,215,283,.760,65,221,286,120,70,9,88,180,712,2004
Eric Williams,SF,31,BOS,21,0,513,77,177,.435,11,32,.344,66,145,.455,.466,78,109,.716,21,74,95,25,22,1,31,52,243,2004
Eric Williams,SF,31,CLE,50,36,1373,154,421,.366,24,95,.253,130,326,.399,.394,137,174,.787,44,147,191,95,48,8,57,128,469,2004
Frank Williams,PG,23,NYK,56,3,714,80,208,.385,18,60,.300,62,148,.419,.428,41,48,.854,8,45,53,121,25,6,63,58,219,2004
Jason Williams,PG,28,MEM,72,68,2115,290,713,.407,120,364,.330,170,349,.487,.491,82,98,.837,25,122,147,492,92,5,136,97,782,2004
Jerome Williams,PF,30,TOT,68,44,1637,158,336,.470,0,8,.000,158,328,.482,.470,106,155,.684,177,298,475,72,90,8,74,134,422,2004
Jerome Williams,PF,30,TOR,15,12,407,28,57,.491,0,1,.000,28,56,.500,.491,21,29,.724,35,93,128,11,19,3,23,30,77,2004
Jerome Williams,PF,30,CHI,53,32,1230,130,279,.466,0,7,.000,130,272,.478,.466,85,126,.675,142,205,347,61,71,5,51,104,345,2004
Mo Williams,SG,21,UTA,57,0,772,115,303,.380,10,39,.256,105,264,.398,.396,44,56,.786,23,49,72,76,28,2,51,87,284,2004
Scott Williams,C,35,TOT,43,21,527,90,186,.484,2,3,.667,88,183,.481,.489,16,27,.593,38,94,132,17,20,16,16,95,198,2004
Scott Williams,C,35,PHO,16,10,267,53,101,.525,2,2,1.000,51,99,.515,.535,9,13,.692,23,49,72,6,15,7,6,45,117,2004
Scott Williams,C,35,DAL,27,11,260,37,85,.435,0,1,.000,37,84,.440,.435,7,14,.500,15,45,60,11,5,9,10,50,81,2004
Shammond Williams,SG-PG,28,TOT,53,4,763,87,232,.375,30,100,.300,57,132,.432,.440,51,58,.879,9,51,60,116,37,2,47,62,255,2004
Shammond Williams,SG,28,ORL,37,2,525,59,151,.391,25,74,.338,34,77,.442,.474,40,45,.889,9,34,43,64,23,1,26,40,183,2004
Shammond Williams,PG,28,NOH,16,2,238,28,81,.346,5,26,.192,23,55,.418,.377,11,13,.846,0,17,17,52,14,1,21,22,72,2004
Corliss Williamson,PF,30,DET,79,0,1574,304,602,.505,0,0,.000,304,602,.505,.505,144,197,.731,88,168,256,57,30,20,113,204,752,2004
Kevin Willis,C,41,SAS,48,0,373,70,150,.467,0,1,.000,70,149,.470,.467,24,39,.615,37,61,98,11,21,9,32,61,164,2004
Loren Woods,C,25,MIA,38,2,506,44,96,.458,0,0,.000,44,96,.458,.458,33,55,.600,65,69,134,10,11,19,26,52,121,2004
Qyntel Woods,SF,22,POR,62,8,673,88,237,.371,10,29,.345,78,208,.375,.392,38,60,.633,46,90,136,46,20,14,52,88,224,2004
Metta World Peace,SF,24,IND,73,71,2714,468,1112,.421,75,242,.310,393,870,.452,.455,322,439,.733,100,285,385,272,152,50,202,194,1333,2004
Lorenzen Wright,C,28,MEM,65,46,1674,257,586,.439,0,5,.000,257,581,.442,.439,96,131,.733,144,301,445,71,45,58,77,192,610,2004
Wang Zhizhi,C,26,TOT,16,0,114,17,46,.370,4,14,.286,13,32,.406,.413,9,10,.900,4,14,18,2,3,5,6,13,47,2004
Wang Zhizhi,C,26,LAC,2,0,9,0,1,.000,0,0,.000,0,1,.000,.000,4,4,1.000,0,4,4,0,0,1,0,0,4,2004
Wang Zhizhi,C,26,MIA,14,0,105,17,45,.378,4,14,.286,13,31,.419,.422,5,6,.833,4,10,14,2,3,4,6,13,43,2004
Tariq Abdul-Wahad,SG,28,DAL,14,0,204,27,58,.466,0,1,.000,27,57,.474,.466,3,6,.500,14,26,40,21,6,3,7,26,57,2003
Shareef Abdur-Rahim,PF,26,ATL,81,81,3087,566,1183,.478,21,60,.350,545,1123,.485,.487,455,541,.841,175,502,677,242,87,38,212,240,1608,2003
Courtney Alexander,PG,25,NOH,66,7,1360,193,505,.382,19,57,.333,174,448,.388,.401,118,146,.808,39,79,118,79,31,6,68,125,523,2003
Malik Allen,PF,24,MIA,80,73,2318,335,790,.424,0,4,.000,335,786,.426,.424,97,121,.802,134,291,425,54,37,78,128,234,767,2003
Ray Allen,SG,27,TOT,76,75,2880,598,1363,.439,201,533,.377,397,830,.478,.512,316,345,.916,94,287,381,334,103,14,198,220,1713,2003
Ray Allen,SG,27,MIL,47,46,1683,351,803,.437,123,311,.395,228,492,.463,.514,178,195,.913,45,173,218,164,57,11,117,149,1003,2003
Ray Allen,SG,27,SEA,29,29,1197,247,560,.441,78,222,.351,169,338,.500,.511,138,150,.920,49,114,163,170,46,3,81,71,710,2003
Rafer Alston,PG,26,TOR,47,4,980,139,335,.415,51,130,.392,88,205,.429,.491,37,54,.685,21,86,107,192,38,15,86,120,366,2003
John Amaechi,C,32,UTA,50,1,474,37,118,.314,0,0,.000,37,118,.314,.314,25,52,.481,26,51,77,21,14,7,34,50,99,2003
Chris Andersen,C,24,DEN,59,3,907,114,285,.400,0,1,.000,114,284,.401,.400,77,140,.550,109,165,274,32,30,60,60,90,305,2003
Derek Anderson,PG,28,POR,76,76,2556,355,832,.427,116,331,.350,239,501,.477,.496,231,269,.859,53,211,264,325,90,16,128,141,1057,2003
Kenny Anderson,PG,32,TOT,61,2,1135,163,382,.427,1,7,.143,162,375,.432,.428,45,57,.789,31,101,132,198,58,5,75,106,372,2003
Kenny Anderson,PG,32,SEA,38,1,689,102,232,.440,0,5,.000,102,227,.449,.440,29,35,.829,17,70,87,121,40,1,33,63,233,2003
Kenny Anderson,PG,32,NOH,23,1,446,61,150,.407,1,2,.500,60,148,.405,.410,16,22,.727,14,31,45,77,18,4,42,43,139,2003
Shandon Anderson,SF,29,NYK,82,9,1731,248,537,.462,52,140,.371,196,397,.494,.510,139,190,.732,64,190,254,87,73,20,114,177,687,2003
Robert Archibald,PF,22,MEM,12,0,72,6,20,.300,0,0,.000,6,20,.300,.300,7,18,.389,6,11,17,3,0,3,7,9,19,2003
Gilbert Arenas,PG,21,GSW,82,82,2866,509,1180,.431,109,313,.348,400,867,.461,.478,370,468,.791,97,289,386,514,124,17,290,260,1497,2003
Brandon Armstrong,SG,22,NJN,17,0,69,9,27,.333,1,6,.167,8,21,.381,.352,5,6,.833,0,4,4,2,3,1,5,8,24,2003
Darrell Armstrong,PG,34,ORL,82,23,2350,263,643,.409,78,232,.336,185,411,.450,.470,165,188,.878,91,204,295,323,135,13,160,167,769,2003
Carlos Arroyo,PG,23,UTA,44,0,287,50,109,.459,3,7,.429,47,102,.461,.472,18,22,.818,11,15,26,53,12,1,30,28,121,2003
Chucky Atkins,PG,28,DET,65,7,1398,168,465,.361,86,242,.355,82,223,.368,.454,40,49,.816,21,75,96,175,27,4,77,108,462,2003
Stacey Augmon,SG,34,NOH,70,3,862,79,192,.411,0,7,.000,79,185,.427,.411,54,72,.750,26,93,119,69,27,9,40,80,212,2003
Dalibor Bagaric,C,22,CHI,10,0,76,8,26,.308,0,0,.000,8,26,.308,.308,3,4,.750,7,13,20,4,3,3,5,11,19,2003
Vin Baker,C,31,BOS,52,9,942,99,207,.478,0,4,.000,99,203,.488,.478,72,107,.673,90,108,198,29,22,30,61,146,270,2003
Brent Barry,SG,31,SEA,75,68,2480,264,577,.458,118,293,.403,146,284,.514,.560,128,161,.795,48,253,301,384,113,15,142,199,774,2003
Jon Barry,SG,33,DET,80,0,1473,191,424,.450,87,214,.407,104,210,.495,.553,86,100,.860,33,147,180,206,63,14,81,104,555,2003
Maceo Baston,PF,27,TOR,16,0,106,15,25,.600,0,0,.000,15,25,.600,.600,10,12,.833,4,19,23,0,4,11,6,16,40,2003
Mengke Bateer,C,27,SAS,12,0,46,4,17,.235,1,3,.333,3,14,.214,.265,0,2,.000,2,8,10,4,0,0,6,14,9,2003
Mike Batiste,PF,25,MEM,75,2,1248,197,467,.422,18,81,.222,179,386,.464,.441,69,88,.784,82,175,257,52,42,16,69,120,481,2003
Tony Battie,C,26,BOS,67,62,1683,199,369,.539,1,5,.200,198,364,.544,.541,88,118,.746,148,285,433,49,33,81,48,197,487,2003
Shane Battier,SF,24,MEM,78,47,2383,275,569,.483,86,216,.398,189,353,.535,.559,120,145,.828,128,217,345,105,102,88,68,207,756,2003
Lonny Baxter,C,24,CHI,55,0,682,96,206,.466,0,2,.000,96,204,.471,.466,70,103,.680,65,100,165,16,9,22,46,135,262,2003
Raja Bell,SG,26,DAL,75,32,1173,93,211,.441,21,51,.412,72,160,.450,.491,23,34,.676,47,98,145,57,52,8,43,134,230,2003
Jonathan Bender,SF,22,IND,46,2,819,112,254,.441,19,53,.358,93,201,.463,.478,60,84,.714,42,91,133,42,8,56,42,86,303,2003
Corey Benjamin,SG,24,ATL,9,0,152,13,43,.302,2,13,.154,11,30,.367,.326,12,16,.750,10,21,31,10,1,2,6,20,40,2003
Travis Best,PG,30,MIA,72,52,1807,231,583,.396,36,109,.330,195,474,.411,.427,105,123,.854,26,121,147,255,44,7,106,174,603,2003
Mike Bibby,PG,24,SAC,55,55,1835,329,700,.470,56,137,.409,273,563,.485,.510,161,187,.861,34,113,147,285,72,8,127,93,875,2003
Chauncey Billups,PG,26,DET,74,74,2327,366,870,.421,149,380,.392,217,490,.443,.506,318,362,.878,38,235,273,287,63,15,134,136,1199,2003
Corie Blount,C,34,CHI,50,3,836,65,134,.485,0,0,.000,65,134,.485,.485,20,35,.571,68,137,205,50,33,19,43,121,150,2003
Mark Blount,C,27,TOT,81,31,1403,150,347,.432,0,0,.000,150,347,.432,.432,101,139,.727,111,197,308,56,42,68,103,187,401,2003
Mark Blount,C,27,DEN,54,24,885,105,267,.393,0,0,.000,105,267,.393,.393,71,99,.717,62,121,183,35,22,51,70,112,281,2003
Mark Blount,C,27,BOS,27,7,518,45,80,.563,0,0,.000,45,80,.563,.563,30,40,.750,49,76,125,21,20,17,33,75,120,2003
Calvin Booth,C,26,SEA,47,0,575,52,119,.437,0,2,.000,52,117,.444,.437,34,47,.723,32,77,109,12,11,33,22,74,138,2003
Carlos Boozer,PF,21,CLE,81,54,2049,331,618,.536,0,1,.000,331,617,.536,.536,148,192,.771,202,407,609,106,59,50,103,224,810,2003
Ruben Boumtje-Boumtje,C,24,POR,2,0,5,0,1,.000,0,0,.000,0,1,.000,.000,0,0,.000,1,0,1,1,1,0,0,0,0,2003
Bruce Bowen,SF,31,SAS,82,82,2566,223,479,.466,101,229,.441,122,250,.488,.571,36,89,.404,59,180,239,113,66,42,72,195,583,2003
Ryan Bowen,SG,27,DEN,62,31,996,97,197,.492,2,7,.286,95,190,.500,.497,27,41,.659,78,79,157,54,65,29,43,82,223,2003
Earl Boykins,PG,26,GSW,68,0,1321,199,464,.429,29,77,.377,170,387,.439,.460,173,200,.865,35,53,88,221,38,4,73,75,600,2003
Michael Bradley,PF,23,TOR,67,11,1314,151,314,.481,1,6,.167,150,308,.487,.482,35,67,.522,162,247,409,67,16,32,76,125,338,2003
Shawn Bradley,C,30,DAL,81,39,1731,201,375,.536,0,1,.000,201,374,.537,.536,141,175,.806,151,325,476,54,65,170,67,242,543,2003
Elton Brand,PF,23,LAC,62,61,2454,451,899,.502,0,1,.000,451,898,.502,.502,244,356,.685,283,420,703,157,71,158,161,204,1146,2003
J.R. Bremer,PG,22,BOS,64,41,1503,171,464,.369,101,286,.353,70,178,.393,.477,85,111,.766,18,127,145,164,38,3,59,80,528,2003
Jamison Brewer,PG,22,IND,10,0,80,9,17,.529,0,2,.000,9,15,.600,.529,4,9,.444,5,4,9,18,2,1,6,11,22,2003
Primoz Brezec,C,23,IND,22,1,111,15,38,.395,0,1,.000,15,37,.405,.395,12,20,.600,13,10,23,4,2,4,7,16,42,2003
Damone Brown,PF,23,TOR,5,3,115,11,35,.314,0,2,.000,11,33,.333,.314,6,8,.750,3,12,15,3,1,0,6,14,28,2003
Devin Brown,SG,24,TOT,10,2,93,12,35,.343,0,1,.000,12,34,.353,.343,6,8,.750,8,10,18,7,4,1,9,14,30,2003
Devin Brown,SG,24,SAS,7,0,22,5,10,.500,0,0,.000,5,10,.500,.500,2,2,1.000,4,3,7,2,0,0,5,3,12,2003
Devin Brown,SG,24,DEN,3,2,71,7,25,.280,0,1,.000,7,24,.292,.280,4,6,.667,4,7,11,5,4,1,4,11,18,2003
Kedrick Brown,SF,21,BOS,51,5,666,61,171,.357,3,39,.077,58,132,.439,.365,20,32,.625,45,95,140,20,34,13,23,68,145,2003
Kwame Brown,C,20,WAS,80,20,1773,224,502,.446,0,3,.000,224,499,.449,.446,145,217,.668,128,298,426,58,50,80,110,159,593,2003
P.J. Brown,PF,33,NOH,78,78,2609,319,601,.531,0,3,.000,319,598,.533,.531,194,232,.836,243,458,701,147,67,80,98,203,832,2003
Randy Brown,PG,34,PHO,32,0,262,16,43,.372,0,0,.000,16,43,.372,.372,9,12,.750,3,23,26,35,17,2,17,36,41,2003
Tierre Brown,PG,23,CLE,15,0,168,27,59,.458,0,1,.000,27,58,.466,.458,11,14,.786,8,22,30,39,13,0,22,9,65,2003
Rick Brunson,PG,30,CHI,17,0,196,23,50,.460,4,6,.667,19,44,.432,.500,10,12,.833,4,15,19,36,10,3,17,20,60,2003
Kobe Bryant,SG,24,LAL,82,82,3401,868,1924,.451,124,324,.383,744,1600,.465,.483,601,713,.843,106,458,564,481,181,67,288,218,2461,2003
Mark Bryant,PF,37,TOT,16,0,100,5,19,.263,0,0,.000,5,19,.263,.263,3,4,.750,8,12,20,4,1,1,7,18,13,2003
Mark Bryant,PF,37,PHI,11,0,77,5,17,.294,0,0,.000,5,17,.294,.294,2,2,1.000,7,9,16,1,1,1,5,12,12,2003
Mark Bryant,PF,37,DEN,3,0,14,0,1,.000,0,0,.000,0,1,.000,.000,1,2,.500,1,1,2,2,0,0,2,4,1,2003
Mark Bryant,PF,37,BOS,2,0,9,0,1,.000,0,0,.000,0,1,.000,.000,0,0,.000,0,2,2,1,0,0,0,2,0,2003
Greg Buckner,SG,26,PHI,75,5,1514,185,398,.465,15,55,.273,170,343,.496,.484,65,81,.802,72,144,216,96,72,16,62,203,450,2003
Pat Burke,C,29,ORL,62,8,783,113,296,.382,1,7,.143,112,289,.388,.383,40,58,.690,57,89,146,23,19,25,47,99,267,2003
Caron Butler,SF,22,MIA,78,78,2858,429,1032,.416,34,107,.318,395,925,.427,.432,309,375,.824,135,262,397,213,137,31,192,230,1201,2003
Rasual Butler,SG,23,MIA,72,28,1514,207,572,.362,50,171,.292,157,401,.392,.406,76,104,.731,29,157,186,93,21,43,77,105,540,2003
Jason Caffey,PF,29,MIL,51,16,894,113,248,.456,0,0,.000,113,248,.456,.456,69,106,.651,68,108,176,38,19,15,56,122,295,2003
Marcus Camby,C,28,DEN,29,9,616,93,227,.410,2,5,.400,91,222,.410,.414,33,50,.660,75,133,208,47,20,40,27,69,221,2003
Elden Campbell,C,34,TOT,56,1,869,117,295,.397,0,1,.000,117,294,.398,.397,109,136,.801,47,134,181,51,33,39,50,129,343,2003
Elden Campbell,C,34,NOH,41,1,685,101,247,.409,0,1,.000,101,246,.411,.409,93,115,.809,34,108,142,42,24,31,42,102,295,2003
Elden Campbell,C,34,SEA,15,0,184,16,48,.333,0,0,.000,16,48,.333,.333,16,21,.762,13,26,39,9,9,8,8,27,48,2003
Brian Cardinal,PF,25,WAS,5,0,15,1,4,.250,0,1,.000,1,3,.333,.250,2,2,1.000,3,2,5,1,0,0,1,0,4,2003
Anthony Carter,PG,27,MIA,49,26,912,83,233,.356,0,8,.000,83,225,.369,.356,33,50,.660,12,71,83,203,45,5,81,70,199,2003
Vince Carter,SG,26,TOR,43,42,1471,355,760,.467,45,131,.344,310,629,.493,.497,129,160,.806,59,129,188,143,48,41,74,121,884,2003
Sam Cassell,PG,33,MIL,78,77,2700,546,1162,.470,59,163,.362,487,999,.487,.495,385,447,.861,57,285,342,450,88,14,177,216,1536,2003
Kelvin Cato,C,28,HOU,73,5,1247,133,256,.520,0,4,.000,133,252,.528,.520,66,124,.532,132,296,428,20,38,85,56,176,332,2003
Tyson Chandler,C,20,CHI,75,68,1827,257,484,.531,0,0,.000,257,484,.531,.531,177,291,.608,169,345,514,76,37,106,135,220,691,2003
Calbert Cheaney,SG,31,UTA,81,74,2351,325,651,.499,10,25,.400,315,626,.503,.507,40,69,.580,73,211,284,163,65,13,108,225,700,2003
Chris Childs,PG,35,NJN,12,0,106,6,20,.300,1,6,.167,5,14,.357,.325,2,3,.667,3,2,5,16,8,1,6,17,15,2003
Doug Christie,SG,32,SAC,80,80,2710,267,557,.479,73,185,.395,194,372,.522,.545,141,174,.810,61,281,342,376,180,37,144,186,748,2003
Keon Clark,C,27,SAC,80,11,1780,226,451,.501,0,4,.000,226,447,.506,.501,84,128,.656,138,313,451,80,38,150,94,227,536,2003
Speedy Claxton,PG,24,SAS,30,0,471,67,145,.462,0,11,.000,67,134,.500,.462,39,57,.684,22,34,56,75,22,7,35,43,173,2003
Mateen Cleaves,PG,25,SAC,12,0,55,6,23,.261,1,1,1.000,5,22,.227,.283,3,4,.750,1,7,8,10,2,0,14,6,16,2003
Derrick Coleman,C,35,PHI,64,35,1742,223,498,.448,22,67,.328,201,431,.466,.470,134,171,.784,151,299,450,87,53,69,96,171,602,2003
Bimbo Coles,PG,34,TOT,35,11,691,56,168,.333,7,32,.219,49,136,.360,.354,35,42,.833,11,48,59,72,17,4,28,60,154,2003
Bimbo Coles,PG,34,CLE,21,11,516,34,119,.286,7,25,.280,27,94,.287,.315,27,34,.794,10,38,48,56,11,4,18,43,102,2003
Bimbo Coles,PG,34,BOS,14,0,175,22,49,.449,0,7,.000,22,42,.524,.449,8,8,1.000,1,10,11,16,6,0,10,17,52,2003
Jason Collier,C,25,HOU,13,3,104,17,36,.472,0,0,.000,17,36,.472,.472,2,2,1.000,12,17,29,1,2,1,2,10,36,2003
Jarron Collins,C,24,UTA,22,7,421,38,86,.442,0,1,.000,38,85,.447,.442,44,62,.710,32,28,60,14,5,6,19,70,120,2003
Jason Collins,C,24,NJN,81,66,1900,140,338,.414,0,4,.000,140,334,.419,.414,180,236,.763,136,232,368,87,47,44,85,252,460,2003
Chris Crawford,PF,27,ATL,5,0,38,8,13,.615,1,3,.333,7,10,.700,.654,7,8,.875,3,4,7,1,2,3,2,7,24,2003
Jamal Crawford,PG,22,CHI,80,31,1992,334,808,.413,86,242,.355,248,566,.438,.467,104,129,.806,21,164,185,334,77,25,134,126,858,2003
Austin Croshere,PF,27,IND,49,0,633,86,209,.411,27,69,.391,59,140,.421,.476,53,65,.815,40,115,155,56,6,13,28,48,252,2003
John Crotty,PG,33,DEN,12,0,180,14,41,.341,4,13,.308,10,28,.357,.390,9,15,.600,1,14,15,29,3,0,9,16,41,2003
Eddy Curry,C,20,CHI,81,48,1571,335,573,.585,0,0,.000,335,573,.585,.585,179,287,.624,116,237,353,37,18,62,137,226,849,2003
Michael Curry,SF,34,DET,78,77,1555,92,229,.402,16,54,.296,76,175,.434,.437,36,45,.800,16,111,127,104,44,4,43,163,236,2003
Erick Dampier,C,27,GSW,82,82,1978,259,522,.496,0,2,.000,259,520,.498,.496,155,222,.698,248,295,543,58,27,154,112,242,673,2003
Antonio Daniels,SG,27,POR,67,2,872,84,186,.452,18,59,.305,66,127,.520,.500,65,76,.855,11,61,72,85,33,9,32,43,251,2003
Antonio Davis,C,34,TOR,53,52,1894,261,641,.407,0,0,.000,261,641,.407,.407,216,280,.771,130,307,437,131,23,62,118,150,738,2003
Baron Davis,PG,23,NOH,50,47,1889,332,798,.416,99,283,.350,233,515,.452,.478,93,131,.710,56,130,186,320,91,22,140,148,856,2003
Dale Davis,C,33,POR,78,78,2282,237,438,.541,0,0,.000,237,438,.541,.541,105,166,.633,233,331,564,94,51,70,71,189,579,2003
Emanual Davis,SG,34,ATL,24,1,340,32,88,.364,7,29,.241,25,59,.424,.403,17,22,.773,5,38,43,36,12,2,25,28,88,2003
Hubert Davis,SG,32,DET,43,1,328,31,79,.392,12,36,.333,19,43,.442,.468,5,6,.833,6,30,36,29,5,0,11,23,79,2003
Ricky Davis,SG,23,CLE,79,76,3131,602,1470,.410,74,204,.363,528,1266,.417,.435,348,465,.748,97,293,390,436,125,36,277,180,1626,2003
Andrew DeClercq,C,29,ORL,77,21,1327,149,279,.534,0,0,.000,149,279,.534,.534,67,104,.644,142,197,339,52,39,36,84,258,365,2003
Tony Delk,PG,29,BOS,67,39,1873,233,560,.416,120,304,.395,113,256,.441,.523,68,87,.782,41,191,232,146,72,10,69,124,654,2003
Dan Dickau,PG,24,ATL,50,0,515,70,170,.412,22,61,.361,48,109,.440,.476,21,26,.808,9,34,43,85,14,2,53,66,183,2003
Michael Dickerson,SG,27,MEM,6,1,87,10,24,.417,4,11,.364,6,13,.462,.500,5,5,1.000,1,5,6,8,5,1,6,16,29,2003
DeSagana Diop,PF,21,CLE,80,1,943,54,154,.351,0,0,.000,54,154,.351,.351,11,30,.367,63,152,215,43,33,81,56,148,119,2003
Vlade Divac,C,34,SAC,80,80,2384,305,655,.466,6,25,.240,299,630,.475,.470,179,251,.713,157,417,574,274,83,105,152,239,795,2003
Juan Dixon,PG,24,WAS,42,3,647,104,271,.384,25,84,.298,79,187,.422,.430,37,46,.804,13,59,72,40,26,3,42,54,270,2003
Michael Doleac,C,25,NYK,75,0,1041,146,343,.426,0,0,.000,146,343,.426,.426,36,46,.783,65,154,219,42,16,16,49,150,328,2003
Keyon Dooling,SG,22,LAC,55,1,969,128,329,.389,50,139,.360,78,190,.411,.465,44,57,.772,9,63,72,89,24,6,60,93,350,2003
Bryce Drew,PG,28,NOH,13,0,79,8,27,.296,3,7,.429,5,20,.250,.352,0,0,.000,4,9,13,11,2,0,3,2,19,2003
Predrag Drobnjak,C,27,SEA,82,69,1984,325,789,.412,30,85,.353,295,704,.419,.431,91,115,.791,111,209,320,86,48,38,65,180,771,2003
Chris Dudley,C,37,POR,3,0,11,0,1,.000,0,0,.000,0,1,.000,.000,0,0,.000,2,0,2,0,0,0,0,3,0,2003
Tim Duncan,PF,26,SAS,81,81,3181,714,1392,.513,6,22,.273,708,1370,.517,.515,450,634,.710,259,784,1043,316,55,237,248,231,1884,2003
Mike Dunleavy,SF,22,GSW,82,3,1305,168,417,.403,52,150,.347,116,267,.434,.465,78,100,.780,66,148,214,106,53,19,86,120,466,2003
Howard Eisley,PG,30,NYK,82,76,2243,262,628,.417,131,337,.389,131,291,.450,.521,89,105,.848,24,162,186,444,71,9,149,222,744,2003
LaPhonso Ellis,PF,32,MIA,55,3,784,100,262,.382,27,107,.252,73,155,.471,.433,50,66,.758,44,113,157,15,15,15,31,88,277,2003
Melvin Ely,C,24,LAC,52,7,802,92,186,.495,0,0,.000,92,186,.495,.495,52,74,.703,64,110,174,15,10,32,50,95,236,2003
Evan Eschmeyer,C,27,DAL,17,3,135,7,19,.368,0,0,.000,7,19,.368,.368,3,4,.750,10,19,29,6,10,7,6,35,17,2003
Reggie Evans,PF,22,SEA,67,60,1365,66,140,.471,0,0,.000,66,140,.471,.471,80,154,.519,167,278,445,34,38,11,52,173,212,2003
Danny Ferry,SF,36,SAS,64,1,601,44,124,.355,21,60,.350,23,64,.359,.440,10,13,.769,20,55,75,21,7,9,27,55,119,2003
Michael Finley,SF,29,DAL,69,69,2642,507,1193,.425,119,322,.370,388,871,.445,.475,198,230,.861,107,295,402,205,76,21,114,105,1331,2003
Derek Fisher,PG,28,LAL,82,82,2829,339,775,.437,85,212,.401,254,563,.451,.492,100,125,.800,40,199,239,298,93,15,94,195,863,2003
Marcus Fizer,PF,24,CHI,38,0,809,178,383,.465,1,6,.167,177,377,.469,.466,88,134,.657,80,136,216,48,14,17,57,89,445,2003
Alton Ford,PF,21,PHO,11,0,31,3,9,.333,0,0,.000,3,9,.333,.333,1,3,.333,0,6,6,1,0,0,2,7,7,2003
Joseph Forte,SG,21,SEA,17,0,86,10,35,.286,0,3,.000,10,32,.313,.286,4,6,.667,4,7,11,11,4,0,10,6,24,2003
Danny Fortson,PF,26,GSW,17,0,223,20,54,.370,0,1,.000,20,53,.377,.370,19,29,.655,28,45,73,12,9,0,15,43,59,2003
Greg Foster,C,34,TOR,29,9,539,47,122,.385,1,4,.250,46,118,.390,.389,26,32,.813,30,72,102,13,1,9,30,82,121,2003
Jeff Foster,C,26,IND,77,2,802,64,178,.360,0,2,.000,64,176,.364,.360,34,63,.540,118,161,279,51,28,21,34,103,162,2003
Tremaine Fowlkes,SF,26,LAC,37,10,573,56,128,.438,2,9,.222,54,119,.454,.445,50,59,.847,41,62,103,23,25,2,20,63,164,2003
Rick Fox,SF,33,LAL,76,75,2181,262,621,.422,105,280,.375,157,341,.460,.506,52,69,.754,64,259,323,253,69,14,121,215,681,2003
Adonal Foyle,C,27,GSW,82,0,1787,185,345,.536,0,1,.000,185,344,.538,.536,70,104,.673,176,314,490,37,40,205,73,214,440,2003
Steve Francis,PG,25,HOU,81,81,3318,571,1312,.435,85,240,.354,486,1072,.453,.468,476,595,.800,159,340,499,502,141,41,299,251,1703,2003
Lawrence Funderburke,PF,32,SAC,27,0,229,32,72,.444,0,0,.000,32,72,.444,.444,10,17,.588,17,38,55,8,1,11,6,25,74,2003
Dan Gadzuric,C,24,MIL,49,30,760,70,145,.483,0,1,.000,70,144,.486,.483,29,56,.518,66,131,197,9,22,52,27,125,169,2003
Kevin Garnett,PF,26,MIN,82,82,3321,743,1481,.502,20,71,.282,723,1410,.513,.508,377,502,.751,244,858,1102,495,113,129,229,199,1883,2003
Pat Garrity,PF,26,ORL,81,53,2584,312,744,.419,161,407,.396,151,337,.448,.528,83,100,.830,72,234,306,121,62,20,77,255,868,2003
Pau Gasol,PF,22,MEM,82,82,2948,569,1116,.510,1,10,.100,568,1106,.514,.510,416,565,.736,192,528,720,229,34,148,213,220,1555,2003
Devean George,SF,25,LAL,71,7,1613,180,461,.390,49,132,.371,131,329,.398,.444,83,105,.790,91,195,286,92,56,38,65,180,492,2003
Kendall Gill,SG,34,MIN,82,34,2068,286,677,.422,19,59,.322,267,618,.432,.436,123,161,.764,51,197,248,156,78,15,108,176,714,2003
Manu Ginobili,SG,25,SAS,69,5,1431,174,397,.438,51,148,.345,123,249,.494,.503,126,171,.737,47,114,161,138,96,17,100,170,525,2003
Gordan Giricek,SG-SF,25,TOT,76,62,2148,350,803,.436,85,249,.341,265,554,.478,.489,150,183,.820,36,202,238,137,52,8,145,159,935,2003
Gordan Giricek,SG,25,MEM,49,35,1187,207,478,.433,46,130,.354,161,348,.463,.481,88,107,.822,18,90,108,70,22,6,94,104,548,2003
Gordan Giricek,SF,25,ORL,27,27,961,143,325,.440,39,119,.328,104,206,.505,.500,62,76,.816,18,112,130,67,30,2,51,55,387,2003
Dion Glover,SG,24,ATL,76,42,1890,277,648,.427,56,158,.354,221,490,.451,.471,127,162,.784,62,220,282,141,71,15,108,146,737,2003
Anthony Goldwire,PG,31,TOT,15,0,85,9,25,.360,3,9,.333,6,16,.375,.420,4,7,.571,0,6,6,4,3,0,6,6,25,2003
Anthony Goldwire,PG,31,SAS,10,0,51,5,18,.278,2,8,.250,3,10,.300,.333,0,2,.000,0,3,3,3,3,0,2,5,12,2003
Anthony Goldwire,PG,31,WAS,5,0,34,4,7,.571,1,1,1.000,3,6,.500,.643,4,5,.800,0,3,3,1,0,0,4,1,13,2003
Drew Gooden,SF-PF,21,TOT,70,47,1873,355,777,.457,14,48,.292,341,729,.468,.466,151,212,.712,163,292,455,83,53,35,150,172,875,2003
Drew Gooden,SF,21,MEM,51,29,1329,255,576,.443,14,46,.304,241,530,.455,.455,92,132,.697,105,190,295,63,38,22,105,121,616,2003
Drew Gooden,PF,21,ORL,19,18,544,100,201,.498,0,2,.000,100,199,.503,.498,59,80,.738,58,102,160,20,15,13,45,51,259,2003
Brian Grant,C,30,MIA,82,82,2641,344,676,.509,0,0,.000,344,676,.509,.509,158,205,.771,241,596,837,104,63,47,129,300,846,2003
Horace Grant,PF,37,ORL,5,1,85,13,25,.520,0,0,.000,13,25,.520,.520,0,0,.000,2,6,8,7,3,0,1,5,26,2003
Adrian Griffin,SG,28,DAL,74,48,1373,146,337,.433,6,24,.250,140,313,.447,.442,27,32,.844,88,176,264,105,77,6,47,157,325,2003
Eddie Griffin,PF,20,HOU,77,66,1890,271,678,.400,64,192,.333,207,486,.426,.447,58,94,.617,138,323,461,86,52,111,76,136,664,2003
Tom Gugliotta,PF,33,PHO,27,11,447,60,132,.455,0,1,.000,60,131,.458,.455,9,9,1.000,25,75,100,31,14,5,31,35,129,2003
A.J. Guyton,PG,24,GSW,2,0,9,0,4,.000,0,1,.000,0,3,.000,.000,0,0,.000,0,0,0,2,1,0,1,0,0,2003
Marcus Haislip,PF,22,MIL,39,8,441,66,153,.431,3,12,.250,63,141,.447,.441,26,38,.684,21,32,53,9,7,18,21,55,161,2003
Darvin Ham,SG,29,ATL,75,1,926,71,159,.447,0,3,.000,71,156,.455,.447,38,79,.481,73,80,153,38,16,19,65,127,180,2003
Richard Hamilton,SG,24,DET,82,82,2640,570,1286,.443,32,119,.269,538,1167,.461,.456,440,528,.833,88,230,318,208,64,13,200,249,1612,2003
Zendon Hamilton,C,27,TOR,3,0,12,2,5,.400,0,0,.000,2,5,.400,.400,2,2,1.000,1,3,4,0,1,0,1,2,6,2003
Anfernee Hardaway,SG,31,PHO,58,51,1777,256,573,.447,26,73,.356,230,500,.460,.469,77,97,.794,66,192,258,235,66,26,145,150,615,2003
Tim Hardaway,PG,36,IND,10,0,127,18,49,.367,11,31,.355,7,18,.389,.480,2,4,.500,1,14,15,24,9,0,11,8,49,2003
Matt Harpring,SF,26,UTA,78,69,2557,521,1020,.511,66,160,.413,455,860,.529,.543,262,331,.792,190,324,514,133,73,17,160,217,1370,2003
Adam Harrington,SG,22,TOT,19,0,111,11,37,.297,5,14,.357,6,23,.261,.365,3,4,.750,1,7,8,12,2,1,2,8,30,2003
Adam Harrington,SG,22,DAL,13,0,37,4,17,.235,1,3,.333,3,14,.214,.265,2,2,1.000,0,2,2,2,1,1,2,2,11,2003
Adam Harrington,SG,22,DEN,6,0,74,7,20,.350,4,11,.364,3,9,.333,.450,1,2,.500,1,5,6,10,1,0,0,6,19,2003
Al Harrington,SF,22,IND,82,37,2467,389,896,.434,13,46,.283,376,850,.442,.441,211,274,.770,159,352,511,125,71,33,163,280,1002,2003
Junior Harrington,PG,22,DEN,82,51,2003,169,467,.362,7,28,.250,162,439,.369,.369,73,112,.652,44,206,250,277,80,15,157,250,418,2003
Othella Harrington,PF,29,NYK,74,64,1850,225,443,.508,0,0,.000,225,443,.508,.508,123,150,.820,165,311,476,62,12,23,90,231,573,2003
Lucious Harris,SG,32,NJN,77,25,1973,298,721,.413,47,136,.346,251,585,.429,.446,152,189,.804,63,169,232,155,53,8,71,95,795,2003
Antonio Harvey,PF,32,ATL,4,0,32,2,5,.400,0,0,.000,2,5,.400,.400,0,0,.000,1,5,6,0,1,4,3,7,4,2003
Donnell Harvey,SF,22,DEN,77,27,1613,246,551,.446,1,7,.143,245,544,.450,.447,118,176,.670,125,284,409,100,48,27,123,203,611,2003
Trenton Hassell,SG,23,CHI,82,53,1999,144,392,.367,13,40,.325,131,352,.372,.384,41,55,.745,37,218,255,151,45,61,83,197,342,2003
Kirk Haston,SF,23,NOH,12,0,57,2,17,.118,0,3,.000,2,14,.143,.118,2,4,.500,0,7,7,3,0,5,7,10,6,2003
Juaquin Hawkins,SG,29,HOU,58,10,685,57,148,.385,10,24,.417,47,124,.379,.419,10,20,.500,16,62,78,47,29,6,29,57,134,2003
Brendan Haywood,C,23,WAS,81,69,1930,173,339,.510,0,0,.000,173,339,.510,.510,155,245,.633,192,212,404,29,32,119,65,225,501,2003
Alan Henderson,C,30,ATL,82,3,1494,153,327,.468,0,2,.000,153,325,.471,.468,88,138,.638,156,242,398,41,33,32,61,168,394,2003
Nene Hilario,C,20,DEN,80,53,2258,321,619,.519,0,3,.000,321,616,.521,.519,197,341,.578,208,283,491,149,127,65,181,295,839,2003
Grant Hill,SF,30,ORL,29,29,843,151,307,.492,1,4,.250,150,303,.495,.493,118,144,.819,40,166,206,122,28,13,84,46,421,2003
Tyrone Hill,PF,34,TOT,56,43,1351,129,306,.422,0,0,.000,129,306,.422,.422,54,80,.675,126,265,391,41,46,26,68,172,312,2003
Tyrone Hill,PF,34,CLE,32,25,855,85,197,.431,0,0,.000,85,197,.431,.431,33,45,.733,70,197,267,32,31,19,52,104,203,2003
Tyrone Hill,PF,34,PHI,24,18,496,44,109,.404,0,0,.000,44,109,.404,.404,21,35,.600,56,68,124,9,15,7,16,68,109,2003
Fred Hoiberg,SG,30,CHI,63,0,784,49,126,.389,5,21,.238,44,105,.419,.409,41,50,.820,11,126,137,70,40,5,25,59,144,2003
Robert Horry,PF,32,LAL,80,26,2343,184,476,.387,51,177,.288,133,299,.445,.440,103,134,.769,181,333,514,233,96,61,112,247,522,2003
Eddie House,SG,24,MIA,55,7,1025,172,444,.387,36,120,.300,136,324,.420,.428,31,36,.861,17,84,101,87,44,1,46,73,411,2003
Allan Houston,SG,31,NYK,82,82,3108,652,1465,.445,178,450,.396,474,1015,.467,.506,363,395,.919,26,205,231,220,54,7,178,191,1845,2003
Juwan Howard,PF,29,DEN,77,77,2730,567,1261,.450,2,4,.500,565,1257,.449,.450,282,351,.803,181,404,585,234,77,27,189,239,1418,2003
Troy Hudson,PG,26,MIN,79,74,2600,409,956,.428,97,266,.365,312,690,.452,.479,208,231,.900,42,141,183,452,60,7,182,160,1123,2003
Nate Huffman,C,27,TOR,7,0,76,9,25,.360,0,0,.000,9,25,.360,.360,5,8,.625,9,14,23,5,1,3,3,13,23,2003
Larry Hughes,PG,24,WAS,67,56,2137,346,741,.467,29,79,.367,317,662,.479,.487,136,186,.731,67,241,308,205,86,24,136,149,857,2003
Ryan Humphrey,PF,23,TOT,48,1,444,35,120,.292,0,0,.000,35,120,.292,.292,23,39,.590,34,65,99,11,9,18,23,75,93,2003
Ryan Humphrey,PF,23,ORL,35,1,322,23,85,.271,0,0,.000,23,85,.271,.271,18,28,.643,30,39,69,7,4,16,21,57,64,2003
Ryan Humphrey,PF,23,MEM,13,0,122,12,35,.343,0,0,.000,12,35,.343,.343,5,11,.455,4,26,30,4,5,2,2,18,29,2003
Lindsey Hunter,PG,32,TOR,29,0,673,106,302,.351,34,107,.318,72,195,.369,.407,34,47,.723,15,44,59,71,35,5,57,50,280,2003
Steven Hunter,C,21,ORL,33,5,447,56,103,.544,0,0,.000,56,103,.544,.544,18,44,.409,38,55,93,6,9,36,15,56,130,2003
Zydrunas Ilgauskas,C,27,CLE,81,81,2432,495,1122,.441,0,5,.000,495,1117,.443,.441,400,512,.781,240,371,611,127,56,152,210,274,1390,2003
Allen Iverson,SG,27,PHI,82,82,3485,804,1940,.414,84,303,.277,720,1637,.440,.436,570,736,.774,68,276,344,454,225,13,286,149,2262,2003
Bobby Jackson,PG,29,SAC,59,26,1676,340,732,.464,89,235,.379,251,497,.505,.525,126,149,.846,57,162,219,182,71,3,106,126,895,2003
Jermaine Jackson,SG,26,TOT,53,1,559,40,110,.364,1,10,.100,39,100,.390,.368,40,55,.727,19,38,57,74,19,6,34,51,121,2003
Jermaine Jackson,SG,26,TOR,24,1,286,21,68,.309,1,9,.111,20,59,.339,.316,23,27,.852,10,15,25,39,9,3,19,24,66,2003
Jermaine Jackson,SG,26,ATL,29,0,273,19,42,.452,0,1,.000,19,41,.463,.452,17,28,.607,9,23,32,35,10,3,15,27,55,2003
Jim Jackson,SF,32,SAC,63,0,1309,204,462,.442,32,71,.451,172,391,.440,.476,47,55,.855,84,178,262,118,31,4,80,132,487,2003
Marc Jackson,C,28,MIN,77,0,1041,153,349,.438,1,1,1.000,152,348,.437,.440,114,149,.765,86,139,225,37,24,30,59,137,421,2003
Mark Jackson,PG,37,UTA,82,0,1467,147,369,.398,27,95,.284,120,274,.438,.435,61,80,.763,34,142,176,375,48,3,152,90,382,2003
Stephen Jackson,SG,24,SAS,80,58,2254,356,818,.435,95,297,.320,261,521,.501,.493,139,183,.760,66,220,286,183,125,30,176,202,946,2003
Casey Jacobsen,SF,21,PHO,72,0,1147,122,327,.373,52,165,.315,70,162,.432,.453,72,105,.686,29,54,83,73,35,6,55,90,368,2003
Jerome James,C,27,SEA,51,16,766,111,232,.478,0,0,.000,111,232,.478,.478,54,92,.587,78,138,216,27,12,82,75,166,276,2003
Mike James,PG,27,MIA,78,8,1722,218,585,.373,67,228,.294,151,357,.423,.430,104,142,.732,26,123,149,246,64,5,108,176,607,2003
Antawn Jamison,SF,26,GSW,82,82,3226,691,1471,.470,65,209,.311,626,1262,.496,.492,375,475,.789,195,383,578,156,76,45,177,197,1822,2003
Marko Jaric,SF,24,LAC,66,12,1379,179,446,.401,53,166,.319,126,280,.450,.461,79,105,.752,35,125,160,193,97,11,103,125,490,2003
Chris Jefferies,SF,22,TOR,51,10,666,75,194,.387,18,54,.333,57,140,.407,.433,29,43,.674,16,43,59,22,19,16,45,56,197,2003
Richard Jefferson,SF,22,NJN,80,80,2879,456,911,.501,6,24,.250,450,887,.507,.504,324,436,.743,150,364,514,201,80,44,156,216,1242,2003
Jared Jeffries,SF,21,WAS,20,1,292,30,63,.476,3,6,.500,27,57,.474,.500,16,29,.552,26,32,58,16,8,5,21,28,79,2003
Anthony Johnson,PG,28,NJN,66,2,842,103,231,.446,13,35,.371,90,196,.459,.474,51,74,.689,13,65,78,86,37,5,41,93,270,2003
Avery Johnson,PG,37,DAL,48,0,430,63,150,.420,0,2,.000,63,148,.426,.420,30,39,.769,10,21,31,64,15,1,29,26,156,2003
Ervin Johnson,C,35,MIL,69,17,1170,61,135,.452,0,0,.000,61,135,.452,.452,30,44,.682,117,177,294,24,34,63,34,178,152,2003
Joe Johnson,SG,21,PHO,82,34,2255,316,796,.397,75,205,.366,241,591,.408,.444,96,124,.774,57,207,264,210,62,19,108,143,803,2003
Ken Johnson,C,24,MIA,16,0,156,15,37,.405,0,0,.000,15,37,.405,.405,2,6,.333,4,28,32,0,1,12,6,20,32,2003
Damon Jones,PG,26,SAC,49,1,709,80,210,.381,44,121,.364,36,89,.404,.486,20,27,.741,11,59,70,80,18,4,23,42,224,2003
Eddie Jones,SG,31,MIA,47,47,1789,291,688,.423,98,241,.407,193,447,.432,.494,189,230,.822,35,191,226,173,64,31,85,137,869,2003
Fred Jones,SG,23,IND,19,1,115,9,24,.375,2,7,.286,7,17,.412,.417,3,4,.750,4,5,9,5,6,1,6,13,23,2003
Jumaine Jones,SF,23,CLE,80,12,2204,308,710,.434,111,314,.354,197,396,.497,.512,57,83,.687,106,299,405,112,67,22,107,176,784,2003
Popeye Jones,PF,32,DAL,26,0,222,24,62,.387,0,0,.000,24,62,.387,.387,5,11,.455,29,30,59,8,5,1,15,31,53,2003
Michael Jordan,SF,39,WAS,82,67,3031,679,1527,.445,16,55,.291,663,1472,.450,.450,266,324,.821,71,426,497,311,123,39,173,171,1640,2003
Shawn Kemp,C,33,ORL,79,55,1633,211,505,.418,0,1,.000,211,504,.419,.418,115,155,.742,147,304,451,55,66,33,102,239,537,2003
Steve Kerr,PG,37,SAS,75,0,952,110,256,.430,49,124,.395,61,132,.462,.525,30,34,.882,12,48,60,70,27,3,35,49,299,2003
Jason Kidd,PG,29,NJN,80,80,2989,515,1244,.414,126,370,.341,389,874,.445,.465,339,403,.841,110,394,504,711,179,25,296,127,1495,2003
Andrei Kirilenko,SF,21,UTA,80,11,2213,315,642,.491,37,114,.325,278,528,.527,.519,296,370,.800,147,273,420,138,118,175,136,185,963,2003
Kerry Kittles,SG,28,NJN,65,57,1951,332,711,.467,78,219,.356,254,492,.516,.522,106,135,.785,52,200,252,170,101,30,55,110,848,2003
Brevin Knight,PG,27,MEM,55,4,928,97,228,.425,2,8,.250,95,220,.432,.430,20,37,.541,15,66,81,233,69,2,94,123,216,2003
Travis Knight,C,28,NYK,32,0,287,25,65,.385,0,1,.000,25,64,.391,.385,10,13,.769,18,44,62,14,8,9,10,44,60,2003
Toni Kukoc,PF,34,MIL,63,0,1704,249,577,.432,95,263,.361,154,314,.490,.514,137,194,.706,67,199,266,230,81,29,122,134,730,2003
Christian Laettner,PF,33,WAS,76,66,2215,255,516,.494,2,16,.125,253,500,.506,.496,120,144,.833,114,388,502,235,82,40,87,206,632,2003
Raef LaFrentz,C,26,DAL,69,43,1611,266,514,.518,47,116,.405,219,398,.550,.563,60,88,.682,125,205,330,54,35,91,46,264,639,2003
Sean Lampley,SF,23,MIA,35,0,487,56,129,.434,0,4,.000,56,125,.448,.434,57,82,.695,26,57,83,31,7,3,25,43,169,2003
Dan Langhi,SF,25,PHO,60,0,541,81,202,.401,9,31,.290,72,171,.421,.423,12,20,.600,19,68,87,21,15,6,16,58,183,2003
Voshon Lenard,SG,29,TOR,63,24,1929,325,809,.402,92,252,.365,233,557,.418,.459,156,194,.804,48,164,212,144,59,21,103,156,898,2003
Rashard Lewis,SF,23,SEA,77,77,3044,519,1149,.452,75,217,.346,444,932,.476,.484,283,345,.820,152,351,503,133,99,35,143,205,1396,2003
Randy Livingston,PG,27,NOH,2,0,12,2,4,.500,0,0,.000,2,4,.500,.500,2,2,1.000,0,0,0,1,0,0,0,0,6,2003
Art Long,SF,30,TOT,26,0,211,28,75,.373,2,3,.667,26,72,.361,.387,2,10,.200,21,39,60,6,5,11,20,35,60,2003
Art Long,SF,30,PHI,19,0,131,19,50,.380,1,1,1.000,18,49,.367,.390,1,5,.200,13,27,40,2,2,8,9,22,40,2003
Art Long,SF,30,TOR,7,0,80,9,25,.360,1,2,.500,8,23,.348,.380,1,5,.200,8,12,20,4,3,3,11,13,20,2003
Grant Long,PF,36,BOS,41,1,488,27,70,.386,0,3,.000,27,67,.403,.386,18,23,.783,24,59,83,25,9,1,19,62,72,2003
Tyronn Lue,PG,25,WAS,75,24,1986,248,573,.433,60,176,.341,188,397,.474,.485,91,104,.875,22,127,149,263,47,1,77,151,647,2003
George Lynch,SG,32,NOH,81,32,1497,147,359,.409,28,79,.354,119,280,.425,.448,41,74,.554,139,214,353,104,66,19,52,136,363,2003
Todd MacCulloch,C,27,PHI,42,35,812,123,238,.517,0,0,.000,123,238,.517,.517,53,79,.671,66,130,196,20,19,32,35,107,299,2003
Tito Maddox,SG,21,HOU,9,0,35,3,12,.250,0,3,.000,3,9,.333,.250,5,8,.625,1,6,7,5,3,1,3,4,11,2003
Mark Madsen,PF,27,LAL,54,22,781,69,163,.423,0,0,.000,69,163,.423,.423,36,61,.590,86,73,159,38,15,19,27,116,174,2003
Corey Maggette,SG,23,LAC,64,57,2006,343,773,.444,62,177,.350,281,596,.471,.484,325,405,.802,77,245,322,123,55,16,147,194,1073,2003
Jamaal Magloire,C,24,NOH,82,82,2443,305,635,.480,0,3,.000,305,632,.483,.480,231,322,.717,260,464,724,88,49,111,158,276,841,2003
Karl Malone,PF,39,UTA,81,81,2936,595,1289,.462,3,14,.214,592,1275,.464,.463,474,621,.763,113,515,628,379,136,31,210,204,1667,2003
Matt Maloney,PG,31,ATL,14,0,103,8,25,.320,5,15,.333,3,10,.300,.420,3,5,.600,1,6,7,17,4,0,5,9,24,2003
Danny Manning,PF,36,DET,13,0,89,13,32,.406,3,8,.375,10,24,.417,.453,5,6,.833,7,11,18,7,9,3,7,11,34,2003
Stephon Marbury,PG,25,PHO,81,81,3240,671,1530,.439,89,296,.301,582,1234,.472,.468,375,467,.803,53,210,263,654,108,20,263,200,1806,2003
Shawn Marion,SF,24,PHO,81,81,3373,662,1466,.452,141,364,.387,521,1102,.473,.500,251,295,.851,199,574,773,198,185,95,157,208,1716,2003
Sean Marks,PF,27,MIA,23,0,223,22,59,.373,0,1,.000,22,58,.379,.373,10,15,.667,8,27,35,3,5,6,14,37,54,2003
Donny Marshall,SF,30,NJN,3,0,6,0,3,.000,0,1,.000,0,2,.000,.000,0,0,.000,0,3,3,0,0,0,1,0,0,2003
Donyell Marshall,PF,29,CHI,78,53,2378,421,918,.459,33,87,.379,388,831,.467,.477,167,221,.756,234,465,699,137,95,85,135,234,1042,2003
Kenyon Martin,PF,25,NJN,77,77,2628,509,1082,.470,9,43,.209,500,1039,.481,.475,256,392,.653,164,476,640,185,98,70,192,294,1283,2003
Jamal Mashburn,SF,30,NOH,82,81,3321,670,1586,.422,119,306,.389,551,1280,.430,.460,313,369,.848,66,432,498,462,83,17,230,196,1772,2003
Anthony Mason,C,36,MIL,65,58,2119,191,393,.486,0,1,.000,191,392,.487,.486,84,117,.718,90,326,416,209,32,12,79,147,466,2003
Desmond Mason,SF,25,TOT,80,40,2763,457,1017,.449,21,72,.292,436,945,.461,.460,212,283,.749,154,369,523,163,67,32,115,210,1147,2003
Desmond Mason,SF,25,SEA,52,15,1811,291,667,.436,16,55,.291,275,612,.449,.448,134,181,.740,88,247,335,95,47,21,74,136,732,2003
Desmond Mason,SF,25,MIL,28,25,952,166,350,.474,5,17,.294,161,333,.483,.481,78,102,.765,66,122,188,68,20,11,41,74,415,2003
Roger Mason,SF,22,CHI,17,0,113,11,31,.355,6,18,.333,5,13,.385,.452,2,2,1.000,2,10,12,12,4,0,5,20,30,2003
Tony Massenburg,C,35,UTA,58,1,792,104,232,.448,0,0,.000,104,232,.448,.448,65,84,.774,59,97,156,17,17,19,50,144,273,2003
Walter McCarty,SF,28,BOS,82,8,1949,173,418,.414,91,248,.367,82,170,.482,.523,61,98,.622,64,224,288,106,78,28,67,188,498,2003
Amal McCaskill,C,29,ATL,11,0,70,4,17,.235,0,0,.000,4,17,.235,.235,3,4,.750,7,15,22,5,3,1,2,13,11,2003
Jelani McCoy,C,25,TOR,67,25,1367,194,395,.491,0,0,.000,194,395,.491,.491,69,126,.548,95,260,355,43,28,60,96,162,457,2003
Tracy McGrady,SG,23,ORL,75,74,2954,829,1813,.457,173,448,.386,656,1365,.481,.505,576,726,.793,121,367,488,411,124,59,195,156,2407,2003
Jeff McInnis,PG,28,POR,75,1,1311,188,423,.444,6,35,.171,182,388,.469,.452,50,67,.746,22,75,97,170,21,2,75,117,432,2003
Aaron McKie,SF,30,PHI,80,40,2374,286,666,.429,37,112,.330,249,554,.449,.457,112,134,.836,61,289,350,278,131,9,109,177,721,2003
Stanislav Medvedenko,PF,23,LAL,58,10,620,112,258,.434,0,2,.000,112,256,.438,.434,31,43,.721,66,75,141,18,11,8,37,118,255,2003
Ron Mercer,SG,26,IND,72,3,1671,244,597,.409,3,16,.188,241,581,.415,.411,65,81,.802,32,122,154,112,49,14,54,123,556,2003
Chris Mihm,C,23,CLE,52,0,809,116,287,.404,0,3,.000,116,284,.408,.404,76,105,.724,93,138,231,28,18,38,48,124,308,2003
Darius Miles,SF,21,CLE,67,62,2008,263,642,.410,0,14,.000,263,628,.419,.410,92,155,.594,113,250,363,176,67,69,178,159,618,2003
Andre Miller,PG,26,LAC,80,80,2913,377,928,.406,23,108,.213,354,820,.432,.419,311,391,.795,84,232,316,537,99,11,206,203,1088,2003
Brad Miller,C,26,IND,73,72,2270,329,667,.493,5,16,.313,324,651,.498,.497,292,357,.818,185,418,603,193,65,43,118,203,955,2003
Mike Miller,SF,22,TOT,65,52,2186,373,859,.434,109,300,.363,264,559,.472,.498,156,186,.839,46,295,341,170,42,21,125,173,1011,2003
Mike Miller,SF,22,ORL,49,39,1826,296,708,.418,87,256,.340,209,452,.462,.480,127,150,.847,40,246,286,139,36,16,99,139,806,2003
Mike Miller,SF,22,MEM,16,13,360,77,151,.510,22,44,.500,55,107,.514,.583,29,36,.806,6,49,55,31,6,5,26,34,205,2003
Reggie Miller,SG,37,IND,70,70,2117,281,637,.441,113,318,.355,168,319,.527,.530,207,230,.900,21,151,172,170,62,4,66,89,882,2003
Chris Mills,PF,33,GSW,21,0,262,39,106,.368,7,25,.280,32,81,.395,.401,16,18,.889,19,31,50,22,7,3,10,29,101,2003
Yao Ming,C,22,HOU,82,72,2382,401,805,.498,1,2,.500,400,803,.498,.499,301,371,.811,196,479,675,137,31,147,173,230,1104,2003
Cuttino Mobley,SG,27,HOU,73,73,3044,463,1067,.434,112,318,.352,351,749,.469,.486,242,282,.858,70,233,303,208,95,36,166,185,1280,2003
Nazr Mohammed,C,25,ATL,35,0,445,67,159,.421,0,0,.000,67,159,.421,.421,26,41,.634,47,82,129,6,16,21,25,79,160,2003
Jerome Moiso,C,24,NOH,51,1,644,89,171,.520,0,0,.000,89,171,.520,.520,27,41,.659,59,119,178,22,19,44,46,87,205,2003
Mikki Moore,C,27,TOT,8,0,43,5,13,.385,0,0,.000,5,13,.385,.385,8,10,.800,6,2,8,3,0,4,2,7,18,2003
Mikki Moore,C,27,BOS,3,0,12,0,1,.000,0,0,.000,0,1,.000,.000,0,0,.000,1,0,1,0,0,2,0,6,0,2003
Mikki Moore,C,27,ATL,5,0,31,5,12,.417,0,0,.000,5,12,.417,.417,8,10,.800,5,2,7,3,0,2,2,1,18,2003
Terence Morris,SF,24,HOU,49,0,632,82,176,.466,7,32,.219,75,144,.521,.486,11,14,.786,40,88,128,25,8,17,29,35,182,2003
Troy Murphy,PF,22,GSW,79,79,2510,338,749,.451,3,14,.214,335,735,.456,.453,244,290,.841,228,578,806,106,65,30,111,246,923,2003
Ronald Murray,SG,23,TOT,14,0,62,11,31,.355,0,5,.000,11,26,.423,.355,5,8,.625,0,4,4,5,4,0,8,0,27,2003
Ronald Murray,SG,23,MIL,12,0,42,9,26,.346,0,4,.000,9,22,.409,.346,5,8,.625,0,1,1,3,4,0,4,0,23,2003
Ronald Murray,SG,23,SEA,2,0,20,2,5,.400,0,1,.000,2,4,.500,.400,0,0,.000,0,3,3,2,0,0,4,0,4,2003
Tracy Murray,SF,31,LAL,31,0,193,23,71,.324,8,38,.211,15,33,.455,.380,7,9,.778,5,18,23,12,5,3,14,22,61,2003
Dikembe Mutombo,C,36,NJN,24,16,514,49,131,.374,0,0,.000,49,131,.374,.374,40,55,.727,54,99,153,19,4,37,34,54,138,2003
Mamadou N'Diaye,C,27,TOR,22,8,364,43,96,.448,0,0,.000,43,96,.448,.448,34,47,.723,29,53,82,7,8,32,21,58,120,2003
Bostjan Nachbar,SF,22,HOU,14,1,77,11,31,.355,2,10,.200,9,21,.429,.387,5,10,.500,3,8,11,3,2,2,6,13,29,2003
Lee Nailon,SF,27,NYK,38,0,405,84,190,.442,0,1,.000,84,189,.444,.442,42,51,.824,32,38,70,26,6,3,32,46,210,2003
Eduardo Najera,SF,26,DAL,48,12,1103,129,231,.558,0,1,.000,129,230,.561,.558,62,91,.681,90,133,223,47,40,22,23,129,320,2003
Steve Nash,PG,28,DAL,82,82,2711,518,1114,.465,111,269,.413,407,845,.482,.515,308,339,.909,63,171,234,598,85,6,192,134,1455,2003
Rasho Nesterovic,C,26,MIN,77,77,2337,400,762,.525,0,2,.000,400,760,.526,.525,61,95,.642,146,358,504,114,39,116,99,256,861,2003
Ira Newble,SF,28,ATL,73,45,1931,231,467,.495,32,84,.381,199,383,.520,.529,70,90,.778,86,185,271,99,50,26,69,174,564,2003
Moochie Norris,PG,29,HOU,82,3,1375,134,330,.406,11,45,.244,123,285,.432,.423,78,114,.684,37,122,159,196,55,4,86,72,357,2003
Dirk Nowitzki,PF,24,DAL,80,80,3117,690,1489,.463,148,390,.379,542,1099,.493,.513,483,548,.881,81,710,791,239,111,82,152,206,2011,2003
Jermaine O'Neal,PF,24,IND,77,76,2864,610,1260,.484,7,21,.333,603,1239,.487,.487,373,510,.731,202,594,796,155,66,178,180,277,1600,2003
Shaquille O'Neal,C,30,LAL,67,66,2535,695,1211,.574,0,0,.000,695,1211,.574,.574,451,725,.622,259,483,742,206,38,159,196,229,1841,2003
Charles Oakley,C,39,WAS,42,1,514,23,55,.418,0,0,.000,23,55,.418,.418,28,34,.824,37,70,107,40,13,6,21,90,74,2003
Lamar Odom,SF,23,LAC,49,47,1679,268,611,.439,42,129,.326,226,482,.469,.473,136,175,.777,59,267,326,178,42,41,140,181,714,2003
Mehmet Okur,PF,23,DET,72,9,1366,180,423,.426,38,112,.339,142,311,.457,.470,96,131,.733,117,218,335,71,25,39,66,167,494,2003
Dean Oliver,PG,24,GSW,15,0,93,7,29,.241,1,6,.167,6,23,.261,.259,7,8,.875,8,8,16,23,7,0,10,9,22,2003
Kevin Ollie,PG,30,TOT,82,5,1897,199,441,.451,2,6,.333,197,435,.453,.454,134,178,.753,25,157,182,291,69,5,72,122,534,2003
Kevin Ollie,PG,30,MIL,53,4,1127,117,255,.459,1,5,.200,116,250,.464,.461,68,91,.747,12,87,99,181,37,4,36,71,303,2003
Kevin Ollie,PG,30,SEA,29,1,770,82,186,.441,1,1,1.000,81,185,.438,.444,66,87,.759,13,70,83,110,32,1,36,51,231,2003
Michael Olowokandi,C,27,LAC,36,36,1369,186,436,.427,0,0,.000,186,436,.427,.427,69,105,.657,57,271,328,47,18,79,98,110,441,2003
Greg Ostertag,C,29,UTA,81,74,1926,169,326,.518,0,0,.000,169,326,.518,.518,100,196,.510,180,323,503,55,20,147,104,235,438,2003
Bo Outlaw,C,31,PHO,80,20,1800,153,278,.550,0,2,.000,153,276,.554,.550,72,116,.621,134,234,368,112,50,71,76,194,378,2003
Chris Owens,SF,23,MEM,1,0,6,2,3,.667,0,0,.000,2,3,.667,.667,0,0,.000,1,0,1,0,0,0,1,0,4,2003
Olumide Oyedeji,C,21,ORL,27,3,145,10,23,.435,0,0,.000,10,23,.435,.435,7,11,.636,10,40,50,5,5,3,5,30,27,2003
Robert Pack,PG,33,NOH,28,4,440,52,129,.403,0,5,.000,52,124,.419,.403,41,55,.745,11,40,51,81,25,0,40,35,145,2003
Scott Padgett,PF,26,UTA,82,2,1321,170,423,.402,45,133,.338,125,290,.431,.455,81,107,.757,83,189,272,86,41,24,70,148,466,2003
Milt Palacio,PG,24,CLE,80,46,1976,162,388,.418,8,37,.216,154,351,.439,.428,65,87,.747,48,187,235,259,68,16,131,168,397,2003
Jannero Pargo,PG,23,LAL,34,0,342,37,93,.398,7,24,.292,30,69,.435,.435,4,4,1.000,9,28,37,39,13,2,23,45,85,2003
Smush Parker,PG,21,CLE,66,18,1103,136,338,.402,38,118,.322,98,220,.445,.459,98,118,.831,29,90,119,162,48,12,133,106,408,2003
Tony Parker,PG,20,SAS,82,82,2774,484,1043,.464,82,243,.337,402,800,.503,.503,219,290,.755,33,183,216,432,71,4,198,174,1269,2003
Cherokee Parks,PF,30,LAC,30,18,648,82,163,.503,1,2,.500,81,161,.503,.506,23,38,.605,46,86,132,21,16,20,18,52,188,2003
Ruben Patterson,SF,27,POR,78,17,1655,254,516,.492,3,20,.150,251,496,.506,.495,138,220,.627,120,144,264,101,73,29,117,161,649,2003
Gary Payton,PG,34,TOT,80,80,3208,665,1466,.454,54,182,.297,611,1284,.476,.472,250,352,.710,79,255,334,663,133,20,187,181,1634,2003
Gary Payton,PG,34,SEA,52,52,2123,444,992,.448,34,114,.298,410,878,.467,.465,162,234,.692,56,192,248,457,93,12,131,117,1084,2003
Gary Payton,PG,34,MIL,28,28,1085,221,474,.466,20,68,.294,201,406,.495,.487,88,118,.746,23,63,86,206,40,8,56,64,550,2003
Anthony Peeler,SG,33,MIN,82,39,2245,252,609,.414,87,212,.410,165,397,.416,.485,39,50,.780,40,201,241,244,72,13,82,161,630,2003
Wesley Person,SG,31,MEM,66,44,1941,274,601,.456,100,231,.433,174,370,.470,.539,79,97,.814,24,168,192,112,42,19,56,64,727,2003
Morris Peterson,SF,25,TOR,82,80,2949,421,1073,.392,116,344,.337,305,729,.418,.446,195,247,.789,97,266,363,188,88,32,128,232,1153,2003
Eric Piatkowski,SG,32,LAC,62,26,1360,210,446,.471,80,201,.398,130,245,.531,.561,101,122,.828,44,112,156,70,33,9,56,92,601,2003
Paul Pierce,SG,25,BOS,79,79,3096,663,1592,.416,118,391,.302,545,1201,.454,.454,604,753,.802,106,472,578,349,139,62,288,227,2048,2003
Scottie Pippen,SF,37,POR,64,58,1911,265,597,.444,38,133,.286,227,464,.489,.476,121,148,.818,57,221,278,285,105,25,164,149,689,2003
Scot Pollard,C,27,SAC,23,0,325,40,87,.460,0,0,.000,40,87,.460,.460,23,38,.605,46,60,106,6,13,15,15,50,103,2003
James Posey,SF,26,TOT,83,71,2518,309,752,.411,70,229,.306,239,523,.457,.457,205,246,.833,90,336,426,184,106,15,144,197,893,2003
James Posey,SF,26,DEN,25,24,872,121,324,.373,24,88,.273,97,236,.411,.410,86,102,.843,38,107,145,78,29,6,66,63,352,2003
James Posey,SF,26,HOU,58,47,1646,188,428,.439,46,141,.326,142,287,.495,.493,119,144,.826,52,229,281,106,77,9,78,134,541,2003
Lavor Postell,SG,24,NYK,12,0,98,14,38,.368,2,7,.286,12,31,.387,.395,13,15,.867,1,3,4,3,2,0,7,9,43,2003
Vitaly Potapenko,C,27,SEA,26,2,403,41,93,.441,0,0,.000,41,93,.441,.441,22,29,.759,25,64,89,4,9,8,25,46,104,2003
Tayshaun Prince,SF,22,DET,42,5,435,53,118,.449,20,47,.426,33,71,.465,.534,11,17,.647,5,40,45,24,10,14,21,25,137,2003
Joel Przybilla,C,23,MIL,32,17,546,18,46,.391,0,0,.000,18,46,.391,.391,12,24,.500,48,97,145,12,10,45,19,85,48,2003
Vladimir Radmanovic,PF,22,SEA,72,16,1910,274,668,.410,104,293,.355,170,375,.453,.488,72,102,.706,76,247,323,97,64,22,100,136,724,2003
Igor Rakocevic,PG,24,MIN,42,0,244,22,58,.379,5,12,.417,17,46,.370,.422,29,36,.806,4,13,17,33,4,0,23,25,78,2003
Zach Randolph,PF,21,POR,77,11,1301,264,515,.513,0,5,.000,264,510,.518,.513,122,161,.758,139,204,343,41,42,14,62,141,650,2003
Theo Ratliff,C,29,ATL,81,81,2518,276,595,.464,0,0,.000,276,595,.464,.464,154,214,.720,154,453,607,73,56,262,137,271,706,2003
Zeljko Rebraca,C,30,DET,30,12,488,80,145,.552,0,0,.000,80,145,.552,.552,38,48,.792,27,65,92,9,6,17,29,79,198,2003
Michael Redd,SG,23,MIL,82,14,2316,455,971,.469,182,416,.438,273,555,.492,.562,149,185,.805,98,273,371,117,100,13,74,143,1241,2003
Don Reid,PF,29,DET,1,0,10,0,3,.000,0,0,.000,0,3,.000,.000,1,2,.500,0,0,0,0,0,0,0,4,1,2003
Efthimi Rentzias,C,27,PHI,35,0,144,20,59,.339,4,8,.500,16,51,.314,.373,8,9,.889,10,16,26,7,6,2,4,21,52,2003
Glen Rice,SF,35,HOU,62,26,1532,196,457,.429,101,254,.398,95,203,.468,.539,63,83,.759,28,126,154,65,23,5,55,99,556,2003
Jason Richardson,SG,22,GSW,82,82,2698,476,1161,.410,123,334,.368,353,827,.427,.463,207,271,.764,111,267,378,247,90,23,179,201,1282,2003
Quentin Richardson,SG,22,LAC,59,13,1368,203,546,.372,61,198,.308,142,348,.408,.428,85,124,.685,98,183,281,52,35,10,64,92,552,2003
Antoine Rigaudeau,SG,31,DAL,11,0,91,8,35,.229,1,5,.200,7,30,.233,.243,0,0,.000,4,4,8,6,3,0,6,11,17,2003
Clifford Robinson,PF,36,DET,81,69,2825,372,935,.398,87,259,.336,285,676,.422,.444,161,238,.676,81,237,318,268,87,88,158,259,992,2003
David Robinson,C,37,SAS,64,64,1676,197,420,.469,0,0,.000,197,420,.469,.469,152,214,.710,163,345,508,61,52,111,83,126,546,2003
Eddie Robinson,SF,26,CHI,64,18,1355,155,315,.492,3,14,.214,152,301,.505,.497,51,63,.810,76,124,200,66,62,13,52,120,364,2003
Glenn Robinson,SF,30,ATL,69,68,2591,539,1248,.432,90,263,.342,449,985,.456,.468,268,306,.876,86,371,457,205,91,26,248,183,1436,2003
Rodney Rogers,PF,31,NJN,68,0,1303,183,455,.402,44,132,.333,139,323,.430,.451,68,90,.756,61,202,263,107,50,31,91,192,478,2003
Sean Rooks,C,33,LAC,70,38,1344,125,297,.421,0,1,.000,125,296,.422,.421,47,58,.810,53,163,216,69,34,44,66,174,297,2003
Jalen Rose,SF,30,CHI,82,82,3351,642,1583,.406,133,359,.370,509,1224,.416,.448,399,467,.854,68,283,351,395,72,23,285,271,1816,2003
Malik Rose,PF,28,SAS,79,13,1933,289,630,.459,2,5,.400,287,625,.459,.460,242,306,.791,148,358,506,124,57,40,170,206,822,2003
Guy Rucker,PF,25,GSW,3,0,4,0,0,.000,0,0,.000,0,0,.000,.000,0,0,.000,0,1,1,1,0,0,0,1,0,2003
Kareem Rush,PG,22,LAL,76,0,872,96,244,.393,19,68,.279,77,176,.438,.432,16,23,.696,26,68,94,68,10,11,63,71,227,2003
Bryon Russell,SF,32,WAS,70,23,1388,108,306,.353,46,140,.329,62,166,.373,.428,53,69,.768,43,165,208,72,70,7,55,130,315,2003
Arvydas Sabonis,C,38,POR,78,1,1209,172,361,.476,3,6,.500,169,355,.476,.481,129,164,.787,88,247,335,142,61,49,75,141,476,2003
John Salmons,PG,23,PHI,64,1,504,48,116,.414,10,31,.323,38,85,.447,.457,26,35,.743,16,43,59,47,17,6,29,53,132,2003
Soumaila Samake,C,24,LAL,13,1,77,10,24,.417,0,0,.000,10,24,.417,.417,2,2,1.000,10,13,23,4,0,5,2,13,22,2003
Jamal Sampson,PF,19,MIL,5,0,8,0,2,.000,0,0,.000,0,2,.000,.000,0,0,.000,1,1,2,1,1,0,0,0,0,2003
Pepe Sanchez,PG,25,DET,9,0,37,0,5,.000,0,0,.000,0,5,.000,.000,0,0,.000,4,2,6,8,5,0,2,3,0,2003
Jeryl Sasser,SG,23,ORL,75,4,1025,64,207,.309,13,44,.295,51,163,.313,.341,53,78,.679,64,120,184,65,45,12,39,91,194,2003
Kenny Satterfield,PG,21,TOT,39,6,502,55,183,.301,5,28,.179,50,155,.323,.314,17,25,.680,16,27,43,68,20,2,43,36,132,2003
Kenny Satterfield,PG,21,DEN,22,6,420,51,165,.309,5,28,.179,46,137,.336,.324,16,23,.696,12,23,35,53,18,2,36,30,123,2003
Kenny Satterfield,PG,21,PHI,17,0,82,4,18,.222,0,0,.000,4,18,.222,.222,1,2,.500,4,4,8,15,2,0,7,6,9,2003
Predrag Savovic,SG,26,DEN,27,0,256,29,93,.312,4,26,.154,25,67,.373,.333,21,29,.724,9,16,25,22,14,1,21,33,83,2003
Brian Scalabrine,PF,24,NJN,59,7,724,68,169,.402,14,39,.359,54,130,.415,.444,30,36,.833,40,101,141,46,16,18,46,77,180,2003
Ansu Sesay,SF,26,SEA,45,4,448,41,107,.383,0,0,.000,41,107,.383,.383,12,21,.571,34,39,73,23,14,5,25,62,94,2003
Brian Shaw,PG,36,LAL,72,0,900,101,261,.387,38,109,.349,63,152,.414,.460,10,15,.667,20,99,119,103,32,13,54,62,250,2003
Paul Shirley,PF,25,ATL,2,0,5,0,4,.000,0,0,.000,0,4,.000,.000,0,0,.000,0,1,1,0,0,0,0,0,0,2003
Bobby Simmons,SG,22,WAS,36,2,378,44,112,.393,0,5,.000,44,107,.411,.393,32,35,.914,33,44,77,20,10,3,8,51,120,2003
Brian Skinner,PF,26,PHI,77,9,1381,182,331,.550,0,0,.000,182,331,.550,.550,97,161,.602,136,230,366,19,47,53,62,176,461,2003
Reggie Slater,PF,32,MIN,26,0,141,27,50,.540,0,0,.000,27,50,.540,.540,27,45,.600,18,13,31,4,6,1,9,31,81,2003
Tamar Slay,SG,22,NJN,36,0,274,39,103,.379,7,25,.280,32,78,.410,.413,7,10,.700,8,23,31,14,14,3,20,31,92,2003
Charles Smith,SG,27,POR,3,0,13,1,4,.250,0,1,.000,1,3,.333,.250,3,4,.750,0,0,0,1,1,0,1,3,5,2003
Joe Smith,SF,27,MIN,54,21,1117,151,328,.460,0,2,.000,151,326,.463,.460,102,131,.779,111,159,270,38,14,55,43,171,404,2003
Steve Smith,SG,33,SAS,53,18,1032,113,291,.388,39,118,.331,74,173,.428,.455,95,114,.833,21,78,99,70,28,9,43,79,360,2003
Eric Snow,PG,29,PHI,82,82,3108,361,799,.452,7,32,.219,354,767,.462,.456,325,379,.858,71,230,301,544,133,11,194,235,1054,2003
Latrell Sprewell,SF,32,NYK,74,73,2859,454,1127,.403,134,360,.372,320,767,.417,.462,173,218,.794,45,240,285,332,102,22,172,134,1215,2003
Jerry Stackhouse,SG,28,WAS,70,70,2747,491,1201,.409,71,245,.290,420,956,.439,.438,455,518,.878,61,197,258,316,65,28,193,130,1508,2003
Vladimir Stepania,C,26,MIA,79,6,1594,185,427,.433,0,0,.000,185,427,.433,.433,71,134,.530,211,343,554,24,45,40,69,169,441,2003
DeShawn Stevenson,SG,21,UTA,61,8,760,114,284,.401,4,12,.333,110,272,.404,.408,47,68,.691,22,63,85,40,22,8,49,57,279,2003
Michael Stewart,PF,27,CLE,47,0,251,14,37,.378,0,0,.000,14,37,.378,.378,8,12,.667,19,36,55,6,2,15,10,42,36,2003
John Stockton,PG,40,UTA,82,82,2275,309,640,.483,29,80,.363,280,560,.500,.505,237,287,.826,51,150,201,629,137,16,182,184,884,2003
Peja Stojakovic,SF,25,SAC,72,72,2450,497,1034,.481,155,406,.382,342,628,.545,.556,231,264,.875,61,336,397,141,72,5,101,143,1380,2003
Damon Stoudamire,PG,29,POR,59,27,1315,156,415,.376,44,114,.386,112,301,.372,.429,53,67,.791,40,115,155,204,39,6,82,67,409,2003
Amar'e Stoudemire,PF,20,PHO,82,71,2570,392,830,.472,2,10,.200,390,820,.476,.473,320,484,.661,250,471,721,78,62,87,189,269,1106,2003
Erick Strickland,SG,29,IND,71,10,1275,163,380,.429,62,160,.388,101,220,.459,.511,70,87,.805,23,122,145,209,38,7,98,111,458,2003
Mark Strickland,SF,32,DAL,4,0,13,2,5,.400,0,0,.000,2,5,.400,.400,0,0,.000,5,2,7,0,0,0,1,1,4,2003
Rod Strickland,PG,36,MIN,47,8,956,120,278,.432,1,11,.091,119,267,.446,.433,79,107,.738,20,75,95,215,46,6,76,55,320,2003
Bruno Sundov,C,22,BOS,26,0,138,14,56,.250,4,16,.250,10,40,.250,.286,0,2,.000,8,20,28,7,6,3,9,24,32,2003
Bob Sura,SG,29,GSW,55,0,1130,135,328,.412,28,85,.329,107,243,.440,.454,103,148,.696,58,109,167,177,45,2,82,108,401,2003
Stromile Swift,PF,23,MEM,67,26,1478,235,489,.481,0,2,.000,235,487,.483,.481,177,245,.722,114,270,384,45,55,104,99,152,647,2003
Wally Szczerbiak,SF,25,MIN,52,42,1836,351,729,.481,61,145,.421,290,584,.497,.523,150,173,.867,53,188,241,136,44,22,87,123,913,2003
Maurice Taylor,PF,26,HOU,67,9,1377,231,535,.432,0,2,.000,231,533,.433,.432,100,138,.725,95,143,238,66,22,22,100,151,562,2003
Jason Terry,PG,25,ATL,81,81,3081,488,1141,.428,160,431,.371,328,710,.462,.498,259,292,.887,37,242,279,600,126,14,249,175,1395,2003
Etan Thomas,PF,24,WAS,38,0,513,61,124,.492,0,0,.000,61,124,.492,.492,60,94,.638,70,95,165,3,8,23,33,66,182,2003
Kenny Thomas,PF,25,TOT,66,42,1978,260,559,.465,0,0,.000,260,559,.465,.465,147,197,.746,185,344,529,112,62,28,116,169,667,2003
Kenny Thomas,PF,25,HOU,20,14,586,82,190,.432,0,0,.000,82,190,.432,.432,33,45,.733,45,92,137,39,16,6,40,49,197,2003
Kenny Thomas,PF,25,PHI,46,28,1392,178,369,.482,0,0,.000,178,369,.482,.482,114,152,.750,140,252,392,73,46,22,76,120,470,2003
Kurt Thomas,C,30,NYK,81,81,2577,497,1028,.483,2,3,.667,495,1025,.483,.484,138,184,.750,160,477,637,162,81,97,138,344,1134,2003
Tim Thomas,SF,25,MIL,80,70,2358,412,930,.443,97,265,.366,315,665,.474,.495,145,186,.780,97,292,389,102,70,49,133,257,1066,2003
Jamaal Tinsley,PG,24,IND,73,69,2237,220,556,.396,46,166,.277,174,390,.446,.437,80,112,.714,58,202,260,548,125,18,192,201,566,2003
Oscar Torres,SG,26,GSW,17,0,109,16,36,.444,7,13,.538,9,23,.391,.542,14,20,.700,3,9,12,3,4,2,8,9,53,2003
Robert Traylor,C,25,NOH,69,0,851,105,237,.443,1,3,.333,104,234,.444,.445,57,88,.648,108,154,262,50,45,37,53,153,268,2003
Gary Trent,SF,28,MIN,80,22,1222,208,389,.535,0,2,.000,208,387,.537,.535,60,101,.594,106,185,291,77,32,23,59,142,476,2003
Jeff Trepagnier,SG,23,DEN,8,0,97,17,40,.425,4,8,.500,13,32,.406,.475,7,7,1.000,8,8,16,6,8,0,8,5,45,2003
Cezary Trybanski,C,23,MEM,15,0,86,5,20,.250,0,0,.000,5,20,.250,.250,4,10,.400,6,8,14,1,0,6,8,13,14,2003
Jake Tsakalidis,C,23,PHO,33,27,543,61,135,.452,0,0,.000,61,135,.452,.452,39,58,.672,45,77,122,13,6,17,26,80,161,2003
Nikoloz Tskitishvili,SF,19,DEN,81,16,1320,115,393,.293,37,152,.243,78,241,.324,.340,48,65,.738,64,117,181,91,31,29,84,136,315,2003
Hedo Turkoglu,SF,23,SAC,67,11,1175,165,391,.422,29,78,.372,136,313,.435,.459,88,110,.800,35,153,188,87,25,12,50,125,447,2003
Nick Van Exel,SG,31,DAL,73,1,2026,342,831,.412,118,312,.378,224,519,.432,.483,110,144,.764,35,173,208,312,42,4,123,86,912,2003
Keith Van Horn,PF,27,PHI,74,73,2337,459,952,.482,65,176,.369,394,776,.508,.516,193,240,.804,159,365,524,93,63,30,150,251,1176,2003
Jacque Vaughn,PG,27,ORL,80,48,1686,184,411,.448,8,34,.235,176,377,.467,.457,97,125,.776,26,92,118,232,64,2,97,169,473,2003
Jake Voskuhl,C,25,PHO,65,1,947,92,163,.564,0,0,.000,92,163,.564,.564,64,96,.667,97,128,225,36,18,29,48,172,248,2003
Dajuan Wagner,SG,19,CLE,47,24,1385,223,605,.369,55,174,.316,168,431,.390,.414,128,160,.800,20,62,82,130,38,7,85,107,629,2003
Antoine Walker,PF,26,BOS,78,78,3235,603,1554,.388,188,582,.323,415,972,.427,.449,176,286,.615,99,464,563,373,116,31,260,221,1570,2003
Samaki Walker,C,26,LAL,67,39,1243,115,274,.420,0,1,.000,115,273,.421,.420,66,101,.653,115,253,368,64,20,55,56,143,296,2003
Ben Wallace,C,28,DET,73,73,2873,210,437,.481,1,6,.167,209,431,.485,.482,85,189,.450,293,833,1126,120,104,230,88,179,506,2003
Gerald Wallace,SF,20,SAC,47,7,571,90,183,.492,1,4,.250,89,179,.497,.495,39,74,.527,38,90,128,23,24,15,44,68,220,2003
Rasheed Wallace,PF,28,POR,74,74,2684,515,1094,.471,110,307,.358,405,787,.515,.521,200,272,.735,113,435,548,153,70,77,140,223,1340,2003
Charlie Ward,PG,32,NYK,66,6,1465,165,414,.399,101,267,.378,64,147,.435,.521,41,53,.774,25,152,177,306,78,11,95,146,472,2003
Earl Watson,PG,23,MEM,79,2,1366,170,391,.435,31,91,.341,139,300,.463,.474,62,86,.721,46,118,164,225,89,14,88,138,433,2003
Clarence Weatherspoon,PF,32,NYK,79,19,2024,186,414,.449,0,0,.000,186,414,.449,.449,149,194,.768,214,385,599,68,69,36,63,174,521,2003
Chris Webber,PF,29,SAC,67,67,2622,661,1433,.461,5,21,.238,656,1412,.465,.463,215,354,.607,160,544,704,364,106,88,215,204,1542,2003
Bonzi Wells,SG,26,POR,75,65,2396,437,990,.441,38,130,.292,399,860,.464,.461,226,313,.722,98,296,394,246,123,18,215,220,1138,2003
Jiri Welsch,SF,23,GSW,37,0,234,19,75,.253,1,4,.250,18,71,.254,.260,22,29,.759,12,16,28,27,8,2,19,32,61,2003
David Wesley,SG,32,NOH,73,73,2710,449,1037,.433,134,316,.424,315,721,.437,.498,185,237,.781,38,137,175,251,109,9,132,173,1217,2003
Jahidi White,C,26,WAS,16,8,230,25,53,.472,0,0,.000,25,53,.472,.472,17,25,.680,37,36,73,2,1,12,9,33,67,2003
Rodney White,SG,22,DEN,72,19,1563,260,638,.408,32,134,.239,228,504,.452,.433,98,125,.784,43,170,213,121,45,32,156,134,650,2003
Chris Whitney,PG,31,TOT,51,21,1052,124,349,.355,50,164,.305,74,185,.400,.427,57,69,.826,3,64,67,145,29,2,71,92,355,2003
Chris Whitney,PG,31,DEN,29,20,762,94,261,.360,43,128,.336,51,133,.383,.443,46,57,.807,1,45,46,124,17,1,55,77,277,2003
Chris Whitney,PG,31,ORL,22,1,290,30,88,.341,7,36,.194,23,52,.442,.381,11,12,.917,2,19,21,21,12,1,16,15,78,2003
Chris Wilcox,PF,20,LAC,46,3,479,73,140,.521,0,0,.000,73,140,.521,.521,25,50,.500,32,72,104,21,7,12,26,65,171,2003
Mike Wilks,PG-SG,23,TOT,46,7,688,50,148,.338,10,35,.286,40,113,.354,.372,37,47,.787,20,51,71,92,27,4,28,69,147,2003
Mike Wilks,SG,23,ATL,15,7,364,29,81,.358,6,17,.353,23,64,.359,.395,21,29,.724,9,32,41,42,16,1,16,38,85,2003
Mike Wilks,PG,23,MIN,31,0,324,21,67,.313,4,18,.222,17,49,.347,.343,16,18,.889,11,19,30,50,11,3,12,31,62,2003
Aaron Williams,C,31,NJN,81,0,1597,199,439,.453,0,1,.000,199,438,.454,.453,102,130,.785,137,194,331,88,27,57,85,206,500,2003
Alvin Williams,PG,28,TOR,78,78,2638,396,905,.438,48,146,.329,348,759,.458,.464,187,239,.782,55,190,245,416,111,21,128,170,1027,2003
Brandon Williams,SF,27,ATL,6,0,19,1,7,.143,0,1,.000,1,6,.167,.143,0,0,.000,2,0,2,0,2,0,3,4,2,2003
Eric Williams,SF,30,BOS,82,79,2350,254,575,.442,37,110,.336,217,465,.467,.474,201,268,.750,143,239,382,140,86,19,97,234,746,2003
Frank Williams,PG,22,NYK,21,0,167,9,33,.273,6,16,.375,3,17,.176,.364,4,6,.667,3,15,18,34,7,2,17,20,28,2003
Jason Williams,PG,27,MEM,76,76,2407,333,859,.388,143,404,.354,190,455,.418,.471,110,131,.840,25,187,212,631,91,10,168,130,919,2003
Jay Williams,PG,21,CHI,75,54,1961,273,685,.399,65,202,.322,208,483,.431,.446,103,161,.640,27,168,195,350,86,17,171,179,714,2003
Jerome Williams,PF,29,TOR,71,63,2346,267,535,.499,1,6,.167,266,529,.503,.500,156,281,.555,231,419,650,95,116,26,98,197,691,2003
Monty Williams,SF,31,PHI,21,2,276,34,80,.425,0,2,.000,34,78,.436,.425,24,32,.750,12,33,45,26,12,5,17,33,92,2003
Scott Williams,C,34,PHO,69,33,872,120,292,.411,0,2,.000,120,290,.414,.411,33,42,.786,72,121,193,22,27,21,32,159,273,2003
Shammond Williams,PG,27,TOT,78,11,1881,228,579,.394,93,261,.356,135,318,.425,.474,78,102,.765,24,147,171,266,77,6,114,140,627,2003
Shammond Williams,PG,27,BOS,51,2,1169,134,338,.396,56,159,.352,78,179,.436,.479,48,57,.842,12,98,110,128,61,3,61,84,372,2003
Shammond Williams,PG,27,DEN,27,9,712,94,241,.390,37,102,.363,57,139,.410,.467,30,45,.667,12,49,61,138,16,3,53,56,255,2003
Walt Williams,SF,32,DAL,66,1,1161,134,341,.393,64,171,.374,70,170,.412,.487,31,50,.620,53,154,207,59,42,26,35,141,363,2003
Corliss Williamson,SF,29,DET,82,1,2061,374,826,.453,2,11,.182,372,815,.456,.454,237,300,.790,147,211,358,104,44,27,126,238,987,2003
Kevin Willis,C,40,SAS,71,6,840,123,257,.479,0,2,.000,123,255,.482,.479,51,83,.614,83,143,226,24,20,20,60,120,297,2003
Ruben Wolkowyski,PF,29,BOS,7,0,24,2,4,.500,0,1,.000,2,3,.667,.500,1,4,.250,0,1,1,1,0,0,1,3,5,2003
Loren Woods,C,24,MIN,38,11,353,29,76,.382,1,3,.333,28,73,.384,.388,21,27,.778,27,68,95,19,10,13,23,37,80,2003
Qyntel Woods,PF,21,POR,53,0,334,59,118,.500,3,9,.333,56,109,.514,.513,7,20,.350,15,38,53,12,15,1,23,36,128,2003
Metta World Peace,SF,23,IND,69,67,2317,362,846,.428,71,211,.336,291,635,.458,.470,273,371,.736,101,261,362,198,159,50,145,242,1068,2003
Lorenzen Wright,C,27,MEM,70,49,1982,325,716,.454,0,5,.000,325,711,.457,.454,147,223,.659,170,358,528,80,51,54,110,209,797,2003
Vincent Yarbrough,SG,21,DEN,59,39,1381,168,428,.393,21,78,.269,147,350,.420,.417,49,62,.790,36,126,162,130,57,33,81,145,406,2003
Wang Zhizhi,C,25,LAC,41,1,412,62,162,.383,16,47,.340,46,115,.400,.432,42,58,.724,26,51,77,10,8,10,31,41,182,2003
Tariq Abdul-Wahad,SG,27,TOT,24,12,441,55,147,.374,1,2,.500,54,145,.372,.378,24,33,.727,41,43,84,24,20,10,27,56,135,2002
Tariq Abdul-Wahad,SG,27,DEN,20,12,417,55,145,.379,1,2,.500,54,143,.378,.383,24,32,.750,39,39,78,22,18,9,24,51,135,2002
Tariq Abdul-Wahad,SG,27,DAL,4,0,24,0,2,.000,0,0,.000,0,2,.000,.000,0,1,.000,2,4,6,2,2,1,3,5,0,2002
Shareef Abdur-Rahim,PF,25,ATL,77,77,2980,598,1297,.461,21,70,.300,577,1227,.470,.469,419,523,.801,198,498,696,239,98,81,250,214,1636,2002
Courtney Alexander,SG,24,WAS,56,28,1325,223,474,.470,5,18,.278,218,456,.478,.476,98,121,.810,43,105,148,86,35,7,60,113,549,2002
Victor Alexander,C,32,DET,15,0,97,18,51,.353,0,2,.000,18,49,.367,.353,4,8,.500,7,22,29,6,0,1,5,6,40,2002
Malik Allen,PF,23,MIA,12,2,161,22,51,.431,0,1,.000,22,50,.440,.431,8,10,.800,15,23,38,5,3,8,2,16,52,2002
Ray Allen,SG,26,MIL,69,67,2525,530,1148,.462,229,528,.434,301,620,.485,.561,214,245,.873,81,231,312,271,88,18,159,157,1503,2002
Rafer Alston,PG,25,MIL,50,7,600,66,191,.346,27,71,.380,39,120,.325,.416,18,29,.621,10,62,72,143,32,2,40,42,177,2002
John Amaechi,PF,31,UTA,54,0,586,54,166,.325,0,0,.000,54,166,.325,.325,67,105,.638,52,57,109,29,7,10,55,64,175,2002
Chris Andersen,C,23,DEN,24,1,262,25,74,.338,0,4,.000,25,70,.357,.338,22,28,.786,38,38,76,7,7,28,13,35,72,2002
Derek Anderson,SG,27,POR,70,27,1860,247,612,.404,85,228,.373,162,384,.422,.473,178,208,.856,47,142,189,216,68,8,87,113,757,2002
Kenny Anderson,PG,31,BOS,76,76,2430,312,716,.436,9,33,.273,303,683,.444,.442,98,132,.742,57,218,275,403,141,10,119,210,731,2002
Nick Anderson,SG,34,MEM,15,0,219,21,76,.276,13,48,.271,8,28,.286,.362,5,9,.556,1,32,33,14,6,6,14,17,60,2002
Shandon Anderson,SG,28,NYK,82,6,1596,149,373,.399,39,141,.277,110,232,.474,.452,74,107,.692,57,192,249,76,48,15,97,134,411,2002
Greg Anthony,PG,34,TOT,60,38,1514,183,475,.385,48,163,.294,135,312,.433,.436,60,91,.659,22,110,132,282,77,5,94,114,474,2002
Greg Anthony,PG,34,CHI,36,35,961,113,287,.394,29,90,.322,84,197,.426,.444,47,70,.671,16,72,88,203,49,4,58,72,302,2002
Greg Anthony,PG,34,MIL,24,3,553,70,188,.372,19,73,.260,51,115,.443,.423,13,21,.619,6,38,44,79,28,1,36,42,172,2002
Gilbert Arenas,PG,20,GSW,47,30,1155,174,384,.453,39,113,.345,135,271,.498,.504,124,160,.775,41,91,132,174,69,11,97,115,511,2002
Brandon Armstrong,SG,21,NJN,35,0,196,27,85,.318,5,17,.294,22,68,.324,.347,5,10,.500,10,6,16,8,7,1,8,26,64,2002
Darrell Armstrong,PG,33,ORL,82,79,2730,347,828,.419,139,398,.349,208,430,.484,.503,182,205,.888,83,236,319,453,157,10,175,166,1015,2002
Carlos Arroyo,PG,22,TOT,37,1,371,49,111,.441,0,2,.000,49,109,.450,.441,13,18,.722,12,28,40,70,11,1,23,30,111,2002
Carlos Arroyo,PG,22,TOR,17,0,96,13,29,.448,0,0,.000,13,29,.448,.448,4,6,.667,3,9,12,21,6,0,12,12,30,2002
Carlos Arroyo,PG,22,DEN,20,1,275,36,82,.439,0,2,.000,36,80,.450,.439,9,12,.750,9,19,28,49,5,1,11,18,81,2002
Chucky Atkins,PG,27,DET,79,62,2285,368,790,.466,138,336,.411,230,454,.507,.553,83,120,.692,31,127,158,263,72,11,128,177,957,2002
Stacey Augmon,SG,33,CHH,77,3,1319,140,328,.427,0,3,.000,140,325,.431,.427,77,101,.762,59,166,225,103,56,12,54,115,357,2002
Isaac Austin,C,32,MEM,21,8,307,36,92,.391,0,3,.000,36,89,.404,.391,4,4,1.000,11,60,71,13,9,5,11,36,76,2002
William Avery,PG,22,MIN,28,0,258,26,90,.289,6,35,.171,20,55,.364,.322,13,19,.684,4,20,24,36,7,0,19,17,71,2002
Dalibor Bagaric,C,21,CHI,50,0,638,72,178,.404,0,1,.000,72,177,.407,.404,41,70,.586,55,107,162,23,17,24,46,108,185,2002
Vin Baker,C,30,SEA,55,41,1710,315,649,.485,1,8,.125,314,641,.490,.486,143,226,.633,168,182,350,72,22,36,127,197,774,2002
Erick Barkley,PG,23,POR,19,4,228,24,68,.353,1,7,.143,23,61,.377,.360,9,10,.900,5,13,18,34,17,1,12,29,58,2002
Dana Barros,PG,34,DET,29,20,582,74,192,.385,24,71,.338,50,121,.413,.448,21,27,.778,1,56,57,78,14,2,33,37,193,2002
Brent Barry,SG,30,SEA,81,81,3040,401,790,.508,164,387,.424,237,403,.588,.611,198,234,.846,58,383,441,426,147,37,165,182,1164,2002
Jon Barry,SG,32,DET,82,6,1985,255,522,.489,121,258,.469,134,264,.508,.604,108,116,.931,42,192,234,274,94,20,111,134,739,2002
Mengke Bateer,C,26,DEN,27,10,408,53,132,.402,4,12,.333,49,120,.408,.417,29,37,.784,32,64,96,22,10,5,32,94,139,2002
Tony Battie,C,25,BOS,74,73,1819,211,390,.541,0,2,.000,211,388,.544,.541,88,130,.677,184,297,481,35,60,67,51,219,510,2002
Shane Battier,SF,23,MEM,78,78,3097,412,961,.429,103,276,.373,309,685,.451,.482,198,283,.700,180,238,418,216,121,81,155,215,1125,2002
Charlie Bell,SG,22,TOT,7,0,44,3,11,.273,0,6,.000,3,5,.600,.273,2,2,1.000,2,3,5,2,0,0,5,3,8,2002
Charlie Bell,SG,22,PHO,5,0,42,3,11,.273,0,6,.000,3,5,.600,.273,2,2,1.000,2,2,4,2,0,0,5,3,8,2002
Charlie Bell,SG,22,DAL,2,0,2,0,0,.000,0,0,.000,0,0,.000,.000,0,0,.000,0,1,1,0,0,0,0,0,0,2002
Raja Bell,SG,25,PHI,74,12,890,103,240,.429,12,44,.273,91,196,.464,.454,36,48,.750,31,80,111,71,21,4,48,109,254,2002
Jonathan Bender,SF,21,IND,78,17,1647,198,460,.430,45,125,.360,153,335,.457,.479,140,181,.773,64,180,244,62,19,49,96,147,581,2002
Travis Best,PG,29,TOT,74,21,1747,228,518,.440,21,59,.356,207,459,.451,.460,104,116,.897,20,131,151,324,89,7,99,173,581,2002
Travis Best,PG,29,IND,44,3,954,116,264,.439,13,34,.382,103,230,.448,.464,57,65,.877,10,60,70,175,57,6,59,101,302,2002
Travis Best,PG,29,CHI,30,18,793,112,254,.441,8,25,.320,104,229,.454,.457,47,51,.922,10,71,81,149,32,1,40,72,279,2002
Mike Bibby,PG,23,SAC,80,80,2659,446,985,.453,51,138,.370,395,847,.466,.479,155,193,.803,37,185,222,403,87,15,134,133,1098,2002
Chauncey Billups,PG,25,MIN,82,54,2355,348,823,.423,124,315,.394,224,508,.441,.498,207,234,.885,35,191,226,450,66,17,138,169,1027,2002
Mookie Blaylock,PG,34,GSW,35,0,599,50,146,.342,15,42,.357,35,104,.337,.394,4,8,.500,8,44,52,114,24,4,37,20,119,2002
Corie Blount,PF,33,PHI,72,21,1426,115,251,.458,0,1,.000,115,250,.460,.458,29,45,.644,149,219,368,44,49,26,52,176,259,2002
Mark Blount,C,26,BOS,44,0,415,32,76,.421,0,0,.000,32,76,.421,.421,30,37,.811,26,59,85,10,16,19,23,59,94,2002
Calvin Booth,C,25,SEA,15,15,279,35,82,.427,0,0,.000,35,82,.427,.427,23,24,.958,20,34,54,16,6,13,16,47,93,2002
Ruben Boumtje-Boumtje,C,23,POR,33,1,245,13,32,.406,0,0,.000,13,32,.406,.406,13,25,.520,21,34,55,4,3,16,14,38,39,2002
Cal Bowdler,PF,24,ATL,52,0,585,61,174,.351,1,5,.200,60,169,.355,.353,39,47,.830,38,72,110,11,18,15,11,64,162,2002
Bruce Bowen,SF,30,SAS,59,59,1699,155,398,.389,56,148,.378,99,250,.396,.460,46,96,.479,42,120,162,88,62,25,66,116,412,2002
Ryan Bowen,SF,26,DEN,75,21,1686,147,307,.479,1,12,.083,146,295,.495,.480,69,92,.750,134,165,299,52,75,41,41,171,364,2002
Ira Bowman,SG,28,PHI,3,0,29,5,7,.714,0,1,.000,5,6,.833,.714,0,0,.000,0,1,1,1,2,0,0,3,10,2002
Earl Boykins,PG,25,LAC,68,2,761,110,275,.400,13,42,.310,97,233,.416,.424,47,61,.770,27,27,54,145,20,2,44,44,280,2002
Michael Bradley,PF,22,TOR,26,0,118,13,25,.520,0,2,.000,13,23,.565,.520,4,8,.500,7,17,24,3,0,6,6,10,30,2002
Shawn Bradley,C,29,DAL,53,16,757,78,163,.479,0,1,.000,78,162,.481,.479,59,64,.922,53,123,176,20,28,64,25,128,215,2002
Elton Brand,PF,22,LAC,80,80,3020,532,1010,.527,0,0,.000,532,1010,.527,.527,389,524,.742,396,529,925,191,80,163,173,254,1453,2002
Terrell Brandon,PG,31,MIN,32,28,962,155,365,.425,4,23,.174,151,342,.442,.430,83,84,.988,17,76,93,264,52,6,43,49,397,2002
Jamison Brewer,SG,21,IND,13,0,43,2,5,.400,0,1,.000,2,4,.500,.400,0,0,.000,2,6,8,9,2,0,3,3,4,2002
Primoz Brezec,C,22,IND,22,4,160,14,29,.483,0,0,.000,14,29,.483,.483,15,25,.600,16,12,28,6,0,7,6,28,43,2002
Chucky Brown,SF,33,SAC,18,0,92,10,27,.370,0,0,.000,10,27,.370,.370,1,2,.500,10,23,33,6,2,4,5,12,21,2002
Damone Brown,SF,22,PHI,17,0,67,8,21,.381,0,1,.000,8,20,.400,.381,7,8,.875,2,2,4,2,1,1,9,11,23,2002
Dee Brown,PG,33,ORL,7,0,65,3,20,.150,1,12,.083,2,8,.250,.175,0,0,.000,0,9,9,2,3,1,4,4,7,2002
Ernest Brown,C,22,MIA,3,0,21,1,6,.167,0,0,.000,1,6,.167,.167,1,4,.250,1,5,6,0,0,1,3,4,3,2002
Kedrick Brown,SF,20,BOS,29,5,245,23,70,.329,5,27,.185,18,43,.419,.364,12,20,.600,11,39,50,15,18,7,7,18,63,2002
Kwame Brown,PF,19,WAS,57,3,817,94,243,.387,0,1,.000,94,242,.388,.387,70,99,.707,63,135,198,43,16,26,43,105,258,2002
P.J. Brown,C,32,CHH,80,80,2563,250,527,.474,0,0,.000,250,527,.474,.474,169,197,.858,273,513,786,107,59,78,85,222,669,2002
Randy Brown,PG,33,BOS,1,0,6,0,1,.000,0,0,.000,0,1,.000,.000,0,0,.000,0,0,0,2,0,1,0,1,0,2002
Tierre Brown,SG,22,HOU,40,1,403,49,115,.426,4,12,.333,45,103,.437,.443,21,28,.750,12,30,42,70,19,3,40,26,123,2002
Rick Brunson,PG,29,POR,59,2,520,45,113,.398,6,11,.545,39,102,.382,.425,29,41,.707,23,45,68,114,25,2,47,51,125,2002
Kobe Bryant,SG,23,LAL,80,80,3063,749,1597,.469,33,132,.250,716,1465,.489,.479,488,589,.829,112,329,441,438,118,35,223,228,2019,2002
Mark Bryant,PF,36,SAS,30,3,206,25,55,.455,0,0,.000,25,55,.455,.455,6,8,.750,25,19,44,10,7,2,6,38,56,2002
Greg Buckner,SG,25,DAL,44,16,885,104,198,.525,5,16,.313,99,182,.544,.538,40,58,.690,67,106,173,48,31,19,27,124,253,2002
Jud Buechler,SF,33,TOT,66,2,684,44,118,.373,21,60,.350,23,58,.397,.462,2,4,.500,29,87,116,32,21,8,15,53,111,2002
Jud Buechler,SF,33,PHO,6,0,54,2,6,.333,2,6,.333,0,0,.500,.000,0,0,.000,2,6,8,3,1,0,1,7,6,2002
Jud Buechler,SF,33,ORL,60,2,630,42,112,.375,19,54,.352,23,58,.397,.460,2,4,.500,27,81,108,29,20,8,14,46,105,2002
Rodney Buford,SG,24,MEM,63,21,1769,258,593,.435,17,70,.243,241,523,.461,.449,58,80,.725,52,220,272,71,42,12,63,110,591,2002
Matt Bullard,PF,34,CHH,31,0,350,39,115,.339,16,57,.281,23,58,.397,.409,11,12,.917,10,37,47,16,2,2,12,29,105,2002
Mitchell Butler,SG,31,POR,11,0,90,10,23,.435,1,3,.333,9,20,.450,.457,8,12,.667,6,8,14,5,0,1,5,10,29,2002
Jason Caffey,PF,28,MIL,23,0,283,36,72,.500,0,1,.000,36,71,.507,.500,27,43,.628,24,26,50,12,4,5,19,39,99,2002
Marcus Camby,C,27,NYK,29,29,1007,130,290,.448,0,1,.000,130,289,.450,.448,62,99,.626,89,233,322,33,34,50,42,107,322,2002
Elden Campbell,PF,33,CHH,77,74,2156,384,794,.484,0,2,.000,384,792,.485,.484,306,384,.797,133,397,530,102,60,137,138,264,1074,2002
Brian Cardinal,PF,24,DET,8,0,43,6,13,.462,3,7,.429,3,6,.500,.577,2,2,1.000,2,4,6,2,1,0,0,5,17,2002
Anthony Carter,PG,26,MIA,46,18,1050,89,260,.342,1,19,.053,88,241,.365,.344,19,36,.528,19,98,117,214,50,3,72,85,198,2002
Vince Carter,SG,25,TOR,60,60,2385,559,1307,.428,121,313,.387,438,994,.441,.474,245,307,.798,138,175,313,239,94,43,154,191,1484,2002
Sam Cassell,PG,32,MIL,74,73,2605,554,1197,.463,71,204,.348,483,993,.486,.492,282,328,.860,54,258,312,493,90,12,177,208,1461,2002
Kelvin Cato,C,27,HOU,75,73,1917,190,326,.583,0,1,.000,190,325,.585,.583,113,194,.582,176,349,525,29,40,95,53,208,493,2002
Tyson Chandler,C,19,CHI,71,31,1389,151,304,.497,0,0,.000,151,304,.497,.497,134,222,.604,114,229,343,54,28,93,99,179,436,2002
Calbert Cheaney,SG,30,DEN,68,47,1631,224,466,.481,0,4,.000,224,462,.485,.481,46,67,.687,57,183,240,110,34,21,70,156,494,2002
Chris Childs,PG,34,TOR,69,4,1576,97,296,.328,33,120,.275,64,176,.364,.383,58,71,.817,18,136,154,351,56,5,123,177,285,2002
Doug Christie,SG,31,SAC,81,81,2798,338,735,.460,90,256,.352,248,479,.518,.521,206,242,.851,74,300,374,340,160,25,164,209,972,2002
Keon Clark,C,26,TOR,81,31,2185,380,775,.490,0,5,.000,380,770,.494,.490,155,230,.674,182,421,603,88,58,122,140,258,915,2002
Speedy Claxton,PG,23,PHI,67,18,1528,181,452,.400,4,33,.121,177,419,.422,.405,114,136,.838,46,114,160,198,95,6,95,145,480,2002
Mateen Cleaves,PG,24,SAC,32,0,153,30,68,.441,2,8,.250,28,60,.467,.456,8,9,.889,1,7,8,25,7,0,27,9,70,2002
Derrick Coleman,PF,34,PHI,58,58,2080,331,735,.450,28,83,.337,303,652,.465,.469,185,227,.815,167,342,509,98,42,51,119,158,875,2002
Bimbo Coles,PG,33,CLE,47,1,693,56,146,.384,4,20,.200,52,126,.413,.397,33,37,.892,12,43,55,107,13,4,31,59,149,2002
Jason Collier,C,24,HOU,25,2,365,41,95,.432,0,1,.000,41,94,.436,.432,24,32,.750,31,51,82,9,6,4,13,40,106,2002
Jarron Collins,C,23,UTA,70,68,1440,158,343,.461,0,1,.000,158,342,.462,.461,134,181,.740,138,158,296,58,29,22,56,234,450,2002
Jason Collins,C,23,NJN,77,9,1407,117,278,.421,1,2,.500,116,276,.420,.423,115,164,.701,132,169,301,81,29,47,72,173,350,2002
Chris Crawford,PF,26,ATL,7,4,131,21,45,.467,0,1,.000,21,44,.477,.467,11,15,.733,9,16,25,5,2,5,10,21,53,2002
Jamal Crawford,PG,21,CHI,23,6,481,89,187,.476,26,58,.448,63,129,.488,.545,10,13,.769,5,29,34,55,18,5,32,18,214,2002
Joe Crispin,PG,22,TOT,21,0,156,26,68,.382,15,39,.385,11,29,.379,.493,12,13,.923,2,9,11,26,5,0,10,10,79,2002
Joe Crispin,PG,22,LAL,6,0,27,3,12,.250,0,4,.000,3,8,.375,.250,4,5,.800,0,1,1,2,1,0,1,2,10,2002
Joe Crispin,PG,22,PHO,15,0,129,23,56,.411,15,35,.429,8,21,.381,.545,8,8,1.000,2,8,10,24,4,0,9,8,69,2002
Austin Croshere,PF,26,IND,76,1,1286,185,448,.413,49,145,.338,136,303,.449,.468,97,114,.851,74,220,294,77,26,29,67,106,516,2002
John Crotty,PG,32,UTA,41,0,802,98,208,.471,31,69,.449,67,139,.482,.546,57,66,.864,16,59,75,141,19,1,51,77,284,2002
Vonteego Cummings,PG,25,PHI,58,1,501,78,187,.417,12,46,.261,66,141,.468,.449,24,32,.750,14,38,52,60,18,5,36,53,192,2002
Dell Curry,SG,37,TOR,56,4,886,141,347,.406,45,131,.344,96,216,.444,.471,33,37,.892,23,58,81,61,22,6,41,50,360,2002
Eddy Curry,C,19,CHI,72,31,1150,189,377,.501,0,0,.000,189,377,.501,.501,105,160,.656,111,161,272,25,16,53,69,173,483,2002
Michael Curry,SG,33,DET,82,75,1912,125,276,.453,7,26,.269,118,250,.472,.466,72,91,.791,15,153,168,127,47,10,60,207,329,2002
Samuel Dalembert,C,20,PHI,34,0,177,22,50,.440,0,0,.000,22,50,.440,.440,7,18,.389,25,43,68,5,6,13,14,30,51,2002
Erick Dampier,C,26,GSW,73,46,1740,209,480,.435,0,0,.000,209,480,.435,.435,136,211,.645,167,220,387,87,17,167,156,235,554,2002
Antonio Daniels,SG,26,SAS,82,13,2175,269,612,.440,57,196,.291,212,416,.510,.486,158,210,.752,23,153,176,228,48,12,70,104,753,2002
Antonio Davis,PF,33,TOR,77,77,2978,410,963,.426,0,1,.000,410,962,.426,.426,293,358,.818,254,486,740,155,54,83,159,225,1113,2002
Baron Davis,PG,22,CHH,82,82,3318,559,1341,.417,170,478,.356,389,863,.451,.480,196,338,.580,93,256,349,698,172,47,246,241,1484,2002
Dale Davis,C,32,POR,78,77,2447,296,580,.510,0,0,.000,296,580,.510,.510,150,212,.708,262,426,688,96,62,83,62,193,742,2002
Emanual Davis,PG,33,ATL,28,20,774,70,198,.354,29,85,.341,41,113,.363,.427,16,18,.889,19,55,74,68,27,5,52,68,185,2002
Hubert Davis,SG,31,WAS,51,17,1231,146,326,.448,57,126,.452,89,200,.445,.535,16,21,.762,7,70,77,107,28,3,44,58,365,2002
Ricky Davis,SF,22,CLE,82,8,1954,376,781,.481,11,35,.314,365,746,.489,.488,196,248,.790,63,180,243,178,69,23,148,145,959,2002
Andrew DeClercq,C,28,ORL,61,14,633,67,149,.450,0,0,.000,67,149,.450,.450,28,50,.560,74,89,163,22,23,24,34,130,162,2002
Vinny Del Negro,PG,35,PHO,2,0,6,1,4,.250,0,0,.000,1,4,.250,.250,0,0,.000,0,0,0,2,0,0,0,0,2,2002
Tony Delk,SG,28,TOT,63,17,1447,226,588,.384,67,214,.313,159,374,.425,.441,78,97,.804,58,145,203,132,53,10,59,98,597,2002
Tony Delk,SG,28,PHO,41,1,877,166,416,.399,47,147,.320,119,269,.442,.456,56,67,.836,38,86,124,81,31,4,40,60,435,2002
Tony Delk,SG,28,BOS,22,16,570,60,172,.349,20,67,.299,40,105,.381,.407,22,30,.733,20,59,79,51,22,6,19,38,162,2002
Derrick Dial,SG,26,TOT,32,0,299,41,120,.342,1,11,.091,40,109,.367,.346,18,24,.750,14,42,56,35,10,4,16,13,101,2002
Derrick Dial,SG,26,NJN,25,0,249,30,94,.319,0,7,.000,30,87,.345,.319,13,18,.722,12,33,45,31,8,4,13,12,73,2002
Derrick Dial,SG,26,TOR,7,0,50,11,26,.423,1,4,.250,10,22,.455,.442,5,6,.833,2,9,11,4,2,0,3,1,28,2002
Michael Dickerson,SG,26,MEM,4,4,124,15,48,.313,8,21,.381,7,27,.259,.396,5,6,.833,3,9,12,9,3,1,8,12,43,2002
DeSagana Diop,C,20,CLE,18,1,109,12,29,.414,0,0,.000,12,29,.414,.414,1,5,.200,5,12,17,5,1,10,12,19,25,2002
Vlade Divac,C,33,SAC,80,80,2420,338,716,.472,3,13,.231,335,703,.477,.474,209,340,.615,205,466,671,297,79,94,158,229,888,2002
Michael Doleac,C,24,CLE,42,15,705,78,187,.417,0,0,.000,78,187,.417,.417,38,46,.826,47,121,168,25,15,11,37,98,194,2002
Keyon Dooling,PG,21,LAC,14,0,155,22,57,.386,4,14,.286,18,43,.419,.421,10,12,.833,0,3,3,12,4,3,10,20,58,2002
Bryce Drew,PG,27,CHH,61,0,774,78,182,.429,31,73,.425,47,109,.431,.514,23,29,.793,14,58,72,101,32,2,33,49,210,2002
Predrag Drobnjak,C,26,SEA,64,12,1174,191,414,.461,0,2,.000,191,412,.464,.461,55,73,.753,75,144,219,51,20,31,51,109,437,2002
Chris Dudley,C,36,POR,43,2,327,20,50,.400,0,2,.000,20,48,.417,.400,8,15,.533,27,53,80,13,3,14,14,42,48,2002
Tim Duncan,PF,25,SAS,82,82,3329,764,1504,.508,1,10,.100,763,1494,.511,.508,560,701,.799,268,774,1042,307,61,203,263,217,2089,2002
Howard Eisley,PG,29,NYK,39,0,609,59,175,.337,14,58,.241,45,117,.385,.377,39,49,.796,9,40,49,100,24,3,53,55,171,2002
Obinna Ekezie,PF,26,LAC,29,1,152,13,39,.333,0,0,.000,13,39,.333,.333,28,40,.700,12,22,34,3,2,6,10,16,54,2002
LaPhonso Ellis,SF,31,MIA,66,14,1684,189,452,.418,38,124,.306,151,328,.460,.460,53,84,.631,107,180,287,56,30,37,73,196,469,2002
Evan Eschmeyer,C,26,DAL,31,6,299,21,50,.420,0,0,.000,21,50,.420,.420,20,33,.606,35,63,98,9,10,9,16,60,62,2002
Maurice Evans,SG,23,MIN,10,0,45,9,19,.474,0,3,.000,9,16,.563,.474,3,4,.750,3,1,4,4,0,0,2,9,21,2002
Patrick Ewing,C,39,ORL,65,4,901,148,333,.444,0,1,.000,148,332,.446,.444,94,134,.701,60,203,263,35,22,45,65,129,390,2002
Danny Ferry,SF,35,SAS,50,2,799,76,177,.429,43,99,.434,33,78,.423,.551,34,36,.944,15,75,90,48,16,9,22,70,229,2002
Michael Finley,SF,28,DAL,69,69,2754,569,1228,.463,76,224,.339,493,1004,.491,.494,210,251,.837,90,270,360,230,65,25,117,144,1424,2002
Derek Fisher,PG,27,LAL,70,35,1974,274,666,.411,144,349,.413,130,317,.410,.520,94,111,.847,15,131,146,181,66,9,62,121,786,2002
Marcus Fizer,PF,23,CHI,76,20,1963,371,848,.438,7,41,.171,364,807,.451,.442,189,283,.668,128,299,427,120,49,24,131,186,938,2002
Isaac Fontaine,SG,26,MEM,6,0,75,3,14,.214,1,5,.200,2,9,.222,.250,4,6,.667,0,5,5,4,0,0,4,6,11,2002
Alton Ford,PF,20,PHO,53,0,452,61,118,.517,0,0,.000,61,118,.517,.517,42,57,.737,32,75,107,7,6,7,32,99,164,2002
Joseph Forte,SG,20,BOS,8,0,39,1,12,.083,0,3,.000,1,9,.111,.083,4,4,1.000,1,5,6,6,2,0,3,1,6,2002
Danny Fortson,PF,25,GSW,77,76,2216,309,722,.428,1,4,.250,308,718,.429,.429,245,308,.795,290,609,899,127,44,17,160,255,864,2002
Greg Foster,PF,33,MIL,6,0,24,2,9,.222,0,4,.000,2,5,.400,.222,3,4,.750,0,8,8,1,0,0,0,4,7,2002
Jeff Foster,C,25,IND,82,48,1786,177,394,.449,2,15,.133,175,379,.462,.452,111,182,.610,206,350,556,70,71,38,79,232,467,2002
Antonis Fotsis,PF,20,MEM,28,1,320,42,104,.404,7,23,.304,35,81,.432,.438,17,20,.850,25,37,62,10,9,11,21,22,108,2002
Tremaine Fowlkes,SF,25,LAC,22,17,343,25,64,.391,0,0,.000,25,64,.391,.391,24,31,.774,32,32,64,17,11,1,13,39,74,2002
Rick Fox,SF,32,LAL,82,82,2289,255,605,.421,65,208,.313,190,397,.479,.475,70,85,.824,90,299,389,283,67,21,132,244,645,2002
Adonal Foyle,C,26,GSW,79,36,1485,171,385,.444,0,0,.000,171,385,.444,.444,37,93,.398,150,234,384,41,36,168,76,179,379,2002
Steve Francis,PG,24,HOU,57,56,2343,420,1007,.417,68,210,.324,352,797,.442,.451,326,422,.773,102,299,401,362,71,25,221,172,1234,2002
Lawrence Funderburke,PF,31,SAC,56,1,722,115,245,.469,0,3,.000,115,242,.475,.469,34,56,.607,76,122,198,32,11,18,33,65,264,2002
Kevin Garnett,PF,25,MIN,81,81,3175,659,1401,.470,37,116,.319,622,1285,.484,.484,359,448,.801,243,738,981,422,96,126,229,184,1714,2002
Dean Garrett,C,35,TOT,34,0,183,18,55,.327,0,0,.000,18,55,.327,.327,0,3,.000,16,41,57,5,7,10,10,32,36,2002
Dean Garrett,C,35,MIN,29,0,152,14,40,.350,0,0,.000,14,40,.350,.350,0,3,.000,13,34,47,4,5,9,7,26,28,2002
Dean Garrett,C,35,GSW,5,0,31,4,15,.267,0,0,.000,4,15,.267,.267,0,0,.000,3,7,10,1,2,1,3,6,8,2002
Pat Garrity,PF,25,ORL,80,43,2406,327,767,.426,169,396,.427,158,371,.426,.537,61,73,.836,77,261,338,99,61,28,68,230,884,2002
Pau Gasol,C,21,MEM,82,79,3007,551,1064,.518,1,5,.200,550,1059,.519,.518,338,477,.709,238,492,730,223,41,169,224,195,1441,2002
Chris Gatling,PF,34,MIA,54,1,809,131,293,.447,1,8,.125,130,285,.456,.449,82,117,.701,71,135,206,25,17,11,58,109,345,2002
Matt Geiger,C,32,PHI,4,0,36,1,8,.125,0,0,.000,1,8,.125,.125,1,2,.500,3,3,6,0,0,2,2,2,3,2002
Devean George,SF,24,LAL,82,1,1759,215,523,.411,66,178,.371,149,345,.432,.474,85,126,.675,78,225,303,111,71,42,66,190,581,2002
Eddie Gill,PG,23,MEM,23,5,384,39,92,.424,7,22,.318,32,70,.457,.462,31,39,.795,7,21,28,49,11,3,34,38,116,2002
Kendall Gill,SG,33,MIA,65,49,1410,162,422,.384,6,44,.136,156,378,.413,.391,42,62,.677,29,155,184,100,44,8,55,140,372,2002
Dion Glover,SG,23,ATL,55,25,1156,192,456,.421,30,91,.330,162,365,.444,.454,78,103,.757,36,133,169,84,45,14,76,89,492,2002
Steve Goodrich,SF,25,NJN,9,0,50,2,10,.200,0,0,.000,2,10,.200,.200,1,2,.500,1,4,5,5,1,2,3,10,5,2002
Brian Grant,PF,29,MIA,72,72,2256,286,610,.469,0,2,.000,286,608,.470,.469,101,119,.849,168,407,575,137,48,31,122,236,673,2002
Horace Grant,C,36,ORL,76,76,2210,264,515,.513,0,0,.000,264,515,.513,.513,80,111,.721,159,322,481,104,57,49,51,118,608,2002
Adrian Griffin,SG,27,DAL,58,34,1383,179,359,.499,16,54,.296,163,305,.534,.521,41,49,.837,68,161,229,106,75,12,42,142,415,2002
Eddie Griffin,PF,19,HOU,73,24,1896,244,666,.366,90,273,.330,154,393,.392,.434,64,86,.744,117,299,416,53,17,134,47,117,642,2002
Tom Gugliotta,PF,32,PHO,44,40,1129,127,301,.422,3,9,.333,124,292,.425,.427,28,37,.757,59,162,221,77,39,30,61,116,285,2002
A.J. Guyton,PG,23,CHI,45,6,607,88,244,.361,46,123,.374,42,121,.347,.455,22,27,.815,12,32,44,81,10,7,37,23,244,2002
Darvin Ham,SF,28,MIL,70,2,1208,120,211,.569,1,7,.143,119,204,.583,.571,62,123,.504,91,111,202,73,25,37,83,175,303,2002
Richard Hamilton,SG,23,WAS,63,57,2203,472,1084,.435,16,42,.381,456,1042,.438,.443,300,337,.890,73,143,216,171,38,14,132,136,1260,2002
Tang Hamilton,SF,23,MIA,9,2,98,10,19,.526,0,1,.000,10,18,.556,.526,0,1,.000,6,12,18,5,4,0,2,10,20,2002
Zendon Hamilton,PF,26,DEN,54,15,848,103,245,.420,0,0,.000,103,245,.420,.420,118,181,.652,110,143,253,14,21,18,60,104,324,2002
Anfernee Hardaway,SG,30,PHO,80,55,2462,389,931,.418,23,83,.277,366,848,.432,.430,158,195,.810,98,252,350,324,122,32,189,184,959,2002
Tim Hardaway,PG,35,TOT,68,16,1601,226,620,.365,123,354,.347,103,266,.387,.464,77,97,.794,14,110,124,278,57,10,111,109,652,2002
Tim Hardaway,PG,35,DAL,54,2,1276,179,494,.362,95,279,.341,84,215,.391,.459,65,78,.833,13,84,97,201,40,8,73,84,518,2002
Tim Hardaway,PG,35,DEN,14,14,325,47,126,.373,28,75,.373,19,51,.373,.484,12,19,.632,1,26,27,77,17,2,38,25,134,2002
Matt Harpring,SF,25,PHI,81,81,2541,386,838,.461,21,69,.304,365,769,.475,.473,165,222,.743,203,370,573,107,70,5,127,201,958,2002
Al Harrington,PF,21,IND,44,1,1313,230,484,.475,1,3,.333,229,481,.476,.476,115,144,.799,96,180,276,54,41,21,78,166,576,2002
Othella Harrington,PF,28,NYK,77,4,1563,237,450,.527,0,2,.000,237,448,.529,.527,122,172,.709,125,224,349,37,30,36,95,250,596,2002
Lucious Harris,SG,31,NJN,74,0,1553,249,537,.464,44,118,.373,205,419,.489,.505,133,158,.842,49,158,207,116,53,6,61,99,675,2002
Jason Hart,PG,23,SAS,10,0,92,10,19,.526,0,2,.000,10,17,.588,.526,6,6,1.000,4,9,13,12,7,1,8,16,26,2002
Antonio Harvey,PF,31,SEA,5,3,47,4,12,.333,0,0,.000,4,12,.333,.333,1,2,.500,5,4,9,5,1,3,3,8,9,2002
Donnell Harvey,PF,21,TOT,47,4,841,108,217,.498,0,0,.000,108,217,.498,.498,54,90,.600,80,147,227,37,21,24,33,115,270,2002
Donnell Harvey,PF,21,DAL,18,0,162,14,26,.538,0,0,.000,14,26,.538,.538,10,22,.455,12,34,46,5,4,5,8,27,38,2002
Donnell Harvey,PF,21,DEN,29,4,679,94,191,.492,0,0,.000,94,191,.492,.492,44,68,.647,68,113,181,32,17,19,25,88,232,2002
Trenton Hassell,SG,22,CHI,78,47,2237,267,628,.425,60,165,.364,207,463,.447,.473,87,114,.763,65,190,255,172,55,44,101,184,681,2002
Kirk Haston,PF,22,CHH,15,0,77,11,39,.282,0,3,.000,11,36,.306,.282,4,8,.500,5,15,20,5,0,1,3,9,26,2002
Brendan Haywood,C,22,WAS,62,2,1266,109,221,.493,0,0,.000,109,221,.493,.493,97,160,.606,143,179,322,29,21,91,50,158,315,2002
Alan Henderson,PF,29,ATL,26,1,422,59,116,.509,1,1,1.000,58,115,.504,.513,24,45,.533,31,66,97,11,11,15,21,40,143,2002
Cedric Henderson,SF,26,GSW,12,0,70,15,31,.484,2,4,.500,13,27,.481,.516,4,7,.571,1,2,3,4,6,2,8,4,36,2002
Grant Hill,SF,29,ORL,14,14,512,83,195,.426,0,2,.000,83,193,.430,.426,69,80,.863,29,96,125,64,8,4,37,40,235,2002
Tyrone Hill,PF,33,CLE,26,26,810,71,182,.390,0,1,.000,71,181,.392,.390,67,103,.650,79,195,274,23,17,13,48,102,209,2002
Fred Hoiberg,SG,29,CHI,79,8,1408,121,291,.416,24,92,.261,97,199,.487,.457,79,94,.840,18,192,210,136,61,5,32,87,345,2002
Robert Horry,PF,31,LAL,81,23,2140,183,460,.398,76,203,.374,107,257,.416,.480,108,138,.783,130,349,479,232,77,89,88,208,550,2002
Eddie House,PG,23,MIA,64,3,1230,209,524,.399,54,157,.344,155,367,.422,.450,42,49,.857,17,93,110,123,43,5,80,98,514,2002
Allan Houston,SG,30,NYK,77,77,2914,568,1301,.437,136,346,.393,432,955,.452,.489,295,339,.870,37,215,252,190,54,10,170,182,1567,2002
Juwan Howard,PF,28,TOT,81,72,2635,462,1005,.460,0,2,.000,462,1003,.461,.460,261,343,.761,223,389,612,169,46,47,152,265,1185,2002
Juwan Howard,PF,28,DAL,53,44,1659,270,585,.462,0,1,.000,270,584,.462,.462,144,191,.754,138,252,390,93,28,30,78,170,684,2002
Juwan Howard,PF,28,DEN,28,28,976,192,420,.457,0,1,.000,192,419,.458,.457,117,152,.770,85,137,222,76,18,17,74,95,501,2002
Troy Hudson,PG,25,ORL,81,4,1854,354,815,.434,66,187,.353,288,628,.459,.475,176,201,.876,30,115,145,255,57,6,163,119,950,2002
Larry Hughes,SG,23,GSW,73,56,2049,343,810,.423,18,93,.194,325,717,.453,.435,191,259,.737,83,162,245,316,113,23,171,150,895,2002
Lindsey Hunter,PG,31,LAL,82,47,1616,187,490,.382,79,208,.380,108,282,.383,.462,20,40,.500,18,103,121,129,66,19,55,120,473,2002
Steven Hunter,C,20,ORL,53,21,516,67,147,.456,0,0,.000,67,147,.456,.456,55,94,.585,40,57,97,5,5,43,16,81,189,2002
Zydrunas Ilgauskas,C,26,CLE,62,23,1329,241,567,.425,0,5,.000,241,562,.429,.425,208,276,.754,136,198,334,70,17,84,94,187,690,2002
Allen Iverson,SG,26,PHI,60,59,2622,665,1669,.398,78,268,.291,587,1401,.419,.422,475,585,.812,44,225,269,331,168,13,237,102,1883,2002
Bobby Jackson,PG,28,SAC,81,3,1750,334,754,.443,79,219,.361,255,535,.477,.495,149,184,.810,82,169,251,164,73,11,93,145,896,2002
Jaren Jackson,SG,34,ORL,9,0,144,15,37,.405,7,20,.350,8,17,.471,.500,2,4,.500,1,16,17,8,5,0,8,13,39,2002
Jermaine Jackson,SG,25,TOR,24,0,280,20,42,.476,1,2,.500,19,40,.475,.488,16,24,.667,3,24,27,57,9,1,14,24,57,2002
Jim Jackson,SF,31,MIA,55,19,1825,238,538,.442,38,81,.469,200,457,.438,.478,75,87,.862,54,236,290,140,42,14,106,145,589,2002
Marc Jackson,C,27,TOT,39,0,495,60,164,.366,0,1,.000,60,163,.368,.366,66,80,.825,48,80,128,14,11,6,30,69,186,2002
Marc Jackson,C,27,GSW,17,0,169,22,65,.338,0,0,.000,22,65,.338,.338,40,48,.833,17,26,43,7,5,3,12,25,84,2002
Marc Jackson,C,27,MIN,22,0,326,38,99,.384,0,1,.000,38,98,.388,.384,26,32,.813,31,54,85,7,6,3,18,44,102,2002
Mark Jackson,PG,36,NYK,82,82,2367,260,592,.439,79,195,.405,181,397,.456,.506,87,110,.791,56,253,309,605,74,1,150,162,686,2002
Stephen Jackson,SF,23,SAS,23,1,227,34,91,.374,9,36,.250,25,55,.455,.423,12,17,.706,3,23,26,11,15,3,23,29,89,2002
Jerome James,C,26,SEA,56,40,949,134,273,.491,0,0,.000,134,273,.491,.491,30,60,.500,89,143,232,24,25,86,74,174,298,2002
Mike James,PG,26,MIA,15,0,119,15,43,.349,8,21,.381,7,22,.318,.442,4,7,.571,2,12,14,19,6,1,13,17,42,2002
Tim James,SF,25,PHI,9,0,41,5,13,.385,0,0,.000,5,13,.385,.385,2,6,.333,5,2,7,1,0,1,3,5,12,2002
Antawn Jamison,SF,25,GSW,82,82,3033,614,1375,.447,68,210,.324,546,1165,.469,.471,323,440,.734,211,345,556,161,70,45,161,187,1619,2002
Harold Jamison,PF,25,LAC,25,2,176,22,43,.512,0,0,.000,22,43,.512,.512,10,15,.667,24,15,39,6,5,1,6,23,54,2002
Richard Jefferson,SF,21,NJN,79,9,1917,270,591,.457,13,56,.232,257,535,.480,.468,189,265,.713,85,208,293,140,64,48,107,211,742,2002
Anthony Johnson,SG,27,NJN,34,0,366,37,90,.411,4,12,.333,33,78,.423,.433,16,25,.640,10,19,29,48,31,1,20,30,94,2002
Avery Johnson,PG,36,TOT,68,13,1352,207,432,.479,0,5,.000,207,427,.485,.479,121,163,.742,14,55,69,286,40,9,76,86,535,2002
Avery Johnson,PG,36,DEN,51,13,1200,186,383,.486,0,5,.000,186,378,.492,.486,109,146,.747,14,50,64,258,35,8,67,69,481,2002
Avery Johnson,PG,36,DAL,17,0,152,21,49,.429,0,0,.000,21,49,.429,.429,12,17,.706,0,5,5,28,5,1,9,17,54,2002
DerMarr Johnson,SF,21,ATL,72,46,1727,214,540,.396,89,247,.360,125,293,.427,.479,85,105,.810,59,188,247,81,62,56,102,163,602,2002
Ervin Johnson,C,34,MIL,81,9,1660,89,193,.461,0,1,.000,89,192,.464,.461,30,66,.455,142,324,466,27,37,82,52,219,208,2002
Joe Johnson,SG,20,TOT,77,60,1916,251,584,.430,38,130,.292,213,454,.469,.462,41,53,.774,75,182,257,179,59,20,71,114,581,2002
Joe Johnson,SG,20,BOS,48,33,1003,130,296,.439,24,88,.273,106,208,.510,.480,20,26,.769,40,99,139,74,33,9,28,59,304,2002
Joe Johnson,SG,20,PHO,29,27,913,121,288,.420,14,42,.333,107,246,.435,.444,21,27,.778,35,83,118,105,26,11,43,55,277,2002
Alvin Jones,C,23,PHI,23,2,126,8,20,.400,0,0,.000,8,20,.400,.400,10,20,.500,13,23,36,3,3,9,11,35,26,2002
Damon Jones,PG,25,DET,67,0,1083,114,284,.401,69,186,.371,45,98,.459,.523,43,59,.729,13,90,103,140,23,1,61,83,340,2002
Eddie Jones,SG,30,MIA,81,81,3156,517,1198,.432,149,382,.390,368,816,.451,.494,297,355,.837,61,317,378,262,117,77,148,258,1480,2002
Jumaine Jones,PF,22,CLE,81,36,2142,287,640,.448,52,168,.310,235,472,.498,.489,45,68,.662,125,365,490,116,75,46,79,184,671,2002
Popeye Jones,PF,31,WAS,79,40,1920,222,508,.437,4,11,.364,218,497,.439,.441,106,130,.815,233,345,578,127,50,19,88,209,554,2002
Michael Jordan,SF,38,WAS,60,53,2093,551,1324,.416,10,53,.189,541,1271,.426,.420,263,333,.790,50,289,339,310,85,26,162,119,1375,2002
Shawn Kemp,PF,32,POR,75,5,1232,175,407,.430,0,4,.000,175,403,.434,.430,104,131,.794,90,198,288,52,43,33,81,184,454,2002
Steve Kerr,PG,36,POR,65,0,775,102,217,.470,26,66,.394,76,151,.503,.530,39,40,.975,6,54,60,63,13,1,24,49,269,2002
Jason Kidd,PG,28,NJN,82,82,3056,445,1138,.391,117,364,.321,328,774,.424,.442,201,247,.814,130,465,595,808,175,20,286,136,1208,2002
Andrei Kirilenko,SF,20,UTA,82,40,2151,285,633,.450,25,100,.250,260,533,.488,.470,285,371,.768,149,253,402,94,116,159,108,156,880,2002
Kerry Kittles,SG,27,NJN,82,82,2601,438,940,.466,98,242,.405,340,698,.487,.518,128,172,.744,68,207,275,216,130,31,109,108,1102,2002
Brevin Knight,PG,26,MEM,53,11,1151,141,334,.422,2,8,.250,139,326,.426,.425,87,115,.757,11,98,109,302,79,7,111,135,371,2002
Travis Knight,C,27,NYK,49,0,429,41,113,.363,0,0,.000,41,113,.363,.363,16,21,.762,48,56,104,8,11,10,27,95,98,2002
Toni Kukoc,SF,33,ATL,59,9,1494,211,504,.419,53,171,.310,158,333,.474,.471,109,153,.712,43,175,218,210,48,17,113,91,584,2002
Christian Laettner,PF,32,WAS,57,48,1441,168,362,.464,2,10,.200,166,352,.472,.467,66,76,.868,74,227,301,151,60,25,85,129,404,2002
Raef LaFrentz,C,25,TOT,78,76,2455,421,920,.458,104,268,.388,317,652,.486,.514,105,151,.695,176,403,579,89,55,213,94,281,1051,2002
Raef LaFrentz,C,25,DEN,51,51,1668,307,659,.466,75,173,.434,232,486,.477,.523,70,105,.667,117,262,379,60,31,153,60,173,759,2002
Raef LaFrentz,C,25,DAL,27,25,787,114,261,.437,29,95,.305,85,166,.512,.492,35,46,.761,59,141,200,29,24,60,34,108,292,2002
Trajan Langdon,SG,25,CLE,44,0,477,70,176,.398,27,74,.365,43,102,.422,.474,42,46,.913,13,42,55,60,13,5,40,49,209,2002
Dan Langhi,SF,24,HOU,34,8,434,49,125,.392,1,4,.250,48,121,.397,.396,8,11,.727,22,45,67,14,8,5,9,25,107,2002
Rusty LaRue,PG,28,UTA,33,0,542,73,185,.395,17,50,.340,56,135,.415,.441,30,35,.857,11,38,49,71,17,7,43,58,193,2002
Voshon Lenard,SG,28,DEN,71,19,1665,315,769,.410,89,240,.371,226,529,.427,.467,94,120,.783,38,145,183,130,59,25,91,105,813,2002
Quincy Lewis,SG,24,UTA,36,19,490,64,143,.448,3,18,.167,61,125,.488,.458,13,20,.650,10,33,43,36,23,9,32,89,144,2002
Rashard Lewis,SF,22,SEA,71,70,2585,455,972,.468,123,316,.389,332,656,.506,.531,162,200,.810,139,359,498,123,104,40,97,174,1195,2002
Randy Livingston,PG,26,SEA,13,0,176,15,54,.278,1,8,.125,14,46,.304,.287,10,11,.909,9,16,25,26,9,2,2,11,41,2002
Art Long,PF,29,SEA,63,27,989,120,244,.492,0,0,.000,120,244,.492,.492,45,85,.529,107,144,251,41,22,28,63,180,285,2002
Grant Long,PF,35,MEM,66,56,1868,164,385,.426,3,17,.176,161,368,.438,.430,86,123,.699,31,200,231,136,63,12,103,123,417,2002
Felipe Lopez,SG,27,MIN,67,0,581,59,156,.378,14,33,.424,45,123,.366,.423,37,55,.673,29,51,80,39,18,1,36,73,169,2002
Tyronn Lue,PG,24,WAS,71,0,1458,222,520,.427,63,141,.447,159,379,.420,.488,48,63,.762,14,108,122,246,49,0,96,120,555,2002
George Lynch,SF,31,CHH,45,18,893,73,198,.369,1,6,.167,72,192,.375,.371,25,40,.625,70,116,186,54,40,14,41,75,172,2002
Todd MacCulloch,C,26,NJN,62,61,1502,247,465,.531,0,0,.000,247,465,.531,.531,110,164,.671,157,221,378,78,24,89,66,181,604,2002
Sam Mack,SF,31,MIA,12,1,159,14,49,.286,7,28,.250,7,21,.333,.357,5,7,.714,2,12,14,4,5,1,7,17,40,2002
Mark Madsen,PF,26,LAL,59,5,650,66,146,.452,0,2,.000,66,144,.458,.452,35,54,.648,89,73,162,44,16,13,22,104,167,2002
Corey Maggette,SG,22,LAC,63,52,1615,235,530,.443,46,139,.331,189,391,.483,.487,201,251,.801,54,177,231,112,41,19,116,155,717,2002
Jamaal Magloire,C,23,CHH,82,8,1549,228,414,.551,0,1,.000,228,413,.552,.551,243,333,.730,153,308,461,31,27,86,118,201,699,2002
Dan Majerle,SG,36,PHO,65,1,1180,99,289,.343,79,235,.336,20,54,.370,.479,23,39,.590,28,148,176,90,48,15,35,104,300,2002
Karl Malone,PF,38,UTA,80,80,3040,635,1399,.454,9,25,.360,626,1374,.456,.457,509,639,.797,142,544,686,341,152,59,263,229,1788,2002
Danny Manning,PF,35,DAL,41,10,552,71,149,.477,1,7,.143,70,142,.493,.480,22,33,.667,25,83,108,30,21,21,25,80,165,2002
Stephon Marbury,PG,24,PHO,82,80,3187,625,1413,.442,71,248,.286,554,1165,.476,.467,353,452,.781,75,191,266,666,77,13,284,186,1674,2002
Shawn Marion,SF,23,PHO,81,81,3109,654,1395,.469,48,122,.393,606,1273,.476,.486,191,226,.845,211,592,803,162,149,86,144,214,1547,2002
Sean Marks,C,26,MIA,21,6,319,38,88,.432,0,0,.000,38,88,.432,.432,20,34,.588,19,56,75,8,5,10,19,40,96,2002
Donny Marshall,SF,29,NJN,20,0,118,8,29,.276,2,4,.500,6,25,.240,.310,12,18,.667,8,13,21,5,3,0,2,14,30,2002
Donyell Marshall,SF,28,UTA,58,42,1750,343,661,.519,13,42,.310,330,619,.533,.529,160,226,.708,158,285,443,101,50,67,124,150,859,2002
Darrick Martin,PG,30,DAL,3,0,22,0,10,.000,0,2,.000,0,8,.000,.000,1,2,.500,0,1,1,3,2,0,1,4,1,2002
Kenyon Martin,PF,24,NJN,73,73,2504,445,962,.463,15,67,.224,430,895,.480,.470,181,267,.678,113,275,388,192,90,121,172,261,1086,2002
Jamal Mashburn,SF,29,CHH,40,40,1601,303,744,.407,41,112,.366,262,632,.415,.435,211,241,.876,31,211,242,171,45,6,110,80,858,2002
Anthony Mason,PF,35,MIL,82,82,3143,316,626,.505,1,1,1.000,315,625,.504,.506,154,221,.697,124,522,646,346,57,22,130,187,787,2002
Desmond Mason,SF,24,SEA,75,20,2420,357,769,.464,16,59,.271,341,710,.480,.475,201,237,.848,92,259,351,104,67,27,104,170,931,2002
Tony Massenburg,PF,34,MEM,73,31,1247,159,349,.456,1,1,1.000,158,348,.454,.457,84,117,.718,100,224,324,26,30,31,65,174,403,2002
Walter McCarty,PF,27,BOS,56,0,718,80,180,.444,39,99,.394,41,81,.506,.553,13,19,.684,32,96,128,41,18,7,22,83,212,2002
Amal McCaskill,C,28,SAS,27,0,153,20,49,.408,0,0,.000,20,49,.408,.408,12,26,.462,16,20,36,4,6,10,14,23,52,2002
George McCloud,SF,34,DEN,69,26,1830,206,576,.358,60,222,.270,146,354,.412,.410,132,163,.810,67,184,251,204,58,19,144,175,604,2002
Jelani McCoy,C,24,LAL,21,0,104,12,21,.571,0,0,.000,12,21,.571,.571,2,8,.250,8,17,25,7,0,5,8,14,26,2002
Antonio McDyess,PF,27,DEN,10,10,236,43,75,.573,0,0,.000,43,75,.573,.573,27,33,.818,18,37,55,18,10,8,20,20,113,2002
Tracy McGrady,SG,22,ORL,76,76,2912,715,1586,.451,103,283,.364,612,1303,.470,.483,415,555,.748,150,447,597,400,119,73,189,139,1948,2002
Jeff McInnis,PG,27,LAC,81,80,3030,463,1121,.413,75,234,.321,388,887,.437,.446,183,219,.836,45,168,213,500,63,6,147,202,1184,2002
Derrick McKey,SF,35,PHI,41,1,784,52,122,.426,5,12,.417,47,110,.427,.447,10,14,.714,48,79,127,45,41,4,22,90,119,2002
Aaron McKie,SG,29,PHI,48,16,1471,220,490,.449,51,128,.398,169,362,.467,.501,96,122,.787,26,166,192,179,56,14,93,74,587,2002
Stanislav Medvedenko,C,22,LAL,71,6,729,145,304,.477,0,4,.000,145,300,.483,.477,41,62,.661,85,73,158,43,29,11,42,119,331,2002
Ron Mercer,SG,25,TOT,53,41,1716,311,784,.397,18,62,.290,293,722,.406,.408,95,119,.798,50,128,178,128,32,13,88,108,735,2002
Ron Mercer,SG,25,CHI,40,40,1503,286,717,.399,17,57,.298,269,660,.408,.411,84,108,.778,44,111,155,118,30,10,79,86,673,2002
Ron Mercer,SG,25,IND,13,1,213,25,67,.373,1,5,.200,24,62,.387,.381,11,11,1.000,6,17,23,10,2,3,9,22,62,2002
Chris Mihm,C,22,CLE,74,60,1659,221,526,.420,3,7,.429,218,519,.420,.423,124,179,.693,133,259,392,24,18,89,97,260,569,2002
Darius Miles,SF,20,LAC,82,6,2227,309,642,.481,3,19,.158,306,623,.491,.484,158,255,.620,109,344,453,184,71,103,160,184,779,2002
Andre Miller,PG,25,CLE,81,81,3023,474,1045,.454,22,87,.253,452,958,.472,.464,365,447,.817,108,271,379,882,126,34,245,228,1335,2002
Brad Miller,C,25,TOT,76,75,2263,366,733,.499,3,7,.429,363,726,.500,.501,297,383,.775,252,369,621,152,76,41,115,244,1032,2002
Brad Miller,C,25,CHI,48,47,1391,208,452,.460,2,4,.500,206,448,.460,.462,190,253,.751,176,225,401,101,52,29,74,156,608,2002
Brad Miller,C,25,IND,28,28,872,158,281,.562,1,3,.333,157,278,.565,.564,107,130,.823,76,144,220,51,24,12,41,88,424,2002
Mike Miller,SF,21,ORL,63,53,2123,351,802,.438,116,303,.383,235,499,.471,.510,138,181,.762,49,224,273,198,47,23,108,145,956,2002
Reggie Miller,SG,36,IND,79,79,2889,414,913,.453,180,443,.406,234,470,.498,.552,296,325,.911,23,196,219,253,88,10,120,143,1304,2002
Chris Mills,SF,32,GSW,66,0,1237,178,427,.417,48,127,.378,130,300,.433,.473,85,107,.794,51,139,190,72,31,13,56,120,489,2002
Sam Mitchell,SF,38,MIN,74,10,726,98,227,.432,10,35,.286,88,192,.458,.454,38,49,.776,18,64,82,45,12,4,26,79,244,2002
Cuttino Mobley,SG,26,HOU,74,74,3116,595,1358,.438,149,377,.395,446,981,.455,.493,267,314,.850,63,237,300,187,109,37,180,189,1606,2002
Nazr Mohammed,C,24,ATL,82,73,2168,329,713,.461,0,1,.000,329,712,.462,.461,137,222,.617,242,409,651,33,63,61,118,252,795,2002
Jerome Moiso,C,23,CHH,15,0,76,8,20,.400,0,0,.000,8,20,.400,.400,0,0,.000,4,21,25,4,3,2,8,12,16,2002
Eric Montross,C,30,TOR,49,24,655,53,132,.402,0,1,.000,53,131,.405,.402,10,31,.323,36,104,140,16,12,23,25,92,116,2002
Mikki Moore,C,26,DET,30,0,217,29,61,.475,1,2,.500,28,59,.475,.484,20,26,.769,22,31,53,11,7,9,14,35,79,2002
Terence Morris,SF,23,HOU,68,12,1110,111,289,.384,15,78,.192,96,211,.455,.410,18,28,.643,77,134,211,64,21,27,45,72,255,2002
Hanno Mottola,C,25,ATL,82,14,1371,169,384,.440,1,13,.077,168,371,.453,.441,57,76,.750,81,187,268,50,20,19,70,174,396,2002
Alonzo Mourning,C,31,MIA,75,74,2455,447,866,.516,1,3,.333,446,863,.517,.517,283,431,.657,182,450,632,87,27,186,182,258,1178,2002
Troy Murphy,PF,21,GSW,82,4,1448,178,423,.421,3,9,.333,175,414,.423,.424,121,156,.776,99,223,322,70,36,21,84,217,480,2002
Lamond Murray,SF,28,CLE,71,68,2312,430,986,.436,101,238,.424,329,748,.440,.487,215,263,.817,81,291,372,157,70,43,141,148,1176,2002
Tracy Murray,SF,30,TOR,40,3,473,85,207,.411,40,104,.385,45,103,.437,.507,17,21,.810,18,35,53,19,11,8,25,38,227,2002
Dikembe Mutombo,C,35,PHI,80,80,2907,321,641,.501,0,0,.000,321,641,.501,.501,278,364,.764,254,609,863,83,29,190,156,242,920,2002
Mamadou N'Diaye,C,26,TOR,5,0,46,6,10,.600,0,0,.000,6,10,.600,.600,8,10,.800,6,5,11,0,0,2,1,6,20,2002
Lee Nailon,SF,26,CHH,79,41,1912,369,764,.483,1,2,.500,368,762,.483,.484,112,150,.747,103,188,291,94,59,17,96,175,851,2002
Eduardo Najera,PF,25,DAL,62,11,1357,150,300,.500,0,2,.000,150,298,.503,.500,100,148,.676,149,193,342,38,56,30,40,156,400,2002
Steve Nash,PG,27,DAL,82,82,2837,525,1088,.483,156,343,.455,369,745,.495,.554,260,293,.887,50,204,254,634,53,4,229,164,1466,2002
Tyrone Nesby,SF,26,WAS,70,9,1498,183,421,.435,13,47,.277,170,374,.455,.450,64,93,.688,105,213,318,91,61,22,49,164,443,2002
Rasho Nesterovic,C,25,MIN,82,82,2218,324,657,.493,0,1,.000,324,656,.494,.493,39,71,.549,200,334,534,75,45,109,94,262,687,2002
Ira Newble,SF,27,ATL,42,35,1273,131,263,.498,1,7,.143,130,256,.508,.500,75,88,.852,80,142,222,45,38,20,49,117,338,2002
Johnny Newman,SF,38,DAL,47,17,724,67,148,.453,22,57,.386,45,91,.495,.527,42,58,.724,9,40,49,14,29,4,21,88,198,2002
Moochie Norris,PG,28,HOU,82,26,2249,251,631,.398,36,134,.269,215,497,.433,.426,127,169,.751,73,173,246,403,81,4,156,130,665,2002
Dirk Nowitzki,C,23,DAL,76,76,2891,600,1258,.477,139,350,.397,461,908,.508,.532,440,516,.853,120,635,755,186,83,77,145,222,1779,2002
Jermaine O'Neal,PF,23,IND,72,72,2707,543,1133,.479,1,14,.071,542,1119,.484,.480,284,413,.688,188,569,757,118,45,166,174,269,1371,2002
Shaquille O'Neal,C,29,LAL,67,66,2422,712,1229,.579,0,1,.000,712,1228,.580,.579,398,717,.555,235,480,715,200,41,137,171,199,1822,2002
Charles Oakley,PF,38,CHI,57,36,1383,97,263,.369,1,6,.167,96,257,.374,.371,21,28,.750,72,271,343,114,49,11,87,175,216,2002
Lamar Odom,SF,22,LAC,29,25,999,151,360,.419,16,84,.190,135,276,.489,.442,61,93,.656,31,145,176,171,23,36,97,91,379,2002
Hakeem Olajuwon,C,39,TOR,61,37,1378,194,418,.464,0,2,.000,194,416,.466,.464,47,84,.560,98,268,366,66,74,90,98,147,435,2002
Dean Oliver,PG,23,GSW,20,0,139,17,46,.370,2,13,.154,15,33,.455,.391,6,9,.667,0,8,8,21,3,0,11,16,42,2002
Kevin Ollie,PG,29,TOT,81,17,1723,137,353,.388,1,2,.500,136,351,.387,.390,187,227,.824,25,159,184,291,62,2,106,97,462,2002
Kevin Ollie,PG,29,CHI,52,17,1146,97,253,.383,1,2,.500,96,251,.382,.385,109,130,.838,18,110,128,193,36,1,80,64,304,2002
Kevin Ollie,PG,29,IND,29,0,577,40,100,.400,0,0,.000,40,100,.400,.400,78,97,.804,7,49,56,98,26,1,26,33,158,2002
Michael Olowokandi,C,26,LAC,80,79,2568,384,886,.433,0,0,.000,384,886,.433,.433,117,188,.622,164,547,711,90,55,145,175,217,885,2002
Greg Ostertag,C,28,UTA,74,14,1107,91,201,.453,0,0,.000,91,201,.453,.453,63,130,.485,125,188,313,50,15,109,51,152,245,2002
Bo Outlaw,PF,30,TOT,83,36,1928,166,299,.555,1,2,.500,165,297,.556,.557,43,102,.422,147,217,364,127,70,92,96,205,376,2002
Bo Outlaw,PF,30,ORL,10,0,160,13,21,.619,0,0,.000,13,21,.619,.619,8,18,.444,15,14,29,5,9,9,11,23,34,2002
Bo Outlaw,PF,30,PHO,73,36,1768,153,278,.550,1,2,.500,152,276,.551,.552,35,84,.417,132,203,335,122,61,83,85,182,342,2002
Doug Overton,PG,32,LAC,18,0,130,14,44,.318,7,27,.259,7,17,.412,.398,4,7,.571,1,11,12,13,3,1,12,10,39,2002
Olumide Oyedeji,C,20,SEA,36,1,221,22,41,.537,0,0,.000,22,41,.537,.537,11,18,.611,27,52,79,4,4,2,14,36,55,2002
Robert Pack,PG,32,MIN,16,0,252,25,68,.368,1,4,.250,24,64,.375,.375,11,15,.733,7,16,23,49,13,0,20,32,62,2002
Scott Padgett,PF,25,UTA,75,1,1295,188,395,.476,49,113,.434,139,282,.493,.538,75,102,.735,111,174,285,82,43,13,69,140,500,2002
Milt Palacio,PG-SG,23,TOT,69,1,790,82,214,.383,13,41,.317,69,173,.399,.414,54,74,.730,11,62,73,83,30,4,40,61,231,2002
Milt Palacio,PG,23,BOS,41,0,518,52,135,.385,12,34,.353,40,101,.396,.430,36,51,.706,8,42,50,54,21,3,24,38,152,2002
Milt Palacio,SG,23,PHO,28,1,272,30,79,.380,1,7,.143,29,72,.403,.386,18,23,.783,3,20,23,29,9,1,16,23,79,2002
Tony Parker,PG,19,SAS,77,72,2267,268,639,.419,61,189,.323,207,450,.460,.467,108,160,.675,33,164,197,334,89,7,151,166,705,2002
Cherokee Parks,C,29,SAS,42,1,234,30,83,.361,0,0,.000,30,83,.361,.361,3,8,.375,24,34,58,10,7,8,14,34,63,2002
Ruben Patterson,SF,26,POR,75,13,1765,319,619,.515,9,36,.250,310,583,.532,.523,192,274,.701,155,143,298,107,79,37,114,140,839,2002
Gary Payton,PG,33,SEA,82,82,3301,737,1578,.467,74,236,.314,663,1342,.494,.490,267,335,.797,80,316,396,737,131,26,209,179,1815,2002
Anthony Peeler,SG,32,MIN,82,0,2060,288,684,.421,111,283,.392,177,401,.441,.502,50,58,.862,37,169,206,177,61,11,76,137,737,2002
Mike Penberthy,PG,27,LAL,3,0,12,1,2,.500,0,0,.000,1,2,.500,.500,3,4,.750,0,2,2,2,2,0,0,0,5,2002
Elliot Perry,PG,32,MEM,2,0,48,5,10,.500,0,0,.000,5,10,.500,.500,1,2,.500,0,4,4,7,3,0,7,6,11,2002
Wesley Person,SG,30,CLE,78,78,2793,467,944,.495,143,322,.444,324,622,.521,.570,99,124,.798,50,244,294,173,77,37,74,93,1176,2002
Morris Peterson,SF,24,TOR,63,56,1988,336,768,.438,84,231,.364,252,537,.469,.492,127,169,.751,91,132,223,153,73,11,86,174,883,2002
Eric Piatkowski,SG,31,LAC,71,64,1718,207,471,.439,111,238,.466,96,233,.412,.557,101,113,.894,43,141,184,112,41,12,64,110,626,2002
Paul Pierce,SG,24,BOS,82,82,3302,707,1598,.442,210,520,.404,497,1078,.461,.508,520,643,.809,81,485,566,261,154,86,241,237,2144,2002
Scottie Pippen,SF,36,POR,62,60,1996,246,599,.411,54,177,.305,192,422,.455,.456,113,146,.774,77,244,321,363,101,35,171,162,659,2002
Scot Pollard,C,26,SAC,80,29,1881,197,358,.550,0,0,.000,197,358,.550,.550,115,166,.693,188,377,565,53,70,76,68,202,509,2002
Mark Pope,PF,29,MIL,45,12,426,36,91,.396,4,25,.160,32,66,.485,.418,11,21,.524,20,53,73,17,11,11,15,47,87,2002
Terry Porter,PG,38,SAS,72,0,1294,136,321,.424,59,142,.415,77,179,.430,.516,68,83,.819,12,152,164,205,45,16,85,89,399,2002
James Posey,SF,25,DEN,73,63,2238,277,736,.376,67,237,.283,210,499,.421,.422,161,203,.793,109,320,429,180,114,39,127,224,782,2002
Lavor Postell,SG,23,NYK,23,0,179,28,84,.333,6,26,.231,22,58,.379,.369,31,41,.756,2,14,16,5,6,0,11,7,93,2002
Vitaly Potapenko,C,26,BOS,79,9,1343,137,301,.455,0,0,.000,137,301,.455,.455,89,120,.742,167,180,347,30,37,18,63,174,363,2002
Brent Price,PG,33,SAC,20,0,89,9,27,.333,4,15,.267,5,12,.417,.407,9,13,.692,4,4,8,9,3,1,10,13,31,2002
Joel Przybilla,C,22,MIL,71,62,1128,76,142,.535,0,1,.000,76,141,.539,.535,38,90,.422,78,205,283,21,20,118,43,199,190,2002
Vladimir Radmanovic,PF,21,SEA,61,16,1230,146,354,.412,66,157,.420,80,197,.406,.506,49,72,.681,45,185,230,81,56,24,72,119,407,2002
Zach Randolph,PF,20,POR,41,0,238,48,107,.449,0,0,.000,48,107,.449,.449,18,27,.667,31,38,69,13,7,4,15,29,114,2002
Theo Ratliff,C,28,ATL,3,2,82,10,20,.500,0,0,.000,10,20,.500,.500,6,11,.545,5,11,16,1,1,8,7,8,26,2002
Zeljko Rebraca,C,29,DET,74,4,1179,189,374,.505,0,0,.000,189,374,.505,.505,135,175,.771,84,206,290,38,28,73,84,192,513,2002
Eldridge Recasner,PG-SG,34,TOT,6,0,33,2,6,.333,0,1,.000,2,5,.400,.333,1,1,1.000,0,0,0,5,1,0,1,4,5,2002
Eldridge Recasner,SG,34,CHH,1,0,2,0,0,.000,0,0,.000,0,0,.000,.000,0,0,.000,0,0,0,0,0,0,0,1,0,2002
Eldridge Recasner,PG,34,LAC,5,0,31,2,6,.333,0,1,.000,2,5,.400,.333,1,1,1.000,0,0,0,5,1,0,1,3,5,2002
Michael Redd,SG,22,MIL,67,8,1417,294,609,.483,88,198,.444,206,411,.501,.555,91,115,.791,77,147,224,91,42,7,57,96,767,2002
Don Reid,PF,28,ORL,68,5,714,90,190,.474,0,0,.000,90,190,.474,.474,44,68,.647,65,111,176,27,20,44,54,180,224,2002
Glen Rice,SF,34,HOU,20,20,606,65,167,.389,18,64,.281,47,103,.456,.443,24,30,.800,5,42,47,31,12,3,24,34,172,2002
Jason Richardson,SG,21,GSW,80,75,2629,464,1090,.426,82,246,.333,382,844,.453,.463,141,210,.671,124,216,340,236,106,31,160,195,1151,2002
Norm Richardson,SG,22,TOT,11,0,67,10,26,.385,4,8,.500,6,18,.333,.462,6,9,.667,3,5,8,2,0,0,3,5,30,2002
Norm Richardson,SG,22,IND,3,0,4,0,3,.000,0,0,.000,0,3,.000,.000,0,0,.000,1,0,1,1,0,0,0,0,0,2002
Norm Richardson,SG,22,CHI,8,0,63,10,23,.435,4,8,.500,6,15,.400,.522,6,9,.667,2,5,7,1,0,0,3,5,30,2002
Quentin Richardson,SG,21,LAC,81,0,2152,400,926,.432,133,349,.381,267,577,.463,.504,143,187,.765,113,221,334,128,78,21,102,142,1076,2002
Mitch Richmond,SG,36,LAL,64,2,709,100,247,.405,18,62,.290,82,185,.443,.441,42,44,.955,14,80,94,57,18,6,40,61,260,2002
Isaiah Rider,SG,30,DEN,10,1,173,37,81,.457,6,15,.400,31,66,.470,.494,13,17,.765,10,23,33,12,3,2,14,11,93,2002
Clifford Robinson,PF,35,DET,80,80,2855,454,1069,.425,115,304,.378,339,765,.443,.478,143,206,.694,79,307,386,202,89,95,151,243,1166,2002
David Robinson,C,36,SAS,78,78,2303,341,672,.507,0,0,.000,341,672,.507,.507,269,395,.681,191,456,647,94,86,140,104,193,951,2002
Eddie Robinson,SF,25,CHI,29,12,653,112,247,.453,2,5,.400,110,242,.455,.457,36,48,.750,24,54,78,37,23,11,36,35,262,2002
Glenn Robinson,SF,29,MIL,66,63,2346,536,1147,.467,58,178,.326,478,969,.493,.493,236,282,.837,70,336,406,168,97,41,174,173,1366,2002
Larry Robinson,SG,34,NYK,2,0,10,1,4,.250,1,2,.500,0,2,.000,.375,0,0,.000,0,2,2,0,0,0,0,1,3,2002
Carlos Rogers,C,30,IND,22,1,168,24,43,.558,1,6,.167,23,37,.622,.570,10,19,.526,14,24,38,3,5,6,5,17,59,2002
Rodney Rogers,SF,30,TOT,77,8,1880,356,756,.471,88,235,.374,268,521,.514,.529,117,149,.785,129,219,348,112,66,29,108,226,917,2002
Rodney Rogers,SF,30,PHO,50,7,1254,249,534,.466,49,140,.350,200,394,.508,.512,82,99,.828,95,146,241,72,50,17,66,148,629,2002
Rodney Rogers,SF,30,BOS,27,1,626,107,222,.482,39,95,.411,68,127,.535,.570,35,50,.700,34,73,107,40,16,12,42,78,288,2002
Sean Rooks,C,32,LAC,61,2,728,81,194,.418,0,0,.000,81,194,.418,.418,21,29,.724,32,92,124,25,12,21,20,114,183,2002
Jalen Rose,SF,29,TOT,83,83,3153,663,1458,.455,89,246,.362,574,1212,.474,.485,281,335,.839,43,330,373,355,78,45,201,251,1696,2002
Jalen Rose,SF,29,IND,53,53,1937,387,871,.444,52,146,.356,335,725,.462,.474,156,186,.839,29,220,249,197,45,29,105,148,982,2002
Jalen Rose,SF,29,CHI,30,30,1216,276,587,.470,37,100,.370,239,487,.491,.502,125,149,.839,14,110,124,158,33,16,96,103,714,2002
Malik Rose,PF,27,SAS,82,1,1725,293,633,.463,1,12,.083,292,621,.470,.464,185,257,.720,172,320,492,61,70,42,140,208,772,2002
Michael Ruffin,PF,25,PHI,15,0,169,7,26,.269,0,0,.000,7,26,.269,.269,2,8,.250,23,28,51,5,5,8,11,23,16,2002
Bryon Russell,SG,31,UTA,66,40,1998,222,584,.380,77,226,.341,145,358,.405,.446,115,140,.821,79,216,295,136,64,19,110,205,636,2002
Daniel Santiago,C,25,PHO,3,0,24,4,8,.500,0,0,.000,4,8,.500,.500,0,0,.000,0,7,7,2,0,1,2,4,8,2002
Jeryl Sasser,SG,22,ORL,7,0,36,3,14,.214,0,0,.000,3,14,.214,.214,4,5,.800,3,4,7,2,3,0,2,3,10,2002
Kenny Satterfield,PG,20,DEN,36,4,560,73,199,.367,7,27,.259,66,172,.384,.384,36,46,.783,17,35,52,108,31,1,53,43,189,2002
Brian Scalabrine,PF,23,NJN,28,0,290,23,67,.343,3,10,.300,20,57,.351,.366,11,15,.733,12,39,51,21,9,2,24,39,60,2002
Shawnelle Scott,C,29,DEN,21,10,252,37,75,.493,0,0,.000,37,75,.493,.493,8,20,.400,53,50,103,8,3,6,15,49,82,2002
Ansu Sesay,SF,25,SEA,9,0,142,22,44,.500,0,0,.000,22,44,.500,.500,14,20,.700,7,13,20,8,3,2,2,18,58,2002
Brian Shaw,PG,35,LAL,58,0,631,61,173,.353,29,88,.330,32,85,.376,.436,18,26,.692,19,93,112,89,25,3,32,43,169,2002
Bobby Simmons,SF,21,WAS,30,3,343,43,95,.453,4,14,.286,39,81,.481,.474,22,30,.733,25,27,52,17,13,5,14,31,112,2002
Dickey Simpkins,PF,29,ATL,1,0,3,0,0,.000,0,0,.000,0,0,.000,.000,0,0,.000,0,0,0,1,0,0,0,0,0,2002
Brian Skinner,PF,25,CLE,65,8,1107,88,162,.543,0,0,.000,88,162,.543,.543,48,79,.608,93,188,281,17,24,61,42,130,224,2002
Reggie Slater,PF,31,TOT,8,0,47,7,15,.467,0,0,.000,7,15,.467,.467,7,10,.700,5,4,9,1,1,1,1,3,21,2002
Reggie Slater,PF,31,NJN,4,0,10,2,2,1.000,0,0,.000,2,2,1.000,1.000,1,1,1.000,0,2,2,0,0,0,1,1,5,2002
Reggie Slater,PF,31,ATL,4,0,37,5,13,.385,0,0,.000,5,13,.385,.385,6,9,.667,5,2,7,1,1,1,0,2,16,2002
Charles Smith,SG,26,SAS,60,22,1141,182,428,.425,35,131,.267,147,297,.495,.466,42,65,.646,34,99,133,80,52,44,59,114,441,2002
Jabari Smith,C,24,TOT,23,0,181,26,63,.413,0,3,.000,26,60,.433,.413,21,32,.656,8,20,28,11,6,6,5,31,73,2002
Jabari Smith,C,24,SAC,12,0,71,6,21,.286,0,1,.000,6,20,.300,.286,6,12,.500,2,12,14,6,2,4,2,12,18,2002
Jabari Smith,C,24,PHI,11,0,110,20,42,.476,0,2,.000,20,40,.500,.476,15,20,.750,6,8,14,5,4,2,3,19,55,2002
Joe Smith,C,26,MIN,72,63,1922,297,581,.511,2,3,.667,295,578,.510,.513,171,206,.830,152,301,453,82,39,59,86,250,767,2002
Leon Smith,C,21,ATL,14,0,100,10,26,.385,0,0,.000,10,26,.385,.385,11,17,.647,10,21,31,3,5,1,3,12,31,2002
Steve Smith,SG,32,SAS,77,76,2211,310,682,.455,116,246,.472,194,436,.445,.540,159,181,.878,45,148,193,151,54,15,108,158,895,2002
Eric Snow,PG,28,PHI,61,61,2225,276,624,.442,3,27,.111,273,597,.457,.445,183,227,.806,33,182,215,400,95,9,138,167,738,2002
Will Solomon,SG,23,MEM,62,4,872,113,331,.341,46,162,.284,67,169,.396,.411,49,73,.671,12,56,68,92,35,7,62,76,321,2002
Felton Spencer,C,34,NYK,32,8,248,6,26,.231,0,0,.000,6,26,.231,.231,17,33,.515,16,34,50,3,7,8,12,73,29,2002
Latrell Sprewell,SF,31,NYK,81,81,3326,573,1419,.404,145,403,.360,428,1016,.421,.455,284,346,.821,59,239,298,313,94,14,223,161,1575,2002
Jerry Stackhouse,SF,27,DET,76,76,2685,524,1319,.397,86,300,.287,438,1019,.430,.430,495,577,.858,77,238,315,403,77,37,266,163,1629,2002
John Starks,SG,36,UTA,66,1,929,114,310,.368,29,95,.305,85,215,.395,.415,33,41,.805,15,53,68,70,33,0,52,126,290,2002
Vladimir Stepania,C,25,MIA,67,4,884,117,249,.470,1,2,.500,116,247,.470,.472,50,104,.481,100,170,270,16,24,44,52,103,285,2002
DeShawn Stevenson,SG,20,UTA,67,23,1134,143,371,.385,2,25,.080,141,346,.408,.388,37,53,.698,44,87,131,116,29,24,68,82,325,2002
Michael Stewart,C,26,TOR,11,0,93,8,23,.348,0,0,.000,8,23,.348,.348,6,11,.545,12,13,25,3,4,3,4,22,22,2002
Bryant Stith,SG,31,CLE,50,5,665,70,188,.372,24,68,.353,46,120,.383,.436,44,52,.846,20,65,85,42,29,6,30,42,208,2002
John Stockton,PG,39,UTA,82,82,2566,401,775,.517,25,78,.321,376,697,.539,.534,275,321,.857,59,204,263,674,152,24,208,209,1102,2002
Peja Stojakovic,SF,24,SAC,71,71,2649,547,1130,.484,129,310,.416,418,820,.510,.541,283,323,.876,72,301,373,175,81,14,140,120,1506,2002
Damon Stoudamire,PG,28,POR,75,71,2796,369,918,.402,104,295,.353,265,623,.425,.459,174,196,.888,78,214,292,490,67,7,149,153,1016,2002
Erick Strickland,PG,28,BOS,79,4,1643,190,488,.389,95,247,.385,95,241,.394,.487,131,155,.845,22,191,213,184,56,1,94,145,606,2002
Mark Strickland,SF,31,ATL,46,10,654,91,204,.446,1,4,.250,90,200,.450,.449,25,44,.568,41,90,131,20,19,17,28,48,208,2002
Rod Strickland,PG,35,MIA,76,64,2294,316,714,.443,8,26,.308,308,688,.448,.448,154,201,.766,49,183,232,463,82,11,159,114,794,2002
Bruno Sundov,C,21,IND,22,0,88,16,40,.400,0,1,.000,16,39,.410,.400,0,2,.000,7,14,21,3,3,3,4,16,32,2002
Bob Sura,PG,28,GSW,78,5,1780,250,590,.424,42,133,.316,208,457,.455,.459,236,328,.720,89,167,256,275,88,17,133,160,778,2002
Stromile Swift,PF,22,MEM,68,14,1805,293,611,.480,0,3,.000,293,608,.482,.480,217,305,.711,161,269,430,50,53,113,122,178,803,2002
Wally Szczerbiak,SF,24,MIN,82,82,3117,609,1200,.508,87,191,.455,522,1009,.517,.544,226,272,.831,120,271,391,257,66,21,181,188,1531,2002
Jason Terry,SG,24,ATL,78,78,2967,524,1219,.430,172,444,.387,352,775,.454,.500,284,340,.835,40,230,270,444,144,13,181,156,1504,2002
Etan Thomas,C,23,WAS,47,0,618,81,151,.536,0,0,.000,81,151,.536,.536,41,74,.554,55,126,181,6,17,35,26,76,203,2002
Kenny Thomas,PF,24,HOU,72,71,2484,396,829,.478,0,16,.000,396,813,.487,.478,223,336,.664,158,358,516,137,85,66,143,195,1015,2002
Kurt Thomas,C,29,NYK,82,82,2771,463,938,.494,1,6,.167,462,932,.496,.494,216,265,.815,214,533,747,87,71,79,153,341,1143,2002
Tim Thomas,SF,24,MIL,74,22,1987,316,753,.420,95,291,.326,221,462,.478,.483,142,179,.793,64,236,300,105,65,32,127,200,869,2002
Jamaal Tinsley,PG,23,IND,80,78,2442,289,760,.380,42,175,.240,247,585,.422,.408,131,186,.704,78,220,298,647,138,40,270,248,751,2002
Oscar Torres,SG,25,HOU,65,13,1075,135,341,.396,37,126,.294,98,215,.456,.450,82,105,.781,47,75,122,40,25,9,49,64,389,2002
Robert Traylor,PF,24,CHH,61,1,678,87,204,.426,1,1,1.000,86,203,.424,.429,53,84,.631,67,120,187,37,24,37,45,127,228,2002
Gary Trent,PF,27,MIN,64,10,1140,193,381,.507,0,2,.000,193,379,.509,.507,92,144,.639,104,166,270,60,21,27,58,160,478,2002
Jeff Trepagnier,SG,22,CLE,12,0,77,7,23,.304,0,1,.000,7,22,.318,.304,4,7,.571,3,9,12,12,8,4,11,8,18,2002
Jake Tsakalidis,C,22,PHO,67,47,1582,190,400,.475,0,1,.000,190,399,.476,.475,111,159,.698,130,244,374,23,23,69,78,193,491,2002
Hedo Turkoglu,SF,22,SAC,80,10,1970,290,687,.422,63,171,.368,227,516,.440,.468,167,230,.726,63,300,363,163,57,31,81,184,810,2002
Nick Van Exel,PG-SG,30,TOT,72,46,2496,501,1226,.409,119,350,.340,382,876,.436,.457,201,251,.801,28,226,254,478,44,11,156,104,1322,2002
Nick Van Exel,PG,30,DEN,45,44,1739,372,912,.408,85,252,.337,287,660,.435,.454,136,174,.782,19,150,169,365,30,7,116,69,965,2002
Nick Van Exel,SG,30,DAL,27,2,757,129,314,.411,34,98,.347,95,216,.440,.465,65,77,.844,9,76,85,113,14,4,40,35,357,2002
Keith Van Horn,SF,26,NJN,81,81,2465,471,1089,.433,101,293,.345,370,796,.465,.479,156,195,.800,137,472,609,164,63,42,146,221,1199,2002
Ratko Varda,C,22,DET,1,0,6,2,3,.667,0,0,.000,2,3,.667,.667,1,1,1.000,0,1,1,0,0,0,1,3,5,2002
Jacque Vaughn,PG,26,ATL,82,16,1856,206,438,.470,24,54,.444,182,384,.474,.498,104,126,.825,18,150,168,349,65,2,112,183,540,2002
Jake Voskuhl,C,24,PHO,59,34,900,107,193,.554,0,0,.000,107,193,.554,.554,82,109,.752,103,147,250,18,11,23,48,139,296,2002
Antoine Walker,PF,25,BOS,81,81,3406,666,1689,.394,222,645,.344,444,1044,.425,.460,240,324,.741,150,564,714,407,122,38,251,237,1794,2002
Samaki Walker,PF,25,LAL,69,63,1655,187,365,.512,0,0,.000,187,365,.512,.512,86,129,.667,129,352,481,64,28,88,53,170,460,2002
Ben Wallace,C,27,DET,80,80,2921,255,480,.531,0,3,.000,255,477,.535,.531,99,234,.423,318,721,1039,115,138,278,70,178,609,2002
Gerald Wallace,SF,19,SAC,54,1,430,75,175,.429,0,7,.000,75,168,.446,.429,23,46,.500,49,40,89,27,19,6,22,46,173,2002
John Wallace,SF,27,PHO,46,0,490,93,214,.435,5,13,.385,88,201,.438,.446,40,46,.870,27,58,85,29,11,9,29,60,231,2002
Rasheed Wallace,PF,27,POR,79,79,2963,603,1287,.469,114,317,.360,489,970,.504,.513,201,274,.734,136,509,645,152,101,101,131,212,1521,2002
Charlie Ward,PG,31,NYK,63,0,1058,113,303,.373,53,164,.323,60,139,.432,.460,47,58,.810,15,112,127,203,68,14,75,100,326,2002
Earl Watson,PG,22,SEA,64,0,964,96,212,.453,16,44,.364,80,168,.476,.491,23,36,.639,31,52,83,125,60,5,51,93,231,2002
Clarence Weatherspoon,PF,31,NYK,56,41,1728,189,452,.418,0,0,.000,189,452,.418,.418,116,146,.795,149,311,460,60,37,48,47,132,494,2002
Chris Webber,PF,28,SAC,54,54,2071,532,1075,.495,5,19,.263,527,1056,.499,.497,253,338,.749,150,396,546,258,90,76,158,181,1322,2002
Bonzi Wells,SG,25,POR,74,69,2348,487,1039,.469,66,172,.384,421,867,.486,.500,215,290,.741,121,323,444,204,113,25,191,208,1255,2002
David Wesley,SG,31,CHH,67,63,2487,364,910,.400,85,256,.332,279,654,.427,.447,138,188,.734,44,99,143,236,74,15,119,147,951,2002
Jahidi White,C,25,WAS,71,69,1346,150,279,.538,0,0,.000,150,279,.538,.538,83,154,.539,159,285,444,17,25,75,65,163,383,2002
Rodney White,SF,21,DET,16,0,129,21,60,.350,2,9,.222,19,51,.373,.367,12,14,.857,2,16,18,12,9,2,14,6,56,2002
Chris Whitney,PG,30,WAS,82,81,2171,274,656,.418,131,323,.406,143,333,.429,.518,154,175,.880,11,141,152,314,72,6,85,182,833,2002
Aaron Williams,PF,30,NJN,82,13,1546,231,439,.526,0,2,.000,231,437,.529,.526,130,186,.699,115,224,339,77,29,76,79,212,592,2002
Alvin Williams,PG,27,TOR,82,82,2927,403,971,.415,62,193,.321,341,778,.438,.447,103,140,.736,58,223,281,468,135,26,150,191,971,2002
Eric Williams,SF,29,BOS,74,30,1747,144,385,.374,24,86,.279,120,299,.401,.405,160,219,.731,58,163,221,109,77,8,95,179,472,2002
Jason Williams,PG,26,MEM,65,65,2236,376,985,.382,127,430,.295,249,555,.449,.446,80,101,.792,22,173,195,519,111,7,214,102,959,2002
Jerome Williams,PF,28,TOR,68,32,1641,190,388,.490,0,0,.000,190,388,.490,.490,138,204,.676,165,221,386,75,78,25,68,153,518,2002
Monty Williams,SF,30,ORL,68,19,1284,198,362,.547,0,4,.000,198,358,.553,.547,88,134,.657,80,155,235,96,49,17,86,134,484,2002
Scott Williams,PF,33,DEN,41,16,737,86,217,.396,0,2,.000,86,215,.400,.396,30,41,.732,82,127,209,13,17,33,35,98,202,2002
Shammond Williams,SG,26,SEA,50,2,603,81,193,.420,28,75,.373,53,118,.449,.492,31,39,.795,16,47,63,83,21,2,35,35,221,2002
Walt Williams,SF,31,HOU,48,25,1117,166,396,.419,78,183,.426,88,213,.413,.518,40,51,.784,37,125,162,69,18,10,53,106,450,2002
Corliss Williamson,SF,28,DET,78,7,1701,411,806,.510,1,5,.200,410,801,.512,.511,240,298,.805,117,202,319,94,49,26,137,226,1063,2002
Kevin Willis,PF,39,HOU,52,5,865,125,284,.440,0,1,.000,125,283,.442,.440,65,87,.747,105,194,299,14,25,23,41,98,315,2002
Loren Woods,C,23,MIN,60,0,516,33,96,.344,0,2,.000,33,94,.351,.344,44,60,.733,46,76,122,22,17,34,36,60,110,2002
Metta World Peace,SF,22,TOT,55,50,1642,269,636,.423,53,170,.312,216,466,.464,.465,136,204,.667,73,198,271,127,141,39,118,217,727,2002
Metta World Peace,SF,22,CHI,27,26,823,152,351,.433,36,91,.396,116,260,.446,.484,81,129,.628,40,91,131,77,75,23,69,108,421,2002
Metta World Peace,SF,22,IND,28,24,819,117,285,.411,17,79,.215,100,206,.485,.440,55,75,.733,33,107,140,50,66,16,49,109,306,2002
Lorenzen Wright,C,26,MEM,43,33,1251,223,486,.459,0,2,.000,223,484,.461,.459,70,123,.569,130,275,405,44,30,23,72,126,516,2002
Wang Zhizhi,C,24,DAL,55,0,600,109,248,.440,48,116,.414,61,132,.462,.536,42,57,.737,19,92,111,22,11,18,25,84,308,2002
Mahmoud Abdul-Rauf,PG,31,VAN,41,0,486,120,246,.488,4,14,.286,116,232,.500,.496,22,29,.759,5,20,25,76,9,1,26,50,266,2001
Tariq Abdul-Wahad,SG,26,DEN,29,12,420,43,111,.387,4,10,.400,39,101,.386,.405,21,36,.583,14,45,59,22,14,13,34,54,111,2001
Shareef Abdur-Rahim,SF,24,VAN,81,81,3241,604,1280,.472,12,64,.188,592,1216,.487,.477,443,531,.834,175,560,735,250,90,77,231,238,1663,2001
Cory Alexander,PG,27,ORL,26,0,227,18,56,.321,4,16,.250,14,40,.350,.357,12,18,.667,0,25,25,36,16,0,25,29,52,2001
Courtney Alexander,PG,23,TOT,65,24,1382,239,573,.417,17,46,.370,222,527,.421,.432,123,150,.820,42,101,143,62,45,5,75,139,618,2001
Courtney Alexander,PG,23,DAL,38,6,472,62,178,.348,3,10,.300,59,168,.351,.357,33,45,.733,20,43,63,21,16,3,21,76,160,2001
Courtney Alexander,PG,23,WAS,27,18,910,177,395,.448,14,36,.389,163,359,.454,.466,90,105,.857,22,58,80,41,29,2,54,63,458,2001
Ray Allen,SG,25,MIL,82,82,3129,628,1309,.480,202,467,.433,426,842,.506,.557,348,392,.888,101,327,428,374,124,20,204,192,1806,2001
Rafer Alston,PG,24,MIL,37,2,288,30,84,.357,8,30,.267,22,54,.407,.405,9,13,.692,4,27,31,68,13,0,20,27,77,2001
John Amaechi,C,30,ORL,82,36,1710,237,592,.400,0,7,.000,237,585,.405,.400,176,279,.631,77,191,268,74,28,29,124,175,650,2001
Derek Anderson,SG,26,SAS,82,82,2859,413,993,.416,101,253,.399,312,740,.422,.467,342,402,.851,75,288,363,301,120,14,165,188,1269,2001
Kenny Anderson,PG,30,BOS,33,28,849,88,227,.388,11,33,.333,77,194,.397,.412,59,71,.831,16,57,73,134,44,2,52,62,246,2001
Nick Anderson,SG,33,SAC,21,0,169,14,57,.246,10,39,.256,4,18,.222,.333,0,0,.000,3,22,25,13,10,4,7,13,38,2001
Shandon Anderson,SG,27,HOU,82,82,2396,263,590,.446,46,170,.271,217,420,.517,.485,138,188,.734,72,261,333,189,82,40,131,202,710,2001
Greg Anthony,PG,33,POR,58,0,856,97,253,.383,65,159,.409,32,94,.340,.512,23,35,.657,21,40,61,82,40,3,43,63,282,2001
Darrell Armstrong,PG,32,ORL,75,75,2767,413,1002,.412,143,403,.355,270,599,.451,.484,220,249,.884,94,249,343,524,135,13,200,155,1189,2001
Chucky Atkins,PG,26,DET,81,75,2363,380,952,.399,121,339,.357,259,613,.423,.463,90,130,.692,28,145,173,330,67,5,149,184,971,2001
Stacey Augmon,SG,32,POR,66,23,1182,127,266,.477,0,4,.000,127,262,.485,.477,57,87,.655,60,99,159,98,48,21,48,105,311,2001
Isaac Austin,C,31,VAN,52,16,845,96,270,.356,6,24,.250,90,246,.366,.367,28,40,.700,50,172,222,58,20,23,54,94,226,2001
William Avery,PG,21,MIN,55,0,463,55,144,.382,16,59,.271,39,85,.459,.438,28,36,.778,5,24,29,75,13,4,45,48,154,2001
Dalibor Bagaric,C,20,CHI,35,0,259,17,65,.262,0,1,.000,17,64,.266,.262,13,28,.464,22,34,56,10,9,16,21,44,47,2001
Vin Baker,PF,29,SEA,76,27,2129,347,822,.422,1,16,.063,346,806,.429,.423,232,321,.723,179,251,430,90,38,73,158,264,927,2001
Erick Barkley,PG,22,POR,8,0,38,8,22,.364,3,8,.375,5,14,.357,.432,0,0,.000,0,3,3,6,2,0,5,2,19,2001
Dana Barros,PG,33,DET,60,0,1079,183,412,.444,44,105,.419,139,307,.453,.498,68,80,.850,6,88,94,110,30,2,60,63,478,2001
Brent Barry,SG,29,SEA,67,20,1778,198,401,.494,109,229,.476,89,172,.517,.630,84,103,.816,33,178,211,225,80,14,86,126,589,2001
Jon Barry,SG,31,SAC,62,2,1010,103,255,.404,46,132,.348,57,123,.463,.494,64,73,.877,16,78,94,130,28,6,53,66,316,2001
Tony Battie,C,24,BOS,40,25,845,108,201,.537,0,3,.000,108,198,.545,.537,44,69,.638,73,160,233,16,27,60,37,126,260,2001
Raja Bell,SG,24,PHI,5,0,30,2,7,.286,1,3,.333,1,4,.250,.357,0,0,.000,0,1,1,0,1,0,2,1,5,2001
Jonathan Bender,SF,20,IND,59,7,574,66,186,.355,11,41,.268,55,145,.379,.384,50,68,.735,14,60,74,32,7,28,42,73,193,2001
Corey Benjamin,PG,22,CHI,65,5,857,115,302,.381,21,81,.259,94,221,.425,.416,56,83,.675,38,62,100,69,28,16,63,128,307,2001
David Benoit,SF,32,UTA,49,2,446,71,147,.483,5,13,.385,66,134,.493,.500,31,39,.795,20,61,81,22,6,6,28,75,178,2001
Travis Best,PG,28,IND,77,21,2457,347,788,.440,37,97,.381,310,691,.449,.464,187,226,.827,38,184,222,473,110,11,127,246,918,2001
Mike Bibby,PG,22,VAN,82,82,3190,525,1157,.454,108,285,.379,417,872,.478,.500,143,188,.761,47,257,304,685,107,12,248,148,1301,2001
Chauncey Billups,SG,24,MIN,77,33,1790,248,587,.422,73,194,.376,175,393,.445,.485,144,171,.842,32,126,158,260,51,11,111,178,713,2001
Mookie Blaylock,PG,33,GSW,69,59,2352,317,801,.396,73,225,.324,244,576,.424,.441,53,76,.697,71,201,272,462,163,20,128,134,760,2001
Corie Blount,PF,32,TOT,68,6,1305,130,294,.442,2,8,.250,128,286,.448,.446,51,83,.614,181,219,400,59,42,22,73,165,313,2001
Corie Blount,PF,32,PHO,30,6,387,23,47,.489,0,0,.000,23,47,.489,.489,8,15,.533,35,50,85,8,13,5,18,75,54,2001
Corie Blount,PF,32,GSW,38,0,918,107,247,.433,2,8,.250,105,239,.439,.437,43,68,.632,146,169,315,51,29,17,55,90,259,2001
Mark Blount,C,25,BOS,64,50,1098,101,200,.505,0,0,.000,101,200,.505,.505,46,66,.697,97,134,231,32,39,76,62,183,248,2001
Muggsy Bogues,PG,36,TOR,3,0,34,0,2,.000,0,1,.000,0,1,.000,.000,0,0,.000,0,3,3,5,2,0,4,3,0,2001
Etdrick Bohannon,PF,27,CLE,6,0,19,2,4,.500,0,0,.000,2,4,.500,.500,4,4,1.000,3,4,7,0,0,2,1,4,8,2001
Calvin Booth,C,24,TOT,55,29,933,120,252,.476,0,0,.000,120,252,.476,.476,53,78,.679,77,169,246,42,29,111,53,146,293,2001
Calvin Booth,C,24,WAS,40,22,640,74,168,.440,0,0,.000,74,168,.440,.440,33,45,.733,53,121,174,23,17,81,36,91,181,2001
Calvin Booth,C,24,DAL,15,7,293,46,84,.548,0,0,.000,46,84,.548,.548,20,33,.606,24,48,72,19,12,30,17,55,112,2001
Cal Bowdler,SF,23,ATL,44,0,375,53,114,.465,1,5,.200,52,109,.477,.469,33,40,.825,30,47,77,4,10,21,11,45,140,2001
Bruce Bowen,SF,29,MIA,82,72,2685,211,581,.363,103,307,.336,108,274,.394,.452,98,161,.609,45,200,245,132,83,53,74,269,623,2001
Ryan Bowen,SF,25,DEN,57,0,696,80,144,.556,4,11,.364,76,133,.571,.569,27,44,.614,62,51,113,30,37,12,24,95,191,2001
Ira Bowman,PG,27,ATL,3,0,19,0,2,.000,0,0,.000,0,2,.000,.000,0,0,.000,1,1,2,7,0,0,1,0,0,2001
Earl Boykins,PG,24,LAC,10,0,149,25,63,.397,1,8,.125,24,55,.436,.405,14,17,.824,4,7,11,32,5,0,9,9,65,2001
Shawn Bradley,C,28,DAL,82,35,2001,219,447,.490,1,6,.167,218,441,.494,.491,140,178,.787,160,448,608,38,36,228,88,256,579,2001
Elton Brand,PF,21,CHI,74,74,2906,578,1215,.476,0,2,.000,578,1213,.477,.476,334,472,.708,285,461,746,240,71,118,219,243,1490,2001
Terrell Brandon,PG,30,MIN,78,78,2821,511,1134,.451,33,91,.363,478,1043,.458,.465,195,224,.871,60,238,298,583,161,21,155,138,1250,2001
Chucky Brown,SF,32,TOT,26,2,339,40,95,.421,0,3,.000,40,92,.435,.421,22,34,.647,8,46,54,11,9,7,8,37,102,2001
Chucky Brown,SF,32,GSW,6,0,74,9,20,.450,0,2,.000,9,18,.500,.450,6,10,.600,3,15,18,5,3,1,2,10,24,2001
Chucky Brown,SF,32,CLE,20,2,265,31,75,.413,0,1,.000,31,74,.419,.413,16,24,.667,5,31,36,6,6,6,6,27,78,2001
Dee Brown,PG,32,ORL,7,0,155,16,44,.364,12,32,.375,4,12,.333,.500,4,5,.800,0,11,11,12,4,0,7,10,48,2001
P.J. Brown,C,31,CHH,80,79,2811,249,561,.444,0,4,.000,249,557,.447,.444,178,209,.852,257,485,742,127,78,92,108,260,676,2001
Randy Brown,PG,32,BOS,54,35,1238,100,237,.422,0,3,.000,100,234,.427,.422,23,40,.575,23,76,99,154,62,10,56,132,223,2001
Rick Brunson,PG,28,TOT,22,0,208,18,54,.333,2,14,.143,16,40,.400,.352,8,15,.533,5,16,21,31,8,1,17,21,46,2001
Rick Brunson,PG,28,BOS,7,0,142,10,35,.286,2,11,.182,8,24,.333,.314,4,9,.444,2,7,9,24,7,1,9,16,26,2001
Rick Brunson,PG,28,NYK,15,0,66,8,19,.421,0,3,.000,8,16,.500,.421,4,6,.667,3,9,12,7,1,0,8,5,20,2001
Kobe Bryant,SG,22,LAL,68,68,2783,701,1510,.464,61,200,.305,640,1310,.489,.484,475,557,.853,104,295,399,338,114,43,220,222,1938,2001
Mark Bryant,PF,35,DAL,18,1,101,8,20,.400,0,0,.000,8,20,.400,.400,3,5,.600,4,17,21,3,1,2,5,29,19,2001
Greg Buckner,SG,24,DAL,37,9,820,84,192,.438,2,7,.286,82,185,.443,.443,59,81,.728,60,97,157,49,33,9,27,118,229,2001
Jud Buechler,SF,32,DET,57,3,737,76,164,.463,32,77,.416,44,87,.506,.561,9,12,.750,20,74,94,39,21,10,25,83,193,2001
Rodney Buford,SF,23,PHI,47,0,573,104,241,.432,16,38,.421,88,203,.433,.465,24,29,.828,16,58,74,17,17,6,29,68,248,2001
Matt Bullard,PF,33,HOU,61,5,1000,129,305,.423,86,213,.404,43,92,.467,.564,10,14,.714,22,108,130,42,10,9,12,76,354,2001
Scott Burrell,SF,30,CHH,4,0,41,7,15,.467,2,6,.333,5,9,.556,.533,1,4,.250,1,2,3,1,3,0,0,8,17,2001
Jason Caffey,PF,27,MIL,70,33,1460,179,367,.488,0,0,.000,179,367,.488,.488,142,211,.673,135,218,353,53,38,25,77,184,500,2001
Marcus Camby,C,26,NYK,63,63,2127,304,580,.524,1,8,.125,303,572,.530,.525,150,225,.667,196,527,723,52,66,136,63,205,759,2001
Elden Campbell,PF,32,CHH,78,78,2337,367,834,.440,0,6,.000,367,828,.443,.440,288,406,.709,157,451,608,104,60,140,144,280,1022,2001
Brian Cardinal,PF,23,DET,15,0,126,10,31,.323,0,5,.000,10,26,.385,.323,11,18,.611,8,15,23,3,7,2,9,27,31,2001
Chris Carr,SG,26,BOS,35,0,309,53,112,.473,17,37,.459,36,75,.480,.549,46,60,.767,11,33,44,11,4,3,19,45,169,2001
Anthony Carter,PG,25,MIA,72,6,1630,195,480,.406,6,40,.150,189,440,.430,.413,65,103,.631,46,134,180,268,73,10,119,154,461,2001
Vince Carter,SF,24,TOR,75,75,2979,762,1656,.460,162,397,.408,600,1259,.477,.509,384,502,.765,176,240,416,291,114,82,167,205,2070,2001
Sam Cassell,PG,31,MIL,76,75,2709,537,1132,.474,30,98,.306,507,1034,.490,.488,277,323,.858,46,244,290,580,88,8,220,214,1381,2001
Kelvin Cato,C,26,HOU,35,13,624,64,111,.577,0,0,.000,64,111,.577,.577,37,57,.649,47,94,141,11,13,31,25,89,165,2001
Duane Causwell,C,32,MIA,31,14,384,32,85,.376,0,0,.000,32,85,.376,.376,12,25,.480,23,60,83,5,8,18,23,67,76,2001
Cedric Ceballos,SF,31,TOT,40,0,559,101,229,.441,22,73,.301,79,156,.506,.489,37,43,.860,34,72,106,20,16,7,32,61,261,2001
Cedric Ceballos,SF,31,DET,13,0,166,28,71,.394,11,40,.275,17,31,.548,.472,8,10,.800,7,19,26,7,6,3,9,19,75,2001
Cedric Ceballos,SF,31,MIA,27,0,393,73,158,.462,11,33,.333,62,125,.496,.497,29,33,.879,27,53,80,13,10,4,23,42,186,2001
Calbert Cheaney,SG,29,DEN,9,5,153,10,30,.333,0,0,.000,10,30,.333,.333,1,2,.500,5,15,20,9,4,2,5,14,21,2001
Chris Childs,PG,33,TOT,77,5,1859,135,335,.403,32,106,.302,103,229,.450,.451,60,71,.845,24,178,202,355,59,15,156,242,362,2001
Chris Childs,PG,33,NYK,51,5,1309,93,222,.419,20,64,.313,73,158,.462,.464,39,46,.848,14,124,138,236,37,7,98,160,245,2001
Chris Childs,PG,33,TOR,26,0,550,42,113,.372,12,42,.286,30,71,.423,.425,21,25,.840,10,54,64,119,22,8,58,82,117,2001
Doug Christie,SG,30,SAC,81,81,2939,311,788,.395,94,250,.376,217,538,.403,.454,280,312,.897,95,260,355,289,183,45,154,224,996,2001
Keon Clark,PF,25,TOT,81,3,1720,249,519,.480,0,1,.000,249,518,.481,.480,142,240,.592,136,298,434,72,32,154,90,244,640,2001
Keon Clark,PF,25,DEN,35,3,752,82,199,.412,0,0,.000,82,199,.412,.412,63,105,.600,58,128,186,34,16,44,48,101,227,2001
Keon Clark,PF,25,TOR,46,0,968,167,320,.522,0,1,.000,167,319,.524,.522,79,135,.585,78,170,248,38,16,110,42,143,413,2001
Mateen Cleaves,PG,23,DET,78,8,1268,160,400,.400,5,17,.294,155,383,.405,.406,97,137,.708,26,106,132,207,49,1,139,153,422,2001
John Coker,C,29,GSW,6,0,32,1,8,.125,0,0,.000,1,8,.125,.125,0,0,.000,3,2,5,2,1,0,2,4,2,2001
Derrick Coleman,PF,33,CHH,34,3,683,97,255,.380,20,51,.392,77,204,.377,.420,63,92,.685,46,138,184,39,10,21,42,53,277,2001
Bimbo Coles,PG,32,CLE,47,0,804,91,239,.381,2,16,.125,89,223,.399,.385,48,56,.857,9,39,48,138,27,6,59,87,232,2001
Jason Collier,C,23,HOU,23,0,222,27,71,.380,0,1,.000,27,70,.386,.380,17,24,.708,12,25,37,6,2,3,11,27,71,2001
Sean Colson,PG,25,TOT,13,0,44,6,24,.250,1,5,.200,5,19,.263,.271,2,4,.500,2,4,6,10,1,0,2,6,15,2001
Sean Colson,PG,25,ATL,3,0,14,0,5,.000,0,1,.000,0,4,.000,.000,0,0,.000,0,3,3,3,0,0,2,0,0,2001
Sean Colson,PG,25,HOU,10,0,30,6,19,.316,1,4,.250,5,15,.333,.342,2,4,.500,2,1,3,7,1,0,0,6,15,2001
Tyrone Corbin,SF,38,TOR,15,1,117,9,38,.237,0,5,.000,9,33,.273,.237,2,4,.500,3,10,13,4,2,0,3,18,20,2001
Chris Crawford,PF,25,ATL,47,22,901,122,270,.452,6,22,.273,116,248,.468,.463,68,83,.819,28,82,110,37,21,16,62,117,318,2001
Jamal Crawford,PG,20,CHI,61,8,1050,107,304,.352,41,117,.350,66,187,.353,.419,27,34,.794,9,80,89,141,43,14,85,68,282,2001
Austin Croshere,PF,25,IND,81,23,1874,276,701,.394,70,207,.338,206,494,.417,.444,200,231,.866,123,264,387,92,36,50,136,180,822,2001
John Crotty,PG,31,UTA,31,0,264,22,65,.338,4,7,.571,18,58,.310,.369,17,19,.895,13,15,28,34,6,0,19,32,65,2001
Vonteego Cummings,PG,24,GSW,66,11,1495,178,517,.344,48,143,.336,130,374,.348,.391,79,116,.681,47,90,137,227,67,14,91,160,483,2001
Bill Curley,PF,28,TOT,20,2,192,25,47,.532,1,2,.500,24,45,.533,.543,12,19,.632,21,16,37,3,7,9,16,45,63,2001
Bill Curley,PF,28,DAL,5,0,15,1,4,.250,0,1,.000,1,3,.333,.250,1,4,.250,0,0,0,0,1,1,2,4,3,2001
Bill Curley,PF,28,GSW,15,2,177,24,43,.558,1,1,1.000,23,42,.548,.570,11,15,.733,21,16,37,3,6,8,14,41,60,2001
Dell Curry,SG,36,TOR,71,1,956,162,382,.424,62,145,.428,100,237,.422,.505,43,51,.843,16,69,85,75,27,8,39,66,429,2001
Michael Curry,SG,32,DET,68,58,1485,145,319,.455,4,9,.444,141,310,.455,.461,62,73,.849,21,100,121,132,27,3,61,173,356,2001
Erick Dampier,C,25,GSW,43,26,1038,126,314,.401,0,2,.000,126,312,.404,.401,67,126,.532,97,153,250,59,17,58,82,123,319,2001
Antonio Daniels,PG,25,SAS,79,23,2060,275,588,.468,74,183,.404,201,405,.496,.531,121,156,.776,26,137,163,304,61,14,109,120,745,2001
Kornel David,SF,29,TOT,27,0,209,25,51,.490,0,0,.000,25,51,.490,.490,12,13,.923,15,37,52,7,6,4,11,28,62,2001
Kornel David,SF,29,TOR,17,0,140,15,29,.517,0,0,.000,15,29,.517,.517,12,13,.923,9,24,33,4,2,3,7,20,42,2001
Kornel David,SF,29,DET,10,0,69,10,22,.455,0,0,.000,10,22,.455,.455,0,0,.000,6,13,19,3,4,1,4,8,20,2001
Antonio Davis,C,32,TOR,78,77,2729,375,866,.433,0,1,.000,375,865,.434,.433,319,423,.754,274,513,787,106,22,151,135,230,1069,2001
Baron Davis,PG,21,CHH,82,82,3192,409,957,.427,85,274,.310,324,683,.474,.472,228,337,.677,129,279,408,598,170,36,226,267,1131,2001
Dale Davis,C,31,POR,81,43,2162,242,487,.497,0,4,.000,242,483,.501,.497,96,152,.632,233,373,606,103,44,76,67,199,580,2001
Emanual Davis,SG,32,SEA,62,39,1290,133,318,.418,50,127,.394,83,191,.435,.497,45,55,.818,28,126,154,137,64,12,77,101,361,2001
Hubert Davis,PG,30,TOT,66,18,1692,196,433,.453,78,171,.456,118,262,.450,.543,54,62,.871,28,111,139,110,35,1,81,121,524,2001
Hubert Davis,PG,30,DAL,51,7,1261,139,314,.443,58,133,.436,81,181,.448,.535,35,41,.854,18,91,109,61,29,1,56,92,371,2001
Hubert Davis,PG,30,WAS,15,11,431,57,119,.479,20,38,.526,37,81,.457,.563,19,21,.905,10,20,30,49,6,0,25,29,153,2001
Ricky Davis,SG,21,MIA,7,0,70,12,29,.414,1,1,1.000,11,28,.393,.431,7,8,.875,1,6,7,11,5,2,5,7,32,2001
Terry Davis,PF,33,DEN,19,1,228,12,25,.480,0,0,.000,12,25,.480,.480,9,22,.409,24,29,53,7,1,1,5,34,33,2001
Todd Day,SG,31,MIN,31,0,345,44,118,.373,26,69,.377,18,49,.367,.483,18,23,.783,10,27,37,28,10,7,24,52,132,2001
Andrew DeClercq,C,27,ORL,67,51,903,107,193,.554,0,0,.000,107,193,.554,.554,47,82,.573,91,145,236,32,41,33,51,198,261,2001
Vinny Del Negro,PG,34,TOT,65,1,922,106,234,.453,1,13,.077,105,221,.475,.455,41,44,.932,12,70,82,126,26,3,34,78,254,2001
Vinny Del Negro,PG,34,GSW,29,1,396,30,90,.333,1,9,.111,29,81,.358,.339,16,16,1.000,4,27,31,62,6,0,15,36,77,2001
Vinny Del Negro,PG,34,PHO,36,0,526,76,144,.528,0,4,.000,76,140,.543,.528,25,28,.893,8,43,51,64,20,3,19,42,177,2001
Tony Delk,SG,27,PHO,82,11,2288,383,923,.415,54,168,.321,329,755,.436,.444,185,235,.787,76,185,261,160,75,17,101,171,1005,2001
Derrick Dial,SG,25,SAS,33,0,207,36,83,.434,2,10,.200,34,73,.466,.446,12,21,.571,12,26,38,21,4,6,12,22,86,2001
Michael Dickerson,SG,25,VAN,70,69,2618,425,1020,.417,86,230,.374,339,790,.429,.459,206,270,.763,70,159,229,233,62,27,162,207,1142,2001
Vlade Divac,C,32,SAC,81,81,2420,364,755,.482,4,14,.286,360,741,.486,.485,242,350,.691,207,466,673,231,87,93,192,242,974,2001
Michael Doleac,C,23,ORL,77,21,1398,220,527,.417,0,3,.000,220,524,.420,.417,50,59,.847,70,203,273,65,37,41,59,239,490,2001
Keyon Dooling,PG,20,LAC,76,1,1237,148,362,.409,28,80,.350,120,282,.426,.448,125,179,.698,8,81,89,177,41,11,94,107,449,2001
Sherman Douglas,PG,34,NJN,59,7,1094,122,303,.403,8,40,.200,114,263,.433,.416,86,115,.748,21,53,74,144,36,4,79,93,338,2001
Bryce Drew,PG,26,CHI,48,41,1305,124,327,.379,40,105,.381,84,222,.378,.440,14,19,.737,12,57,69,185,32,3,68,99,302,2001
Chris Dudley,C,35,PHO,53,33,613,29,73,.397,0,0,.000,29,73,.397,.397,14,36,.389,64,119,183,18,14,29,26,111,72,2001
Tim Duncan,PF,24,SAS,82,82,3174,702,1406,.499,7,27,.259,695,1379,.504,.502,409,662,.618,259,738,997,245,70,192,242,247,1820,2001
Tyus Edney,PG,27,IND,24,0,263,35,91,.385,1,6,.167,34,85,.400,.390,35,39,.897,5,19,24,54,17,0,25,17,106,2001
Kevin Edwards,SG,35,VAN,46,5,634,56,170,.329,5,19,.263,51,151,.338,.344,43,53,.811,23,59,82,52,29,8,37,46,160,2001
Howard Eisley,SG,28,DAL,82,40,2426,265,675,.393,107,269,.398,158,406,.389,.472,104,126,.825,23,174,197,295,99,12,102,218,741,2001
Obinna Ekezie,PF,25,TOT,33,0,281,32,81,.395,0,0,.000,32,81,.395,.395,37,53,.698,31,47,78,9,5,5,14,48,101,2001
Obinna Ekezie,PF,25,WAS,29,0,273,32,77,.416,0,0,.000,32,77,.416,.416,37,53,.698,31,45,76,9,5,5,14,46,101,2001
Obinna Ekezie,PF,25,DAL,4,0,8,0,4,.000,0,0,.000,0,4,.000,.000,0,0,.000,0,2,2,0,0,0,0,2,0,2001
Khalid El-Amin,PG,21,CHI,50,14,936,115,311,.370,28,84,.333,87,227,.383,.415,56,72,.778,21,60,81,145,48,2,54,99,314,2001
Mario Elie,SG,37,PHO,68,67,1506,104,246,.423,36,100,.360,68,146,.466,.496,55,69,.797,38,117,155,131,58,12,60,112,299,2001
Sean Elliott,SF,32,SAS,52,34,1229,147,339,.434,55,129,.426,92,210,.438,.515,60,84,.714,17,153,170,81,23,25,51,80,409,2001
LaPhonso Ellis,PF,30,MIN,82,5,1948,298,642,.464,7,22,.318,291,620,.469,.470,169,214,.790,199,295,494,93,67,74,108,290,772,2001
Pervis Ellison,C,33,SEA,9,0,40,2,7,.286,0,0,.000,2,7,.286,.286,2,2,1.000,2,10,12,3,0,2,3,13,6,2001
Evan Eschmeyer,C,25,NJN,74,51,1331,92,200,.460,0,0,.000,92,200,.460,.460,67,102,.657,135,231,366,40,41,58,53,220,251,2001
Patrick Ewing,C,38,SEA,79,79,2107,294,684,.430,0,2,.000,294,682,.431,.430,172,251,.685,124,461,585,92,53,91,151,229,760,2001
Jamie Feick,C,26,NJN,6,0,149,8,23,.348,0,0,.000,8,23,.348,.348,6,12,.500,12,44,56,5,8,3,7,15,22,2001
Danny Ferry,SF,34,SAS,80,29,1688,178,375,.475,70,156,.449,108,219,.493,.568,22,30,.733,55,168,223,71,28,21,50,169,448,2001
Michael Finley,SF,27,DAL,82,82,3443,711,1552,.458,91,263,.346,620,1289,.481,.487,252,325,.775,109,316,425,360,118,32,190,174,1765,2001
Derek Fisher,PG,26,LAL,20,20,709,77,187,.412,25,63,.397,52,124,.419,.479,50,62,.806,5,54,59,87,39,2,29,50,229,2001
Marcus Fizer,PF,22,CHI,72,13,1580,278,646,.430,10,39,.256,268,607,.442,.438,117,161,.727,76,237,313,76,30,19,124,175,683,2001
Danny Fortson,PF,24,GSW,6,6,203,29,50,.580,0,0,.000,29,50,.580,.580,42,54,.778,29,69,98,5,2,0,10,22,100,2001
Greg Foster,C,32,LAL,62,8,451,56,133,.421,3,9,.333,53,124,.427,.432,10,14,.714,29,83,112,32,9,12,25,76,125,2001
Jeff Foster,C,24,IND,71,9,1152,100,213,.469,2,7,.286,98,206,.476,.474,47,91,.516,144,245,389,33,39,28,52,152,249,2001
Rick Fox,SF,31,LAL,82,77,2291,287,646,.444,118,300,.393,169,346,.488,.536,95,122,.779,80,245,325,262,70,29,136,225,787,2001
Adonal Foyle,C,25,GSW,58,37,1457,156,375,.416,0,0,.000,156,375,.416,.416,30,68,.441,156,249,405,48,31,156,79,136,342,2001
Steve Francis,PG,23,HOU,80,79,3194,550,1219,.451,133,336,.396,417,883,.472,.506,358,438,.817,190,363,553,517,141,31,265,274,1591,2001
Todd Fuller,C,26,MIA,10,0,77,10,35,.286,0,0,.000,10,35,.286,.286,8,8,1.000,7,11,18,1,3,2,3,10,28,2001
Lawrence Funderburke,PF,30,SAC,59,2,698,120,242,.496,0,0,.000,120,242,.496,.496,48,77,.623,74,122,196,17,9,13,32,44,288,2001
Ruben Garces,PF,27,TOT,13,0,73,7,22,.318,0,0,.000,7,22,.318,.318,2,8,.250,16,13,29,5,3,2,5,14,16,2001
Ruben Garces,PF,27,PHO,10,0,62,7,15,.467,0,0,.000,7,15,.467,.467,2,8,.250,12,10,22,4,2,1,5,14,16,2001
Ruben Garces,PF,27,GSW,3,0,11,0,7,.000,0,0,.000,0,7,.000,.000,0,0,.000,4,3,7,1,1,1,0,0,0,2001
Chris Garner,PG,25,GSW,8,0,149,7,37,.189,0,7,.000,7,30,.233,.189,5,6,.833,2,10,12,18,7,1,9,18,19,2001
Kevin Garnett,PF,24,MIN,81,81,3202,704,1475,.477,19,66,.288,685,1409,.486,.484,357,467,.764,219,702,921,401,111,145,230,204,1784,2001
Dean Garrett,C,34,MIN,70,21,831,75,156,.481,0,0,.000,75,156,.481,.481,27,39,.692,65,152,217,24,26,49,25,93,177,2001
Pat Garrity,SF,24,ORL,76,1,1579,223,576,.387,97,224,.433,126,352,.358,.471,85,98,.867,51,159,210,51,40,15,68,241,628,2001
Chris Gatling,PF,33,CLE,74,6,1670,329,733,.449,28,92,.304,301,641,.470,.468,156,228,.684,99,292,391,61,52,27,119,185,842,2001
Matt Geiger,C,31,PHI,35,4,542,88,224,.393,0,2,.000,88,222,.396,.393,37,54,.685,50,89,139,14,12,8,25,73,213,2001
Devean George,SF,23,LAL,59,1,593,64,207,.309,15,68,.221,49,139,.353,.345,39,55,.709,35,75,110,19,15,15,34,87,182,2001
Eddie Gill,PG,22,NJN,8,0,152,16,41,.390,3,9,.333,13,32,.406,.427,4,5,.800,0,9,9,24,4,1,10,9,39,2001
Kendall Gill,SG,32,NJN,31,26,892,107,323,.331,4,14,.286,103,309,.333,.337,65,90,.722,32,99,131,87,47,7,48,64,283,2001
Dion Glover,SG,22,ATL,57,7,929,141,336,.420,9,46,.196,132,290,.455,.433,47,69,.681,39,92,131,69,49,10,54,92,338,2001
Anthony Goldwire,PG,29,DEN,20,0,201,30,80,.375,9,34,.265,21,46,.457,.431,13,17,.765,1,11,12,34,9,0,15,13,82,2001
Steve Goodrich,PF,24,CHI,12,0,133,7,18,.389,1,3,.333,6,15,.400,.417,4,7,.571,7,14,21,6,2,1,8,14,19,2001
Brian Grant,C,28,MIA,82,79,2771,484,1010,.479,0,1,.000,484,1009,.480,.479,282,354,.797,217,501,718,101,60,71,170,293,1250,2001
Gary Grant,PG,35,POR,4,0,17,5,7,.714,0,0,.000,5,7,.714,.714,0,0,.000,0,0,0,1,0,0,0,1,10,2001
Horace Grant,PF,35,LAL,77,77,2390,263,569,.462,0,3,.000,263,566,.465,.462,131,169,.775,220,325,545,121,51,61,48,181,657,2001
A.C. Green,PF,37,MIA,82,1,1411,144,324,.444,0,6,.000,144,318,.453,.444,79,111,.712,107,206,313,39,30,8,45,119,367,2001
Adrian Griffin,SF,26,BOS,44,0,377,33,97,.340,9,26,.346,24,71,.338,.387,18,24,.750,27,60,87,27,18,5,18,45,93,2001
Tom Gugliotta,PF,31,PHO,57,2,1159,149,380,.392,3,12,.250,146,368,.397,.396,61,77,.792,76,179,255,55,47,21,51,110,362,2001
A.J. Guyton,PG,22,CHI,33,8,630,78,192,.406,27,69,.391,51,123,.415,.477,15,18,.833,10,26,36,64,9,5,24,35,198,2001
Darvin Ham,SF,27,MIL,29,13,540,39,80,.488,2,3,.667,37,77,.481,.500,29,49,.592,56,65,121,25,17,21,33,85,109,2001
Richard Hamilton,SF,22,WAS,78,42,2519,547,1249,.438,40,146,.274,507,1103,.460,.454,277,319,.868,75,163,238,224,75,10,201,203,1411,2001
Zendon Hamilton,C,25,LAC,3,0,19,2,9,.222,0,0,.000,2,9,.222,.222,5,8,.625,3,5,8,0,0,0,2,4,9,2001
Tom Hammonds,PF,33,MIN,7,0,30,3,10,.300,0,0,.000,3,10,.300,.300,1,2,.500,2,2,4,1,0,0,3,8,7,2001
Anfernee Hardaway,SG,29,PHO,4,4,112,15,36,.417,2,8,.250,13,28,.464,.444,7,11,.636,5,13,18,15,6,1,3,6,39,2001
Tim Hardaway,PG,34,MIA,77,77,2613,408,1042,.392,189,517,.366,219,525,.417,.482,145,181,.801,26,178,204,483,90,6,189,155,1150,2001
Ron Harper,PG,37,LAL,47,46,1139,127,271,.469,19,72,.264,108,199,.543,.504,34,48,.708,46,120,166,113,39,25,62,70,307,2001
Matt Harpring,SG,24,CLE,56,55,1615,238,524,.454,13,52,.250,225,472,.477,.467,134,165,.812,90,152,242,102,42,17,90,161,623,2001
Al Harrington,PF,20,IND,78,38,1892,241,543,.444,1,7,.143,240,536,.448,.445,103,157,.656,119,262,381,130,63,18,148,223,586,2001
Othella Harrington,C,27,TOT,74,45,1815,247,507,.487,0,3,.000,247,504,.490,.487,171,224,.763,139,249,388,56,34,45,145,237,665,2001
Othella Harrington,C,27,VAN,44,40,1267,180,386,.466,0,3,.000,180,383,.470,.466,120,154,.779,102,187,289,36,19,26,104,136,480,2001
Othella Harrington,C,27,NYK,30,5,548,67,121,.554,0,0,.000,67,121,.554,.554,51,70,.729,37,62,99,20,15,19,41,101,185,2001
Lucious Harris,SG,30,NJN,73,50,2071,265,624,.425,46,132,.348,219,492,.445,.462,107,139,.770,71,217,288,135,74,16,64,127,683,2001
Jason Hart,PG,22,MIL,1,0,10,1,1,1.000,0,0,.000,1,1,1.000,1.000,0,0,.000,0,0,0,1,0,0,2,0,2,2001
Antonio Harvey,PF,30,POR,12,0,72,13,28,.464,0,0,.000,13,28,.464,.464,5,6,.833,5,9,14,4,1,6,3,10,31,2001
Donnell Harvey,PF,20,DAL,18,0,65,8,14,.571,0,0,.000,8,14,.571,.571,6,16,.375,6,14,20,2,3,1,7,15,22,2001
Hersey Hawkins,SG,34,CHH,59,0,681,56,137,.409,17,46,.370,39,91,.429,.471,54,63,.857,17,63,80,72,33,9,19,45,183,2001
Michael Hawkins,PG,28,CLE,10,0,76,3,9,.333,2,4,.500,1,5,.200,.444,0,0,.000,2,3,5,13,2,0,6,13,8,2001
Alan Henderson,PF,28,ATL,73,42,1810,298,671,.444,0,1,.000,298,670,.445,.444,173,271,.638,180,226,406,50,51,29,126,164,769,2001
Cedric Henderson,SF,25,CLE,55,10,961,102,262,.389,1,8,.125,101,254,.398,.391,30,46,.652,19,71,90,79,29,23,63,101,235,2001
Chris Herren,PG,25,BOS,25,7,408,29,96,.302,16,55,.291,13,41,.317,.385,9,12,.750,4,17,21,56,14,0,20,43,83,2001
Grant Hill,SF,28,ORL,4,4,133,19,43,.442,1,1,1.000,18,42,.429,.453,16,26,.615,8,17,25,25,5,2,11,9,55,2001
Tyrone Hill,PF,32,PHI,76,75,2363,278,587,.474,0,1,.000,278,586,.474,.474,172,273,.630,239,448,687,48,37,27,127,242,728,2001
Fred Hoiberg,SG,28,CHI,74,37,2247,217,495,.438,103,250,.412,114,245,.465,.542,136,157,.866,21,287,308,263,98,12,74,155,673,2001
Robert Horry,PF,30,LAL,79,1,1587,147,380,.387,54,156,.346,93,224,.415,.458,59,83,.711,93,203,296,128,54,54,79,210,407,2001
Eddie House,PG,22,MIA,50,0,550,104,247,.421,19,55,.345,85,192,.443,.460,24,35,.686,5,37,42,52,13,0,35,58,251,2001
Allan Houston,SG,29,NYK,78,78,2858,542,1208,.449,96,252,.381,446,956,.467,.488,279,307,.909,20,263,283,173,52,10,161,190,1459,2001
Juwan Howard,PF,27,TOT,81,81,2974,583,1218,.479,0,3,.000,583,1215,.480,.479,296,383,.773,171,401,572,224,75,37,242,292,1462,2001
Juwan Howard,PF,27,WAS,54,54,1981,392,827,.474,0,0,.000,392,827,.474,.474,197,256,.770,121,258,379,154,46,21,169,186,981,2001
Juwan Howard,PF,27,DAL,27,27,993,191,391,.488,0,3,.000,191,388,.492,.488,99,127,.780,50,143,193,70,29,16,73,106,481,2001
Troy Hudson,PG,24,ORL,75,7,1008,125,372,.336,22,109,.202,103,263,.392,.366,85,104,.817,38,67,105,162,37,3,92,82,357,2001
Larry Hughes,SG,22,GSW,50,45,1846,308,805,.383,14,75,.187,294,730,.403,.391,193,252,.766,76,200,276,223,96,29,152,147,823,2001
Lindsey Hunter,PG,30,MIL,82,5,2002,298,783,.381,152,407,.373,146,376,.388,.478,77,96,.802,32,137,169,222,102,12,68,172,825,2001
Zydrunas Ilgauskas,C,25,CLE,24,24,616,114,234,.487,0,2,.000,114,232,.491,.487,53,78,.679,65,95,160,18,15,37,60,78,281,2001
Allen Iverson,SG,25,PHI,71,71,2979,762,1813,.420,98,306,.320,664,1507,.441,.447,585,719,.814,50,223,273,325,178,20,237,147,2207,2001
Bobby Jackson,PG,27,SAC,79,7,1648,231,526,.439,39,104,.375,192,422,.455,.476,65,88,.739,74,172,246,161,87,7,103,139,566,2001
Jaren Jackson,SG,33,SAS,16,0,114,16,40,.400,7,18,.389,9,22,.409,.488,0,2,.000,1,11,12,7,5,0,3,13,39,2001
Jim Jackson,SF,30,TOT,56,40,1690,239,632,.378,26,80,.325,213,552,.386,.399,139,169,.822,53,171,224,163,53,10,130,139,643,2001
Jim Jackson,SF,30,ATL,17,14,550,77,217,.355,16,38,.421,61,179,.341,.392,73,85,.859,17,62,79,50,19,4,48,42,243,2001
Jim Jackson,SF,30,CLE,39,26,1140,162,415,.390,10,42,.238,152,373,.408,.402,66,84,.786,36,109,145,113,34,6,82,97,400,2001
Marc Jackson,C,26,GSW,48,35,1410,237,508,.467,5,23,.217,232,485,.478,.471,154,192,.802,119,242,361,59,34,27,93,138,633,2001
Mark Jackson,PG,35,TOT,83,82,2588,244,583,.419,70,207,.338,174,376,.463,.479,73,93,.785,63,242,305,661,84,7,175,139,631,2001
Mark Jackson,PG,35,TOR,54,54,1802,170,403,.422,57,165,.345,113,238,.475,.493,64,76,.842,42,143,185,498,63,7,117,83,461,2001
Mark Jackson,PG,35,NYK,29,28,786,74,180,.411,13,42,.310,61,138,.442,.447,9,17,.529,21,99,120,163,21,0,58,56,170,2001
Stephen Jackson,SF,22,NJN,77,40,1660,243,572,.425,52,155,.335,191,417,.458,.470,97,135,.719,41,167,208,140,86,14,130,166,635,2001
Sam Jacobson,PG,25,MIN,14,0,59,9,18,.500,0,0,.000,9,18,.500,.500,2,3,.667,3,3,6,4,3,0,0,19,20,2001
Tim James,SF,24,CHH,30,0,197,16,52,.308,1,3,.333,15,49,.306,.317,12,14,.857,15,20,35,8,2,5,8,27,45,2001
Antawn Jamison,SF,24,GSW,82,82,3394,800,1812,.442,62,205,.302,738,1607,.459,.459,382,534,.715,280,435,715,164,114,28,199,225,2044,2001
Anthony Johnson,PG,26,TOT,53,0,511,53,152,.349,1,5,.200,52,147,.354,.352,23,33,.697,10,34,44,78,23,6,34,62,130,2001
Anthony Johnson,PG,26,ATL,25,0,279,26,71,.366,0,3,.000,26,68,.382,.366,12,17,.706,3,20,23,34,17,5,20,41,64,2001
Anthony Johnson,PG,26,CLE,28,0,232,27,81,.333,1,2,.500,26,79,.329,.340,11,16,.688,7,14,21,44,6,1,14,21,66,2001
Avery Johnson,PG,35,SAS,55,20,1290,134,300,.447,1,6,.167,133,294,.452,.448,41,60,.683,21,64,85,237,33,4,60,90,310,2001
DerMarr Johnson,SF,20,ATL,78,21,1313,146,390,.374,41,127,.323,105,263,.399,.427,64,87,.736,56,122,178,64,43,30,93,134,397,2001
Ervin Johnson,C,33,MIL,82,19,1981,108,198,.545,0,0,.000,108,198,.545,.545,50,93,.538,205,408,613,40,44,97,47,257,266,2001
Larry Johnson,PF,31,NYK,65,65,2105,246,598,.411,51,163,.313,195,435,.448,.454,102,128,.797,90,273,363,127,39,29,97,209,645,2001
Damon Jones,PG,24,VAN,71,10,1415,170,416,.409,84,231,.364,86,185,.465,.510,37,52,.712,16,108,124,224,36,1,76,58,461,2001
Eddie Jones,SG,29,MIA,63,58,2282,388,871,.445,90,238,.378,298,633,.471,.497,228,270,.844,75,217,292,171,110,58,135,183,1094,2001
Jumaine Jones,SF,21,PHI,65,0,866,122,275,.444,20,60,.333,102,215,.474,.480,40,53,.755,63,126,189,32,30,15,39,68,304,2001
Popeye Jones,PF,30,WAS,45,1,638,60,153,.392,1,6,.167,59,147,.401,.395,41,55,.745,83,137,220,31,19,8,21,95,162,2001
Garth Joseph,C,27,TOT,4,0,16,1,5,.200,0,0,.000,1,5,.200,.200,0,2,.000,2,0,2,1,0,1,2,1,2,2001
Garth Joseph,C,27,TOR,2,0,8,1,2,.500,0,0,.000,1,2,.500,.500,0,0,.000,2,0,2,1,0,0,1,1,2,2001
Garth Joseph,C,27,DEN,2,0,8,0,3,.000,0,0,.000,0,3,.000,.000,0,2,.000,0,0,0,0,0,1,1,0,0,2001
Adam Keefe,PF,30,GSW,67,13,836,64,159,.403,1,3,.333,63,156,.404,.406,39,63,.619,90,119,209,36,28,20,40,102,168,2001
Shawn Kemp,PF,31,POR,68,3,1083,168,413,.407,4,11,.364,164,402,.408,.412,101,131,.771,63,196,259,65,45,23,99,184,441,2001
Steve Kerr,PG,35,SAS,55,1,650,67,159,.421,33,77,.429,34,82,.415,.525,14,15,.933,6,29,35,57,16,1,21,30,181,2001
Jerome Kersey,SF,38,MIL,22,2,243,32,69,.464,0,1,.000,32,68,.471,.464,8,16,.500,8,37,45,15,14,8,6,36,72,2001
Lari Ketner,PF,23,IND,3,0,7,0,0,.000,0,0,.000,0,0,.000,.000,0,0,.000,0,0,0,1,0,0,2,0,0,2001
Jason Kidd,PG,27,PHO,77,76,3065,451,1097,.411,69,232,.297,382,865,.442,.443,328,403,.814,91,403,494,753,166,23,286,171,1299,2001
Gerard King,SF,28,WAS,45,3,706,90,176,.511,0,0,.000,90,176,.511,.511,36,45,.800,39,90,129,31,14,11,47,94,216,2001
Brevin Knight,PG,25,TOT,53,43,1457,139,371,.375,1,10,.100,138,361,.382,.376,54,66,.818,23,145,168,311,101,4,91,155,333,2001
Brevin Knight,PG,25,CLE,6,0,93,2,15,.133,0,0,.000,2,15,.133,.133,5,6,.833,1,6,7,25,6,1,7,17,9,2001
Brevin Knight,PG,25,ATL,47,43,1364,137,356,.385,1,10,.100,136,346,.393,.386,49,60,.817,22,139,161,286,95,3,84,138,324,2001
Travis Knight,C,26,NYK,45,0,256,10,53,.189,0,1,.000,10,52,.192,.189,9,18,.500,19,34,53,5,5,11,10,47,29,2001
Toni Kukoc,SF,32,TOT,65,19,1597,275,582,.473,70,157,.446,205,425,.482,.533,101,160,.631,66,193,259,199,48,11,111,98,721,2001
Toni Kukoc,SF,32,PHI,48,5,979,151,330,.458,32,78,.410,119,252,.472,.506,52,88,.591,47,115,162,93,35,6,60,62,386,2001
Toni Kukoc,SF,32,ATL,17,14,618,124,252,.492,38,79,.481,86,173,.497,.567,49,72,.681,19,78,97,106,13,5,51,36,335,2001
Christian Laettner,C-PF,31,TOT,78,48,1663,277,551,.503,4,13,.308,273,538,.507,.506,170,204,.833,118,247,365,124,71,46,137,242,728,2001
Christian Laettner,C,31,DAL,53,35,930,165,323,.511,1,3,.333,164,320,.513,.512,67,82,.817,75,137,212,67,40,27,70,159,398,2001
Christian Laettner,PF,31,WAS,25,13,733,112,228,.491,3,10,.300,109,218,.500,.498,103,122,.844,43,110,153,57,31,19,67,83,330,2001
Raef LaFrentz,C,24,DEN,78,74,2457,387,812,.477,51,139,.367,336,673,.499,.508,183,262,.698,173,434,607,107,37,206,97,290,1008,2001
Trajan Langdon,SG,24,CLE,65,5,1116,135,313,.431,51,124,.411,84,189,.444,.513,68,76,.895,12,77,89,81,38,9,52,114,389,2001
Dan Langhi,SF,23,HOU,33,0,241,37,99,.374,0,1,.000,37,98,.378,.374,16,29,.552,13,28,41,4,7,1,8,16,90,2001
Voshon Lenard,SG,27,DEN,80,58,2331,336,846,.397,147,382,.385,189,464,.407,.484,153,192,.797,47,184,231,190,65,18,102,170,972,2001
Quincy Lewis,SF,23,UTA,35,2,402,50,123,.407,9,25,.360,41,98,.418,.443,15,21,.714,14,33,47,18,10,10,17,78,124,2001
Rashard Lewis,PF,21,SEA,78,78,2720,426,887,.480,123,285,.432,303,602,.503,.550,176,213,.826,143,398,541,125,91,45,129,191,1151,2001
Randy Livingston,PG,25,GSW,2,0,7,0,2,.000,0,1,.000,0,1,.000,.000,0,0,.000,0,1,1,1,0,0,0,0,0,2001
Art Long,SF,28,SAC,9,0,20,0,4,.000,0,0,.000,0,4,.000,.000,0,2,.000,2,6,8,1,0,3,2,5,0,2001
Grant Long,PF,34,VAN,66,27,1507,140,319,.439,4,15,.267,136,304,.447,.445,112,157,.713,76,198,274,83,72,15,62,160,396,2001
Luc Longley,C,32,NYK,25,2,301,18,54,.333,0,0,.000,18,54,.333,.333,13,17,.765,26,40,66,7,3,9,22,51,49,2001
Felipe Lopez,SG-PG,26,TOT,70,48,1565,211,478,.441,19,52,.365,192,426,.451,.461,109,156,.699,55,179,234,107,62,30,83,156,550,2001
Felipe Lopez,SG,26,WAS,47,38,1108,142,326,.436,6,29,.207,136,297,.458,.445,90,123,.732,30,130,160,73,41,18,56,110,380,2001
Felipe Lopez,PG,26,MIN,23,10,457,69,152,.454,13,23,.565,56,129,.434,.497,19,33,.576,25,49,74,34,21,12,27,46,170,2001
Tyronn Lue,PG,23,LAL,38,1,468,50,117,.427,11,34,.324,39,83,.470,.474,19,24,.792,5,27,32,45,19,0,27,54,130,2001
George Lynch,SF,30,PHI,82,80,2649,274,616,.445,15,57,.263,259,559,.463,.457,123,171,.719,200,390,590,139,99,30,109,222,686,2001
Todd MacCulloch,C,25,PHI,63,3,597,109,185,.589,0,0,.000,109,185,.589,.589,42,66,.636,69,99,168,10,7,19,27,96,260,2001
Don MacLean,SF,31,MIA,8,1,76,10,20,.500,2,2,1.000,8,18,.444,.550,9,12,.750,7,11,18,4,5,1,10,9,31,2001
Mark Madsen,PF,25,LAL,70,3,641,55,113,.487,1,1,1.000,54,112,.482,.491,26,37,.703,74,78,152,24,8,8,27,111,137,2001
Corey Maggette,SF,21,LAC,69,9,1359,225,487,.462,17,56,.304,208,431,.483,.479,223,288,.774,88,203,291,82,35,9,106,140,690,2001
Jamaal Magloire,C,22,CHH,74,0,1095,122,271,.450,0,2,.000,122,269,.454,.450,95,145,.655,103,192,295,27,18,78,61,139,339,2001
Dan Majerle,SG,35,MIA,53,19,1306,87,259,.336,57,181,.315,30,78,.385,.446,36,44,.818,20,146,166,88,53,15,35,98,267,2001
Karl Malone,PF,37,UTA,81,81,2895,670,1345,.498,2,5,.400,668,1340,.499,.499,536,676,.793,114,555,669,361,93,62,244,216,1878,2001
Matt Maloney,PG,29,ATL,55,27,1403,146,348,.420,51,142,.359,95,206,.461,.493,26,34,.765,14,103,117,154,56,5,70,94,369,2001
Danny Manning,PF,34,UTA,82,0,1305,247,500,.494,7,28,.250,240,472,.508,.501,102,140,.729,66,148,214,92,47,29,96,219,603,2001
Stephon Marbury,PG,23,NJN,67,67,2557,563,1277,.441,110,335,.328,453,942,.481,.484,362,458,.790,53,152,205,506,79,5,197,150,1598,2001
Shawn Marion,SF,22,PHO,79,79,2857,557,1160,.480,21,82,.256,536,1078,.497,.489,234,289,.810,220,628,848,160,132,108,129,211,1369,2001
Donyell Marshall,SF,27,UTA,81,49,2326,427,849,.503,41,128,.320,386,721,.535,.527,205,273,.751,172,394,566,133,85,78,128,196,1100,2001
Darrick Martin,PG,29,SAC,31,0,176,29,76,.382,14,27,.519,15,49,.306,.474,31,35,.886,2,14,16,14,7,0,10,27,103,2001
Kenyon Martin,PF,23,NJN,68,68,2272,346,777,.445,1,11,.091,345,766,.450,.446,121,192,.630,137,365,502,131,78,113,138,281,814,2001
Jamal Mashburn,SF,28,CHH,76,76,2989,573,1388,.413,103,289,.356,470,1099,.428,.450,279,364,.766,92,484,576,411,85,13,211,185,1528,2001
Anthony Mason,PF,34,MIA,80,80,3254,460,954,.482,0,0,.000,460,954,.482,.482,370,474,.781,169,601,770,248,80,25,179,231,1290,2001
Desmond Mason,SF,23,SEA,78,14,1522,189,439,.431,18,67,.269,171,372,.460,.451,67,91,.736,72,177,249,63,39,20,53,146,463,2001
Tony Massenburg,PF,33,VAN,52,20,823,92,199,.462,0,0,.000,92,199,.462,.462,49,70,.700,75,135,210,9,10,28,48,122,233,2001
Vernon Maxwell,PG,35,TOT,43,6,660,73,223,.327,34,111,.306,39,112,.348,.404,21,32,.656,4,62,66,49,21,3,35,64,201,2001
Vernon Maxwell,PG,35,PHI,24,6,375,42,125,.336,21,64,.328,21,61,.344,.420,15,22,.682,3,34,37,29,12,0,18,33,120,2001
Vernon Maxwell,PG,35,DAL,19,0,285,31,98,.316,13,47,.277,18,51,.353,.383,6,10,.600,1,28,29,20,9,3,17,31,81,2001
Walter McCarty,PF,26,BOS,60,3,478,45,126,.357,19,56,.339,26,70,.371,.433,22,28,.786,24,57,81,39,14,7,20,82,131,2001
Dan McClintock,C,23,DEN,6,1,58,9,18,.500,0,0,.000,9,18,.500,.500,0,5,.000,10,7,17,1,0,2,3,11,18,2001
George McCloud,SF,33,DEN,76,8,2007,250,655,.382,77,234,.329,173,421,.411,.440,152,181,.840,55,169,224,279,53,27,117,165,729,2001
Jelani McCoy,C,23,SEA,70,44,1143,138,264,.523,0,0,.000,138,264,.523,.523,41,93,.441,92,159,251,57,18,49,75,141,317,2001
Antonio McDyess,PF,26,DEN,70,70,2555,577,1165,.495,0,0,.000,577,1165,.495,.495,304,434,.700,240,605,845,146,43,102,162,220,1458,2001
Tracy McGrady,SG,21,ORL,77,77,3087,788,1724,.457,59,166,.355,729,1558,.468,.474,430,587,.733,192,388,580,352,116,118,198,160,2065,2001
Jim McIlvaine,C,28,NJN,18,3,193,10,28,.357,0,0,.000,10,28,.357,.357,8,12,.667,8,27,35,4,7,15,9,35,28,2001
Jeff McInnis,PG,26,LAC,81,81,2831,432,933,.463,52,144,.361,380,789,.482,.491,130,161,.807,41,179,220,447,75,7,113,199,1046,2001
Derrick McKey,SF,34,IND,66,20,987,60,136,.441,4,20,.200,56,116,.483,.456,21,27,.778,49,127,176,74,48,13,47,136,145,2001
Aaron McKie,SG,28,PHI,76,33,2394,338,714,.473,53,170,.312,285,544,.524,.511,149,194,.768,33,278,311,377,106,8,203,178,878,2001
Roshown McLeod,SF,25,TOT,35,25,922,145,332,.437,2,22,.091,143,310,.461,.440,45,51,.882,38,82,120,58,23,8,58,90,337,2001
Roshown McLeod,SF,25,ATL,34,25,907,144,330,.436,2,21,.095,142,309,.460,.439,45,51,.882,37,81,118,58,23,8,57,88,335,2001
Roshown McLeod,SF,25,PHI,1,0,15,1,2,.500,0,1,.000,1,1,1.000,.500,0,0,.000,1,1,2,0,0,0,1,2,2,2001
Paul McPherson,PG,22,TOT,55,0,595,109,216,.505,2,12,.167,107,204,.525,.509,42,58,.724,40,39,79,38,25,4,47,80,262,2001
Paul McPherson,PG,22,PHO,33,0,308,47,96,.490,0,6,.000,47,90,.522,.490,18,24,.750,20,28,48,16,12,3,23,48,112,2001
Paul McPherson,PG,22,GSW,22,0,287,62,120,.517,2,6,.333,60,114,.526,.525,24,34,.706,20,11,31,22,13,1,24,32,150,2001
Stanislav Medvedenko,PF,21,LAL,7,0,39,12,25,.480,1,1,1.000,11,24,.458,.500,7,12,.583,1,8,9,2,1,1,3,9,32,2001
Ron Mercer,SG,24,CHI,61,61,2535,500,1121,.446,14,46,.304,486,1075,.452,.452,188,228,.825,72,164,236,201,78,27,129,148,1202,2001
Chris Mihm,C,21,CLE,59,43,1166,173,391,.442,0,1,.000,173,390,.444,.442,100,126,.794,106,174,280,16,20,53,80,156,446,2001
Darius Miles,SF,19,LAC,81,21,2133,318,630,.505,1,19,.053,317,611,.519,.506,124,238,.521,127,350,477,99,51,125,147,191,761,2001
Andre Miller,PG,24,CLE,82,82,2848,452,999,.452,17,64,.266,435,935,.465,.461,375,450,.833,94,266,360,657,119,28,265,229,1296,2001
Anthony Miller,PF,29,TOT,4,0,11,1,2,.500,0,0,.000,1,2,.500,.500,0,0,.000,0,2,2,0,0,0,1,1,2,2001
Anthony Miller,PF,29,ATL,2,0,6,1,2,.500,0,0,.000,1,2,.500,.500,0,0,.000,0,2,2,0,0,0,1,0,2,2001
Anthony Miller,PF,29,HOU,1,0,3,0,0,.000,0,0,.000,0,0,.000,.000,0,0,.000,0,0,0,0,0,0,0,1,0,2001
Anthony Miller,PF,29,PHI,1,0,2,0,0,.000,0,0,.000,0,0,.000,.000,0,0,.000,0,0,0,0,0,0,0,0,0,2001
Brad Miller,C,24,CHI,57,45,1434,168,386,.435,1,5,.200,167,381,.438,.437,168,226,.743,144,275,419,107,33,38,73,176,505,2001
Mike Miller,SF,20,ORL,82,62,2390,368,845,.436,148,364,.407,220,481,.457,.523,91,128,.711,66,261,327,140,51,19,97,200,975,2001
Reggie Miller,SG,35,IND,81,81,3181,517,1176,.440,170,464,.366,347,712,.487,.512,323,348,.928,38,247,285,260,81,15,133,162,1527,2001
Chris Mills,SF,31,GSW,15,8,493,71,191,.372,7,25,.280,64,166,.386,.390,31,36,.861,24,69,93,18,9,5,20,43,180,2001
Terry Mills,PF,33,IND,14,0,113,11,34,.324,3,17,.176,8,17,.471,.368,0,0,.000,4,17,21,5,3,1,10,20,25,2001
Sam Mitchell,SF,37,MIN,82,4,983,118,289,.408,9,43,.209,109,246,.443,.424,40,55,.727,28,95,123,57,26,10,36,117,285,2001
Cuttino Mobley,SG,25,HOU,79,49,3002,527,1214,.434,90,252,.357,437,962,.454,.471,394,474,.831,83,314,397,195,84,26,165,169,1538,2001
Nazr Mohammed,C,23,TOT,58,22,912,176,369,.477,0,1,.000,176,368,.478,.477,89,126,.706,115,192,307,19,29,35,64,113,441,2001
Nazr Mohammed,C,23,PHI,30,3,196,41,88,.466,0,0,.000,41,88,.466,.466,14,28,.500,18,37,55,2,6,7,9,40,96,2001
Nazr Mohammed,C,23,ATL,28,19,716,135,281,.480,0,1,.000,135,280,.482,.480,75,98,.765,97,155,252,17,23,28,55,73,345,2001
Jerome Moiso,C,22,BOS,24,0,135,12,30,.400,0,1,.000,12,29,.414,.400,11,26,.423,12,30,42,3,3,4,18,29,35,2001
Eric Montross,C,29,TOT,54,21,649,56,138,.406,0,0,.000,56,138,.406,.406,8,31,.258,52,121,173,19,11,26,41,115,120,2001
Eric Montross,C,29,DET,42,20,568,50,121,.413,0,0,.000,50,121,.413,.413,7,26,.269,43,101,144,15,8,23,37,100,107,2001
Eric Montross,C,29,TOR,12,1,81,6,17,.353,0,0,.000,6,17,.353,.353,1,5,.200,9,20,29,4,3,3,4,15,13,2001
Mikki Moore,C,25,DET,81,2,1154,132,268,.493,0,1,.000,132,267,.494,.493,95,130,.731,121,195,316,33,24,61,74,202,359,2001
Hanno Mottola,SF,24,ATL,73,3,989,123,277,.444,0,3,.000,123,274,.449,.444,73,90,.811,49,125,174,25,11,9,67,163,319,2001
Alonzo Mourning,C,30,MIA,13,3,306,73,141,.518,0,1,.000,73,140,.521,.518,31,55,.564,35,66,101,12,4,31,28,24,177,2001
Chris Mullin,SF,37,GSW,20,8,374,36,106,.340,19,52,.365,17,54,.315,.429,24,28,.857,10,31,41,19,16,10,19,28,115,2001
Lamond Murray,SF,27,CLE,78,46,2225,391,925,.423,61,165,.370,330,760,.434,.456,155,211,.735,104,236,340,124,83,27,141,173,998,2001
Tracy Murray,SF,29,TOT,51,1,588,94,248,.379,36,103,.350,58,145,.400,.452,33,42,.786,22,59,81,23,12,7,26,53,257,2001
Tracy Murray,SF,29,DEN,13,0,135,17,55,.309,7,23,.304,10,32,.313,.373,9,10,.900,4,18,22,9,4,1,6,8,50,2001
Tracy Murray,SF,29,TOR,38,1,453,77,193,.399,29,80,.363,48,113,.425,.474,24,32,.750,18,41,59,14,8,6,20,45,207,2001
Dikembe Mutombo,C,34,TOT,75,75,2591,269,556,.484,0,0,.000,269,556,.484,.484,211,291,.725,307,708,1015,76,29,203,144,204,749,2001
Dikembe Mutombo,C,34,ATL,49,49,1716,169,354,.477,0,0,.000,169,354,.477,.477,107,154,.695,188,505,693,54,20,137,92,139,445,2001
Dikembe Mutombo,C,34,PHI,26,26,875,100,202,.495,0,0,.000,100,202,.495,.495,104,137,.759,119,203,322,22,9,66,52,65,304,2001
Mamadou N'Diaye,C,25,TOR,3,0,10,1,4,.250,0,0,.000,1,4,.250,.250,2,2,1.000,1,1,2,0,0,0,0,3,4,2001
Lee Nailon,SF,25,CHH,42,0,469,66,136,.485,0,1,.000,66,135,.489,.485,32,43,.744,29,63,92,24,9,5,27,60,164,2001
Eduardo Najera,PF,24,DAL,40,4,431,58,111,.523,1,3,.333,57,108,.528,.527,14,33,.424,41,54,95,27,13,8,17,48,131,2001
Steve Nash,PG,26,DAL,70,70,2387,386,792,.487,89,219,.406,297,573,.518,.544,231,258,.895,46,177,223,509,72,5,205,158,1092,2001
Tyrone Nesby,SF-SG,25,TOT,62,34,1556,189,530,.357,49,180,.272,140,350,.400,.403,85,106,.802,51,122,173,76,51,20,65,155,512,2001
Tyrone Nesby,SG,25,LAC,14,12,333,40,123,.325,10,46,.217,30,77,.390,.366,18,23,.783,16,26,42,11,10,4,10,28,108,2001
Tyrone Nesby,SF,25,WAS,48,22,1223,149,407,.366,39,134,.291,110,273,.403,.414,67,83,.807,35,96,131,65,41,16,55,127,404,2001
Rasho Nesterovic,C,24,MIN,73,39,1233,147,319,.461,0,1,.000,147,318,.462,.461,34,65,.523,99,187,286,45,25,63,55,189,328,2001
Ira Newble,SF,26,SAS,27,6,184,21,55,.382,4,9,.444,17,46,.370,.418,8,16,.500,13,22,35,6,2,4,7,18,54,2001
Johnny Newman,SG,37,NJN,82,17,2049,291,695,.419,59,176,.335,232,519,.447,.461,254,297,.855,34,142,176,115,63,10,106,229,895,2001
Moochie Norris,PG,27,HOU,82,6,1654,184,413,.446,25,89,.281,159,324,.491,.476,151,194,.778,44,154,198,283,69,2,107,84,544,2001
Dirk Nowitzki,PF,22,DAL,82,82,3125,591,1247,.474,151,390,.387,440,857,.513,.534,451,538,.838,119,635,754,173,79,101,156,245,1784,2001
Jermaine O'Neal,C,22,IND,81,80,2641,404,868,.465,0,5,.000,404,863,.468,.465,233,388,.601,249,545,794,98,49,228,161,280,1041,2001
Shaquille O'Neal,C,28,LAL,74,74,2924,813,1422,.572,0,2,.000,813,1420,.573,.572,499,972,.513,291,649,940,277,47,204,218,256,2125,2001
Charles Oakley,PF,37,TOR,78,77,2767,305,786,.388,11,49,.224,294,737,.399,.395,127,152,.836,142,599,741,264,76,48,139,258,748,2001
Lamar Odom,PF,21,LAC,76,74,2836,481,1046,.460,80,253,.316,401,793,.506,.498,262,386,.679,110,482,592,392,74,122,264,236,1304,2001
Hakeem Olajuwon,C,38,HOU,58,55,1545,283,568,.498,0,1,.000,283,567,.499,.498,123,198,.621,124,307,431,72,70,88,81,141,689,2001
Kevin Ollie,PG,28,TOT,70,4,925,76,192,.396,1,3,.333,75,189,.397,.398,63,89,.708,16,79,95,146,30,1,49,84,216,2001
Kevin Ollie,PG,28,NJN,19,0,161,5,27,.185,0,0,.000,5,27,.185,.185,12,19,.632,3,20,23,25,5,0,9,14,22,2001
Kevin Ollie,PG,28,PHI,51,4,764,71,165,.430,1,3,.333,70,162,.432,.433,51,70,.729,13,59,72,121,25,1,40,70,194,2001
Michael Olowokandi,C,25,LAC,82,82,2127,308,708,.435,0,0,.000,308,708,.435,.435,85,156,.545,168,357,525,46,30,108,169,250,701,2001
Greg Ostertag,C,27,UTA,81,3,1491,139,281,.495,1,2,.500,138,279,.495,.496,84,151,.556,164,251,415,22,22,142,63,215,363,2001
Bo Outlaw,PF,29,ORL,80,69,2534,226,368,.614,1,2,.500,225,366,.615,.615,129,225,.573,211,408,619,225,105,137,141,241,582,2001
Doug Overton,PG,31,TOT,21,10,475,52,139,.374,11,36,.306,41,103,.398,.414,10,16,.625,4,35,39,72,8,0,31,37,125,2001
Doug Overton,PG,31,BOS,7,1,144,15,44,.341,1,4,.250,14,40,.350,.352,7,11,.636,3,12,15,19,4,0,13,15,38,2001
Doug Overton,PG,31,CHH,2,0,15,2,2,1.000,0,0,.000,2,2,1.000,1.000,0,0,.000,0,0,0,0,1,0,3,2,4,2001
Doug Overton,PG,31,NJN,12,9,316,35,93,.376,10,32,.313,25,61,.410,.430,3,5,.600,1,23,24,53,3,0,15,20,83,2001
Billy Owens,PF,31,DET,45,14,793,88,230,.383,3,20,.150,85,210,.405,.389,19,40,.475,84,121,205,55,32,12,39,93,198,2001
Olumide Oyedeji,C,19,SEA,30,1,221,18,37,.486,0,0,.000,18,37,.486,.486,9,12,.750,24,43,67,2,7,10,11,40,45,2001
Robert Pack,PG,31,DEN,74,11,1260,181,426,.425,12,31,.387,169,395,.428,.439,105,137,.766,30,107,137,293,65,1,135,114,479,2001
Scott Padgett,PF,24,UTA,27,0,127,18,43,.419,5,9,.556,13,34,.382,.477,15,20,.750,19,20,39,5,6,3,10,21,56,2001
Milt Palacio,PG,22,BOS,58,6,1141,126,267,.472,12,36,.333,114,231,.494,.494,78,92,.848,25,77,102,151,48,0,80,83,342,2001
Andy Panko,SF,23,ATL,1,0,1,0,0,.000,0,0,.000,0,0,.000,.000,0,0,.000,0,0,0,0,0,0,0,0,0,2001
Cherokee Parks,C,28,TOT,65,31,1054,134,274,.489,0,6,.000,134,268,.500,.489,31,44,.705,71,158,229,46,25,36,41,122,299,2001
Cherokee Parks,C,28,WAS,13,0,178,18,38,.474,0,0,.000,18,38,.474,.474,12,17,.706,13,27,40,7,6,11,10,20,48,2001
Cherokee Parks,C,28,LAC,52,31,876,116,236,.492,0,6,.000,116,230,.504,.492,19,27,.704,58,131,189,39,19,25,31,102,251,2001
Ruben Patterson,SF,25,SEA,76,22,2059,370,749,.494,2,36,.056,368,713,.516,.495,246,361,.681,183,199,382,161,103,45,155,176,988,2001
Gary Payton,PG,32,SEA,79,79,3244,725,1591,.456,102,272,.375,623,1319,.472,.488,271,354,.766,73,288,361,642,127,26,209,184,1823,2001
Anthony Peeler,SG,31,MIN,75,41,2126,308,732,.421,100,256,.391,208,476,.437,.489,75,87,.862,44,148,192,192,91,18,105,166,791,2001
Mike Penberthy,PG,26,LAL,53,0,851,92,222,.414,55,139,.396,37,83,.446,.538,28,31,.903,10,53,63,71,22,2,34,57,267,2001
Will Perdue,C,35,POR,13,0,58,6,9,.667,0,0,.000,6,9,.667,.667,2,4,.500,6,12,18,2,3,2,0,8,14,2001
Sam Perkins,PF,39,IND,64,41,999,86,226,.381,38,110,.345,48,116,.414,.465,32,38,.842,32,136,168,41,33,18,19,61,242,2001
Elliot Perry,PG,31,TOT,49,6,499,65,140,.464,1,5,.200,64,135,.474,.468,16,22,.727,9,37,46,79,22,1,38,29,147,2001
Elliot Perry,PG,31,ORL,6,0,39,5,11,.455,0,1,.000,5,10,.500,.455,0,0,.000,1,3,4,5,3,0,6,1,10,2001
Elliot Perry,PG,31,PHO,43,6,460,60,129,.465,1,4,.250,59,125,.472,.469,16,22,.727,8,34,42,74,19,1,32,28,137,2001
Wesley Person,SG,29,CLE,44,22,958,128,292,.438,34,84,.405,94,208,.452,.497,24,30,.800,11,119,130,64,27,11,40,62,314,2001
Morris Peterson,SG,23,TOR,80,49,1809,290,673,.431,63,165,.382,227,508,.447,.478,104,145,.717,112,147,259,105,63,20,78,164,747,2001
Eric Piatkowski,SG,30,LAC,81,40,2144,291,672,.433,120,297,.404,171,375,.456,.522,158,181,.873,54,187,241,96,46,19,76,123,860,2001
Paul Pierce,SF,23,BOS,82,82,3120,687,1513,.454,147,384,.383,540,1129,.478,.503,550,738,.745,94,428,522,253,138,69,262,251,2071,2001
Scottie Pippen,SF,35,POR,64,60,2133,269,596,.451,64,186,.344,205,410,.500,.505,119,161,.739,70,263,333,294,94,35,154,158,721,2001
Scot Pollard,C,25,SAC,77,8,1658,185,395,.468,0,2,.000,185,393,.471,.468,128,171,.749,173,292,465,47,48,97,66,206,498,2001
Olden Polynice,C,36,UTA,81,79,1619,206,415,.496,0,1,.000,206,414,.498,.496,17,65,.262,157,221,378,31,27,77,78,241,429,2001
Mark Pope,PF,28,MIL,63,45,942,62,142,.437,5,24,.208,57,118,.483,.454,22,35,.629,56,91,147,38,16,26,17,140,151,2001
Chris Porter,SF,22,GSW,51,35,1147,173,445,.389,0,5,.000,173,440,.393,.389,94,141,.667,89,100,189,61,45,6,59,111,440,2001
Terry Porter,PG,37,SAS,80,42,1678,197,440,.448,87,205,.424,110,235,.468,.547,92,116,.793,24,177,201,251,52,11,104,88,573,2001
James Posey,SF,24,DEN,82,82,2255,243,590,.412,65,217,.300,178,373,.477,.467,115,141,.816,125,306,431,163,93,40,102,226,666,2001
Lavor Postell,SG,22,NYK,26,0,169,17,54,.315,3,11,.273,14,43,.326,.343,22,27,.815,8,17,25,5,4,2,17,12,59,2001
Vitaly Potapenko,C,25,BOS,82,7,1901,248,521,.476,0,0,.000,248,521,.476,.476,115,158,.728,206,289,495,64,52,23,105,228,611,2001
Brent Price,PG,32,VAN,6,0,30,3,11,.273,1,4,.250,2,7,.286,.318,6,7,.857,1,3,4,5,2,0,4,8,13,2001
Laron Profit,PG,23,WAS,35,12,605,56,142,.394,7,26,.269,49,116,.422,.419,33,45,.733,18,46,64,89,36,11,46,43,152,2001
Joel Przybilla,C,21,MIL,33,13,270,12,35,.343,0,0,.000,12,35,.343,.343,3,11,.273,29,42,71,2,3,30,13,56,27,2001
Theo Ratliff,C,27,PHI,50,50,1800,228,457,.499,0,0,.000,228,457,.499,.499,165,217,.760,125,288,413,58,30,187,126,165,621,2001
Eldridge Recasner,PG,33,CHH,43,0,403,38,114,.333,13,39,.333,25,75,.333,.390,14,18,.778,13,37,50,39,6,1,27,30,103,2001
Michael Redd,SG,21,MIL,6,0,35,5,19,.263,0,3,.000,5,16,.313,.263,3,6,.500,3,1,4,1,1,0,1,2,13,2001
Bryant Reeves,C,27,VAN,75,48,1832,254,552,.460,1,4,.250,253,548,.462,.461,113,142,.796,132,320,452,80,43,54,90,243,622,2001
Don Reid,PF,27,ORL,65,7,764,82,145,.566,0,0,.000,82,145,.566,.566,46,75,.613,84,158,242,21,23,54,48,190,210,2001
J.R. Reid,PF,32,CLE,6,0,39,2,5,.400,0,0,.000,2,5,.400,.400,6,8,.750,5,3,8,1,2,1,1,4,10,2001
Glen Rice,SF,33,NYK,75,25,2212,331,752,.440,82,211,.389,249,541,.460,.495,155,182,.852,61,246,307,89,41,13,96,179,899,2001
Quentin Richardson,SG,20,LAC,76,28,1358,232,525,.442,50,151,.331,182,374,.487,.490,99,158,.627,105,152,257,62,42,7,64,98,613,2001
Mitch Richmond,SG,35,WAS,37,30,1216,205,504,.407,45,133,.338,160,371,.431,.451,143,160,.894,15,94,109,111,43,7,84,86,598,2001
Isaiah Rider,SG,29,LAL,67,6,1206,201,472,.426,34,92,.370,167,380,.439,.462,71,83,.855,44,112,156,111,27,7,98,105,507,2001
Terrance Roberson,SF,24,CHH,3,0,13,0,2,.000,0,1,.000,0,1,.000,.000,0,0,.000,0,1,1,1,0,0,2,3,0,2001
Clifford Robinson,PF,34,PHO,82,82,2751,501,1186,.422,90,249,.361,411,937,.439,.460,253,357,.709,105,229,334,237,87,82,186,258,1345,2001
David Robinson,C,35,SAS,80,80,2371,400,823,.486,0,1,.000,400,822,.487,.486,351,470,.747,208,483,691,116,80,197,122,212,1151,2001
Eddie Robinson,SF,24,CHH,67,6,1201,216,407,.531,2,4,.500,214,403,.531,.533,64,88,.727,60,138,198,59,50,32,43,66,498,2001
Glenn Robinson,SF,28,MIL,76,74,2813,684,1460,.468,55,184,.299,629,1276,.493,.487,251,306,.820,124,402,526,252,86,62,219,191,1674,2001
Jamal Robinson,SF,27,MIA,6,0,72,3,22,.136,0,2,.000,3,20,.150,.136,0,0,.000,3,8,11,2,6,0,3,7,6,2001
James Robinson,PG,30,ORL,6,0,50,4,11,.364,2,5,.400,2,6,.333,.455,0,0,.000,0,8,8,0,4,1,4,5,10,2001
Larry Robinson,PG-SG,33,TOT,34,1,632,67,184,.364,44,116,.379,23,68,.338,.484,21,24,.875,23,64,87,36,28,2,25,46,199,2001
Larry Robinson,SG,33,CLE,1,0,1,0,0,.000,0,0,.000,0,0,.000,.000,0,0,.000,0,0,0,0,0,0,1,0,0,2001
Larry Robinson,PG,33,ATL,33,1,631,67,184,.364,44,116,.379,23,68,.338,.484,21,24,.875,23,64,87,36,28,2,24,46,199,2001
Carlos Rogers,C,29,HOU,39,0,544,75,110,.682,0,1,.000,75,109,.688,.682,29,52,.558,48,91,139,9,10,18,17,33,179,2001
Rodney Rogers,SF,29,PHO,82,3,2183,377,876,.430,56,189,.296,321,687,.467,.462,188,247,.761,94,265,359,180,97,47,157,269,998,2001
Sean Rooks,C,31,LAC,82,0,1553,169,395,.428,1,2,.500,168,393,.427,.429,107,143,.748,91,212,303,77,34,64,73,197,446,2001
Jalen Rose,SF,28,IND,72,72,2943,567,1242,.457,59,174,.339,508,1068,.476,.480,285,344,.828,37,322,359,435,65,43,211,230,1478,2001
Malik Rose,PF,26,SAS,57,9,1219,160,368,.435,3,17,.176,157,351,.447,.439,114,160,.713,95,213,308,48,59,40,74,148,437,2001
Michael Ruffin,PF,24,CHI,45,16,879,40,90,.444,0,0,.000,40,90,.444,.444,39,77,.506,101,161,262,39,30,38,46,131,119,2001
Bryon Russell,SF,30,UTA,78,46,2473,308,700,.440,95,230,.413,213,470,.453,.508,222,285,.779,94,236,330,160,96,20,113,229,933,2001
Arvydas Sabonis,C,36,POR,61,42,1299,247,516,.479,1,15,.067,246,501,.491,.480,121,156,.776,51,280,331,91,40,62,85,137,616,2001
Soumaila Samake,C,22,NJN,34,0,226,18,48,.375,0,0,.000,18,48,.375,.375,10,24,.417,22,31,53,1,2,14,4,23,46,2001
Pepe Sanchez,PG,23,TOT,29,0,150,9,28,.321,0,1,.000,9,27,.333,.321,2,2,1.000,3,12,15,41,11,1,6,21,20,2001
Pepe Sanchez,PG,23,ATL,5,0,34,0,7,.000,0,0,.000,0,7,.000,.000,0,0,.000,1,0,1,5,2,0,3,3,0,2001
Pepe Sanchez,PG,23,PHI,24,0,116,9,21,.429,0,1,.000,9,20,.450,.429,2,2,1.000,2,12,14,36,9,1,3,18,20,2001
Daniel Santiago,C,24,PHO,54,2,581,64,134,.478,0,0,.000,64,134,.478,.478,42,61,.689,35,67,102,11,17,21,47,101,170,2001
Detlef Schrempf,SF,38,POR,26,0,397,39,95,.411,3,8,.375,36,87,.414,.426,23,27,.852,17,61,78,44,7,3,28,43,104,2001
Shawnelle Scott,C,28,SAS,27,1,144,17,41,.415,0,0,.000,17,41,.415,.415,9,22,.409,23,27,50,4,5,6,11,23,43,2001
Brian Shaw,SG,34,LAL,80,28,1833,164,411,.399,42,135,.311,122,276,.442,.450,51,64,.797,48,256,304,258,49,27,97,159,421,2001
Brian Skinner,PF,24,LAC,39,23,584,64,161,.398,0,0,.000,64,161,.398,.398,32,59,.542,55,113,168,18,14,11,32,61,160,2001
Reggie Slater,PF,30,MIN,55,16,686,90,175,.514,0,0,.000,90,175,.514,.514,74,110,.673,78,108,186,26,18,9,43,126,254,2001
Jabari Smith,C,23,SAC,9,0,66,11,22,.500,0,0,.000,11,22,.500,.500,4,6,.667,1,7,8,6,4,0,3,7,26,2001
Joe Smith,PF,25,DET,69,59,1941,308,765,.403,0,5,.000,308,760,.405,.403,231,287,.805,160,331,491,79,47,50,88,258,847,2001
Michael Smith,PF,28,WAS,79,29,1610,106,218,.486,0,1,.000,106,217,.488,.486,89,154,.578,172,390,562,101,57,37,62,156,301,2001
Mike Smith,SF,24,WAS,17,0,180,19,59,.322,3,18,.167,16,41,.390,.347,10,16,.625,10,12,22,10,5,3,7,8,51,2001
Steve Smith,SG,31,POR,81,36,2542,359,788,.456,78,230,.339,281,558,.504,.505,309,347,.890,87,185,272,213,48,24,137,203,1105,2001
Tony Smith,SG,32,ATL,6,0,78,8,23,.348,0,2,.000,8,21,.381,.348,1,2,.500,2,1,3,10,7,0,9,12,17,2001
Eric Snow,PG,27,PHI,50,50,1740,182,435,.418,5,19,.263,177,416,.425,.424,122,154,.792,27,139,166,369,77,7,124,123,491,2001
Felton Spencer,C,33,NYK,18,0,113,12,20,.600,0,0,.000,12,20,.600,.600,15,25,.600,16,19,35,2,2,2,11,24,39,2001
Latrell Sprewell,SF,30,NYK,77,77,3017,524,1219,.430,41,135,.304,483,1084,.446,.447,275,351,.783,49,298,347,269,106,28,218,159,1364,2001
Jerry Stackhouse,SG,26,DET,80,80,3215,774,1927,.402,166,473,.351,608,1454,.418,.445,666,810,.822,99,216,315,410,97,54,326,160,2380,2001
John Starks,SG,35,UTA,75,64,2122,273,686,.398,64,182,.352,209,504,.415,.445,89,111,.802,29,125,154,178,73,10,94,217,699,2001
Vladimir Stepania,C,24,NJN,29,0,280,28,88,.318,1,4,.250,27,84,.321,.324,25,34,.735,35,74,109,16,10,11,19,47,82,2001
DeShawn Stevenson,SG,19,UTA,40,2,293,31,91,.341,1,12,.083,30,79,.380,.346,26,38,.684,9,19,28,18,10,2,28,29,89,2001
Michael Stewart,C,25,TOR,26,0,123,11,34,.324,0,0,.000,11,34,.324,.324,11,18,.611,16,13,29,2,4,3,5,19,33,2001
Bryant Stith,SG,30,BOS,78,74,2504,245,611,.401,91,242,.376,154,369,.417,.475,175,207,.845,65,219,284,168,93,14,90,182,756,2001
John Stockton,PG,38,UTA,82,82,2397,328,651,.504,61,132,.462,267,519,.514,.551,227,278,.817,54,173,227,713,132,21,203,194,944,2001
Peja Stojakovic,SF,23,SAC,75,75,2905,559,1189,.470,144,360,.400,415,829,.501,.531,267,312,.856,93,341,434,164,91,13,146,144,1529,2001
Damon Stoudamire,PG,27,POR,82,82,2655,406,935,.434,82,219,.374,324,716,.453,.478,172,207,.831,69,234,303,468,106,8,191,202,1066,2001
Erick Strickland,PG,27,TOT,50,0,830,81,267,.303,30,95,.316,51,172,.297,.360,68,79,.861,18,110,128,95,44,2,48,88,260,2001
Erick Strickland,PG,27,NYK,28,0,421,40,131,.305,16,47,.340,24,84,.286,.366,24,28,.857,9,43,52,29,22,1,21,46,120,2001
Erick Strickland,PG,27,VAN,22,0,409,41,136,.301,14,48,.292,27,88,.307,.353,44,51,.863,9,67,76,66,22,1,27,42,140,2001
Mark Strickland,SF,30,TOT,55,2,719,103,239,.431,1,2,.500,102,237,.430,.433,45,70,.643,54,107,161,24,16,22,34,72,252,2001
Mark Strickland,SF,30,DEN,46,2,517,82,185,.443,0,1,.000,82,184,.446,.443,37,59,.627,43,77,120,17,12,19,24,58,201,2001
Mark Strickland,SF,30,NJN,9,0,202,21,54,.389,1,1,1.000,20,53,.377,.398,8,11,.727,11,30,41,7,4,3,10,14,51,2001
Rod Strickland,PG,34,TOT,54,28,1371,182,429,.424,4,17,.235,178,412,.432,.429,130,173,.751,36,104,140,303,53,5,107,76,498,2001
Rod Strickland,PG,34,WAS,33,28,1020,141,331,.426,4,16,.250,137,315,.435,.432,115,147,.782,25,80,105,231,43,4,83,55,401,2001
Rod Strickland,PG,34,POR,21,0,351,41,98,.418,0,1,.000,41,97,.423,.418,15,26,.577,11,24,35,72,10,1,24,21,97,2001
Derek Strong,PF,32,LAC,28,8,491,45,117,.385,0,1,.000,45,116,.388,.385,28,37,.757,34,74,108,7,14,1,22,30,118,2001
Bruno Sundov,C,20,IND,11,4,120,20,41,.488,0,4,.000,20,37,.541,.488,3,5,.600,4,19,23,2,2,4,3,21,43,2001
Bob Sura,SG,27,GSW,53,42,1684,202,518,.390,47,172,.273,155,346,.448,.435,135,189,.714,54,173,227,242,54,8,160,127,586,2001
Stromile Swift,PF,21,VAN,80,6,1312,153,339,.451,0,4,.000,153,335,.457,.451,85,141,.603,109,175,284,28,62,82,64,160,391,2001
Wally Szczerbiak,SF,23,MIN,82,82,2856,469,920,.510,26,77,.338,443,843,.526,.524,181,208,.870,133,314,447,260,59,33,138,226,1145,2001
Zan Tabak,C,30,IND,55,14,777,98,186,.527,0,0,.000,98,186,.527,.527,20,47,.426,65,148,213,33,10,30,57,125,216,2001
Dragan Tarlac,C,27,CHI,43,12,598,39,99,.394,0,0,.000,39,99,.394,.394,25,33,.758,37,85,122,31,7,19,38,95,103,2001
Maurice Taylor,SF,24,HOU,69,69,1972,390,797,.489,0,4,.000,390,793,.492,.489,119,162,.735,109,269,378,104,28,38,125,208,899,2001
Jason Terry,SG,23,ATL,82,77,3089,596,1367,.436,124,314,.395,472,1053,.448,.481,303,358,.846,42,227,269,403,104,12,239,204,1619,2001
Jamel Thomas,SF,27,NJN,5,0,56,6,19,.316,1,3,.333,5,16,.313,.342,0,0,.000,4,5,9,0,3,0,6,6,13,2001
Kenny Thomas,PF,23,HOU,74,21,1820,206,465,.443,25,92,.272,181,373,.485,.470,91,126,.722,122,295,417,77,40,43,116,178,528,2001
Kurt Thomas,PF,28,NYK,77,29,2125,314,614,.511,1,3,.333,313,611,.512,.512,171,210,.814,172,343,515,63,61,69,99,287,800,2001
Tim Thomas,PF,23,MIL,76,16,2086,326,758,.430,107,260,.412,219,498,.440,.501,195,253,.771,79,234,313,138,78,45,114,194,954,2001
Otis Thorpe,PF,38,CHH,49,4,647,59,131,.450,0,0,.000,59,131,.450,.450,20,24,.833,50,95,145,29,12,7,32,108,138,2001
Robert Traylor,C,23,CLE,70,7,1212,161,324,.497,0,2,.000,161,322,.500,.497,80,141,.567,124,176,300,63,49,76,98,204,402,2001
Gary Trent,PF,26,DAL,33,4,319,57,130,.438,0,1,.000,57,129,.442,.438,19,36,.528,39,53,92,10,13,8,22,52,133,2001
Jake Tsakalidis,C,21,PHO,57,39,947,101,215,.470,0,0,.000,101,215,.470,.470,54,91,.593,83,159,242,19,10,55,66,137,256,2001
Hedo Turkoglu,SF,21,SAC,74,7,1245,138,335,.412,28,86,.326,110,249,.442,.454,87,112,.777,49,161,210,69,52,24,55,139,391,2001
Nick Van Exel,PG,29,DEN,71,70,2688,460,1112,.414,135,358,.377,325,754,.431,.474,204,249,.819,44,197,241,600,61,18,165,109,1259,2001
Keith Van Horn,SF,25,NJN,49,47,1733,308,708,.435,65,170,.382,243,538,.452,.481,150,186,.806,78,269,347,82,40,20,103,150,831,2001
David Vanterpool,PG,27,WAS,22,0,411,46,110,.418,0,6,.000,46,104,.442,.418,30,50,.600,15,22,37,66,23,3,37,44,122,2001
Jacque Vaughn,PG,25,UTA,82,0,1620,170,393,.433,30,78,.385,140,315,.444,.471,128,164,.780,18,132,150,323,48,3,129,145,498,2001
Loy Vaught,PF,32,TOT,51,1,549,80,169,.473,0,0,.000,80,169,.473,.473,8,10,.800,51,122,173,23,21,7,26,74,168,2001
Loy Vaught,PF,32,DAL,37,1,392,55,121,.455,0,0,.000,55,121,.455,.455,4,6,.667,35,88,123,16,15,5,18,61,114,2001
Loy Vaught,PF,32,WAS,14,0,157,25,48,.521,0,0,.000,25,48,.521,.521,4,4,1.000,16,34,50,7,6,2,8,13,54,2001
Jake Voskuhl,C,23,CHI,16,2,143,11,25,.440,0,0,.000,11,25,.440,.440,8,14,.571,12,22,34,5,5,6,12,38,30,2001
Antoine Walker,PF,24,BOS,81,81,3396,711,1720,.413,221,603,.367,490,1117,.439,.478,249,348,.716,151,568,719,445,138,49,301,251,1892,2001
Samaki Walker,PF,24,SAS,61,1,963,121,252,.480,1,3,.333,120,249,.482,.482,78,124,.629,67,176,243,29,10,41,68,103,321,2001
Ben Wallace,C,26,DET,80,80,2760,215,439,.490,1,4,.250,214,435,.492,.491,80,238,.336,303,749,1052,123,107,186,117,192,511,2001
John Wallace,SF,26,DET,40,0,527,100,236,.424,2,15,.133,98,221,.443,.428,35,45,.778,25,58,83,23,13,16,36,72,237,2001
Rasheed Wallace,PF,26,POR,77,75,2940,590,1178,.501,52,162,.321,538,1016,.530,.523,245,320,.766,147,455,602,212,90,135,158,206,1477,2001
Charlie Ward,PG,30,NYK,61,33,1492,155,373,.416,67,175,.383,88,198,.444,.505,56,70,.800,32,127,159,273,70,10,112,132,433,2001
Clarence Weatherspoon,PF,30,CLE,82,82,2774,347,692,.501,0,0,.000,347,692,.501,.501,230,291,.790,223,573,796,103,85,105,112,171,924,2001
Chris Webber,PF,27,SAC,70,70,2836,786,1635,.481,2,28,.071,784,1607,.488,.481,324,461,.703,179,598,777,294,93,118,195,226,1898,2001
Bonzi Wells,SF,24,POR,75,46,1995,387,726,.533,17,50,.340,370,676,.547,.545,159,240,.663,120,247,367,208,94,20,169,203,950,2001
David Wesley,SG,30,CHH,82,82,3106,523,1239,.422,97,258,.376,426,981,.434,.461,271,339,.799,64,160,224,361,128,16,171,220,1414,2001
Doug West,SG,33,VAN,15,6,171,11,38,.289,0,2,.000,11,36,.306,.289,6,7,.857,4,11,15,14,3,4,4,21,28,2001
Jahidi White,C,24,WAS,68,56,1609,203,408,.498,0,1,.000,203,407,.499,.498,177,312,.567,178,343,521,20,32,111,136,211,583,2001
Chris Whitney,PG,29,WAS,59,31,1532,182,470,.387,93,248,.375,89,222,.401,.486,101,113,.894,12,94,106,248,55,3,103,150,558,2001
Aaron Williams,PF,29,NJN,82,25,2336,297,650,.457,0,2,.000,297,648,.458,.457,244,310,.787,211,379,590,88,59,113,132,319,838,2001
Alvin Williams,SG,26,TOR,82,34,2394,330,767,.430,33,108,.306,297,659,.451,.452,109,145,.752,50,162,212,407,123,26,103,171,802,2001
Eric Williams,SF,28,BOS,81,11,1745,162,448,.362,46,139,.331,116,309,.375,.413,165,231,.714,64,143,207,112,64,13,76,179,535,2001
Jason Williams,PG,25,SAC,77,77,2290,281,690,.407,98,311,.315,183,379,.483,.478,60,76,.789,19,166,185,416,94,9,160,114,720,2001
Jerome Williams,PF,27,TOT,59,2,1182,136,294,.463,0,3,.000,136,291,.467,.463,100,135,.741,133,249,382,45,57,20,63,124,372,2001
Jerome Williams,PF,27,DET,33,2,804,88,201,.438,0,2,.000,88,199,.442,.438,65,90,.722,98,180,278,32,39,10,47,81,241,2001
Jerome Williams,PF,27,TOR,26,0,378,48,93,.516,0,1,.000,48,92,.522,.516,35,45,.778,35,69,104,13,18,10,16,43,131,2001
Monty Williams,SF,29,ORL,82,0,1211,162,364,.445,1,13,.077,161,351,.459,.446,85,133,.639,86,157,243,79,29,16,85,136,410,2001
Scott Williams,C,32,MIL,66,31,1272,171,361,.474,1,4,.250,170,357,.476,.475,60,70,.857,97,267,364,35,48,32,41,178,403,2001
Shammond Williams,PG,25,SEA,69,6,1238,161,368,.438,61,133,.459,100,235,.426,.520,84,96,.875,34,98,132,190,31,4,82,83,467,2001
Walt Williams,SF,30,HOU,72,31,1583,202,513,.394,98,248,.395,104,265,.392,.489,97,126,.770,31,214,245,97,30,28,73,153,599,2001
Corliss Williamson,SF,27,TOT,69,40,1686,325,647,.502,0,2,.000,325,645,.504,.502,151,237,.637,110,211,321,61,50,21,110,185,801,2001
Corliss Williamson,SF,27,TOR,42,31,886,153,325,.471,0,2,.000,153,323,.474,.471,84,130,.646,57,96,153,33,15,13,65,98,390,2001
Corliss Williamson,SF,27,DET,27,9,800,172,322,.534,0,0,.000,172,322,.534,.534,67,107,.626,53,115,168,28,35,8,45,87,411,2001
Kevin Willis,C,38,TOT,78,22,1830,304,690,.441,1,6,.167,303,684,.443,.441,113,147,.769,177,355,532,50,57,52,87,216,722,2001
Kevin Willis,C,38,TOR,35,9,771,124,269,.461,0,2,.000,124,267,.464,.461,61,81,.753,68,155,223,21,19,21,40,78,309,2001
Kevin Willis,C,38,DEN,43,13,1059,180,421,.428,1,4,.250,179,417,.429,.429,52,66,.788,109,200,309,29,38,31,47,138,413,2001
David Wingate,SG,37,SEA,1,0,9,3,3,1.000,0,0,.000,3,3,1.000,1.000,0,0,.000,0,0,0,2,0,0,0,1,6,2001
Ruben Wolkowyski,PF,27,SEA,34,1,305,25,79,.316,0,2,.000,25,77,.325,.316,25,34,.735,12,34,46,3,6,18,12,38,75,2001
Metta World Peace,SF,21,CHI,76,74,2363,327,815,.401,43,148,.291,284,667,.426,.428,210,280,.750,59,235,294,228,152,45,159,254,907,2001
Lorenzen Wright,C,25,ATL,71,46,1988,363,811,.448,0,2,.000,363,809,.449,.448,155,216,.718,180,355,535,87,42,63,125,232,881,2001
Wang Zhizhi,C,23,DAL,5,0,38,8,19,.421,0,2,.000,8,17,.471,.421,8,10,.800,1,6,7,0,0,0,1,8,24,2001
