,Player,Age,Tm,Lg,Season,G,GS,MP,FG,FGA,2P,2PA,3P,3PA,FT,FTA,ORB,DRB,TRB,AST,STL,BLK,TOV,PF,PTS
0,Courtney Alexander,23,TOT,NBA,2000-01,65,24,1382,239,573,222,527,17,46,123,150,42,101,143,62,45,5,75,139,618
1,Dalibor Bagaric,20,CHI,NBA,2000-01,35,0,259,17,65,17,64,0,1,13,28,22,34,56,10,9,16,21,44,47
2,Erick Barkley,22,POR,NBA,2000-01,8,0,38,8,22,5,14,3,8,0,0,0,3,3,6,2,0,5,2,19
3,Raja Bell,24,PHI,NBA,2000-01,5,0,30,2,7,1,4,1,3,0,0,0,1,1,0,1,0,2,1,5
4,Mark Blount,25,BOS,NBA,2000-01,64,50,1098,101,200,101,200,0,0,46,66,97,134,231,32,39,76,62,183,248
5,Brian Cardinal,23,DET,NBA,2000-01,15,0,126,10,31,10,26,0,5,11,18,8,15,23,3,7,2,9,27,31
6,Mateen Cleaves,23,DET,NBA,2000-01,78,8,1268,160,400,155,383,5,17,97,137,26,106,132,207,49,1,139,153,422
7,Jason Collier,23,HOU,NBA,2000-01,23,0,222,27,71,27,70,0,1,17,24,12,25,37,6,2,3,11,27,71
8,Sean Colson,25,TOT,NBA,2000-01,13,0,44,6,24,5,19,1,5,2,4,2,4,6,10,1,0,2,6,15
9,Jamal Crawford,20,CHI,NBA,2000-01,61,8,1050,107,304,66,187,41,117,27,34,9,80,89,141,43,14,85,68,282
10,Keyon Dooling,20,LAC,NBA,2000-01,76,1,1237,148,362,120,282,28,80,125,179,8,81,89,177,41,11,94,107,449
11,Khalid El-Amin,21,CHI,NBA,2000-01,50,14,936,115,311,87,227,28,84,56,72,21,60,81,145,48,2,54,99,314
12,Marcus Fizer,22,CHI,NBA,2000-01,72,13,1580,278,646,268,607,10,39,117,161,76,237,313,76,30,19,124,175,683
13,Ruben Garces,27,TOT,NBA,2000-01,13,0,73,7,22,7,22,0,0,2,8,16,13,29,5,3,2,5,14,16
14,Eddie Gill,22,NJN,NBA,2000-01,8,0,152,16,41,13,32,3,9,4,5,0,9,9,24,4,1,10,9,39
15,Steve Goodrich,24,CHI,NBA,2000-01,12,0,133,7,18,6,15,1,3,4,7,7,14,21,6,2,1,8,14,19
16,A.J. Guyton,22,CHI,NBA,2000-01,33,8,630,78,192,51,123,27,69,15,18,10,26,36,64,9,5,24,35,198
17,Zendon Hamilton,25,LAC,NBA,2000-01,3,0,19,2,9,2,9,0,0,5,8,3,5,8,0,0,0,2,4,9
18,Jason Hart,22,MIL,NBA,2000-01,1,0,10,1,1,1,1,0,0,0,0,0,0,0,1,0,0,2,0,2
19,Donnell Harvey,20,DAL,NBA,2000-01,18,0,65,8,14,8,14,0,0,6,16,6,14,20,2,3,1,7,15,22
20,Eddie House,22,MIA,NBA,2000-01,50,0,550,104,247,85,192,19,55,24,35,5,37,42,52,13,0,35,58,251
21,Marc Jackson,26,GSW,NBA,2000-01,48,35,1410,237,508,232,485,5,23,154,192,119,242,361,59,34,27,93,138,633
22,Stephen Jackson,22,NJN,NBA,2000-01,77,40,1660,243,572,191,417,52,155,97,135,41,167,208,140,86,14,130,166,635
23,DerMarr Johnson,20,ATL,NBA,2000-01,78,21,1313,146,390,105,263,41,127,64,87,56,122,178,64,43,30,93,134,397
24,Garth Joseph,27,TOT,NBA,2000-01,4,0,16,1,5,1,5,0,0,0,2,2,0,2,1,0,1,2,1,2
25,Dan Langhi,23,HOU,NBA,2000-01,33,0,241,37,99,37,98,0,1,16,29,13,28,41,4,7,1,8,16,90
26,Art Long,28,SAC,NBA,2000-01,9,0,20,0,4,0,4,0,0,0,2,2,6,8,1,0,3,2,5,0
27,Mark Madsen,25,LAL,NBA,2000-01,70,3,641,55,113,54,112,1,1,26,37,74,78,152,24,8,8,27,111,137
28,Jamaal Magloire,22,CHH,NBA,2000-01,74,0,1095,122,271,122,269,0,2,95,145,103,192,295,27,18,78,61,139,339
29,Kenyon Martin,23,NJN,NBA,2000-01,68,68,2272,346,777,345,766,1,11,121,192,137,365,502,131,78,113,138,281,814
30,Desmond Mason,23,SEA,NBA,2000-01,78,14,1522,189,439,171,372,18,67,67,91,72,177,249,63,39,20,53,146,463
31,Dan McClintock,23,DEN,NBA,2000-01,6,1,58,9,18,9,18,0,0,0,5,10,7,17,1,0,2,3,11,18
32,Paul McPherson,22,TOT,NBA,2000-01,55,0,595,109,216,107,204,2,12,42,58,40,39,79,38,25,4,47,80,262
33,Stanislav Medvedenko,21,LAL,NBA,2000-01,7,0,39,12,25,11,24,1,1,7,12,1,8,9,2,1,1,3,9,32
34,Chris Mihm,21,CLE,NBA,2000-01,59,43,1166,173,391,173,390,0,1,100,126,106,174,280,16,20,53,80,156,446
35,Darius Miles,19,LAC,NBA,2000-01,81,21,2133,318,630,317,611,1,19,124,238,127,350,477,99,51,125,147,191,761
36,Mike Miller,20,ORL,NBA,2000-01,82,62,2390,368,845,220,481,148,364,91,128,66,261,327,140,51,19,97,200,975
37,Jerome Moiso,22,BOS,NBA,2000-01,24,0,135,12,30,12,29,0,1,11,26,12,30,42,3,3,4,18,29,35
38,Hanno Mottola,24,ATL,NBA,2000-01,73,3,989,123,277,123,274,0,3,73,90,49,125,174,25,11,9,67,163,319
39,Mamadou N'Diaye,25,TOR,NBA,2000-01,3,0,10,1,4,1,4,0,0,2,2,1,1,2,0,0,0,0,3,4
40,Lee Nailon,25,CHH,NBA,2000-01,42,0,469,66,136,66,135,0,1,32,43,29,63,92,24,9,5,27,60,164
41,Eduardo Najera,24,DAL,NBA,2000-01,40,4,431,58,111,57,108,1,3,14,33,41,54,95,27,13,8,17,48,131
42,Ira Newble,26,SAS,NBA,2000-01,27,6,184,21,55,17,46,4,9,8,16,13,22,35,6,2,4,7,18,54
43,Olumide Oyedeji,19,SEA,NBA,2000-01,30,1,221,18,37,18,37,0,0,9,12,24,43,67,2,7,10,11,40,45
44,Andy Panko,23,ATL,NBA,2000-01,1,0,1,0,0,0,0,0,0,0,0,0,0,0,0,0,0,0,0,0
45,Mike Penberthy,26,LAL,NBA,2000-01,53,0,851,92,222,37,83,55,139,28,31,10,53,63,71,22,2,34,57,267
46,Morris Peterson,23,TOR,NBA,2000-01,80,49,1809,290,673,227,508,63,165,104,145,112,147,259,105,63,20,78,164,747
47,Chris Porter,22,GSW,NBA,2000-01,51,35,1147,173,445,173,440,0,5,94,141,89,100,189,61,45,6,59,111,440
48,Lavor Postell,22,NYK,NBA,2000-01,26,0,169,17,54,14,43,3,11,22,27,8,17,25,5,4,2,17,12,59
49,Joel Przybilla,21,MIL,NBA,2000-01,33,13,270,12,35,12,35,0,0,3,11,29,42,71,2,3,30,13,56,27
50,Michael Redd,21,MIL,NBA,2000-01,6,0,35,5,19,5,16,0,3,3,6,3,1,4,1,1,0,1,2,13
51,Quentin Richardson,20,LAC,NBA,2000-01,76,28,1358,232,525,182,374,50,151,99,158,105,152,257,62,42,7,64,98,613
52,Terrance Roberson,24,CHH,NBA,2000-01,3,0,13,0,2,0,1,0,1,0,0,0,1,1,1,0,0,2,3,0
53,Jamal Robinson,27,MIA,NBA,2000-01,6,0,72,3,22,3,20,0,2,0,0,3,8,11,2,6,0,3,7,6
54,Soumaila Samake,22,NJN,NBA,2000-01,34,0,226,18,48,18,48,0,0,10,24,22,31,53,1,2,14,4,23,46
55,Pepe Sanchez,23,TOT,NBA,2000-01,29,0,150,9,28,9,27,0,1,2,2,3,12,15,41,11,1,6,21,20
56,Daniel Santiago,24,PHO,NBA,2000-01,54,2,581,64,134,64,134,0,0,42,61,35,67,102,11,17,21,47,101,170
57,Jabari Smith,23,SAC,NBA,2000-01,9,0,66,11,22,11,22,0,0,4,6,1,7,8,6,4,0,3,7,26
58,Mike Smith,24,WAS,NBA,2000-01,17,0,180,19,59,16,41,3,18,10,16,10,12,22,10,5,3,7,8,51
59,DeShawn Stevenson,19,UTA,NBA,2000-01,40,2,293,31,91,30,79,1,12,26,38,9,19,28,18,10,2,28,29,89
60,Stromile Swift,21,VAN,NBA,2000-01,80,6,1312,153,339,153,335,0,4,85,141,109,175,284,28,62,82,64,160,391
61,Dragan Tarlac,27,CHI,NBA,2000-01,43,12,598,39,99,39,99,0,0,25,33,37,85,122,31,7,19,38,95,103
62,Jake Tsakalidis,21,PHO,NBA,2000-01,57,39,947,101,215,101,215,0,0,54,91,83,159,242,19,10,55,66,137,256
63,Hedo Turkoglu,21,SAC,NBA,2000-01,74,7,1245,138,335,110,249,28,86,87,112,49,161,210,69,52,24,55,139,391
64,David Vanterpool,27,WAS,NBA,2000-01,22,0,411,46,110,46,104,0,6,30,50,15,22,37,66,23,3,37,44,122
65,Jake Voskuhl,23,CHI,NBA,2000-01,16,2,143,11,25,11,25,0,0,8,14,12,22,34,5,5,6,12,38,30
66,Ruben Wolkowyski,27,SEA,NBA,2000-01,34,1,305,25,79,25,77,0,2,25,34,12,34,46,3,6,18,12,38,75
67,Wang Zhizhi,23,DAL,NBA,2000-01,5,0,38,8,19,8,17,0,2,8,10,1,6,7,0,0,0,1,8,24
68,Malik Allen,23,MIA,NBA,2001-02,12,2,161,22,51,22,50,0,1,8,10,15,23,38,5,3,8,2,16,52
69,Chris Andersen,23,DEN,NBA,2001-02,24,1,262,25,74,25,70,0,4,22,28,38,38,76,7,7,28,13,35,72
70,Gilbert Arenas,20,GSW,NBA,2001-02,47,30,1155,174,384,135,271,39,113,124,160,41,91,132,174,69,11,97,115,511
71,Brandon Armstrong,21,NJN,NBA,2001-02,35,0,196,27,85,22,68,5,17,5,10,10,6,16,8,7,1,8,26,64
72,Carlos Arroyo,22,TOT,NBA,2001-02,37,1,371,49,111,49,109,0,2,13,18,12,28,40,70,11,1,23,30,111
73,Mengke Bateer,26,DEN,NBA,2001-02,27,10,408,53,132,49,120,4,12,29,37,32,64,96,22,10,5,32,94,139
74,Shane Battier,23,MEM,NBA,2001-02,78,78,3097,412,961,309,685,103,276,198,283,180,238,418,216,121,81,155,215,1125
75,Charlie Bell,22,TOT,NBA,2001-02,7,0,44,3,11,3,5,0,6,2,2,2,3,5,2,0,0,5,3,8
76,Ruben Boumtje-Boumtje,23,POR,NBA,2001-02,33,1,245,13,32,13,32,0,0,13,25,21,34,55,4,3,16,14,38,39
77,Michael Bradley,22,TOR,NBA,2001-02,26,0,118,13,25,13,23,0,2,4,8,7,17,24,3,0,6,6,10,30
78,Jamison Brewer,21,IND,NBA,2001-02,13,0,43,2,5,2,4,0,1,0,0,2,6,8,9,2,0,3,3,4
79,Primoz Brezec,22,IND,NBA,2001-02,22,4,160,14,29,14,29,0,0,15,25,16,12,28,6,0,7,6,28,43
80,Damone Brown,22,PHI,NBA,2001-02,17,0,67,8,21,8,20,0,1,7,8,2,2,4,2,1,1,9,11,23
81,Ernest Brown,22,MIA,NBA,2001-02,3,0,21,1,6,1,6,0,0,1,4,1,5,6,0,0,1,3,4,3
82,Kedrick Brown,20,BOS,NBA,2001-02,29,5,245,23,70,18,43,5,27,12,20,11,39,50,15,18,7,7,18,63
83,Kwame Brown,19,WAS,NBA,2001-02,57,3,817,94,243,94,242,0,1,70,99,63,135,198,43,16,26,43,105,258
84,Tierre Brown,22,HOU,NBA,2001-02,40,1,403,49,115,45,103,4,12,21,28,12,30,42,70,19,3,40,26,123
85,Tyson Chandler,19,CHI,NBA,2001-02,71,31,1389,151,304,151,304,0,0,134,222,114,229,343,54,28,93,99,179,436
86,Speedy Claxton,23,PHI,NBA,2001-02,67,18,1528,181,452,177,419,4,33,114,136,46,114,160,198,95,6,95,145,480
87,Jarron Collins,23,UTA,NBA,2001-02,70,68,1440,158,343,158,342,0,1,134,181,138,158,296,58,29,22,56,234,450
88,Jason Collins,23,NJN,NBA,2001-02,77,9,1407,117,278,116,276,1,2,115,164,132,169,301,81,29,47,72,173,350
89,Joe Crispin,22,TOT,NBA,2001-02,21,0,156,26,68,11,29,15,39,12,13,2,9,11,26,5,0,10,10,79
90,Eddy Curry,19,CHI,NBA,2001-02,72,31,1150,189,377,189,377,0,0,105,160,111,161,272,25,16,53,69,173,483
91,Samuel Dalembert,20,PHI,NBA,2001-02,34,0,177,22,50,22,50,0,0,7,18,25,43,68,5,6,13,14,30,51
92,DeSagana Diop,20,CLE,NBA,2001-02,18,1,109,12,29,12,29,0,0,1,5,5,12,17,5,1,10,12,19,25
93,Predrag Drobnjak,26,SEA,NBA,2001-02,64,12,1174,191,414,191,412,0,2,55,73,75,144,219,51,20,31,51,109,437
94,Maurice Evans,23,MIN,NBA,2001-02,10,0,45,9,19,9,16,0,3,3,4,3,1,4,4,0,0,2,9,21
95,Isaac Fontaine,26,MEM,NBA,2001-02,6,0,75,3,14,2,9,1,5,4,6,0,5,5,4,0,0,4,6,11
96,Alton Ford,20,PHO,NBA,2001-02,53,0,452,61,118,61,118,0,0,42,57,32,75,107,7,6,7,32,99,164
97,Joseph Forte,20,BOS,NBA,2001-02,8,0,39,1,12,1,9,0,3,4,4,1,5,6,6,2,0,3,1,6
98,Antonis Fotsis,20,MEM,NBA,2001-02,28,1,320,42,104,35,81,7,23,17,20,25,37,62,10,9,11,21,22,108
99,Tremaine Fowlkes,25,LAC,NBA,2001-02,22,17,343,25,64,25,64,0,0,24,31,32,32,64,17,11,1,13,39,74
100,Courtney Alexander,23,TOT,NBA,2000-01,65,24,1382,239,573,222,527,17,46,123,150,42,101,143,62,45,5,75,139,618
101,Dalibor Bagaric,20,CHI,NBA,2000-01,35,0,259,17,65,17,64,0,1,13,28,22,34,56,10,9,16,21,44,47
102,Erick Barkley,22,POR,NBA,2000-01,8,0,38,8,22,5,14,3,8,0,0,0,3,3,6,2,0,5,2,19
103,Raja Bell,24,PHI,NBA,2000-01,5,0,30,2,7,1,4,1,3,0,0,0,1,1,0,1,0,2,1,5
104,Mark Blount,25,BOS,NBA,2000-01,64,50,1098,101,200,101,200,0,0,46,66,97,134,231,32,39,76,62,183,248
105,Brian Cardinal,23,DET,NBA,2000-01,15,0,126,10,31,10,26,0,5,11,18,8,15,23,3,7,2,9,27,31
106,Mateen Cleaves,23,DET,NBA,2000-01,78,8,1268,160,400,155,383,5,17,97,137,26,106,132,207,49,1,139,153,422
107,Jason Collier,23,HOU,NBA,2000-01,23,0,222,27,71,27,70,0,1,17,24,12,25,37,6,2,3,11,27,71
108,Sean Colson,25,TOT,NBA,2000-01,13,0,44,6,24,5,19,1,5,2,4,2,4,6,10,1,0,2,6,15
109,Jamal Crawford,20,CHI,NBA,2000-01,61,8,1050,107,304,66,187,41,117,27,34,9,80,89,141,43,14,85,68,282
110,Keyon Dooling,20,LAC,NBA,2000-01,76,1,1237,148,362,120,282,28,80,125,179,8,81,89,177,41,11,94,107,449
111,Khalid El-Amin,21,CHI,NBA,2000-01,50,14,936,115,311,87,227,28,84,56,72,21,60,81,145,48,2,54,99,314
112,Marcus Fizer,22,CHI,NBA,2000-01,72,13,1580,278,646,268,607,10,39,117,161,76,237,313,76,30,19,124,175,683
113,Ruben Garces,27,TOT,NBA,2000-01,13,0,73,7,22,7,22,0,0,2,8,16,13,29,5,3,2,5,14,16
114,Eddie Gill,22,NJN,NBA,2000-01,8,0,152,16,41,13,32,3,9,4,5,0,9,9,24,4,1,10,9,39
115,Steve Goodrich,24,CHI,NBA,2000-01,12,0,133,7,18,6,15,1,3,4,7,7,14,21,6,2,1,8,14,19
116,A.J. Guyton,22,CHI,NBA,2000-01,33,8,630,78,192,51,123,27,69,15,18,10,26,36,64,9,5,24,35,198
117,Zendon Hamilton,25,LAC,NBA,2000-01,3,0,19,2,9,2,9,0,0,5,8,3,5,8,0,0,0,2,4,9
118,Jason Hart,22,MIL,NBA,2000-01,1,0,10,1,1,1,1,0,0,0,0,0,0,0,1,0,0,2,0,2
119,Donnell Harvey,20,DAL,NBA,2000-01,18,0,65,8,14,8,14,0,0,6,16,6,14,20,2,3,1,7,15,22
120,Eddie House,22,MIA,NBA,2000-01,50,0,550,104,247,85,192,19,55,24,35,5,37,42,52,13,0,35,58,251
121,Marc Jackson,26,GSW,NBA,2000-01,48,35,1410,237,508,232,485,5,23,154,192,119,242,361,59,34,27,93,138,633
122,Stephen Jackson,22,NJN,NBA,2000-01,77,40,1660,243,572,191,417,52,155,97,135,41,167,208,140,86,14,130,166,635
123,DerMarr Johnson,20,ATL,NBA,2000-01,78,21,1313,146,390,105,263,41,127,64,87,56,122,178,64,43,30,93,134,397
124,Garth Joseph,27,TOT,NBA,2000-01,4,0,16,1,5,1,5,0,0,0,2,2,0,2,1,0,1,2,1,2
125,Dan Langhi,23,HOU,NBA,2000-01,33,0,241,37,99,37,98,0,1,16,29,13,28,41,4,7,1,8,16,90
126,Art Long,28,SAC,NBA,2000-01,9,0,20,0,4,0,4,0,0,0,2,2,6,8,1,0,3,2,5,0
127,Mark Madsen,25,LAL,NBA,2000-01,70,3,641,55,113,54,112,1,1,26,37,74,78,152,24,8,8,27,111,137
128,Jamaal Magloire,22,CHH,NBA,2000-01,74,0,1095,122,271,122,269,0,2,95,145,103,192,295,27,18,78,61,139,339
129,Kenyon Martin,23,NJN,NBA,2000-01,68,68,2272,346,777,345,766,1,11,121,192,137,365,502,131,78,113,138,281,814
130,Desmond Mason,23,SEA,NBA,2000-01,78,14,1522,189,439,171,372,18,67,67,91,72,177,249,63,39,20,53,146,463
131,Dan McClintock,23,DEN,NBA,2000-01,6,1,58,9,18,9,18,0,0,0,5,10,7,17,1,0,2,3,11,18
132,Paul McPherson,22,TOT,NBA,2000-01,55,0,595,109,216,107,204,2,12,42,58,40,39,79,38,25,4,47,80,262
133,Stanislav Medvedenko,21,LAL,NBA,2000-01,7,0,39,12,25,11,24,1,1,7,12,1,8,9,2,1,1,3,9,32
134,Chris Mihm,21,CLE,NBA,2000-01,59,43,1166,173,391,173,390,0,1,100,126,106,174,280,16,20,53,80,156,446
135,Darius Miles,19,LAC,NBA,2000-01,81,21,2133,318,630,317,611,1,19,124,238,127,350,477,99,51,125,147,191,761
136,Mike Miller,20,ORL,NBA,2000-01,82,62,2390,368,845,220,481,148,364,91,128,66,261,327,140,51,19,97,200,975
137,Jerome Moiso,22,BOS,NBA,2000-01,24,0,135,12,30,12,29,0,1,11,26,12,30,42,3,3,4,18,29,35
138,Hanno Mottola,24,ATL,NBA,2000-01,73,3,989,123,277,123,274,0,3,73,90,49,125,174,25,11,9,67,163,319
139,Mamadou N'Diaye,25,TOR,NBA,2000-01,3,0,10,1,4,1,4,0,0,2,2,1,1,2,0,0,0,0,3,4
140,Lee Nailon,25,CHH,NBA,2000-01,42,0,469,66,136,66,135,0,1,32,43,29,63,92,24,9,5,27,60,164
141,Eduardo Najera,24,DAL,NBA,2000-01,40,4,431,58,111,57,108,1,3,14,33,41,54,95,27,13,8,17,48,131
142,Ira Newble,26,SAS,NBA,2000-01,27,6,184,21,55,17,46,4,9,8,16,13,22,35,6,2,4,7,18,54
143,Olumide Oyedeji,19,SEA,NBA,2000-01,30,1,221,18,37,18,37,0,0,9,12,24,43,67,2,7,10,11,40,45
144,Andy Panko,23,ATL,NBA,2000-01,1,0,1,0,0,0,0,0,0,0,0,0,0,0,0,0,0,0,0,0
145,Mike Penberthy,26,LAL,NBA,2000-01,53,0,851,92,222,37,83,55,139,28,31,10,53,63,71,22,2,34,57,267
146,Morris Peterson,23,TOR,NBA,2000-01,80,49,1809,290,673,227,508,63,165,104,145,112,147,259,105,63,20,78,164,747
147,Chris Porter,22,GSW,NBA,2000-01,51,35,1147,173,445,173,440,0,5,94,141,89,100,189,61,45,6,59,111,440
148,Lavor Postell,22,NYK,NBA,2000-01,26,0,169,17,54,14,43,3,11,22,27,8,17,25,5,4,2,17,12,59
149,Joel Przybilla,21,MIL,NBA,2000-01,33,13,270,12,35,12,35,0,0,3,11,29,42,71,2,3,30,13,56,27
150,Michael Redd,21,MIL,NBA,2000-01,6,0,35,5,19,5,16,0,3,3,6,3,1,4,1,1,0,1,2,13
151,Quentin Richardson,20,LAC,NBA,2000-01,76,28,1358,232,525,182,374,50,151,99,158,105,152,257,62,42,7,64,98,613
152,Terrance Roberson,24,CHH,NBA,2000-01,3,0,13,0,2,0,1,0,1,0,0,0,1,1,1,0,0,2,3,0
153,Jamal Robinson,27,MIA,NBA,2000-01,6,0,72,3,22,3,20,0,2,0,0,3,8,11,2,6,0,3,7,6
154,Soumaila Samake,22,NJN,NBA,2000-01,34,0,226,18,48,18,48,0,0,10,24,22,31,53,1,2,14,4,23,46
155,Pepe Sanchez,23,TOT,NBA,2000-01,29,0,150,9,28,9,27,0,1,2,2,3,12,15,41,11,1,6,21,20
156,Daniel Santiago,24,PHO,NBA,2000-01,54,2,581,64,134,64,134,0,0,42,61,35,67,102,11,17,21,47,101,170
157,Jabari Smith,23,SAC,NBA,2000-01,9,0,66,11,22,11,22,0,0,4,6,1,7,8,6,4,0,3,7,26
158,Mike Smith,24,WAS,NBA,2000-01,17,0,180,19,59,16,41,3,18,10,16,10,12,22,10,5,3,7,8,51
159,DeShawn Stevenson,19,UTA,NBA,2000-01,40,2,293,31,91,30,79,1,12,26,38,9,19,28,18,10,2,28,29,89
160,Stromile Swift,21,VAN,NBA,2000-01,80,6,1312,153,339,153,335,0,4,85,141,109,175,284,28,62,82,64,160,391
161,Dragan Tarlac,27,CHI,NBA,2000-01,43,12,598,39,99,39,99,0,0,25,33,37,85,122,31,7,19,38,95,103
162,Jake Tsakalidis,21,PHO,NBA,2000-01,57,39,947,101,215,101,215,0,0,54,91,83,159,242,19,10,55,66,137,256
163,Hedo Turkoglu,21,SAC,NBA,2000-01,74,7,1245,138,335,110,249,28,86,87,112,49,161,210,69,52,24,55,139,391
164,David Vanterpool,27,WAS,NBA,2000-01,22,0,411,46,110,46,104,0,6,30,50,15,22,37,66,23,3,37,44,122
165,Jake Voskuhl,23,CHI,NBA,2000-01,16,2,143,11,25,11,25,0,0,8,14,12,22,34,5,5,6,12,38,30
166,Ruben Wolkowyski,27,SEA,NBA,2000-01,34,1,305,25,79,25,77,0,2,25,34,12,34,46,3,6,18,12,38,75
167,Wang Zhizhi,23,DAL,NBA,2000-01,5,0,38,8,19,8,17,0,2,8,10,1,6,7,0,0,0,1,8,24
168,Malik Allen,23,MIA,NBA,2001-02,12,2,161,22,51,22,50,0,1,8,10,15,23,38,5,3,8,2,16,52
169,Chris Andersen,23,DEN,NBA,2001-02,24,1,262,25,74,25,70,0,4,22,28,38,38,76,7,7,28,13,35,72
170,Gilbert Arenas,20,GSW,NBA,2001-02,47,30,1155,174,384,135,271,39,113,124,160,41,91,132,174,69,11,97,115,511
171,Brandon Armstrong,21,NJN,NBA,2001-02,35,0,196,27,85,22,68,5,17,5,10,10,6,16,8,7,1,8,26,64
172,Carlos Arroyo,22,TOT,NBA,2001-02,37,1,371,49,111,49,109,0,2,13,18,12,28,40,70,11,1,23,30,111
173,Mengke Bateer,26,DEN,NBA,2001-02,27,10,408,53,132,49,120,4,12,29,37,32,64,96,22,10,5,32,94,139
174,Shane Battier,23,MEM,NBA,2001-02,78,78,3097,412,961,309,685,103,276,198,283,180,238,418,216,121,81,155,215,1125
175,Charlie Bell,22,TOT,NBA,2001-02,7,0,44,3,11,3,5,0,6,2,2,2,3,5,2,0,0,5,3,8
176,Ruben Boumtje-Boumtje,23,POR,NBA,2001-02,33,1,245,13,32,13,32,0,0,13,25,21,34,55,4,3,16,14,38,39
177,Michael Bradley,22,TOR,NBA,2001-02,26,0,118,13,25,13,23,0,2,4,8,7,17,24,3,0,6,6,10,30
178,Jamison Brewer,21,IND,NBA,2001-02,13,0,43,2,5,2,4,0,1,0,0,2,6,8,9,2,0,3,3,4
179,Primoz Brezec,22,IND,NBA,2001-02,22,4,160,14,29,14,29,0,0,15,25,16,12,28,6,0,7,6,28,43
180,Damone Brown,22,PHI,NBA,2001-02,17,0,67,8,21,8,20,0,1,7,8,2,2,4,2,1,1,9,11,23
181,Ernest Brown,22,MIA,NBA,2001-02,3,0,21,1,6,1,6,0,0,1,4,1,5,6,0,0,1,3,4,3
182,Kedrick Brown,20,BOS,NBA,2001-02,29,5,245,23,70,18,43,5,27,12,20,11,39,50,15,18,7,7,18,63
183,Kwame Brown,19,WAS,NBA,2001-02,57,3,817,94,243,94,242,0,1,70,99,63,135,198,43,16,26,43,105,258
184,Tierre Brown,22,HOU,NBA,2001-02,40,1,403,49,115,45,103,4,12,21,28,12,30,42,70,19,3,40,26,123
185,Tyson Chandler,19,CHI,NBA,2001-02,71,31,1389,151,304,151,304,0,0,134,222,114,229,343,54,28,93,99,179,436
186,Speedy Claxton,23,PHI,NBA,2001-02,67,18,1528,181,452,177,419,4,33,114,136,46,114,160,198,95,6,95,145,480
187,Jarron Collins,23,UTA,NBA,2001-02,70,68,1440,158,343,158,342,0,1,134,181,138,158,296,58,29,22,56,234,450
188,Jason Collins,23,NJN,NBA,2001-02,77,9,1407,117,278,116,276,1,2,115,164,132,169,301,81,29,47,72,173,350
189,Joe Crispin,22,TOT,NBA,2001-02,21,0,156,26,68,11,29,15,39,12,13,2,9,11,26,5,0,10,10,79
190,Eddy Curry,19,CHI,NBA,2001-02,72,31,1150,189,377,189,377,0,0,105,160,111,161,272,25,16,53,69,173,483
191,Samuel Dalembert,20,PHI,NBA,2001-02,34,0,177,22,50,22,50,0,0,7,18,25,43,68,5,6,13,14,30,51
192,DeSagana Diop,20,CLE,NBA,2001-02,18,1,109,12,29,12,29,0,0,1,5,5,12,17,5,1,10,12,19,25
193,Predrag Drobnjak,26,SEA,NBA,2001-02,64,12,1174,191,414,191,412,0,2,55,73,75,144,219,51,20,31,51,109,437
194,Maurice Evans,23,MIN,NBA,2001-02,10,0,45,9,19,9,16,0,3,3,4,3,1,4,4,0,0,2,9,21
195,Isaac Fontaine,26,MEM,NBA,2001-02,6,0,75,3,14,2,9,1,5,4,6,0,5,5,4,0,0,4,6,11
196,Alton Ford,20,PHO,NBA,2001-02,53,0,452,61,118,61,118,0,0,42,57,32,75,107,7,6,7,32,99,164
197,Joseph Forte,20,BOS,NBA,2001-02,8,0,39,1,12,1,9,0,3,4,4,1,5,6,6,2,0,3,1,6
198,Antonis Fotsis,20,MEM,NBA,2001-02,28,1,320,42,104,35,81,7,23,17,20,25,37,62,10,9,11,21,22,108
199,Tremaine Fowlkes,25,LAC,NBA,2001-02,22,17,343,25,64,25,64,0,0,24,31,32,32,64,17,11,1,13,39,74
200,Pau Gasol,21,MEM,NBA,2001-02,82,79,3007,551,1064,550,1059,1,5,338,477,238,492,730,223,41,169,224,195,1441
201,Eddie Griffin,19,HOU,NBA,2001-02,73,24,1896,244,666,154,393,90,273,64,86,117,299,416,53,17,134,47,117,642
202,Tang Hamilton,23,MIA,NBA,2001-02,9,2,98,10,19,10,18,0,1,0,1,6,12,18,5,4,0,2,10,20
203,Trenton Hassell,22,CHI,NBA,2001-02,78,47,2237,267,628,207,463,60,165,87,114,65,190,255,172,55,44,101,184,681
204,Kirk Haston,22,CHH,NBA,2001-02,15,0,77,11,39,11,36,0,3,4,8,5,15,20,5,0,1,3,9,26
205,Brendan Haywood,22,WAS,NBA,2001-02,62,2,1266,109,221,109,221,0,0,97,160,143,179,322,29,21,91,50,158,315
206,Steven Hunter,20,ORL,NBA,2001-02,53,21,516,67,147,67,147,0,0,55,94,40,57,97,5,5,43,16,81,189
207,Mike James,26,MIA,NBA,2001-02,15,0,119,15,43,7,22,8,21,4,7,2,12,14,19,6,1,13,17,42
208,Richard Jefferson,21,NJN,NBA,2001-02,79,9,1917,270,591,257,535,13,56,189,265,85,208,293,140,64,48,107,211,742
209,Joe Johnson,20,TOT,NBA,2001-02,77,60,1916,251,584,213,454,38,130,41,53,75,182,257,179,59,20,71,114,581
210,Alvin Jones,23,PHI,NBA,2001-02,23,2,126,8,20,8,20,0,0,10,20,13,23,36,3,3,9,11,35,26
211,Andrei Kirilenko,20,UTA,NBA,2001-02,82,40,2151,285,633,260,533,25,100,285,371,149,253,402,94,116,159,108,156,880
212,Terence Morris,23,HOU,NBA,2001-02,68,12,1110,111,289,96,211,15,78,18,28,77,134,211,64,21,27,45,72,255
213,Troy Murphy,21,GSW,NBA,2001-02,82,4,1448,178,423,175,414,3,9,121,156,99,223,322,70,36,21,84,217,480
214,Dean Oliver,23,GSW,NBA,2001-02,20,0,139,17,46,15,33,2,13,6,9,0,8,8,21,3,0,11,16,42
215,Tony Parker,19,SAS,NBA,2001-02,77,72,2267,268,639,207,450,61,189,108,160,33,164,197,334,89,7,151,166,705
216,Vladimir Radmanovic,21,SEA,NBA,2001-02,61,16,1230,146,354,80,197,66,157,49,72,45,185,230,81,56,24,72,119,407
217,Zach Randolph,20,POR,NBA,2001-02,41,0,238,48,107,48,107,0,0,18,27,31,38,69,13,7,4,15,29,114
218,Zeljko Rebraca,29,DET,NBA,2001-02,74,4,1179,189,374,189,374,0,0,135,175,84,206,290,38,28,73,84,192,513
219,Jason Richardson,21,GSW,NBA,2001-02,80,75,2629,464,1090,382,844,82,246,141,210,124,216,340,236,106,31,160,195,1151
220,Norm Richardson,22,TOT,NBA,2001-02,11,0,67,10,26,6,18,4,8,6,9,3,5,8,2,0,0,3,5,30
221,Jeryl Sasser,22,ORL,NBA,2001-02,7,0,36,3,14,3,14,0,0,4,5,3,4,7,2,3,0,2,3,10
222,Kenny Satterfield,20,DEN,NBA,2001-02,36,4,560,73,199,66,172,7,27,36,46,17,35,52,108,31,1,53,43,189
223,Brian Scalabrine,23,NJN,NBA,2001-02,28,0,290,23,67,20,57,3,10,11,15,12,39,51,21,9,2,24,39,60
224,Ansu Sesay,25,SEA,NBA,2001-02,9,0,142,22,44,22,44,0,0,14,20,7,13,20,8,3,2,2,18,58
225,Bobby Simmons,21,WAS,NBA,2001-02,30,3,343,43,95,39,81,4,14,22,30,25,27,52,17,13,5,14,31,112
226,Leon Smith,21,ATL,NBA,2001-02,14,0,100,10,26,10,26,0,0,11,17,10,21,31,3,5,1,3,12,31
227,Will Solomon,23,MEM,NBA,2001-02,62,4,872,113,331,67,169,46,162,49,73,12,56,68,92,35,7,62,76,321
228,Etan Thomas,23,WAS,NBA,2001-02,47,0,618,81,151,81,151,0,0,41,74,55,126,181,6,17,35,26,76,203
229,Jamaal Tinsley,23,IND,NBA,2001-02,80,78,2442,289,760,247,585,42,175,131,186,78,220,298,647,138,40,270,248,751
230,Oscar Torres,25,HOU,NBA,2001-02,65,13,1075,135,341,98,215,37,126,82,105,47,75,122,40,25,9,49,64,389
231,Jeff Trepagnier,22,CLE,NBA,2001-02,12,0,77,7,23,7,22,0,1,4,7,3,9,12,12,8,4,11,8,18
232,Ratko Varda,22,DET,NBA,2001-02,1,0,6,2,3,2,3,0,0,1,1,0,1,1,0,0,0,1,3,5
233,Gerald Wallace,19,SAC,NBA,2001-02,54,1,430,75,175,75,168,0,7,23,46,49,40,89,27,19,6,22,46,173
234,Earl Watson,22,SEA,NBA,2001-02,64,0,964,96,212,80,168,16,44,23,36,31,52,83,125,60,5,51,93,231
235,Rodney White,21,DET,NBA,2001-02,16,0,129,21,60,19,51,2,9,12,14,2,16,18,12,9,2,14,6,56
236,Loren Woods,23,MIN,NBA,2001-02,60,0,516,33,96,33,94,0,2,44,60,46,76,122,22,17,34,36,60,110
237,Robert Archibald,22,MEM,NBA,2002-03,12,0,72,6,20,6,20,0,0,7,18,6,11,17,3,0,3,7,9,19
238,Maceo Baston,27,TOR,NBA,2002-03,16,0,106,15,25,15,25,0,0,10,12,4,19,23,0,4,11,6,16,40
239,Mike Batiste,25,MEM,NBA,2002-03,75,2,1248,197,467,179,386,18,81,69,88,82,175,257,52,42,16,69,120,481
240,Lonny Baxter,24,CHI,NBA,2002-03,55,0,682,96,206,96,204,0,2,70,103,65,100,165,16,9,22,46,135,262
241,Carlos Boozer,21,CLE,NBA,2002-03,81,54,2049,331,618,331,617,0,1,148,192,202,407,609,106,59,50,103,224,810
242,J.R. Bremer,22,BOS,NBA,2002-03,64,41,1503,171,464,70,178,101,286,85,111,18,127,145,164,38,3,59,80,528
243,Devin Brown,24,TOT,NBA,2002-03,10,2,93,12,35,12,34,0,1,6,8,8,10,18,7,4,1,9,14,30
244,Pat Burke,29,ORL,NBA,2002-03,62,8,783,113,296,112,289,1,7,40,58,57,89,146,23,19,25,47,99,267
245,Caron Butler,22,MIA,NBA,2002-03,78,78,2858,429,1032,395,925,34,107,309,375,135,262,397,213,137,31,192,230,1201
246,Rasual Butler,23,MIA,NBA,2002-03,72,28,1514,207,572,157,401,50,171,76,104,29,157,186,93,21,43,77,105,540
247,Dan Dickau,24,ATL,NBA,2002-03,50,0,515,70,170,48,109,22,61,21,26,9,34,43,85,14,2,53,66,183
248,Juan Dixon,24,WAS,NBA,2002-03,42,3,647,104,271,79,187,25,84,37,46,13,59,72,40,26,3,42,54,270
249,Mike Dunleavy,22,GSW,NBA,2002-03,82,3,1305,168,417,116,267,52,150,78,100,66,148,214,106,53,19,86,120,466
250,Melvin Ely,24,LAC,NBA,2002-03,52,7,802,92,186,92,186,0,0,52,74,64,110,174,15,10,32,50,95,236
251,Reggie Evans,22,SEA,NBA,2002-03,67,60,1365,66,140,66,140,0,0,80,154,167,278,445,34,38,11,52,173,212
252,Dan Gadzuric,24,MIL,NBA,2002-03,49,30,760,70,145,70,144,0,1,29,56,66,131,197,9,22,52,27,125,169
253,Manu Ginobili,25,SAS,NBA,2002-03,69,5,1431,174,397,123,249,51,148,126,171,47,114,161,138,96,17,100,170,525
254,Gordan Giricek,25,TOT,NBA,2002-03,76,62,2148,350,803,265,554,85,249,150,183,36,202,238,137,52,8,145,159,935
255,Drew Gooden,21,TOT,NBA,2002-03,70,47,1873,355,777,341,729,14,48,151,212,163,292,455,83,53,35,150,172,875
256,Marcus Haislip,22,MIL,NBA,2002-03,39,8,441,66,153,63,141,3,12,26,38,21,32,53,9,7,18,21,55,161
257,Adam Harrington,22,TOT,NBA,2002-03,19,0,111,11,37,6,23,5,14,3,4,1,7,8,12,2,1,2,8,30
258,Junior Harrington,22,DEN,NBA,2002-03,82,51,2003,169,467,162,439,7,28,73,112,44,206,250,277,80,15,157,250,418
259,Juaquin Hawkins,29,HOU,NBA,2002-03,58,10,685,57,148,47,124,10,24,10,20,16,62,78,47,29,6,29,57,134
260,Nene Hilario,20,DEN,NBA,2002-03,80,53,2258,321,619,321,616,0,3,197,341,208,283,491,149,127,65,181,295,839
261,Nate Huffman,27,TOR,NBA,2002-03,7,0,76,9,25,9,25,0,0,5,8,9,14,23,5,1,3,3,13,23
262,Ryan Humphrey,23,TOT,NBA,2002-03,48,1,444,35,120,35,120,0,0,23,39,34,65,99,11,9,18,23,75,93
263,Casey Jacobsen,21,PHO,NBA,2002-03,72,0,1147,122,327,70,162,52,165,72,105,29,54,83,73,35,6,55,90,368
264,Marko Jaric,24,LAC,NBA,2002-03,66,12,1379,179,446,126,280,53,166,79,105,35,125,160,193,97,11,103,125,490
265,Chris Jefferies,22,TOR,NBA,2002-03,51,10,666,75,194,57,140,18,54,29,43,16,43,59,22,19,16,45,56,197
266,Jared Jeffries,21,WAS,NBA,2002-03,20,1,292,30,63,27,57,3,6,16,29,26,32,58,16,8,5,21,28,79
267,Ken Johnson,24,MIA,NBA,2002-03,16,0,156,15,37,15,37,0,0,2,6,4,28,32,0,1,12,6,20,32
268,Fred Jones,23,IND,NBA,2002-03,19,1,115,9,24,7,17,2,7,3,4,4,5,9,5,6,1,6,13,23
269,Sean Lampley,23,MIA,NBA,2002-03,35,0,487,56,129,56,125,0,4,57,82,26,57,83,31,7,3,25,43,169
270,Tito Maddox,21,HOU,NBA,2002-03,9,0,35,3,12,3,9,0,3,5,8,1,6,7,5,3,1,3,4,11
271,Roger Mason,22,CHI,NBA,2002-03,17,0,113,11,31,5,13,6,18,2,2,2,10,12,12,4,0,5,20,30
272,Yao Ming,22,HOU,NBA,2002-03,82,72,2382,401,805,400,803,1,2,301,371,196,479,675,137,31,147,173,230,1104
273,Ronald Murray,23,TOT,NBA,2002-03,14,0,62,11,31,11,26,0,5,5,8,0,4,4,5,4,0,8,0,27
274,Bostjan Nachbar,22,HOU,NBA,2002-03,14,1,77,11,31,9,21,2,10,5,10,3,8,11,3,2,2,6,13,29
275,Mehmet Okur,23,DET,NBA,2002-03,72,9,1366,180,423,142,311,38,112,96,131,117,218,335,71,25,39,66,167,494
276,Chris Owens,23,MEM,NBA,2002-03,1,0,6,2,3,2,3,0,0,0,0,1,0,1,0,0,0,1,0,4
277,Jannero Pargo,23,LAL,NBA,2002-03,34,0,342,37,93,30,69,7,24,4,4,9,28,37,39,13,2,23,45,85
278,Smush Parker,21,CLE,NBA,2002-03,66,18,1103,136,338,98,220,38,118,98,118,29,90,119,162,48,12,133,106,408
279,Tayshaun Prince,22,DET,NBA,2002-03,42,5,435,53,118,33,71,20,47,11,17,5,40,45,24,10,14,21,25,137
280,Igor Rakocevic,24,MIN,NBA,2002-03,42,0,244,22,58,17,46,5,12,29,36,4,13,17,33,4,0,23,25,78
281,Efthimi Rentzias,27,PHI,NBA,2002-03,35,0,144,20,59,16,51,4,8,8,9,10,16,26,7,6,2,4,21,52
282,Antoine Rigaudeau,31,DAL,NBA,2002-03,11,0,91,8,35,7,30,1,5,0,0,4,4,8,6,3,0,6,11,17
283,Guy Rucker,25,GSW,NBA,2002-03,3,0,4,0,0,0,0,0,0,0,0,0,1,1,1,0,0,0,1,0
284,Kareem Rush,22,LAL,NBA,2002-03,76,0,872,96,244,77,176,19,68,16,23,26,68,94,68,10,11,63,71,227
285,John Salmons,23,PHI,NBA,2002-03,64,1,504,48,116,38,85,10,31,26,35,16,43,59,47,17,6,29,53,132
286,Jamal Sampson,19,MIL,NBA,2002-03,5,0,8,0,2,0,2,0,0,0,0,1,1,2,1,1,0,0,0,0
287,Predrag Savovic,26,DEN,NBA,2002-03,27,0,256,29,93,25,67,4,26,21,29,9,16,25,22,14,1,21,33,83
288,Paul Shirley,25,ATL,NBA,2002-03,2,0,5,0,4,0,4,0,0,0,0,0,1,1,0,0,0,0,0,0
289,Tamar Slay,22,NJN,NBA,2002-03,36,0,274,39,103,32,78,7,25,7,10,8,23,31,14,14,3,20,31,92
290,Amar'e Stoudemire,20,PHO,NBA,2002-03,82,71,2570,392,830,390,820,2,10,320,484,250,471,721,78,62,87,189,269,1106
291,Cezary Trybanski,23,MEM,NBA,2002-03,15,0,86,5,20,5,20,0,0,4,10,6,8,14,1,0,6,8,13,14
292,Nikoloz Tskitishvili,19,DEN,NBA,2002-03,81,16,1320,115,393,78,241,37,152,48,65,64,117,181,91,31,29,84,136,315
293,Dajuan Wagner,19,CLE,NBA,2002-03,47,24,1385,223,605,168,431,55,174,128,160,20,62,82,130,38,7,85,107,629
294,Jiri Welsch,23,GSW,NBA,2002-03,37,0,234,19,75,18,71,1,4,22,29,12,16,28,27,8,2,19,32,61
295,Chris Wilcox,20,LAC,NBA,2002-03,46,3,479,73,140,73,140,0,0,25,50,32,72,104,21,7,12,26,65,171
296,Mike Wilks,23,TOT,NBA,2002-03,46,7,688,50,148,40,113,10,35,37,47,20,51,71,92,27,4,28,69,147
297,Frank Williams,22,NYK,NBA,2002-03,21,0,167,9,33,3,17,6,16,4,6,3,15,18,34,7,2,17,20,28
298,Jay Williams,21,CHI,NBA,2002-03,75,54,1961,273,685,208,483,65,202,103,161,27,168,195,350,86,17,171,179,714
299,Qyntel Woods,21,POR,NBA,2002-03,53,0,334,59,118,56,109,3,9,7,20,15,38,53,12,15,1,23,36,128
300,Vincent Yarbrough,21,DEN,NBA,2002-03,59,39,1381,168,428,147,350,21,78,49,62,36,126,162,130,57,33,81,145,406
301,Carmelo Anthony,19,DEN,NBA,2003-04,82,82,2995,624,1465,555,1251,69,214,408,525,183,315,498,227,97,41,247,225,1725
302,Marcus Banks,22,BOS,NBA,2003-04,81,2,1385,177,442,150,356,27,86,99,131,30,103,133,175,88,13,125,171,480
303,Leandro Barbosa,21,PHO,NBA,2003-04,70,46,1500,210,470,127,260,83,210,47,61,23,100,123,165,93,7,120,184,550
304,Matt Barnes,23,LAC,NBA,2003-04,38,9,724,63,138,61,125,2,13,43,61,53,98,151,48,27,3,44,76,171
305,Jerome Beasley,23,MIA,NBA,2003-04,2,0,5,1,3,1,3,0,0,0,0,0,1,1,0,0,0,0,0,2
306,Troy Bell,23,MEM,NBA,2003-04,6,0,34,4,18,4,14,0,4,3,3,3,1,4,4,1,0,6,6,11
307,Steve Blake,23,WAS,NBA,2003-04,75,14,1392,157,407,82,205,75,202,55,67,18,99,117,209,57,7,128,100,444
308,Keith Bogans,23,ORL,NBA,2003-04,73,36,1787,183,454,116,267,67,187,65,103,106,211,317,98,46,10,75,128,498
309,Curtis Borchardt,23,UTA,NBA,2003-04,16,0,258,22,56,22,55,0,1,14,18,13,41,54,15,4,14,18,40,58
310,Chris Bosh,19,TOR,NBA,2003-04,75,63,2510,327,712,322,698,5,14,202,288,191,366,557,78,59,106,107,215,861
311,Torraye Braggs,27,TOT,NBA,2003-04,15,0,154,16,33,16,33,0,0,8,12,18,21,39,7,4,2,13,29,40
312,Zarko Cabarkapa,22,PHO,NBA,2003-04,49,4,570,81,197,75,165,6,32,35,53,26,73,99,40,10,13,54,75,203
313,Matt Carroll,23,TOT,NBA,2003-04,16,0,70,7,16,6,13,1,3,4,6,1,5,6,2,1,0,6,8,19
314,Maurice Carter,27,TOT,NBA,2003-04,10,0,110,11,35,7,24,4,11,16,20,2,9,11,4,0,0,9,10,42
315,Brian Cook,23,LAL,NBA,2003-04,35,2,442,67,141,67,136,0,5,21,28,31,70,101,20,16,16,17,64,155
316,Omar Cook,22,POR,NBA,2003-04,17,0,139,7,27,7,26,0,1,0,0,3,3,6,24,10,0,10,14,14
317,Marquis Daniels,23,DAL,NBA,2003-04,56,15,1039,203,411,192,375,11,36,60,78,66,80,146,116,53,12,44,51,477
318,Josh Davis,23,ATL,NBA,2003-04,4,1,23,2,5,2,3,0,2,1,1,1,4,5,0,0,0,2,3,5
319,Boris Diaw,21,ATL,NBA,2003-04,76,37,1919,140,313,134,287,6,26,56,93,111,231,342,182,59,37,126,191,342
320,Kaniel Dickens,25,POR,NBA,2003-04,3,0,12,3,3,3,3,0,0,1,2,2,0,2,0,0,0,1,3,7
321,Ronald Dupree,23,CHI,NBA,2003-04,47,8,893,111,282,107,273,4,9,66,105,55,112,167,55,32,18,51,134,292
322,Ndudi Ebi,19,MIN,NBA,2003-04,17,0,32,6,14,6,14,0,0,1,4,2,1,3,3,0,4,3,6,13
323,Francisco Elson,27,DEN,NBA,2003-04,62,14,875,94,199,94,198,0,1,30,45,65,138,203,32,35,39,35,145,218
324,Desmond Ferguson,26,POR,NBA,2003-04,7,0,32,5,12,2,4,3,8,0,2,0,4,4,1,0,0,1,0,13
325,T.J. Ford,20,MIL,NBA,2003-04,55,55,1472,153,398,148,377,5,21,80,98,37,140,177,356,60,3,139,123,391
326,Richie Frahm,26,SEA,NBA,2003-04,54,0,469,63,139,29,47,34,92,23,26,12,44,56,24,16,4,7,50,183
327,Hiram Fuller,22,ATL,NBA,2003-04,4,0,43,3,8,3,8,0,0,2,6,4,7,11,2,0,1,4,5,8
328,Reece Gaines,23,ORL,NBA,2003-04,38,1,364,25,86,22,76,3,10,16,25,8,31,39,40,11,2,18,22,69
329,Alex Garcia,23,SAS,NBA,2003-04,2,0,13,1,7,1,7,0,0,1,2,0,0,0,0,2,0,1,0,3
330,Willie Green,22,PHI,NBA,2003-04,53,0,767,143,357,124,296,19,61,59,81,16,49,65,53,26,5,59,83,364
331,Ben Handlogten,30,UTA,NBA,2003-04,17,0,172,25,47,25,47,0,0,18,27,22,33,55,6,3,4,10,32,68
332,Travis Hansen,25,ATL,NBA,2003-04,41,4,507,46,130,37,100,9,30,22,27,30,40,70,19,10,9,15,67,123
333,Udonis Haslem,23,MIA,NBA,2003-04,75,24,1795,205,447,205,444,0,3,140,183,189,284,473,51,33,24,74,197,550
334,Jarvis Hayes,22,WAS,NBA,2003-04,70,42,2044,278,695,238,564,40,131,77,98,71,193,264,106,71,11,110,157,673
335,Kirk Hinrich,23,CHI,NBA,2003-04,76,66,2706,318,823,174,454,144,369,135,168,42,217,259,517,101,21,204,276,915
336,Josh Howard,23,DAL,NBA,2003-04,67,29,1589,229,532,209,466,20,66,97,138,149,219,368,97,69,54,67,168,575
337,Brandon Hunter,23,BOS,NBA,2003-04,36,12,406,53,116,53,113,0,3,19,43,50,68,118,19,13,1,22,40,125
338,LeBron James,19,CLE,NBA,2003-04,79,79,3122,622,1492,559,1275,63,217,347,460,99,333,432,465,130,58,273,149,1654
339,Britton Johnsen,24,ORL,NBA,2003-04,20,4,290,17,59,16,47,1,12,7,16,15,30,45,12,7,1,14,28,42
340,Linton Johnson,23,CHI,NBA,2003-04,41,20,734,72,203,65,170,7,33,22,37,59,124,183,27,37,32,37,90,173
341,Dahntay Jones,23,MEM,NBA,2003-04,20,0,154,15,53,14,49,1,4,5,11,7,16,23,12,5,6,12,23,36
342,James Jones,23,IND,NBA,2003-04,6,0,26,2,9,1,5,1,4,2,2,0,2,2,0,1,0,0,1,7
343,Chris Kaman,21,LAC,NBA,2003-04,82,61,1843,200,435,200,433,0,2,99,142,126,335,461,85,23,73,155,211,499
344,Jason Kapono,22,CLE,NBA,2003-04,41,3,427,52,129,31,85,21,44,20,24,19,36,55,14,13,2,21,41,145
345,Kyle Korver,22,PHI,NBA,2003-04,74,0,882,115,327,34,120,81,207,19,24,30,81,111,40,25,8,41,102,330
346,Maciej Lampe,18,PHO,NBA,2003-04,21,0,224,43,88,43,84,0,4,10,13,9,35,44,9,3,3,15,28,96
347,Raul Lopez,23,UTA,NBA,2003-04,82,11,1617,223,517,198,432,25,85,101,117,24,131,155,305,62,2,174,200,572
348,Keith McLeod,24,MIN,NBA,2003-04,33,0,391,27,82,26,72,1,10,33,43,5,29,34,59,16,1,29,39,88
349,Darko Milicic,18,DET,NBA,2003-04,34,0,159,17,65,17,64,0,1,14,24,11,32,43,7,7,15,13,33,48
350,Travis Outlaw,19,POR,NBA,2003-04,8,0,19,3,7,3,7,0,0,2,4,2,2,4,1,1,0,1,1,8
351,Zaza Pachulia,19,ORL,NBA,2003-04,59,2,664,68,175,68,175,0,0,58,90,69,105,174,13,21,12,34,87,194
352,Sasha Pavlovic,20,UTA,NBA,2003-04,79,14,1144,149,376,130,306,19,70,65,84,44,115,159,60,41,16,67,187,382
353,Desmond Penigar,22,ORL,NBA,2003-04,10,0,89,14,28,14,28,0,0,4,4,6,18,24,3,2,2,6,14,32
354,Kirk Penney,23,MIA,NBA,2003-04,2,0,18,1,6,0,3,1,3,0,0,0,1,1,1,1,0,3,1,3
355,Kendrick Perkins,19,BOS,NBA,2003-04,10,0,35,8,15,8,15,0,0,6,9,5,9,14,3,0,2,5,6,22
356,Mickael Pietrus,21,GSW,NBA,2003-04,53,22,748,96,231,61,126,35,105,52,75,48,71,119,27,32,12,40,100,279
357,Zoran Planinic,21,NJN,NBA,2003-04,49,1,473,53,129,44,97,9,32,38,60,14,41,55,68,13,3,36,70,153
358,Luke Ridnour,22,SEA,NBA,2003-04,69,6,1114,145,350,118,270,27,80,65,79,35,73,108,163,52,7,80,105,382
359,Theron Smith,23,MEM,NBA,2003-04,20,0,178,16,43,10,31,6,12,6,8,13,28,41,7,5,5,14,18,44
360,Darius Songaila,25,SAC,NBA,2003-04,73,7,976,133,273,133,273,0,0,71,88,91,134,225,48,42,12,43,126,337
361,Mike Sweetney,21,NYK,NBA,2003-04,42,1,494,69,140,69,139,0,1,42,58,68,89,157,14,18,12,32,57,180
362,Ime Udoka,26,LAL,NBA,2003-04,4,0,28,3,9,3,8,0,1,2,4,1,4,5,2,2,1,3,3,8
363,Slavko Vranes,21,POR,NBA,2003-04,1,0,3,0,1,0,1,0,0,0,0,0,0,0,0,0,0,0,1,0
364,Dwyane Wade,22,MIA,NBA,2003-04,61,56,2126,371,798,355,745,16,53,233,312,85,162,247,275,86,34,196,140,991
365,Luke Walton,23,LAL,NBA,2003-04,72,2,730,65,153,52,114,13,39,31,44,39,88,127,113,28,8,44,70,174
366,David West,23,NOH,NBA,2003-04,71,1,930,108,228,108,226,0,2,57,80,117,180,297,60,27,28,48,117,273
367,Mo Williams,21,UTA,NBA,2003-04,57,0,772,115,303,105,264,10,39,44,56,23,49,72,76,28,2,51,87,284
368,Tony Allen,23,BOS,NBA,2004-05,77,34,1262,184,387,172,356,12,31,112,152,85,136,221,64,76,24,77,156,492
369,Rafael Araujo,24,TOR,NBA,2004-05,59,41,736,76,175,75,172,1,3,43,55,59,126,185,16,21,8,52,157,196
370,Trevor Ariza,19,NYK,NBA,2004-05,80,12,1382,172,389,169,376,3,13,121,174,89,153,242,85,70,18,73,150,468
371,Maurice Baker,25,TOT,NBA,2004-05,5,0,19,0,1,0,1,0,0,0,0,1,1,2,1,1,0,1,3,0
372,Andre Barrett,22,TOT,NBA,2004-05,38,1,483,45,124,31,72,14,52,14,19,11,29,40,69,19,1,27,51,118
373,Andris Biedrins,18,GSW,NBA,2004-05,30,1,384,45,78,45,77,0,1,19,40,47,71,118,12,12,24,12,87,109
374,Tony Bobbitt,25,LAL,NBA,2004-05,2,0,12,2,5,1,3,1,2,0,0,0,3,3,0,0,0,0,1,5
375,Matt Bonner,24,TOR,NBA,2004-05,82,0,1553,247,463,208,371,39,92,56,71,108,177,285,48,39,19,40,220,589
376,Antonio Burks,24,MEM,NBA,2004-05,24,0,219,28,60,25,49,3,11,14,19,1,11,12,28,13,1,12,25,73
377,Jackie Butler,19,NYK,NBA,2004-05,3,0,5,4,4,4,4,0,0,2,2,0,0,0,0,1,0,1,0,10
378,Geno Carlisle,28,POR,NBA,2004-05,6,0,16,2,3,2,3,0,0,4,6,1,0,1,1,0,0,1,1,8
379,Lionel Chalmers,24,LAC,NBA,2004-05,36,0,433,42,125,30,76,12,49,15,24,4,27,31,51,13,0,24,30,111
380,Josh Childress,21,ATL,NBA,2004-05,80,44,2376,302,642,289,586,13,56,190,231,195,287,482,151,74,35,106,184,807
381,Nick Collison,24,SEA,NBA,2004-05,82,4,1396,190,354,190,351,0,3,83,118,156,220,376,32,34,50,62,252,463
382,Erik Daniels,22,SAC,NBA,2004-05,21,0,72,6,18,5,16,1,2,0,0,7,11,18,4,2,0,6,7,13
383,Carlos Delfino,22,DET,NBA,2004-05,30,4,459,42,117,33,82,9,35,23,40,13,42,55,38,22,6,23,44,116
384,Luol Deng,19,CHI,NBA,2004-05,61,45,1663,280,645,249,528,31,117,120,162,92,230,322,135,48,27,118,98,711
385,Chris Duhon,22,CHI,NBA,2004-05,82,73,2177,172,488,78,223,94,265,49,67,23,190,213,398,82,3,119,205,487
386,Corsley Edwards,25,NOH,NBA,2004-05,10,0,110,10,31,10,31,0,0,7,12,12,13,25,3,3,4,2,19,27
387,John Edwards,23,IND,NBA,2004-05,25,1,139,11,30,11,30,0,0,7,14,8,11,19,3,3,4,8,12,29
388,Andre Emmett,22,MEM,NBA,2004-05,8,0,28,2,6,2,6,0,0,3,5,0,2,2,0,0,0,1,4,7
389,Luis Flores,23,TOT,NBA,2004-05,16,0,77,14,29,9,19,5,10,2,2,1,2,3,11,2,0,11,9,35
390,Matt Freije,23,NOH,NBA,2004-05,23,11,441,37,127,23,73,14,54,5,8,16,45,61,20,13,2,17,40,93
391,Ben Gordon,21,CHI,NBA,2004-05,82,3,2002,434,1056,300,725,134,331,233,270,55,160,215,164,53,10,186,224,1235
392,Devin Harris,21,DAL,NBA,2004-05,76,19,1173,157,366,113,235,44,131,78,103,28,74,102,169,77,19,82,139,436
393,David Harrison,22,IND,NBA,2004-05,43,14,760,106,184,106,184,0,0,52,91,48,87,135,13,16,55,53,134,264
394,Dwight Howard,19,ORL,NBA,2004-05,82,82,2670,352,677,352,675,0,2,277,413,287,536,823,75,77,136,165,232,981
395,Kris Humphries,19,UTA,NBA,2004-05,67,4,873,116,287,114,281,2,6,44,101,73,124,197,43,25,18,52,96,278
396,Andre Iguodala,21,PHI,NBA,2004-05,82,82,2686,269,546,222,404,47,142,156,210,89,375,464,246,138,48,139,204,741
397,Didier Ilunga-Mbenga,24,DAL,NBA,2004-05,15,1,58,6,14,6,14,0,0,3,4,3,5,8,0,0,5,5,13,15
398,Royal Ivey,23,ATL,NBA,2004-05,62,5,809,85,198,82,189,3,9,47,67,19,65,84,103,39,7,58,140,220
399,Luke Jackson,23,CLE,NBA,2004-05,10,0,43,10,27,6,21,4,6,5,6,2,4,6,3,0,0,2,4,29
400,Al Jefferson,20,BOS,NBA,2004-05,71,1,1051,195,369,195,366,0,3,85,135,119,193,312,24,22,55,66,195,475
401,Horace Jenkins,30,DET,NBA,2004-05,15,0,104,15,45,15,36,0,9,12,13,3,6,9,9,5,1,7,6,42
402,Mark Jones,29,ORL,NBA,2004-05,10,0,116,9,31,9,27,0,4,5,10,6,7,13,6,5,2,3,16,23
403,Mario Kasun,24,ORL,NBA,2004-05,45,0,356,47,98,47,97,0,1,24,43,52,76,128,8,8,13,26,86,118
404,Viktor Khryapa,22,POR,NBA,2004-05,32,5,523,54,124,50,113,4,11,23,42,28,80,108,25,20,18,33,80,135
405,Brandin Knight,23,HOU,NBA,2004-05,1,0,3,0,1,0,1,0,0,0,0,0,0,0,1,0,0,0,0,0
406,Nenad Krstic,21,NJN,NBA,2004-05,75,57,1965,281,570,281,568,0,2,185,255,161,240,401,77,32,63,112,280,747
407,Ibo Kutluay,30,SEA,NBA,2004-05,5,0,12,0,1,0,1,0,0,0,0,0,1,1,0,0,0,2,1,0
408,Shaun Livingston,19,LAC,NBA,2004-05,30,15,814,89,215,89,213,0,2,44,59,22,67,89,151,32,11,75,82,222
409,Kevin Martin,21,SAC,NBA,2004-05,45,0,455,45,117,40,92,5,25,36,55,29,29,58,22,16,3,24,35,131
410,Jameer Nelson,22,ORL,NBA,2004-05,79,21,1612,286,628,242,487,44,141,73,107,52,141,193,237,78,3,117,199,689
411,Andres Nocioni,25,CHI,NBA,2004-05,81,38,1892,241,601,216,504,25,97,170,222,69,317,386,122,37,34,135,208,677
412,Emeka Okafor,22,CHA,NBA,2004-05,73,73,2600,448,1003,448,1002,0,1,209,343,275,520,795,64,62,125,125,214,1105
413,Pavel Podkolzin,20,DAL,NBA,2004-05,5,0,10,0,0,0,0,0,0,1,2,0,2,2,0,0,0,2,4,1
414,Peter John Ramos,19,WAS,NBA,2004-05,6,0,20,5,10,5,10,0,0,1,2,1,3,4,0,0,1,3,4,11
415,Justin Reed,23,BOS,NBA,2004-05,23,0,121,15,29,15,26,0,3,11,15,8,8,16,10,3,1,5,12,41
416,Jared Reiner,22,CHI,NBA,2004-05,19,2,132,10,30,10,30,0,0,1,4,13,25,38,1,3,7,9,35,21
417,Bernard Robinson,24,CHA,NBA,2004-05,31,1,328,36,81,33,73,3,8,18,26,14,34,48,30,11,4,20,42,93
418,Quinton Ross,23,LAC,NBA,2004-05,78,19,1659,161,373,160,369,1,4,74,110,59,151,210,109,51,22,54,165,397
419,Ha Seung-Jin,19,POR,NBA,2004-05,19,0,104,10,23,10,23,0,0,6,11,6,12,18,2,1,5,12,21,26
420,Donta Smith,21,ATL,NBA,2004-05,38,0,433,44,113,38,91,6,22,33,48,19,33,52,39,23,5,25,50,127
421,J.R. Smith,19,NOH,NBA,2004-05,76,56,1859,295,748,214,467,81,281,111,161,39,113,152,142,55,11,109,135,782
422,Josh Smith,19,ATL,NBA,2004-05,74,59,2050,274,602,270,579,4,23,163,237,147,310,457,127,59,144,135,157,715
423,Kirk Snyder,21,UTA,NBA,2004-05,68,7,906,122,328,92,243,30,85,64,96,50,71,121,36,26,19,58,116,338
424,Pape Sow,23,TOR,NBA,2004-05,27,4,255,23,58,23,58,0,0,16,27,18,39,57,2,12,4,10,46,62
425,Awvee Storey,27,NJN,NBA,2004-05,9,0,32,3,10,2,8,1,2,1,2,4,1,5,1,0,0,0,3,8
426,Robert Swift,19,SEA,NBA,2004-05,16,0,72,5,11,5,11,0,0,5,9,1,4,5,2,1,7,4,16,15
427,Yuta Tabuse,24,PHO,NBA,2004-05,4,0,17,1,6,0,5,1,1,4,4,2,2,4,3,0,0,1,1,7
428,Sebastian Telfair,19,POR,NBA,2004-05,68,26,1330,169,430,152,361,17,69,105,133,10,94,104,224,35,4,125,120,460
429,Billy Thomas,29,NJN,NBA,2004-05,25,0,356,34,94,17,38,17,56,7,9,7,29,36,17,14,1,9,29,92
430,James Thomas,24,TOT,NBA,2004-05,11,2,117,12,20,12,20,0,0,2,6,17,20,37,4,4,4,7,13,26
431,Beno Udrih,22,SAS,NBA,2004-05,80,2,1149,173,390,115,248,58,142,67,89,16,67,83,150,41,10,77,96,471
432,Anderson Varejao,22,CLE,NBA,2004-05,54,0,863,99,193,99,191,0,2,68,127,109,148,257,27,41,38,26,122,266
433,Jackson Vroman,23,TOT,NBA,2004-05,46,18,705,82,199,82,196,0,3,48,75,64,111,175,40,25,19,64,105,212
434,Sasha Vujacic,20,LAL,NBA,2004-05,35,3,403,33,117,16,54,17,63,18,19,13,49,62,51,12,2,15,41,101
435,Delonte West,21,BOS,NBA,2004-05,39,7,507,66,155,42,88,24,67,19,27,14,51,65,53,21,8,24,69,175
436,Damien Wilkins,25,SEA,NBA,2004-05,29,7,520,73,168,57,109,16,59,21,34,29,37,66,26,22,10,16,55,183
437,Dorell Wright,19,MIA,NBA,2004-05,3,0,27,3,11,3,7,0,4,1,1,0,1,1,3,4,0,3,2,7
438,Alex Acker,23,DET,NBA,2005-06,5,0,35,4,16,3,11,1,5,0,0,1,4,5,4,1,0,4,4,9
439,Alan Anderson,23,CHA,NBA,2005-06,36,7,564,75,181,51,123,24,58,33,41,23,47,70,32,11,4,32,48,207
440,Martynas Andriuskevicius,19,CLE,NBA,2005-06,6,0,9,0,1,0,1,0,0,0,0,1,3,4,0,2,0,0,1,0
441,Earl Barron,24,MIA,NBA,2005-06,8,0,45,5,16,5,16,0,0,3,4,2,8,10,0,0,0,5,10,13
442,Eddie Basden,22,CHI,NBA,2005-06,19,0,141,15,37,14,30,1,7,8,10,7,21,28,8,9,2,9,17,39
443,Brandon Bass,20,NOK,NBA,2005-06,29,1,268,28,70,28,70,0,0,12,19,18,50,68,3,3,7,11,18,68
444,Esteban Batista,22,ATL,NBA,2005-06,57,3,495,34,80,34,79,0,1,33,53,61,83,144,7,15,11,38,111,101
445,Andray Blatche,19,WAS,NBA,2005-06,29,0,175,26,67,23,54,3,13,10,12,12,26,38,10,5,7,12,36,65
446,Andrew Bogut,21,MIL,NBA,2005-06,82,77,2348,323,606,323,603,0,3,122,194,189,384,573,192,49,68,125,259,768
447,Kevin Burleson,26,CHA,NBA,2005-06,39,1,340,22,88,12,34,10,54,16,17,4,22,26,48,26,2,25,63,70
448,Andrew Bynum,18,LAL,NBA,2005-06,46,0,338,33,82,33,82,0,0,8,27,34,46,80,9,4,22,17,56,74
449,Will Bynum,23,GSW,NBA,2005-06,15,0,162,21,52,19,43,2,9,10,16,3,9,12,19,7,0,14,10,54
450,Jose Calderon,24,TOR,NBA,2005-06,64,11,1487,132,312,125,269,7,43,78,92,30,111,141,288,42,4,101,93,349
451,Travis Diener,23,ORL,NBA,2005-06,23,0,246,29,69,4,12,25,57,5,6,4,17,21,16,7,0,10,22,88
452,Ike Diogu,22,GSW,NBA,2005-06,69,14,1031,175,334,175,334,0,0,136,168,95,134,229,29,15,30,78,164,486
453,Monta Ellis,20,GSW,NBA,2005-06,49,3,886,132,318,104,236,28,82,42,59,22,83,105,78,32,11,58,69,334
454,Daniel Ewing,22,LAC,NBA,2005-06,66,5,971,97,255,75,177,22,78,36,46,23,62,85,84,37,6,57,86,252
455,Noel Felix,24,SEA,NBA,2005-06,12,0,82,6,25,5,22,1,3,5,8,3,10,13,2,2,3,8,13,18
456,Raymond Felton,21,CHA,NBA,2005-06,80,54,2406,345,883,248,612,97,271,161,222,77,188,265,446,102,8,182,181,948
457,Gerald Fitch,23,MIA,NBA,2005-06,18,1,239,30,89,23,63,7,26,17,23,7,23,30,33,7,5,15,28,84
458,Sharrod Ford,24,PHO,NBA,2005-06,3,0,13,2,3,2,3,0,0,0,0,1,2,3,0,0,1,2,7,4
459,Channing Frye,22,NYK,NBA,2005-06,65,14,1572,305,640,302,631,3,9,189,229,138,236,374,53,30,47,97,200,802
460,Deng Gai,23,PHI,NBA,2005-06,2,0,5,0,0,0,0,0,0,0,0,0,0,0,0,0,0,0,0,0
461,Francisco Garcia,24,SAC,NBA,2005-06,67,11,1301,130,325,91,188,39,137,78,101,39,146,185,94,41,47,75,135,377
462,Ryan Gomes,23,BOS,NBA,2005-06,61,33,1376,173,355,170,346,3,9,112,149,102,196,298,58,35,5,55,83,461
463,Joey Graham,23,TOR,NBA,2005-06,80,24,1581,198,414,169,327,29,87,108,133,57,187,244,60,37,13,92,228,533
464,Stephen Graham,23,TOT,NBA,2005-06,22,0,175,21,54,19,44,2,10,14,15,5,22,27,7,5,2,13,31,58
465,Danny Granger,22,IND,NBA,2005-06,78,17,1765,221,478,191,385,30,93,115,148,131,253,384,90,58,62,80,211,587
466,Devin Green,23,LAL,NBA,2005-06,27,0,135,6,28,6,26,0,2,13,21,10,14,24,7,3,0,5,13,25
467,Gerald Green,20,BOS,NBA,2005-06,32,3,374,66,138,60,118,6,20,29,37,10,31,41,18,13,4,22,41,167
468,Orien Greene,23,BOS,NBA,2005-06,80,5,1235,100,253,91,213,9,40,45,68,37,108,145,129,77,10,109,181,254
469,Anthony Grundy,26,ATL,NBA,2005-06,12,0,108,19,38,14,23,5,15,9,14,1,16,17,9,7,0,9,14,52
470,Chuck Hayes,22,HOU,NBA,2005-06,40,0,535,59,105,59,104,0,1,29,45,67,112,179,14,26,14,12,76,147
471,Luther Head,23,HOU,NBA,2005-06,80,27,2310,254,630,141,317,113,313,86,123,33,233,266,215,89,9,119,169,707
472,Julius Hodge,22,DEN,NBA,2005-06,14,0,33,5,13,5,13,0,0,3,8,5,2,7,6,2,0,8,7,13
473,Randy Holcomb,26,CHI,NBA,2005-06,4,0,11,1,1,1,1,0,0,0,0,1,0,1,0,0,0,0,2,2
474,Jarrett Jack,22,POR,NBA,2005-06,79,4,1599,189,428,169,352,20,76,128,160,18,142,160,219,41,2,102,138,526
475,Sarunas Jasikevicius,29,IND,NBA,2005-06,75,15,1557,170,429,84,193,86,236,121,133,19,134,153,227,40,4,116,108,547
476,Amir Johnson,18,DET,NBA,2005-06,3,0,39,7,10,5,7,2,3,4,4,3,1,4,3,0,2,4,7,20
477,Dwayne Jones,22,BOS,NBA,2005-06,14,0,87,4,10,4,10,0,0,6,13,10,21,31,2,1,3,3,14,14
478,Linas Kleiza,21,DEN,NBA,2005-06,61,2,519,77,173,75,160,2,13,57,81,38,78,116,15,10,13,16,87,213
479,Yaroslav Korolev,18,LAC,NBA,2005-06,24,0,127,9,30,7,23,2,7,7,10,5,8,13,9,3,0,6,11,27
480,David Lee,22,NYK,NBA,2005-06,67,14,1129,137,230,137,230,0,0,71,123,109,194,303,43,30,20,51,124,345
481,John Lucas III,23,HOU,NBA,2005-06,13,0,107,14,36,12,27,2,9,0,0,2,3,5,12,5,0,7,6,30
482,Arvydas Macijauskas,26,NOK,NBA,2005-06,19,0,135,14,41,11,29,3,12,13,15,3,7,10,5,7,0,8,10,44
483,Rawle Marshall,23,DAL,NBA,2005-06,23,9,241,24,60,23,57,1,3,22,29,8,23,31,10,8,7,15,17,71
484,Jason Maxiell,22,DET,NBA,2005-06,26,0,159,23,54,23,54,0,0,14,42,12,16,28,3,4,5,11,14,60
485,Sean May,21,CHA,NBA,2005-06,23,1,398,70,171,70,166,0,5,49,64,42,67,109,22,17,12,33,58,189
486,Rashad McCants,21,MIN,NBA,2005-06,79,12,1362,241,535,174,355,67,180,78,106,29,114,143,63,44,22,86,176,627
487,Aaron Miles,22,GSW,NBA,2005-06,19,0,118,6,18,6,18,0,0,4,4,0,14,14,24,4,1,11,13,16
488,C.J. Miles,18,UTA,NBA,2005-06,23,0,203,28,76,23,56,5,20,18,24,18,20,38,16,7,2,9,20,79
489,Sergei Monia,22,TOT,NBA,2005-06,26,15,343,29,87,20,53,9,34,10,14,11,41,52,19,7,5,12,41,77
490,Boniface N'Dong,28,LAC,NBA,2005-06,23,1,152,22,53,22,52,0,1,6,9,15,22,37,7,2,5,6,23,50
491,Fabricio Oberto,30,SAS,NBA,2005-06,59,0,490,44,93,44,91,0,2,15,27,57,66,123,27,9,11,28,91,103
492,Andre Owens,25,UTA,NBA,2005-06,23,2,210,27,74,24,58,3,16,12,18,11,10,21,8,5,0,13,25,69
493,Chris Paul,20,NOK,NBA,2005-06,78,78,2808,407,947,357,770,50,177,394,465,61,339,400,611,175,6,183,218,1258
494,Johan Petro,20,SEA,NBA,2005-06,68,41,1282,153,300,153,300,0,0,47,75,109,187,296,15,25,51,60,213,353
495,Josh Powell,23,DAL,NBA,2005-06,37,2,429,37,81,37,81,0,0,36,45,28,53,81,9,7,4,22,52,110
496,Ronnie Price,22,SAC,NBA,2005-06,29,0,150,21,58,15,31,6,27,12,12,5,10,15,11,6,0,10,10,60
497,Shavlik Randolph,22,PHI,NBA,2005-06,57,1,487,44,97,44,97,0,0,43,71,55,78,133,19,19,12,21,83,131
498,Anthony Roberson,22,MEM,NBA,2005-06,16,0,88,14,31,9,21,5,10,2,2,0,6,6,5,1,0,3,6,35
499,Lawrence Roberts,23,MEM,NBA,2005-06,33,0,181,20,44,20,42,0,2,11,23,26,23,49,5,8,2,5,30,51
500,Nate Robinson,21,NYK,NBA,2005-06,72,26,1544,230,565,172,419,58,146,152,202,56,111,167,147,59,1,114,201,670
501,Melvin Sanders,25,SAS,NBA,2005-06,16,0,113,16,33,14,30,2,3,7,10,4,19,23,3,5,0,8,20,41
502,Alex Scales,27,SAS,NBA,2005-06,1,0,0,0,0,0,0,0,0,0,0,0,0,0,0,0,0,0,0,0
503,Luke Schenscher,23,CHI,NBA,2005-06,20,0,149,16,26,16,26,0,0,4,13,8,21,29,7,1,3,5,21,36
504,Wayne Simien,22,MIA,NBA,2005-06,43,2,414,58,120,58,120,0,0,30,34,38,50,88,7,13,1,24,70,146
505,James Singleton,24,LAC,NBA,2005-06,59,10,753,77,151,67,131,10,20,39,50,63,134,197,29,19,21,28,95,203
506,Salim Stoudamire,23,ATL,NBA,2005-06,61,1,1236,204,492,122,276,82,216,99,110,12,104,116,75,27,3,82,118,589
507,Chris Taft,20,GSW,NBA,2005-06,17,0,144,23,38,23,38,0,0,1,6,19,17,36,2,2,7,2,25,47
508,Donell Taylor,23,WAS,NBA,2005-06,51,1,465,53,136,49,119,4,17,30,43,16,37,53,45,30,4,34,47,140
509,Dijon Thompson,22,PHO,NBA,2005-06,10,0,43,11,25,7,14,4,11,2,2,4,7,11,1,3,1,2,6,28
510,Ronny Turiaf,23,LAL,NBA,2005-06,23,1,161,15,30,15,30,0,0,15,27,11,26,37,8,3,10,7,30,45
511,Charlie Villanueva,21,TOR,NBA,2005-06,81,36,2361,435,940,365,726,70,214,113,160,181,340,521,88,60,63,99,247,1053
512,Von Wafer,20,LAL,NBA,2005-06,16,0,73,6,38,4,21,2,17,6,8,5,3,8,4,3,0,1,12,20
513,Matt Walsh,23,MIA,NBA,2005-06,2,0,3,1,1,1,1,0,0,0,2,0,0,0,0,0,0,1,0,2
514,Hakim Warrick,23,MEM,NBA,2005-06,68,2,724,101,228,101,228,0,0,76,115,43,101,144,30,14,21,56,113,278
515,Martell Webster,19,POR,NBA,2005-06,61,18,1070,139,348,74,166,65,182,61,71,29,101,130,34,21,14,43,90,404
516,Robert Whaley,23,UTA,NBA,2005-06,23,0,212,23,57,23,57,0,0,3,6,16,27,43,17,7,8,14,41,49
517,Deron Williams,21,UTA,NBA,2005-06,80,47,2307,339,805,248,586,91,219,95,135,35,159,194,359,60,17,145,233,864
518,Lou Williams,19,PHI,NBA,2005-06,30,0,145,23,52,21,43,2,9,8,13,3,16,19,10,5,0,13,13,56
519,Marvin Williams,19,ATL,NBA,2005-06,79,7,1952,235,531,222,478,13,53,189,253,122,261,383,63,48,24,83,227,672
520,Antoine Wright,21,NJN,NBA,2005-06,39,0,370,29,81,28,66,1,15,11,22,8,22,30,12,4,3,21,42,70
521,Bracey Wright,21,MIN,NBA,2005-06,7,0,135,21,51,15,34,6,17,14,16,3,15,18,5,1,0,8,8,62
522,Derrick Zimmerman,24,NJN,NBA,2005-06,2,0,32,2,3,2,3,0,0,0,0,1,3,4,7,0,0,4,4,4
523,Hassan Adams,22,NJN,NBA,2006-07,61,8,495,75,135,75,134,0,1,24,36,35,42,77,13,17,4,22,47,174
524,Maurice Ager,22,DAL,NBA,2006-07,32,1,214,22,70,17,55,5,15,20,33,1,20,21,7,4,3,15,27,69
525,LaMarcus Aldridge,21,POR,NBA,2006-07,63,22,1392,241,479,241,477,0,2,83,115,144,168,312,24,22,73,43,186,565
526,Lou Amundson,24,TOT,NBA,2006-07,11,0,89,6,15,6,15,0,0,4,10,13,15,28,1,1,8,5,15,16
527,Hilton Armstrong,22,NOK,NBA,2006-07,56,5,634,68,125,68,125,0,0,40,67,58,91,149,10,12,26,35,79,176
528,James Augustine,22,ORL,NBA,2006-07,2,0,7,1,3,1,3,0,0,0,0,1,2,3,2,0,0,0,2,2
529,Kelenna Azubuike,23,GSW,NBA,2006-07,41,9,669,98,220,64,141,34,79,61,78,26,68,94,28,22,10,39,49,291
530,Renaldo Balkman,22,NYK,NBA,2006-07,68,1,1064,139,275,134,248,5,27,51,90,97,197,294,44,57,44,49,146,334
531,J.J. Barea,22,DAL,NBA,2006-07,33,1,191,28,78,22,57,6,21,16,24,7,18,25,24,1,1,14,19,78
532,Andrea Bargnani,21,TOR,NBA,2006-07,65,2,1629,267,625,167,357,100,268,117,142,52,203,255,50,32,53,107,180,751
533,Will Blalock,23,DET,NBA,2006-07,14,0,166,9,30,8,25,1,5,6,6,6,9,15,17,5,0,12,9,25
534,Josh Boone,22,NJN,NBA,2006-07,61,0,669,99,171,99,171,0,0,56,103,64,112,176,10,11,21,33,94,254
535,Cedric Bozeman,23,ATL,NBA,2006-07,23,5,199,11,39,9,26,2,13,2,6,3,20,23,9,5,2,9,32,26
536,Ronnie Brewer,21,UTA,NBA,2006-07,56,14,675,102,193,102,184,0,9,56,83,37,38,75,24,37,6,24,44,260
537,Andre Brown,25,SEA,NBA,2006-07,38,0,271,42,74,42,73,0,1,9,15,26,48,74,2,6,4,29,26,93
538,Dee Brown,22,UTA,NBA,2006-07,49,0,450,32,98,26,70,6,28,24,37,8,32,40,83,22,7,31,51,94
539,Shannon Brown,21,CLE,NBA,2006-07,23,5,202,28,74,21,49,7,25,10,14,6,15,21,10,7,3,14,24,73
540,Rodney Carney,22,PHI,NBA,2006-07,67,35,1169,182,392,157,320,25,72,53,87,39,89,128,26,38,23,43,118,442
541,Mardy Collins,22,NYK,NBA,2006-07,52,9,777,87,228,74,181,13,47,48,82,28,76,104,83,32,3,57,75,235
542,Will Conroy,24,TOT,NBA,2006-07,7,0,52,0,3,0,3,0,0,0,4,3,4,7,9,0,0,2,7,0
543,Paul Davis,22,LAC,NBA,2006-07,31,0,180,22,52,22,52,0,0,7,10,21,23,44,7,6,5,8,28,51
544,Yakhouba Diawara,24,DEN,NBA,2006-07,64,19,1177,100,292,51,122,49,170,35,53,27,83,110,55,30,7,37,132,284
545,Quincy Douby,22,SAC,NBA,2006-07,42,0,359,48,126,36,76,12,50,11,15,11,26,37,15,15,4,15,21,119
546,Jordan Farmar,20,LAL,NBA,2006-07,72,2,1090,124,294,79,157,45,137,27,38,22,97,119,137,44,7,73,77,320
547,Desmon Farmer,25,SEA,NBA,2006-07,8,0,32,5,15,3,7,2,8,1,1,0,1,1,9,1,0,1,2,13
548,Randy Foye,23,MIN,NBA,2006-07,82,12,1879,300,691,232,506,68,185,164,192,49,169,218,232,53,21,152,184,832
549,Jorge Garbajosa,29,TOR,NBA,2006-07,67,60,1909,222,529,156,336,66,193,57,78,48,282,330,125,78,15,64,90,567
550,Rudy Gay,20,MEM,NBA,2006-07,78,43,2103,321,760,269,617,52,143,152,209,93,255,348,100,71,74,140,192,846
551,Mickael Gelabale,23,SEA,NBA,2006-07,70,14,1239,122,264,111,217,11,47,66,82,59,114,173,56,24,22,49,108,321
552,Daniel Gibson,20,CLE,NBA,2006-07,60,16,988,98,231,46,107,52,124,28,39,28,64,92,69,23,8,44,94,276
553,Andreas Glyniadakis,25,SEA,NBA,2006-07,13,4,81,8,17,8,17,0,0,1,2,2,6,8,1,0,0,9,19,17
554,Lynn Greer,27,MIL,NBA,2006-07,41,0,432,61,141,43,89,18,52,27,32,2,25,27,53,17,1,18,32,167
555,Mike Hall,22,WAS,NBA,2006-07,2,0,13,1,4,1,4,0,0,0,0,1,1,2,1,0,0,0,1,2
556,Walter Herrmann,27,CHA,NBA,2006-07,48,12,936,174,330,121,215,53,115,41,53,28,111,139,26,17,7,32,76,442
557,Robert Hite,23,MIA,NBA,2006-07,12,0,136,19,60,14,37,5,23,8,12,4,12,16,8,3,2,6,8,51
558,Ryan Hollins,22,CHA,NBA,2006-07,27,0,185,20,36,20,36,0,0,24,40,11,20,31,1,4,7,16,40,64
559,Mile Ilic,22,NJN,NBA,2006-07,5,0,6,0,3,0,3,0,0,0,0,0,1,1,0,0,0,3,1,0
560,Ersan Ilyasova,19,MIL,NBA,2006-07,66,14,973,139,363,85,215,54,148,70,89,58,131,189,49,27,17,51,147,402
561,Alexander Johnson,23,MEM,NBA,2006-07,59,19,753,91,169,91,169,0,0,78,118,50,131,181,17,25,35,47,137,260
562,Bobby Jones,23,PHI,NBA,2006-07,44,5,336,43,93,42,84,1,9,23,41,22,35,57,16,11,1,18,59,110
563,Solomon Jones,22,ATL,NBA,2006-07,58,8,666,65,128,65,127,0,1,59,75,49,87,136,11,11,42,25,124,189
564,Tarence Kinsey,22,MEM,NBA,2006-07,48,12,967,139,304,126,258,13,46,78,98,29,68,97,41,53,1,46,57,369
565,James Lang,23,WAS,NBA,2006-07,11,0,55,4,9,4,9,0,0,3,5,5,6,11,2,0,3,2,14,11
566,Kyle Lowry,20,MEM,NBA,2006-07,10,0,175,14,38,11,30,3,8,25,28,12,19,31,32,14,1,12,20,56
567,Renaldo Major,24,GSW,NBA,2006-07,1,0,27,2,10,2,10,0,0,1,2,0,2,2,0,2,0,1,4,5
568,Damir Markota,21,MIL,NBA,2006-07,30,0,170,19,52,13,36,6,16,7,11,11,20,31,6,3,1,15,22,51
569,Chris McCray,22,MIL,NBA,2006-07,5,0,12,0,3,0,3,0,0,0,0,0,0,0,0,0,0,2,1,0
570,Ivan McFarlin,24,PHI,NBA,2006-07,11,0,41,5,13,5,12,0,1,5,7,7,4,11,1,0,0,1,8,15
571,Pops Mensah-Bonsu,23,DAL,NBA,2006-07,12,0,71,11,17,11,17,0,0,7,18,9,12,21,0,1,0,9,8,29
572,Paul Millsap,21,UTA,NBA,2006-07,82,1,1472,209,398,208,395,1,3,140,208,183,240,423,62,67,74,94,236,559
573,Randolph Morris,21,NYK,NBA,2006-07,5,0,44,1,6,1,6,0,0,2,6,1,8,9,1,2,1,2,4,4
574,Adam Morrison,22,CHA,NBA,2006-07,78,23,2326,355,944,268,686,87,258,120,169,54,176,230,163,28,6,130,179,917
575,David Noel,22,MIL,NBA,2006-07,68,0,792,65,177,48,124,17,53,37,43,42,81,123,65,25,9,40,77,184
576,Steve Novak,23,HOU,NBA,2006-07,35,1,191,18,50,5,11,13,39,2,2,4,22,26,6,5,0,4,21,51
577,Patrick O'Bryant,20,GSW,NBA,2006-07,16,0,119,10,32,10,32,0,0,11,17,7,14,21,9,6,8,8,26,31
578,Kevinn Pinkney,23,BOS,NBA,2006-07,6,0,100,12,27,11,25,1,2,6,9,7,8,15,5,3,3,4,12,31
579,Leon Powe,23,BOS,NBA,2006-07,63,2,720,79,177,79,175,0,2,106,144,97,118,215,10,14,22,47,104,264
580,Roger Powell,24,UTA,NBA,2006-07,3,0,13,0,3,0,2,0,1,2,2,3,0,3,0,0,0,3,2,2
581,Chris Quinn,23,MIA,NBA,2006-07,42,1,408,48,131,28,74,20,57,25,37,6,24,30,65,15,0,21,32,141
582,Allan Ray,22,BOS,NBA,2006-07,47,5,710,100,259,52,143,48,116,42,55,18,51,69,43,20,3,42,85,290
583,J.J. Redick,22,ORL,NBA,2006-07,42,0,622,80,195,42,97,38,98,54,60,10,42,52,36,12,0,21,52,252
584,Jeremy Richardson,22,TOT,NBA,2006-07,6,0,20,3,6,1,3,2,3,0,0,1,1,2,0,1,0,1,2,8
585,Sergio Rodriguez,20,POR,NBA,2006-07,67,1,862,101,239,77,154,24,85,21,26,20,71,91,218,35,2,77,72,247
586,Rajon Rondo,20,BOS,NBA,2006-07,78,25,1831,188,450,182,421,6,29,119,184,74,218,292,297,128,8,137,181,501
587,Brandon Roy,22,POR,NBA,2006-07,57,55,2015,349,765,294,619,55,146,202,241,58,192,250,230,67,10,116,139,955
588,Thabo Sefolosha,22,CHI,NBA,2006-07,71,4,868,109,256,94,214,15,42,23,45,35,118,153,60,33,11,60,100,256
589,Mouhamed Sene,20,SEA,NBA,2006-07,28,3,169,18,49,18,49,0,0,17,29,16,29,45,0,3,12,11,33,53
590,Cedric Simmons,21,NOK,NBA,2006-07,43,4,534,55,132,55,132,0,0,16,33,44,63,107,12,8,23,22,75,126
591,Uros Slokar,23,TOR,NBA,2006-07,20,0,72,14,26,13,24,1,2,9,13,7,7,14,1,1,2,9,11,38
592,Craig Smith,23,MIN,NBA,2006-07,82,5,1537,246,463,246,457,0,6,116,186,149,267,416,49,51,18,74,223,608
593,Steven Smith,23,PHI,NBA,2006-07,8,0,28,2,8,2,8,0,0,1,2,1,5,6,0,1,0,2,4,5
594,Vassilis Spanoulis,24,HOU,NBA,2006-07,31,0,272,23,72,18,43,5,29,34,42,5,17,22,28,7,1,29,33,85
595,Tyrus Thomas,20,CHI,NBA,2006-07,72,4,966,134,282,134,280,0,2,106,175,89,180,269,40,46,76,94,162,374
596,P.J. Tucker,21,TOR,NBA,2006-07,17,0,83,11,22,11,22,0,0,8,14,11,12,23,3,2,0,6,12,30
597,Marcus Vinicius,22,NOK,NBA,2006-07,13,0,103,7,15,4,8,3,7,5,7,2,9,11,5,2,1,6,10,22
598,James White,24,SAS,NBA,2006-07,6,2,137,18,41,16,34,2,7,12,15,3,17,20,5,3,1,5,7,50
599,Justin Williams,22,SAC,NBA,2006-07,26,1,333,54,88,54,87,0,1,23,63,51,64,115,2,5,16,15,51,131
600,Marcus Williams,21,NJN,NBA,2006-07,79,2,1315,208,526,162,363,46,163,72,85,29,134,163,260,29,2,142,96,534
601,Shawne Williams,20,IND,NBA,2006-07,46,3,556,75,160,56,108,19,52,11,20,33,50,83,22,6,8,24,69,180
602,Shelden Williams,23,ATL,NBA,2006-07,81,31,1514,166,365,164,361,2,4,110,144,131,304,435,44,52,39,96,199,444
603,Arron Afflalo,22,DET,NBA,2007-08,75,9,970,99,241,89,193,10,48,68,87,36,101,137,52,31,8,34,83,276
604,Blake Ahearn,23,MIA,NBA,2007-08,12,0,177,15,57,5,23,10,34,30,31,1,18,19,19,6,0,16,20,70
605,Lance Allred,26,CLE,NBA,2007-08,3,0,10,1,4,1,4,0,0,1,2,0,1,1,0,0,0,0,1,3
606,Morris Almond,22,UTA,NBA,2007-08,9,0,39,4,15,3,11,1,4,4,6,0,2,2,3,1,0,2,5,13
607,Joel Anthony,25,MIA,NBA,2007-08,24,1,498,28,60,28,60,0,0,29,49,38,55,93,3,9,31,17,55,85
608,Marco Belinelli,21,GSW,NBA,2007-08,33,0,241,36,93,20,52,16,41,7,9,3,11,14,15,5,0,12,15,95
609,Corey Brewer,21,MIN,NBA,2007-08,79,35,1803,182,486,175,450,7,36,88,110,82,210,292,111,76,25,89,188,459
610,Aaron Brooks,23,HOU,NBA,2007-08,51,0,608,93,225,57,116,36,109,42,49,13,43,56,87,13,5,44,69,264
611,Wilson Chandler,20,NYK,NBA,2007-08,35,16,685,106,242,97,212,9,30,34,54,38,89,127,33,15,16,27,83,255
612,Mike Conley,20,MEM,NBA,2007-08,53,46,1381,189,442,159,351,30,91,90,123,21,118,139,222,44,2,89,85,498
613,Daequan Cook,20,MIA,NBA,2007-08,59,19,1441,196,514,117,276,79,238,47,57,20,157,177,75,23,9,63,157,518
614,Javaris Crittenton,20,TOT,NBA,2007-08,50,0,679,98,233,88,196,10,37,72,104,27,83,110,51,19,2,55,47,278
615,Jermareo Davidson,23,CHA,NBA,2007-08,38,2,322,51,125,51,125,0,0,18,28,21,41,62,13,7,15,17,46,120
616,Glen Davis,22,BOS,NBA,2007-08,69,1,940,107,221,107,221,0,0,99,150,95,113,208,28,31,20,65,160,313
617,Guillermo Diaz,22,LAC,NBA,2007-08,6,0,18,1,4,1,3,0,1,3,5,2,0,2,1,0,0,0,0,5
618,Jared Dudley,22,CHA,NBA,2007-08,73,14,1384,163,348,154,307,9,41,87,118,121,165,286,81,55,10,50,128,422
619,Kevin Durant,19,SEA,NBA,2007-08,80,80,2768,587,1366,528,1161,59,205,391,448,70,278,348,192,78,75,232,122,1624
620,Nick Fazekas,22,TOT,NBA,2007-08,26,0,269,46,82,46,80,0,2,15,22,34,55,89,11,8,11,13,25,107
621,Kyrylo Fesenko,21,UTA,NBA,2007-08,9,0,70,6,16,6,16,0,0,2,4,14,11,25,2,0,3,8,19,14
622,Thomas Gardner,22,CHI,NBA,2007-08,4,0,45,9,23,6,11,3,12,0,2,3,1,4,1,0,0,4,4,21
623,Marcin Gortat,23,ORL,NBA,2007-08,6,0,41,8,17,8,17,0,0,2,3,8,8,16,2,1,1,2,4,18
624,Aaron Gray,23,CHI,NBA,2007-08,61,1,613,103,204,103,203,0,1,56,99,70,98,168,41,21,16,57,117,262
625,Jeff Green,21,SEA,NBA,2007-08,80,52,2253,320,749,299,673,21,76,177,238,101,278,379,119,46,49,158,198,838
626,Taurean Green,21,TOT,NBA,2007-08,17,0,74,7,25,5,14,2,11,11,12,0,10,10,11,2,0,9,5,27
627,Mike Harris,24,HOU,NBA,2007-08,17,0,159,27,54,27,52,0,2,8,13,24,30,54,3,6,3,9,16,62
628,Spencer Hawes,19,SAC,NBA,2007-08,71,8,931,146,318,142,297,4,21,38,58,68,162,230,44,14,40,56,128,334
629,Al Horford,21,ATL,NBA,2007-08,81,77,2540,333,668,333,663,0,5,155,212,248,537,785,124,60,76,137,267,821
630,Yi Jianlian,20,MIL,NBA,2007-08,66,49,1647,219,520,213,499,6,21,122,145,106,238,344,55,36,56,90,153,566
631,Coby Karl,24,LAL,NBA,2007-08,17,0,71,9,26,5,13,4,13,8,10,3,11,14,9,4,2,5,4,30
632,Carl Landry,24,HOU,NBA,2007-08,42,0,711,135,219,135,218,0,1,72,109,96,111,207,21,17,7,26,98,342
633,Keith Langford,24,SAS,NBA,2007-08,2,0,10,1,4,1,4,0,0,0,0,0,2,2,0,0,0,0,1,2
634,Stephane Lasme,25,TOT,NBA,2007-08,16,4,303,32,71,32,71,0,0,19,32,26,27,53,3,13,22,15,35,83
635,Acie Law,23,ATL,NBA,2007-08,56,6,865,95,237,88,203,7,34,38,48,12,45,57,113,29,0,56,73,235
636,Ian Mahinmi,21,SAS,NBA,2007-08,6,0,23,6,12,6,12,0,0,9,9,0,5,5,1,0,4,2,4,21
637,Dominic McGuire,22,WAS,NBA,2007-08,70,1,695,39,103,38,97,1,6,14,32,53,86,139,40,20,26,40,76,93
638,Josh McRoberts,20,POR,NBA,2007-08,8,0,28,6,10,6,9,0,1,0,0,2,8,10,2,1,0,2,1,12
639,Jamario Moon,27,TOR,NBA,2007-08,78,75,2166,279,575,239,453,40,122,63,85,92,392,484,90,80,108,51,152,661
640,Juan Carlos Navarro,27,MEM,NBA,2007-08,82,30,2117,308,766,152,334,156,432,124,146,34,176,210,177,48,1,134,94,896
641,Demetris Nichols,23,TOT,NBA,2007-08,14,0,44,6,23,3,10,3,13,0,0,0,5,5,1,0,3,4,4,15
642,Joakim Noah,22,CHI,NBA,2007-08,74,31,1534,177,367,177,366,0,1,134,194,174,242,416,84,68,64,89,173,488
643,Oleksiy Pecherov,22,WAS,NBA,2007-08,35,0,320,44,125,27,65,17,60,20,31,21,45,66,7,6,5,17,30,125
644,Kosta Perovic,22,GSW,NBA,2007-08,7,0,38,3,10,3,10,0,0,4,6,6,7,13,1,0,2,1,6,10
645,Kasib Powell,26,MIA,NBA,2007-08,11,4,304,35,95,27,62,8,33,6,9,8,36,44,18,9,2,5,18,84
646,Gabe Pruitt,21,BOS,NBA,2007-08,15,0,95,14,39,11,27,3,12,1,2,1,7,8,13,5,0,5,10,32
647,Chris Richard,23,MIN,NBA,2007-08,52,3,556,41,87,41,87,0,0,16,27,52,83,135,18,10,12,24,83,98
648,Cheikh Samb,23,DET,NBA,2007-08,4,0,31,3,4,3,4,0,0,1,2,3,4,7,0,1,2,1,8,7
649,Luis Scola,27,HOU,NBA,2007-08,82,39,2024,345,670,345,667,0,3,157,235,174,351,525,106,60,19,105,235,847
650,Ramon Sessions,21,MIL,NBA,2007-08,17,7,450,51,117,48,110,3,7,32,41,8,50,58,127,17,3,36,26,137
651,Courtney Sims,24,IND,NBA,2007-08,3,0,11,0,1,0,1,0,0,0,0,1,1,2,1,0,0,0,2,0
652,Jason Smith,21,PHI,NBA,2007-08,76,1,1107,141,310,137,296,4,14,54,82,77,153,230,20,22,50,48,142,340
653,D.J. Strawberry,22,PHO,NBA,2007-08,33,0,270,29,92,23,67,6,25,9,19,9,19,28,30,12,6,11,36,73
654,Rodney Stuckey,21,DET,NBA,2007-08,57,2,1081,153,382,150,366,3,16,127,156,32,97,129,160,49,6,78,113,436
655,Al Thornton,24,LAC,NBA,2007-08,79,31,2158,374,871,331,741,43,130,214,288,98,260,358,98,46,43,128,195,1005
656,Alando Tucker,23,PHO,NBA,2007-08,6,0,48,8,22,7,18,1,4,5,6,4,4,8,0,0,1,0,2,22
657,Darius Washington,22,SAS,NBA,2007-08,18,0,146,21,48,17,36,4,12,7,13,4,16,20,15,5,0,14,16,53
658,Darryl Watkins,23,SAC,NBA,2007-08,9,0,71,5,15,5,15,0,0,2,5,5,7,12,0,2,2,7,8,12
659,C.J. Watson,23,GSW,NBA,2007-08,32,0,368,43,101,34,75,9,26,23,29,13,19,32,35,15,0,18,19,118
660,Mario West,23,ATL,NBA,2007-08,64,2,269,21,49,21,45,0,4,17,26,26,22,48,13,12,4,9,61,59
661,Marcus Williams,21,TOT,NBA,2007-08,11,0,36,5,20,5,20,0,0,0,0,4,8,12,3,1,1,0,3,10
662,Sean Williams,21,NJN,NBA,2007-08,73,29,1278,164,305,164,305,0,0,81,133,115,207,322,28,28,106,70,193,409
663,Brandan Wright,20,GSW,NBA,2007-08,38,6,376,62,112,62,112,0,0,27,40,38,61,99,9,6,22,13,36,151
664,Julian Wright,20,NOH,NBA,2007-08,57,1,640,90,169,80,145,10,24,33,52,33,84,117,40,29,12,34,43,223
665,Nick Young,22,WAS,NBA,2007-08,75,2,1158,210,478,170,378,40,100,101,124,23,92,115,63,35,7,94,130,561
666,Thaddeus Young,19,PHI,NBA,2007-08,74,22,1554,264,490,258,471,6,19,76,103,120,192,312,58,73,8,64,126,610
667,Alexis Ajinca,20,CHA,NBA,2008-09,31,4,182,25,69,25,67,0,2,20,28,9,21,30,3,7,6,12,34,70
668,Joe Alexander,22,MIL,NBA,2008-09,59,0,716,102,245,86,199,16,46,58,83,44,71,115,42,15,29,52,107,278
669,Ryan Anderson,20,NJN,NBA,2008-09,66,30,1312,160,407,91,218,69,189,98,116,104,207,311,52,44,20,63,157,487
670,Darrell Arthur,20,MEM,NBA,2008-09,76,64,1464,191,436,191,434,0,2,40,60,108,238,346,43,52,52,47,206,422
671,D.J. Augustin,21,CHA,NBA,2008-09,72,12,1908,267,621,159,375,108,246,208,233,17,116,133,250,42,2,119,140,850
672,Nicolas Batum,20,POR,NBA,2008-09,79,76,1454,161,361,99,193,62,168,42,52,84,136,220,74,50,40,50,139,426
673,Jerryd Bayless,20,POR,NBA,2008-09,53,0,655,69,189,62,162,7,27,83,103,8,49,57,78,16,2,56,81,228
674,Michael Beasley,20,MIA,NBA,2008-09,81,19,2009,452,957,419,876,33,81,186,241,110,329,439,83,41,37,121,184,1123
675,Bobby Brown,24,TOT,NBA,2008-09,68,2,931,141,360,96,230,45,130,34,43,14,38,52,117,21,3,63,95,361
676,Mario Chalmers,22,MIA,NBA,2008-09,82,82,2626,278,662,164,351,114,311,148,193,37,191,228,403,160,8,165,240,818
677,Joe Crawford,22,NYK,NBA,2008-09,2,0,23,3,10,2,6,1,4,2,2,1,3,4,1,1,0,0,2,9
678,Joey Dorsey,25,HOU,NBA,2008-09,3,0,6,1,2,1,2,0,0,0,0,0,1,1,1,0,0,0,0,2
679,Chris Douglas-Roberts,22,NJN,NBA,2008-09,44,3,585,81,176,78,164,3,12,51,62,14,36,50,52,12,7,31,34,216
680,Goran Dragic,22,PHO,NBA,2008-09,55,1,728,88,224,68,170,20,54,50,65,33,70,103,111,29,3,73,87,246
681,Rudy Fernandez,23,POR,NBA,2008-09,78,4,1993,268,630,109,232,159,398,120,143,47,160,207,159,69,12,86,111,815
682,Danilo Gallinari,20,NYK,NBA,2008-09,28,2,412,56,125,24,53,32,72,26,27,13,42,55,15,14,4,15,48,170
683,Marc Gasol,24,MEM,NBA,2008-09,82,75,2521,350,661,350,660,0,1,275,375,201,404,605,143,63,90,164,265,975
684,J.R. Giddens,23,BOS,NBA,2008-09,6,0,8,2,3,2,3,0,0,0,0,2,1,3,0,1,0,1,1,4
685,Eric Gordon,20,LAC,NBA,2008-09,78,65,2677,411,901,280,564,131,337,299,350,45,156,201,215,78,35,164,172,1252
686,Donte Greene,20,SAC,NBA,2008-09,55,4,725,77,236,51,136,26,100,29,34,19,67,86,30,16,14,37,68,209
687,Hamed Haddadi,23,MEM,NBA,2008-09,19,0,120,15,31,15,31,0,0,18,30,16,31,47,8,1,12,9,20,48
688,Malik Hairston,21,SAS,NBA,2008-09,15,0,155,24,49,24,48,0,1,2,7,11,17,28,13,6,7,12,19,50
689,Roy Hibbert,22,IND,NBA,2008-09,70,42,1009,198,420,198,420,0,0,98,147,115,128,243,49,20,76,55,215,494
690,J.J. Hickson,20,CLE,NBA,2008-09,62,0,705,100,194,100,194,0,0,45,67,52,113,165,9,14,30,45,81,245
691,George Hill,22,SAS,NBA,2008-09,77,7,1270,150,372,126,299,24,73,114,146,30,128,158,136,45,21,74,150,438
692,Steven Hill,23,OKC,NBA,2008-09,1,0,2,1,1,1,1,0,0,0,0,2,1,3,0,0,0,0,0,2
693,Othello Hunter,22,ATL,NBA,2008-09,16,0,92,11,20,11,20,0,0,0,5,9,15,24,1,2,5,2,11,22
694,Darnell Jackson,23,CLE,NBA,2008-09,51,2,430,37,86,37,84,0,2,24,35,32,55,87,8,10,4,14,77,98
695,Nathan Jawai,22,TOR,NBA,2008-09,6,0,19,1,4,1,4,0,0,0,0,1,1,2,0,0,0,2,3,2
696,Dontell Jefferson,25,CHA,NBA,2008-09,6,0,84,11,22,10,20,1,2,6,9,1,11,12,9,4,1,6,9,29
697,Trey Johnson,24,CLE,NBA,2008-09,4,0,14,0,5,0,5,0,0,4,4,0,1,1,0,0,0,1,4,4
698,DeAndre Jordan,20,LAC,NBA,2008-09,53,13,771,93,147,93,147,0,0,42,109,72,165,237,11,11,59,41,96,228
699,Kosta Koufos,19,UTA,NBA,2008-09,48,7,565,94,185,94,185,0,0,36,51,50,88,138,20,12,31,26,70,224
700,Rob Kurz,23,GSW,NBA,2008-09,40,5,442,51,131,36,93,15,38,40,50,33,48,81,20,14,19,16,78,157
701,Courtney Lee,23,ORL,NBA,2008-09,77,42,1939,243,540,161,337,82,203,78,94,18,160,178,91,76,14,69,157,646
702,Brook Lopez,20,NJN,NBA,2008-09,82,75,2501,448,844,448,842,0,2,172,217,225,440,665,86,44,151,147,257,1068
703,Robin Lopez,20,PHO,NBA,2008-09,60,7,614,71,137,71,136,0,1,47,68,52,66,118,8,11,41,28,97,189
704,Kevin Love,20,MIN,NBA,2008-09,81,37,2048,316,688,314,669,2,19,265,336,274,460,734,84,35,50,118,205,899
705,Cartier Martin,24,CHA,NBA,2008-09,33,1,266,28,77,18,44,10,33,20,25,7,26,33,13,8,4,9,33,86
706,O.J. Mayo,21,MEM,NBA,2008-09,82,82,3120,562,1283,417,905,145,378,247,281,56,252,308,262,91,13,226,204,1516
707,Luc Mbah a Moute,22,MIL,NBA,2008-09,82,52,2114,227,491,227,487,0,4,140,192,189,298,487,87,87,45,100,204,594
708,JaVale McGee,21,WAS,NBA,2008-09,75,14,1143,191,387,191,387,0,0,107,162,120,174,294,23,33,75,61,155,489
709,Anthony Morrow,23,GSW,NBA,2008-09,67,17,1515,255,534,169,350,86,184,80,92,78,121,199,80,36,12,52,130,676
710,DeMarcus Nelson,23,GSW,NBA,2008-09,13,5,171,24,54,24,51,0,3,5,14,6,18,24,13,9,2,15,24,53
711,Greg Oden,21,POR,NBA,2008-09,61,39,1314,198,351,198,351,0,0,144,226,169,255,424,31,25,69,87,238,540
712,Anthony Randolph,19,GSW,NBA,2008-09,63,22,1129,199,431,199,427,0,4,101,141,128,235,363,49,42,74,80,141,499
713,Derrick Rose,20,CHI,NBA,2008-09,81,80,3000,574,1208,558,1136,16,72,197,250,96,221,317,512,66,18,202,125,1361
714,Brandon Rush,23,IND,NBA,2008-09,75,19,1803,243,575,165,366,78,209,46,66,34,199,233,66,38,37,75,128,610
715,Walter Sharpe,22,DET,NBA,2008-09,8,0,20,4,11,4,9,0,2,0,2,0,3,3,0,0,2,0,3,8
716,Sean Singletary,23,TOT,NBA,2008-09,37,2,303,31,85,21,60,10,25,18,21,10,25,35,29,11,0,23,45,90
717,Marreese Speights,21,PHI,NBA,2008-09,79,2,1263,252,502,250,494,2,8,102,132,123,170,293,30,27,56,46,181,608
718,Mike Taylor,23,LAC,NBA,2008-09,51,5,771,110,267,97,227,13,40,56,81,22,65,87,106,36,0,73,84,289
719,Jason Thompson,22,SAC,NBA,2008-09,82,56,2303,356,717,356,709,0,8,198,286,234,372,606,93,46,59,146,314,910
720,Anthony Tolliver,23,SAS,NBA,2008-09,19,0,208,19,65,10,24,9,41,5,10,12,29,41,17,5,1,7,16,52
721,Roko Ukic,24,TOR,NBA,2008-09,72,0,890,123,324,112,262,11,62,44,60,27,48,75,153,30,2,60,77,301
722,Henry Walker,21,BOS,NBA,2008-09,29,0,216,36,58,36,57,0,1,16,23,8,21,29,13,6,2,18,51,88
723,Kyle Weaver,22,OKC,NBA,2008-09,56,19,1166,113,246,81,153,32,93,41,58,31,99,130,101,47,25,69,81,299
724,Sonny Weems,22,DEN,NBA,2008-09,12,0,55,8,25,8,22,0,3,3,8,0,4,4,3,1,0,6,8,19
725,Russell Westbrook,20,OKC,NBA,2008-09,82,65,2668,436,1095,401,966,35,129,349,428,178,221,399,435,110,16,274,191,1256
726,D.J. White,22,OKC,NBA,2008-09,7,0,130,26,50,26,50,0,0,10,13,10,22,32,6,3,5,3,10,62
727,Jawad Williams,25,CLE,NBA,2008-09,10,0,20,5,12,3,6,2,6,0,0,1,1,2,0,1,0,1,2,12
728,Sun Yue,23,LAL,NBA,2008-09,10,0,28,3,11,3,5,0,6,0,0,0,0,0,2,1,1,3,10,6
729,David Andersen,29,HOU,NBA,2009-10,63,0,891,147,340,120,262,27,78,46,67,54,154,208,44,15,12,37,119,367
730,Antonio Anderson,24,OKC,NBA,2009-10,1,0,15,1,3,1,3,0,0,0,0,1,0,1,0,0,0,1,1,2
731,Jeff Ayres,22,POR,NBA,2009-10,39,4,405,43,65,43,65,0,0,18,20,25,73,98,1,7,16,12,76,104
732,Rodrigue Beaubois,21,DAL,NBA,2009-10,56,16,700,155,299,110,189,45,110,42,52,12,66,78,74,29,12,54,84,397
733,DeJuan Blair,20,SAS,NBA,2009-10,82,23,1494,275,495,275,493,0,2,88,161,200,326,526,65,50,39,112,224,638
734,Jon Brockman,22,SAC,NBA,2009-10,52,4,654,55,103,55,103,0,0,37,62,105,108,213,22,15,5,23,115,147
735,Derrick Brown,22,CHA,NBA,2009-10,57,0,535,68,147,66,140,2,7,48,72,31,47,78,19,21,10,19,53,186
736,Chase Budinger,21,HOU,NBA,2009-10,74,4,1488,249,565,157,316,92,249,67,87,38,182,220,88,34,11,48,85,657
737,DeMarre Carroll,23,MEM,NBA,2009-10,71,1,795,88,222,88,216,0,6,33,53,53,97,150,33,28,9,24,107,209
738,Omri Casspi,21,SAC,NBA,2009-10,77,31,1931,300,672,225,469,75,203,117,174,75,274,349,95,54,17,98,125,792
739,Earl Clark,22,PHO,NBA,2009-10,51,0,383,56,151,54,146,2,5,26,36,18,44,62,21,7,13,23,25,140
740,Darren Collison,22,NOH,NBA,2009-10,76,37,2109,376,789,330,674,46,115,148,174,41,151,192,432,78,4,202,92,946
741,Dante Cunningham,22,POR,NBA,2009-10,63,2,707,106,214,106,212,0,2,31,48,54,106,160,14,24,22,15,97,243
742,JamesOn Curry,24,LAC,NBA,2009-10,1,0,0,0,0,0,0,0,0,0,0,0,0,0,0,0,0,0,0,0
743,Stephen Curry,21,GSW,NBA,2009-10,80,77,2896,528,1143,362,763,166,380,177,200,48,308,356,472,152,19,243,252,1399
744,Austin Daye,21,DET,NBA,2009-10,69,4,915,137,295,108,200,29,95,46,56,34,140,174,34,25,26,48,114,349
745,DeMar DeRozan,20,TOR,NBA,2009-10,77,65,1664,255,512,251,496,4,16,148,194,66,157,223,53,43,18,62,176,662
746,Toney Douglas,23,NYK,NBA,2009-10,56,12,1087,179,391,111,216,68,175,55,68,40,68,108,112,42,3,55,116,481
747,Wayne Ellington,22,MIN,NBA,2009-10,76,1,1384,190,448,126,286,64,162,61,70,33,126,159,74,20,5,74,72,505
748,Tyreke Evans,20,SAC,NBA,2009-10,72,72,2677,533,1165,497,1024,36,141,348,465,66,314,380,414,109,26,216,204,1450
749,Jonny Flynn,20,MIN,NBA,2009-10,81,81,2339,397,952,320,737,77,215,223,270,24,167,191,356,82,2,233,98,1094
750,Sundiata Gaines,23,UTA,NBA,2009-10,32,0,217,38,82,31,56,7,26,23,46,6,23,29,39,12,0,14,17,106
751,Alonzo Gee,22,WAS,NBA,2009-10,11,2,182,28,59,21,50,7,9,18,29,15,18,33,7,7,1,10,13,81
752,Taj Gibson,24,CHI,NBA,2009-10,82,70,2204,311,629,311,629,0,0,113,175,226,385,611,70,50,104,114,282,735
753,Trey Gilder,25,MEM,NBA,2009-10,2,0,5,1,1,1,1,0,0,0,0,0,1,1,0,1,0,0,0,2
754,Danny Green,22,CLE,NBA,2009-10,20,0,115,15,39,9,17,6,22,4,6,8,9,17,5,6,3,5,9,40
755,Taylor Griffin,23,PHO,NBA,2009-10,8,0,32,4,10,4,8,0,2,2,4,0,2,2,1,0,2,1,4,10
756,Tyler Hansbrough,24,IND,NBA,2009-10,29,1,511,81,225,81,221,0,4,84,113,60,78,138,28,17,8,21,70,246
757,James Harden,20,OKC,NBA,2009-10,76,0,1738,233,578,140,330,93,248,194,240,47,197,244,137,80,20,106,200,753
758,Gerald Henderson,22,CHA,NBA,2009-10,43,0,355,37,104,33,85,4,19,35,47,15,40,55,13,10,9,14,25,113
759,Jordan Hill,22,TOT,NBA,2009-10,47,0,624,99,201,99,199,0,2,46,68,76,99,175,20,14,21,30,92,244
760,Jrue Holiday,19,PHI,NBA,2009-10,73,51,1767,230,520,168,361,62,159,65,86,56,135,191,280,79,18,156,153,587
761,Lester Hudson,25,TOT,NBA,2009-10,25,0,131,21,53,16,37,5,16,11,13,7,11,18,13,8,3,14,12,58
762,Chris Hunter,25,GSW,NBA,2009-10,60,9,783,109,217,109,213,0,4,52,69,56,111,167,37,13,35,30,132,270
763,Serge Ibaka,20,OKC,NBA,2009-10,73,0,1323,201,370,200,368,1,2,58,92,138,259,397,10,25,97,68,194,461
764,Cedric Jackson,23,TOT,NBA,2009-10,12,0,74,6,20,5,14,1,6,7,12,2,6,8,14,3,2,11,7,20
765,Othyus Jeffers,24,UTA,NBA,2009-10,14,0,73,12,29,12,29,0,0,13,19,8,11,19,1,4,0,6,10,37
766,Brandon Jennings,20,MIL,NBA,2009-10,82,82,2671,451,1216,306,828,145,388,223,273,49,233,282,470,105,18,200,191,1270
767,Jonas Jerebko,22,DET,NBA,2009-10,80,73,2232,290,603,254,488,36,115,125,176,194,284,478,58,79,29,82,230,741
768,James Johnson,22,CHI,NBA,2009-10,65,11,757,95,210,80,164,15,46,51,70,34,94,128,48,21,43,62,126,256
769,Oliver Lafayette,25,BOS,NBA,2009-10,1,0,22,3,6,2,4,1,2,0,0,1,3,4,2,0,0,1,0,7
770,Marcus Landry,24,TOT,NBA,2009-10,18,0,111,16,43,7,15,9,28,3,5,5,14,19,0,1,2,6,14,44
771,Ty Lawson,22,DEN,NBA,2009-10,65,8,1318,201,390,167,307,34,83,106,140,42,82,124,203,48,2,82,89,542
772,Wesley Matthews,23,UTA,NBA,2009-10,82,48,2025,273,565,210,400,63,165,160,193,50,141,191,124,64,15,93,152,769
773,Eric Maynor,22,TOT,NBA,2009-10,81,2,1269,154,368,132,297,22,71,52,72,21,108,129,266,40,10,85,115,382
774,Jodie Meeks,22,TOT,NBA,2009-10,60,0,719,104,268,62,136,42,132,31,39,9,90,99,39,18,5,25,52,281
775,Patty Mills,21,POR,NBA,2009-10,10,0,38,10,24,8,20,2,4,4,7,1,1,2,5,0,0,4,6,26
776,Byron Mullens,20,OKC,NBA,2009-10,13,0,54,7,19,7,19,0,0,0,0,3,7,10,1,2,0,4,13,14
777,A.J. Price,23,IND,NBA,2009-10,56,2,865,145,354,85,180,60,174,60,75,12,76,88,106,35,3,59,53,410
778,DaJuan Summers,22,DET,NBA,2009-10,44,0,405,46,130,31,88,15,42,27,38,14,31,45,16,8,7,16,52,134
779,Jermaine Taylor,23,HOU,NBA,2009-10,31,4,303,45,119,40,97,5,22,33,46,21,25,46,16,10,3,19,15,128
780,Jeff Teague,21,ATL,NBA,2009-10,71,3,719,90,227,83,195,7,32,41,49,5,62,67,122,34,11,50,82,228
781,Garrett Temple,23,TOT,NBA,2009-10,27,4,334,44,101,31,64,13,37,35,50,6,25,31,21,13,6,27,42,136
782,Hasheem Thabeet,22,MEM,NBA,2009-10,68,13,883,77,131,77,131,0,0,54,93,85,158,243,11,15,89,43,162,208
783,Marcus Thornton,22,NOH,NBA,2009-10,73,17,1872,398,883,281,570,117,313,144,177,72,139,211,114,58,11,76,127,1057
784,Reggie Williams,23,GSW,NBA,2009-10,24,10,782,140,283,107,191,33,92,52,62,18,92,110,66,23,6,29,49,365
785,Terrence Williams,22,NJN,NBA,2009-10,78,9,1764,261,651,230,551,31,100,103,144,46,302,348,223,43,10,124,126,656
786,Sam Young,24,MEM,NBA,2009-10,80,1,1321,224,497,213,441,11,56,136,175,77,124,201,52,34,20,94,106,595
787,Jeff Adrien,24,GSW,NBA,2010-11,23,0,196,23,54,23,54,0,0,11,19,23,35,58,10,4,5,9,28,57
788,Solomon Alabi,22,TOR,NBA,2010-11,12,0,59,3,15,3,15,0,0,0,2,7,7,14,2,2,2,3,5,6
789,Cole Aldrich,22,OKC,NBA,2010-11,18,0,142,8,15,8,15,0,0,2,4,13,22,35,4,5,7,8,30,18
790,Al-Farouq Aminu,20,LAC,NBA,2010-11,81,14,1452,160,406,115,263,45,143,92,119,75,192,267,60,59,25,103,121,457
791,James Anderson,21,SAS,NBA,2010-11,26,2,286,31,81,13,35,18,46,14,18,2,21,23,18,3,6,13,24,94
792,Omer Asik,24,CHI,NBA,2010-11,82,0,989,78,141,78,141,0,0,73,145,112,194,306,32,20,56,64,153,229
793,Luke Babbitt,21,POR,NBA,2010-11,24,0,137,15,55,12,39,3,16,3,9,6,24,30,6,2,2,8,15,36
794,Eric Bledsoe,21,LAC,NBA,2010-11,81,25,1841,206,486,174,370,32,116,99,133,68,155,223,289,92,26,194,130,543
795,Trevor Booker,23,WAS,NBA,2010-11,65,14,1063,139,253,139,252,0,1,68,101,98,153,251,35,29,42,38,115,346
796,Craig Brackins,23,PHI,NBA,2010-11,3,0,33,4,16,4,11,0,5,0,0,2,2,4,1,1,0,0,3,8
797,Avery Bradley,20,BOS,NBA,2010-11,31,0,162,23,67,23,62,0,5,6,12,4,13,17,12,9,0,16,20,52
798,Derrick Caracter,22,LAL,NBA,2010-11,41,0,215,32,66,32,66,0,0,17,23,19,24,43,7,4,10,19,47,81
799,Sherron Collins,23,CHA,NBA,2010-11,20,0,66,7,25,5,15,2,10,1,1,0,5,5,8,2,0,4,2,17
800,Marcus Cousin,24,UTA,NBA,2010-11,4,0,18,2,3,2,3,0,0,0,0,0,3,3,0,0,1,1,1,4
801,DeMarcus Cousins,20,SAC,NBA,2010-11,81,62,2309,432,1004,429,986,3,18,276,402,217,482,699,204,85,68,268,332,1143
802,Jordan Crawford,22,TOT,NBA,2010-11,42,18,1027,192,500,159,372,33,128,73,84,31,74,105,117,39,3,83,63,490
803,Ed Davis,21,TOR,NBA,2010-11,65,17,1602,215,373,215,373,0,0,71,128,168,294,462,40,39,67,48,183,501
804,Zabian Dowdell,26,PHO,NBA,2010-11,24,0,292,51,125,48,115,3,10,16,17,5,15,20,51,20,2,29,30,121
805,Devin Ebanks,21,LAL,NBA,2010-11,20,0,118,21,51,19,46,2,5,18,23,15,12,27,2,4,5,6,7,62
806,Semih Erden,24,TOT,NBA,2010-11,41,8,595,62,111,62,111,0,0,39,60,37,81,118,20,15,24,34,104,163
807,Jeremy Evans,23,UTA,NBA,2010-11,49,3,463,76,115,76,114,0,1,26,37,36,61,97,24,17,17,19,50,178
808,Patrick Ewing,26,NOH,NBA,2010-11,7,0,19,0,5,0,3,0,2,3,4,1,1,2,2,0,1,1,1,3
809,Christian Eyenga,21,CLE,NBA,2010-11,44,18,947,130,306,105,215,25,91,18,28,27,96,123,35,34,28,47,78,303
810,Derrick Favors,19,TOT,NBA,2010-11,78,27,1535,215,416,215,416,0,0,103,173,171,241,412,39,29,68,77,246,533
811,Landry Fields,22,NYK,NBA,2010-11,82,81,2541,299,602,213,383,86,219,113,147,105,416,521,155,80,17,107,114,797
812,Gary Forbes,25,DEN,NBA,2010-11,63,11,791,124,273,105,215,19,58,59,87,28,88,116,49,23,6,46,77,326
813,Paul George,20,IND,NBA,2010-11,61,19,1265,179,395,138,257,41,138,77,101,37,187,224,65,62,26,70,127,476
814,Blake Griffin,21,LAC,NBA,2010-11,82,82,3112,696,1376,689,1352,7,24,446,695,270,719,989,312,63,45,223,252,1845
815,Luke Harangody,23,TOT,NBA,2010-11,49,0,640,79,206,63,140,16,66,19,26,40,103,143,30,15,17,16,80,193
816,Manny Harris,21,CLE,NBA,2010-11,54,15,933,108,289,74,197,34,92,71,93,36,104,140,85,31,7,63,65,321
817,Gordon Hayward,20,UTA,NBA,2010-11,72,17,1218,142,293,107,219,35,74,69,97,41,98,139,81,30,19,70,106,388
818,Lazar Hayward,24,MIN,NBA,2010-11,42,0,419,55,154,38,94,17,60,33,42,23,47,70,28,12,7,19,44,160
819,Xavier Henry,19,MEM,NBA,2010-11,38,16,527,65,160,63,143,2,17,33,52,9,28,37,18,11,3,13,48,165
820,Damion James,23,NJN,NBA,2010-11,25,9,403,46,103,46,100,0,3,18,28,17,68,85,20,16,12,25,36,110
821,Eugene Jeter,27,SAC,NBA,2010-11,62,1,858,106,259,100,229,6,30,37,41,9,61,70,162,29,2,51,54,255
822,Armon Johnson,21,POR,NBA,2010-11,38,0,277,46,101,41,89,5,12,13,22,11,25,36,45,5,1,38,31,110
823,Chris Johnson,25,TOT,NBA,2010-11,14,1,138,9,21,9,21,0,0,15,20,12,20,32,3,3,9,10,21,33
824,Wesley Johnson,23,MIN,NBA,2010-11,79,63,2069,271,682,168,393,103,289,64,92,51,189,240,148,58,54,95,163,709
825,Dominique Jones,22,DAL,NBA,2010-11,18,0,135,14,45,14,41,0,4,14,17,6,19,25,19,5,3,10,7,42
826,Gani Lawal,22,PHO,NBA,2010-11,1,0,2,0,0,0,0,0,0,0,0,0,0,0,0,0,0,0,1,0
827,Jeremy Lin,22,GSW,NBA,2010-11,29,0,285,28,72,27,67,1,5,19,25,12,22,34,42,33,9,18,31,76
828,Greg Monroe,20,DET,NBA,2010-11,80,48,2222,303,550,303,549,0,1,145,233,248,353,601,105,93,45,81,196,751
829,Timofey Mozgov,24,TOT,NBA,2010-11,45,14,524,63,133,63,133,0,0,37,52,46,75,121,15,15,25,35,84,163
830,Hamady N'Diaye,24,WAS,NBA,2010-11,16,0,80,4,5,4,5,0,0,6,12,2,5,7,0,2,5,3,18,14
831,Gary Neal,26,SAS,NBA,2010-11,80,1,1685,285,632,156,324,129,308,84,104,21,175,196,96,27,4,78,148,783
832,Larry Owens,28,TOT,NBA,2010-11,12,0,143,15,32,9,19,6,13,4,9,1,14,15,8,9,5,5,18,40
833,Patrick Patterson,21,HOU,NBA,2010-11,52,6,868,149,267,149,265,0,2,30,42,86,114,200,41,17,37,31,77,328
834,Nikola Pekovic,25,MIN,NBA,2010-11,65,11,887,136,263,136,263,0,0,87,114,90,103,193,27,18,35,91,181,359
835,Dexter Pittman,22,MIA,NBA,2010-11,2,0,11,1,3,1,3,0,0,0,0,1,2,3,0,0,0,2,2,2
836,Quincy Pondexter,22,NOH,NBA,2010-11,66,6,734,73,180,55,130,18,50,24,34,23,65,88,28,17,10,16,63,188
837,Andy Rautins,24,NYK,NBA,2010-11,5,0,24,3,7,2,3,1,4,1,2,0,1,1,3,1,0,7,0,8
838,Samardo Samuels,22,CLE,NBA,2010-11,37,10,701,110,241,110,238,0,3,68,110,75,83,158,17,15,18,53,88,288
839,Larry Sanders,22,MIL,NBA,2010-11,60,12,872,116,268,116,268,0,0,28,50,59,119,178,16,22,72,38,117,260
840,Kevin Seraphin,21,WAS,NBA,2010-11,58,1,635,66,147,66,147,0,0,22,31,80,72,152,10,17,28,42,126,154
841,Mustafa Shakur,26,WAS,NBA,2010-11,22,0,159,21,59,20,49,1,10,8,15,7,15,22,25,5,3,18,15,51
842,Garret Siler,24,PHO,NBA,2010-11,21,0,101,17,31,17,31,0,0,11,22,16,12,28,3,1,4,10,20,45
843,Ish Smith,22,TOT,NBA,2010-11,43,3,442,43,115,40,105,3,10,12,21,7,40,47,79,18,2,34,37,101
844,Tiago Splitter,26,SAS,NBA,2010-11,60,6,738,101,191,101,190,0,1,76,140,72,129,201,26,29,17,32,91,278
845,Lance Stephenson,20,IND,NBA,2010-11,12,0,115,13,39,13,34,0,5,11,14,1,17,18,21,4,0,16,14,37
846,Pape Sy,22,ATL,NBA,2010-11,3,0,21,2,6,2,5,0,1,3,3,2,1,3,2,1,0,3,1,7
847,Evan Turner,22,PHI,NBA,2010-11,78,14,1797,225,529,211,485,14,44,101,125,42,264,306,159,49,14,80,138,565
848,Ekpe Udoh,23,GSW,NBA,2010-11,58,18,1030,97,222,97,222,0,0,42,64,80,101,181,40,22,86,48,144,236
849,Ben Uzoh,22,NJN,NBA,2010-11,42,0,438,61,144,58,136,3,8,33,56,30,31,61,69,13,8,25,29,158
850,Greivis Vasquez,24,MEM,NBA,2010-11,70,1,860,95,233,70,147,25,86,34,44,12,61,73,151,22,4,70,83,249
851,John Wall,20,WAS,NBA,2010-11,69,64,2606,398,972,364,857,34,115,301,393,35,282,317,574,121,35,261,175,1131
852,Willie Warren,21,LAC,NBA,2010-11,19,0,134,13,35,8,20,5,15,6,8,1,11,12,27,6,0,8,16,37
853,Hassan Whiteside,21,SAC,NBA,2010-11,1,0,2,0,0,0,0,0,0,0,0,0,0,0,0,0,0,0,2,0
854,Lavoy Allen,22,PHI,NBA,2011-12,41,15,624,79,167,79,167,0,0,11,14,47,124,171,34,13,18,20,73,169
855,Gustavo Ayon,26,NOH,NBA,2011-12,54,24,1088,140,261,140,260,0,1,39,63,86,179,265,74,53,46,46,118,319
856,Keith Benson,23,GSW,NBA,2011-12,3,0,9,0,1,0,1,0,0,0,0,2,1,3,0,0,0,0,0,0
857,Bismack Biyombo,19,CHA,NBA,2011-12,63,41,1455,129,278,129,278,0,0,69,143,113,255,368,27,20,115,71,145,327
858,MarShon Brooks,23,NJN,NBA,2011-12,56,47,1648,274,640,227,490,47,150,113,148,70,130,200,131,52,15,118,116,708
859,Alec Burks,20,UTA,NBA,2011-12,59,0,939,153,357,138,312,15,45,104,143,57,75,132,55,27,5,51,84,425
860,Jimmy Butler,22,CHI,NBA,2011-12,42,0,359,32,79,30,68,2,11,43,56,23,33,56,14,11,5,14,20,109
861,Derrick Byars,27,SAS,NBA,2011-12,2,0,37,3,11,3,5,0,6,4,4,6,5,11,1,2,0,0,2,10
862,Norris Cole,23,MIA,NBA,2011-12,65,2,1260,177,450,156,374,21,76,66,85,21,70,91,133,44,2,105,124,441
863,Eric Dawson,27,SAS,NBA,2011-12,4,0,39,7,12,7,12,0,0,1,2,5,5,10,0,1,2,3,6,15
864,Justin Dentmon,26,TOT,NBA,2011-12,6,0,91,10,28,8,14,2,14,4,6,0,8,8,10,2,0,7,10,26
865,Jerome Dyson,24,NOH,NBA,2011-12,9,1,180,19,48,18,40,1,8,28,36,2,17,19,18,11,2,20,19,67
866,Kenneth Faried,22,DEN,NBA,2011-12,46,39,1037,181,309,181,309,0,0,109,164,142,210,352,36,34,47,54,116,471
867,Jeff Foote,24,NOH,NBA,2011-12,4,0,39,2,6,2,6,0,0,0,0,1,5,6,0,0,1,2,5,4
868,Courtney Fortson,23,TOT,NBA,2011-12,10,0,95,11,32,8,19,3,13,10,15,6,9,15,10,3,0,10,5,35
869,Jimmer Fredette,22,SAC,NBA,2011-12,61,7,1135,172,446,94,230,78,216,40,48,17,56,73,108,30,3,67,73,462
870,Mickell Gladness,25,TOT,NBA,2011-12,26,7,252,25,59,25,59,0,0,6,12,14,44,58,5,4,20,7,32,56
871,Andrew Goudelock,23,LAL,NBA,2011-12,40,0,419,68,174,40,99,28,75,11,12,5,26,31,20,4,0,21,32,175
872,Jordan Hamilton,21,DEN,NBA,2011-12,26,2,258,48,111,31,64,17,47,2,5,11,51,62,20,4,3,16,15,115
873,Justin Harper,22,ORL,NBA,2011-12,14,0,84,9,31,7,18,2,13,0,1,3,9,12,2,2,3,6,5,20
874,Josh Harrellson,22,NYK,NBA,2011-12,37,4,540,63,149,43,90,20,59,16,26,47,97,144,11,23,20,20,48,162
875,Terrel Harris,24,MIA,NBA,2011-12,22,1,318,29,83,21,44,8,39,14,21,18,33,51,26,9,2,25,34,80
876,Tobias Harris,19,MIL,NBA,2011-12,42,9,479,79,169,73,146,6,23,44,54,30,71,101,22,13,7,31,45,208
877,Cory Higgins,22,CHA,NBA,2011-12,38,0,423,52,160,48,140,4,20,42,60,7,28,35,36,5,6,39,40,150
878,Darington Hobson,24,MIL,NBA,2011-12,5,0,39,2,13,2,7,0,6,0,0,0,3,3,6,0,0,2,1,4
879,Tyler Honeycutt,21,SAC,NBA,2011-12,15,0,88,8,24,7,21,1,3,3,5,3,11,14,7,4,3,2,3,20
880,Dennis Horner,23,NJN,NBA,2011-12,8,0,22,1,4,1,3,0,1,3,4,2,3,5,0,0,0,1,1,5
881,Kyrie Irving,19,CLE,NBA,2011-12,51,51,1558,350,747,277,564,73,183,171,196,44,147,191,275,54,20,160,110,944
882,Reggie Jackson,21,OKC,NBA,2011-12,45,0,501,51,159,38,97,13,62,25,29,14,39,53,71,25,1,36,31,140
883,Charles Jenkins,22,GSW,NBA,2011-12,51,28,893,130,291,127,271,3,20,34,39,8,60,68,170,33,6,60,85,297
884,Carldell Johnson,29,NOH,NBA,2011-12,15,0,119,11,35,7,20,4,15,1,3,1,8,9,22,8,0,7,11,27
885,Ivan Johnson,27,ATL,NBA,2011-12,56,0,934,141,275,139,269,2,6,72,100,65,161,226,32,43,18,69,116,356
886,JaJuan Johnson,22,BOS,NBA,2011-12,36,0,298,54,121,54,121,0,0,6,9,20,38,58,6,5,14,14,25,114
887,Jerome Jordan,25,NYK,NBA,2011-12,21,0,108,17,33,17,33,0,0,8,10,14,13,27,4,1,6,2,15,42
888,Cory Joseph,20,SAS,NBA,2011-12,29,1,266,22,70,19,55,3,15,11,17,5,20,25,34,7,3,12,16,58
889,Enes Kanter,19,UTA,NBA,2011-12,66,0,874,117,236,117,235,0,1,70,105,107,171,278,8,18,23,54,87,304
890,D.J. Kennedy,22,CLE,NBA,2011-12,2,0,59,5,12,3,8,2,4,0,2,1,6,7,3,2,0,3,7,12
891,Brandon Knight,20,DET,NBA,2011-12,66,60,2129,319,769,214,493,105,276,104,137,33,178,211,251,49,10,171,154,847
892,Malcolm Lee,21,MIN,NBA,2011-12,19,0,243,23,59,21,49,2,10,14,17,9,17,26,31,8,4,17,22,62
893,Kawhi Leonard,20,SAS,NBA,2011-12,64,39,1534,199,404,158,295,41,109,68,88,104,223,327,70,85,24,44,88,507
894,Travis Leslie,21,LAC,NBA,2011-12,10,0,45,5,14,5,14,0,0,4,9,6,3,9,5,2,2,2,4,14
895,Jon Leuer,22,MIL,NBA,2011-12,46,12,555,97,191,94,182,3,9,21,28,45,75,120,25,14,17,18,67,218
896,DeAndre Liggins,23,ORL,NBA,2011-12,17,0,115,12,25,12,21,0,4,9,19,6,9,15,5,6,0,10,6,33
897,Shelvin Mack,21,WAS,NBA,2011-12,64,0,779,88,220,76,178,12,42,42,59,12,80,92,131,28,2,48,50,230
898,Vernon Macklin,25,DET,NBA,2011-12,23,0,135,19,35,19,35,0,0,8,14,14,20,34,5,4,4,3,9,46
899,E'Twaun Moore,22,BOS,NBA,2011-12,38,0,331,43,113,26,68,17,45,7,7,4,29,33,34,11,3,21,33,110
900,Darius Morris,21,LAL,NBA,2011-12,19,0,169,18,42,14,33,4,9,6,9,2,14,16,21,2,0,19,16,46
901,Marcus Morris,22,HOU,NBA,2011-12,17,0,126,16,54,14,37,2,17,6,8,5,11,16,3,2,2,4,12,40
902,Markieff Morris,22,PHO,NBA,2011-12,63,7,1227,174,436,131,312,43,124,76,106,69,210,279,65,41,42,70,179,467
903,Daniel Orton,21,ORL,NBA,2011-12,16,2,187,17,30,17,29,0,1,11,25,19,20,39,5,8,9,7,30,45
904,Jeremy Pargo,25,MEM,NBA,2011-12,44,5,424,50,150,40,112,10,38,16,27,12,25,37,55,15,0,46,46,126
905,Chandler Parsons,23,HOU,NBA,2011-12,63,57,1804,248,549,188,371,60,178,43,78,90,210,300,134,73,29,81,142,599
906,Ryan Reid,25,OKC,NBA,2011-12,5,0,17,4,5,4,5,0,0,0,0,1,1,2,0,0,0,1,1,8
907,Ricky Rubio,21,MIN,NBA,2011-12,41,31,1404,139,389,107,295,32,94,126,157,21,150,171,336,91,8,131,97,436
908,Walker Russell,29,DET,NBA,2011-12,28,0,357,33,95,29,82,4,13,14,22,7,19,26,58,18,1,33,29,84
909,Josh Selby,20,MEM,NBA,2011-12,28,0,237,25,72,23,57,2,15,11,14,2,13,15,30,7,0,29,17,63
910,Iman Shumpert,21,NYK,NBA,2011-12,59,35,1705,214,534,166,377,48,157,87,109,42,144,186,164,101,8,111,173,563
911,Xavier Silas,24,PHI,NBA,2011-12,2,0,39,4,15,3,9,1,6,2,3,2,2,4,3,0,0,3,5,11
912,Chris Singleton,22,WAS,NBA,2011-12,66,51,1431,116,312,72,185,44,127,30,44,43,190,233,49,70,30,38,176,306
913,Donald Sloan,24,TOT,NBA,2011-12,33,11,669,79,198,77,173,2,25,23,30,18,49,67,105,13,3,49,37,183
914,Greg Smith,21,HOU,NBA,2011-12,8,0,69,7,11,7,11,0,0,0,0,5,15,20,1,2,5,1,17,14
915,Jerry Smith,24,NJN,NBA,2011-12,5,0,46,3,14,2,8,1,6,0,0,2,5,7,4,5,0,0,5,7
916,Nolan Smith,23,POR,NBA,2011-12,44,4,541,67,180,54,135,13,45,20,28,17,39,56,62,18,3,42,55,167
917,Greg Stiemsma,26,BOS,NBA,2011-12,55,3,766,66,121,66,121,0,0,29,41,48,129,177,28,37,85,33,144,161
918,Julyan Stone,23,DEN,NBA,2011-12,22,2,179,13,31,11,20,2,11,8,11,5,20,25,37,8,6,11,18,36
919,Isaiah Thomas,22,SAC,NBA,2011-12,65,37,1656,256,571,173,352,83,219,154,185,48,120,168,266,53,8,105,121,749
920,Lance Thomas,23,NOH,NBA,2011-12,42,10,630,57,126,57,125,0,1,52,62,49,77,126,12,10,7,24,78,166
921,Malcolm Thomas,23,SAS,NBA,2011-12,3,0,15,0,3,0,3,0,0,1,2,1,2,3,1,1,1,0,0,1
922,Trey Thompkins,21,LAC,NBA,2011-12,24,0,119,24,61,20,48,4,13,5,7,4,20,24,3,3,3,6,10,57
923,Klay Thompson,21,GSW,NBA,2011-12,66,29,1608,318,718,207,450,111,268,79,91,24,137,161,133,49,20,103,155,826
924,Mychel Thompson,23,CLE,NBA,2011-12,5,3,95,7,24,3,13,4,11,0,0,0,5,5,7,2,1,5,8,18
925,Tristan Thompson,20,CLE,NBA,2011-12,60,25,1424,194,442,194,440,0,2,106,192,187,202,389,27,27,62,81,134,494
926,Jeremy Tyler,20,GSW,NBA,2011-12,42,23,568,88,209,88,208,0,1,29,52,54,86,140,16,16,20,36,84,205
927,Edwin Ubiles,25,WAS,NBA,2011-12,4,0,52,5,18,4,13,1,5,3,3,2,8,10,1,1,1,1,1,14
928,Jan Vesely,21,WAS,NBA,2011-12,57,20,1078,117,218,117,217,0,1,33,62,101,148,249,47,39,32,60,156,267
929,Nikola Vucevic,21,PHI,NBA,2011-12,51,15,812,131,291,128,283,3,8,18,34,88,158,246,31,20,34,33,111,283
930,Kemba Walker,21,CHA,NBA,2011-12,66,25,1792,281,767,212,541,69,226,168,213,30,204,234,289,60,20,119,79,799
931,Derrick Williams,20,MIN,NBA,2011-12,66,15,1418,205,498,168,360,37,138,136,195,77,234,311,38,30,31,77,95,583
932,Elliot Williams,22,POR,NBA,2011-12,24,0,149,37,74,29,47,8,27,6,18,7,12,19,6,6,3,5,18,88
933,Jordan Williams,21,NJN,NBA,2011-12,43,5,635,77,152,77,152,0,0,43,66,66,90,156,11,21,15,23,61,197
934,Chris Wright,23,GSW,NBA,2011-12,24,1,186,23,45,23,45,0,0,24,31,19,26,45,4,7,13,8,22,70
935,Quincy Acy,22,TOR,NBA,2012-13,29,0,342,42,75,41,73,1,2,31,38,30,47,77,11,13,15,17,53,116
936,Josh Akognon,26,DAL,NBA,2012-13,3,0,9,2,4,1,2,1,2,0,0,0,1,1,1,0,0,0,3,5
937,Harrison Barnes,20,GSW,NBA,2012-13,81,81,2058,276,628,224,483,52,145,144,190,53,280,333,98,52,14,101,140,748
938,Will Barton,22,POR,NBA,2012-13,73,5,894,118,309,109,244,9,65,50,65,36,109,145,58,34,9,60,56,295
939,Aron Baynes,26,SAS,NBA,2012-13,16,0,141,18,36,18,35,0,1,7,12,12,20,32,5,1,6,11,23,43
940,Kent Bazemore,23,GSW,NBA,2012-13,61,0,267,43,116,33,82,10,34,27,44,5,17,22,22,17,4,18,27,123
941,Bradley Beal,19,WAS,NBA,2012-13,56,46,1745,282,687,191,451,91,236,125,159,43,168,211,137,50,29,90,113,780
942,Patrick Beverley,24,HOU,NBA,2012-13,41,0,713,79,189,43,93,36,96,34,41,45,64,109,117,37,21,44,83,228
943,Victor Claver,24,POR,NBA,2012-13,49,16,812,74,189,49,102,25,87,14,30,31,88,119,43,26,12,43,75,187
944,Chris Copeland,28,NYK,NBA,2012-13,56,13,862,182,380,123,240,59,140,63,83,34,85,119,27,16,12,50,104,486
945,Jae Crowder,22,DAL,NBA,2012-13,78,16,1353,141,367,78,175,63,192,47,73,35,152,187,94,63,17,49,128,392
946,Jared Cunningham,21,DAL,NBA,2012-13,8,0,26,6,14,4,11,2,3,2,2,1,2,3,1,1,0,2,3,16
947,Anthony Davis,19,NOH,NBA,2012-13,64,60,1846,349,676,349,670,0,6,169,225,165,357,522,63,75,112,89,158,867
948,Nando De Colo,25,SAS,NBA,2012-13,72,6,920,105,241,74,159,31,82,35,44,23,115,138,138,41,6,81,87,276
949,Andre Drummond,19,DET,NBA,2012-13,60,10,1243,208,342,207,340,1,2,59,159,169,288,457,30,59,95,57,144,476
950,Kim English,24,DET,NBA,2012-13,41,0,407,42,112,28,62,14,50,21,29,8,29,37,26,16,3,19,46,119
951,Festus Ezeli,23,GSW,NBA,2012-13,78,41,1120,74,169,74,169,0,0,43,81,141,172,313,22,23,74,63,157,191
952,Evan Fournier,20,DEN,NBA,2012-13,38,4,428,75,152,53,98,22,54,30,39,6,29,35,44,19,1,32,65,202
953,Joel Freeland,25,POR,NBA,2012-13,51,1,477,58,142,58,142,0,0,18,27,40,79,119,13,13,11,19,67,134
954,Diante Garrett,24,PHO,NBA,2012-13,19,0,149,16,49,13,34,3,15,5,10,5,10,15,31,10,0,16,5,40
955,Draymond Green,22,GSW,NBA,2012-13,79,1,1061,84,257,70,190,14,67,45,55,58,202,260,53,42,25,51,159,227
956,Ben Hansbrough,25,IND,NBA,2012-13,28,0,200,15,45,9,22,6,23,21,27,2,16,18,21,7,2,18,23,57
957,Maurice Harkless,19,ORL,NBA,2012-13,76,59,1974,260,564,228,447,32,117,73,128,122,213,335,50,88,62,69,144,625
958,John Henson,22,MIL,NBA,2012-13,63,9,827,162,336,162,333,0,3,56,105,116,181,297,31,19,42,47,83,380
959,Justin Holiday,23,PHI,NBA,2012-13,9,0,142,16,48,12,32,4,16,6,8,0,14,14,15,3,6,9,7,42
960,Bernard James,27,DAL,NBA,2012-13,46,11,457,53,103,53,101,0,2,25,41,52,79,131,6,12,38,18,64,131
961,John Jenkins,21,ATL,NBA,2012-13,61,2,902,131,294,78,156,53,138,59,70,17,77,94,56,12,10,40,37,374
962,Chris Johnson,22,MEM,NBA,2012-13,8,0,102,11,25,5,7,6,18,1,2,5,6,11,2,4,0,3,5,29
963,Orlando Johnson,23,IND,NBA,2012-13,51,0,619,72,180,36,86,36,94,23,32,20,90,110,47,11,9,29,51,203
964,Darius Johnson-Odom,23,LAL,NBA,2012-13,4,0,6,0,4,0,3,0,1,0,0,1,3,4,1,0,0,0,0,0
965,DeQuan Jones,22,ORL,NBA,2012-13,63,17,803,95,218,86,183,9,35,34,51,17,88,105,16,19,22,30,55,233
966,Kevin Jones,23,CLE,NBA,2012-13,32,0,334,43,107,43,107,0,0,9,15,38,40,78,10,9,5,8,25,95
967,Perry Jones,21,OKC,NBA,2012-13,38,1,280,39,99,39,97,0,2,10,15,12,50,62,10,5,6,15,23,88
968,Terrence Jones,21,HOU,NBA,2012-13,19,0,276,43,94,38,75,5,19,13,17,28,37,65,15,12,19,13,21,104
969,Kris Joseph,24,TOT,NBA,2012-13,10,0,54,2,14,2,11,0,3,5,8,1,6,7,1,3,0,2,3,9
970,Michael Kidd-Gilchrist,19,CHA,NBA,2012-13,78,77,2025,281,613,279,604,2,9,140,187,131,324,455,117,54,70,101,164,704
971,Viacheslav Kravtsov,25,DET,NBA,2012-13,25,0,224,33,46,33,46,0,0,11,37,24,21,45,9,5,9,14,32,77
972,Doron Lamb,21,TOT,NBA,2012-13,47,0,577,60,163,46,126,14,37,20,34,8,38,46,32,13,0,26,52,154
973,Jeremy Lamb,20,OKC,NBA,2012-13,23,0,147,24,68,15,38,9,30,14,14,5,13,18,5,2,2,6,13,71
974,Meyers Leonard,20,POR,NBA,2012-13,69,9,1206,151,277,148,270,3,7,72,89,80,175,255,33,11,38,49,168,377
975,Damian Lillard,22,POR,NBA,2012-13,82,82,3167,553,1288,368,785,185,503,271,321,42,215,257,531,74,19,243,172,1562
976,Scott Machado,22,HOU,NBA,2012-13,6,0,21,3,6,3,5,0,1,2,2,0,1,1,6,2,0,8,0,8
977,Kendall Marshall,21,PHO,NBA,2012-13,48,3,702,56,151,33,78,23,73,8,14,4,38,42,143,22,4,57,48,143
978,Fab Melo,22,BOS,NBA,2012-13,6,0,36,3,6,3,6,0,0,1,4,0,3,3,0,2,2,1,7,7
979,Khris Middleton,21,DET,NBA,2012-13,27,0,475,62,141,48,96,14,45,27,32,4,46,50,28,15,4,11,53,165
980,Darius Miller,22,NOH,NBA,2012-13,52,2,694,44,108,22,52,22,56,8,8,8,70,78,44,17,12,23,89,118
981,Quincy Miller,20,DEN,NBA,2012-13,7,0,26,4,12,4,11,0,1,1,2,1,1,2,3,1,0,1,3,9
982,Donatas Motiejunas,22,HOU,NBA,2012-13,44,14,538,97,213,73,130,24,83,32,51,36,57,93,31,7,10,37,73,250
983,Arnett Moultrie,22,PHI,NBA,2012-13,47,0,542,78,134,78,134,0,0,18,28,76,69,145,10,17,10,19,43,174
984,Kevin Murphy,22,UTA,NBA,2012-13,17,0,52,7,28,6,23,1,5,0,0,0,4,4,2,1,0,3,4,15
985,Andrew Nicholson,23,ORL,NBA,2012-13,75,28,1249,256,486,256,486,0,0,75,94,69,189,258,44,24,32,79,133,587
986,Kyle O'Quinn,22,ORL,NBA,2012-13,57,5,638,101,197,101,196,0,1,30,45,65,144,209,52,11,26,37,107,232
987,Tim Ohlbrecht,24,HOU,NBA,2012-13,3,0,12,1,3,1,3,0,0,1,1,0,1,1,1,1,0,4,1,3
988,Miles Plumlee,24,IND,NBA,2012-13,14,0,55,5,21,5,21,0,0,3,4,12,10,22,2,0,3,3,5,13
989,Pablo Prigioni,35,NYK,NBA,2012-13,78,18,1263,100,220,47,86,53,134,22,25,41,102,143,236,69,2,86,127,275
990,Austin Rivers,20,NOH,NBA,2012-13,61,26,1418,145,390,117,304,28,86,59,108,16,93,109,127,26,9,74,122,377
991,Brian Roberts,27,NOH,NBA,2012-13,78,5,1324,213,511,154,358,59,153,70,77,17,80,97,219,37,3,71,108,555
992,Thomas Robinson,21,TOT,NBA,2012-13,70,0,1056,138,321,138,320,0,1,57,109,122,193,315,46,41,26,88,124,333
993,Terrence Ross,21,TOR,NBA,2012-13,73,2,1239,186,457,121,261,65,196,30,42,35,109,144,53,43,14,48,122,467
994,Robert Sacre,23,LAL,NBA,2012-13,32,3,203,18,48,18,48,0,0,7,11,9,25,34,6,0,10,10,38,43
995,Mike Scott,24,ATL,NBA,2012-13,40,1,376,70,147,70,146,0,1,43,56,39,71,110,12,4,2,21,32,183
996,Tornike Shengelia,21,BRK,NBA,2012-13,19,0,93,10,23,9,21,1,2,9,16,9,14,23,3,3,1,11,11,30
997,Alexey Shved,24,MIN,NBA,2012-13,77,16,1840,236,635,151,347,85,288,108,150,41,134,175,286,54,27,147,117,665
998,Henry Sims,22,NOH,NBA,2012-13,2,0,5,2,3,2,3,0,0,0,0,2,0,2,0,0,0,1,1,4
999,Kyle Singler,24,DET,NBA,2012-13,82,74,2293,275,642,205,442,70,200,100,124,109,221,330,77,57,37,98,217,720
1000,Jared Sullinger,20,BOS,NBA,2012-13,45,5,892,111,225,110,220,1,5,47,63,92,172,264,35,22,22,29,154,270
1001,Jeffery Taylor,23,CHA,NBA,2012-13,77,29,1507,172,399,119,245,53,154,75,103,51,99,150,63,47,15,48,136,472
1002,Tyshawn Taylor,22,BRK,NBA,2012-13,38,0,221,32,87,26,74,6,13,15,27,2,16,18,21,13,0,25,25,85
1003,Marquis Teague,19,CHI,NBA,2012-13,48,0,392,43,113,39,90,4,23,9,16,3,41,44,63,9,7,35,47,99
1004,Mirza Teletovic,27,BRK,NBA,2012-13,53,0,499,71,185,34,77,37,108,9,11,33,62,95,23,13,8,20,53,188
1005,Jonas Valanciunas,20,TOR,NBA,2012-13,62,57,1482,204,366,204,366,0,0,146,185,121,251,372,45,17,78,94,188,554
1006,Jarvis Varnado,24,TOT,NBA,2012-13,13,0,58,3,7,3,7,0,0,2,4,2,7,9,3,1,2,6,10,8
1007,Dion Waiters,21,CLE,NBA,2012-13,61,48,1756,336,815,273,612,63,203,159,213,22,127,149,183,59,16,121,113,894
1008,Maalik Wayns,21,TOT,NBA,2012-13,27,1,202,26,88,19,57,7,31,17,19,1,6,7,27,6,0,15,26,76
1009,Chris Wright,23,DAL,NBA,2012-13,3,0,4,1,2,1,2,0,0,0,0,0,0,0,0,0,0,1,0,2
1010,Tony Wroten,19,MEM,NBA,2012-13,35,0,272,33,86,29,70,4,16,21,29,13,15,28,43,8,4,29,34,91
1011,Luke Zeller,25,PHO,NBA,2012-13,16,0,58,9,26,8,21,1,5,0,0,1,9,10,3,0,0,0,5,19
1012,Tyler Zeller,23,CLE,NBA,2012-13,77,55,2033,245,559,245,555,0,4,120,157,159,279,438,96,35,70,95,251,610
1013,Steven Adams,20,OKC,NBA,2013-14,81,20,1197,93,185,93,185,0,0,79,136,142,190,332,43,40,57,71,203,265
1014,Giannis Antetokounmpo,19,MIL,NBA,2013-14,77,23,1897,173,418,132,300,41,118,138,202,78,261,339,150,60,61,122,173,525
1015,Pero Antic,31,ATL,NBA,2013-14,50,26,925,123,294,67,123,56,171,50,66,57,152,209,58,19,12,55,126,352
1016,Chris Babb,23,BOS,NBA,2013-14,14,0,132,8,30,2,3,6,27,0,0,4,13,17,3,6,0,3,13,22
1017,Anthony Bennett,20,CLE,NBA,2013-14,52,0,663,80,225,67,172,13,53,44,69,49,106,155,17,21,8,47,93,217
1018,Vander Blue,21,BOS,NBA,2013-14,3,0,15,2,4,2,3,0,1,1,5,0,3,3,1,0,0,2,1,5
1019,Lorenzo Brown,23,PHI,NBA,2013-14,26,0,224,26,86,23,56,3,30,9,13,8,20,28,41,13,3,16,19,64
1020,Reggie Bullock,22,LAC,NBA,2013-14,43,0,395,43,121,21,48,22,73,7,9,11,43,54,12,9,1,13,26,115
1021,Trey Burke,21,UTA,NBA,2013-14,70,68,2262,341,897,230,561,111,336,102,113,37,171,208,396,42,6,131,145,895
1022,Dwight Buycks,24,TOR,NBA,2013-14,14,0,146,15,48,10,31,5,17,8,9,4,19,23,10,8,0,10,11,43
1023,Nick Calathes,24,MEM,NBA,2013-14,71,7,1173,142,311,123,250,19,61,44,72,23,114,137,207,66,8,101,117,347
1024,Kentavious Caldwell-Pope,20,DET,NBA,2013-14,80,41,1583,182,460,123,275,59,185,47,61,38,118,156,55,75,12,28,145,470
1025,Isaiah Canaan,22,HOU,NBA,2013-14,22,0,252,31,87,13,32,18,55,21,29,7,17,24,22,8,4,21,25,101
1026,Michael Carter-Williams,22,PHI,NBA,2013-14,70,70,2414,427,1054,372,846,55,208,258,367,101,336,437,441,130,43,247,213,1167
1027,Dionte Christmas,27,PHO,NBA,2013-14,31,0,198,22,62,13,31,9,31,18,24,13,25,38,8,2,3,6,19,71
1028,Ian Clark,22,UTA,NBA,2013-14,23,0,172,26,67,15,36,11,31,5,7,3,16,19,15,8,2,14,24,68
1029,Robert Covington,23,HOU,NBA,2013-14,7,0,34,6,14,2,3,4,11,0,0,2,3,5,0,2,0,1,3,16
1030,Allen Crabbe,21,POR,NBA,2013-14,15,0,100,12,33,6,19,6,14,3,4,1,8,9,6,2,1,3,10,33
1031,Seth Curry,23,TOT,NBA,2013-14,2,0,13,1,3,0,2,1,1,0,0,0,1,1,0,2,0,0,0,3
1032,Troy Daniels,22,HOU,NBA,2013-14,5,1,75,15,31,3,6,12,25,0,0,0,4,4,5,0,0,3,6,42
1033,Luigi Datome,26,DET,NBA,2013-14,34,0,238,34,97,27,58,7,39,8,10,14,32,46,11,6,1,11,20,83
1034,Brandon Davies,22,PHI,NBA,2013-14,51,0,575,54,128,52,118,2,10,34,53,38,71,109,28,24,8,35,92,144
1035,Dewayne Dedmon,24,TOT,NBA,2013-14,31,6,390,38,83,38,83,0,0,21,32,38,89,127,5,7,22,18,66,97
1036,Matthew Dellavedova,23,CLE,NBA,2013-14,72,4,1271,122,296,65,141,57,155,38,48,29,94,123,187,33,5,60,121,339
1037,Gorgui Dieng,24,MIN,NBA,2013-14,60,15,818,113,227,112,226,1,1,59,93,103,197,300,39,30,50,54,108,286
1038,Shane Edwards,26,CLE,NBA,2013-14,2,0,12,1,3,1,3,0,0,0,0,1,1,2,0,0,0,1,1,2
1039,Vitor Faverani,25,BOS,NBA,2013-14,37,8,488,64,147,52,107,12,40,24,37,42,86,128,16,14,27,41,74,164
1040,Carrick Felix,23,CLE,NBA,2013-14,7,0,38,7,14,5,9,2,5,3,4,1,5,6,4,0,0,4,4,19
1041,Jamaal Franklin,22,MEM,NBA,2013-14,21,0,161,16,39,11,28,5,11,2,2,4,19,23,6,4,2,11,23,39
1042,Rudy Gobert,21,UTA,NBA,2013-14,45,0,434,36,74,36,74,0,0,32,65,51,104,155,7,8,41,32,57,104
1043,Archie Goodwin,19,PHO,NBA,2013-14,52,0,533,76,167,71,131,5,36,37,55,25,62,87,20,20,11,44,45,194
1044,Jorge Gutierrez,25,BRK,NBA,2013-14,15,2,244,25,54,22,42,3,12,9,12,3,19,22,30,10,1,14,37,62
1045,Justin Hamilton,23,TOT,NBA,2013-14,8,0,72,9,20,6,11,3,9,5,5,4,3,7,0,5,0,4,8,26
1046,Tim Hardaway,21,NYK,NBA,2013-14,81,1,1875,294,687,164,329,130,358,106,128,19,102,121,66,44,7,47,144,824
1047,Elias Harris,24,LAL,NBA,2013-14,2,0,11,0,1,0,1,0,0,0,0,1,0,1,1,1,0,0,0,0
1048,Solomon Hill,22,IND,NBA,2013-14,28,0,226,17,40,10,17,7,23,6,7,9,32,41,12,5,2,13,19,47
1049,Scotty Hopson,24,CLE,NBA,2013-14,2,0,7,0,4,0,2,0,2,1,2,0,0,0,1,1,0,0,0,1
1050,Robbie Hummel,24,MIN,NBA,2013-14,53,5,655,67,177,35,88,32,89,15,16,35,97,132,23,16,2,10,57,181
1051,Sergey Karasev,20,CLE,NBA,2013-14,22,1,156,12,35,8,16,4,19,9,10,0,16,16,6,3,1,11,22,37
1052,Ryan Kelly,22,LAL,NBA,2013-14,59,25,1312,157,371,109,229,48,142,110,135,42,177,219,95,32,45,47,147,472
1053,Ognjen Kuzmic,23,GSW,NBA,2013-14,21,0,92,5,13,5,13,0,0,5,11,10,11,21,2,3,4,10,17,15
1054,Shane Larkin,21,DAL,NBA,2013-14,48,0,489,52,137,40,99,12,38,16,25,11,31,42,71,26,1,39,46,132
1055,Ricky Ledo,21,DAL,NBA,2013-14,11,0,33,6,17,3,9,3,8,4,4,0,2,2,2,1,0,2,2,19
1056,Alex Len,20,PHO,NBA,2013-14,42,3,362,33,78,33,78,0,0,20,31,39,60,99,4,4,18,26,68,86
1057,Ray McCallum,22,SAC,NBA,2013-14,45,10,897,113,300,91,241,22,59,32,43,18,61,79,120,22,9,39,69,280
1058,C.J. McCollum,22,POR,NBA,2013-14,38,0,476,74,178,44,98,30,80,23,34,7,41,48,27,14,2,35,53,201
1059,Ben McLemore,20,SAC,NBA,2013-14,82,55,2187,255,679,160,382,95,297,115,143,53,182,235,82,45,18,96,201,720
1060,Gal Mekel,25,DAL,NBA,2013-14,31,1,292,30,86,25,66,5,20,8,12,5,22,27,63,4,1,31,31,73
1061,Tony Mitchell,21,DET,NBA,2013-14,21,0,79,5,12,4,11,1,1,11,19,15,11,26,2,6,3,4,9,22
1062,Tony Mitchell,24,MIL,NBA,2013-14,3,0,10,3,5,3,4,0,1,0,0,1,0,1,1,1,0,0,0,6
1063,Shabazz Muhammad,21,MIN,NBA,2013-14,37,0,290,57,124,54,113,3,11,26,40,24,29,53,6,8,1,16,24,143
1064,Erik Murphy,23,CHI,NBA,2013-14,24,0,62,3,13,3,10,0,3,0,0,2,6,8,2,0,4,2,7,6
1065,Toure' Murry,24,NYK,NBA,2013-14,51,0,373,56,129,51,117,5,12,23,39,13,31,44,49,19,1,34,46,140
1066,Mike Muscala,22,ATL,NBA,2013-14,20,0,215,31,73,31,70,0,3,14,14,17,35,52,7,3,10,12,29,76
1067,Nemanja Nedovic,22,GSW,NBA,2013-14,24,0,142,8,39,5,21,3,18,7,8,3,12,15,13,0,1,13,13,26
1068,James Nunnally,23,TOT,NBA,2013-14,13,0,165,15,46,7,21,8,25,6,9,1,18,19,8,6,2,7,11,44
1069,Victor Oladipo,21,ORL,NBA,2013-14,80,44,2487,392,936,318,710,74,226,248,318,43,286,329,327,129,37,256,210,1106
1070,Kelly Olynyk,22,BOS,NBA,2013-14,70,9,1400,234,502,194,388,40,114,99,122,140,225,365,109,35,27,106,227,607
1071,Arinze Onuaku,26,TOT,NBA,2013-14,5,0,30,1,5,1,5,0,0,1,2,2,6,8,3,0,0,1,3,3
1072,Mason Plumlee,23,BRK,NBA,2013-14,70,22,1275,199,302,199,299,0,3,122,195,99,209,308,60,49,55,77,171,520
1073,Otto Porter,20,WAS,NBA,2013-14,37,0,319,33,91,29,70,4,21,8,12,21,36,57,10,8,1,14,26,78
1074,Phil Pressey,22,BOS,NBA,2013-14,75,11,1132,78,253,50,147,28,106,29,45,20,85,105,241,68,5,87,97,213
1075,Miroslav Raduljica,26,MIL,NBA,2013-14,48,2,465,68,126,68,126,0,0,45,55,54,54,108,23,7,13,28,84,181
1076,Glen Rice,23,WAS,NBA,2013-14,11,1,109,11,37,6,20,5,17,5,7,4,16,20,7,6,1,9,7,32
1077,Andre Roberson,22,OKC,NBA,2013-14,40,16,399,33,68,31,55,2,13,7,10,36,58,94,15,19,10,19,74,75
1078,Dennis Schroder,20,ATL,NBA,2013-14,49,0,641,72,188,62,146,10,42,29,43,5,55,60,93,17,0,61,54,183
1079,Peyton Siva,23,DET,NBA,2013-14,24,0,224,18,57,11,32,7,25,11,15,2,12,14,34,9,1,18,27,54
1080,Chris Smith,26,NYK,NBA,2013-14,2,0,2,0,0,0,0,0,0,0,0,0,0,0,0,0,0,0,0,0
1081,Tony Snell,22,CHI,NBA,2013-14,77,12,1231,129,336,72,158,57,178,31,41,19,105,124,68,29,15,44,84,346
1082,James Southerland,23,TOT,NBA,2013-14,4,0,30,5,15,2,9,3,6,1,2,0,8,8,0,1,2,1,3,14
1083,D.J. Stephens,23,MIL,NBA,2013-14,3,0,15,3,7,3,7,0,0,1,1,1,4,5,0,0,0,0,0,7
1084,Adonis Thomas,20,TOT,NBA,2013-14,6,1,37,6,14,5,9,1,5,1,1,0,3,3,3,0,0,1,6,14
1085,Hollis Thompson,22,PHI,NBA,2013-14,77,41,1742,171,372,104,205,67,167,52,73,73,174,247,73,53,12,60,144,461
1086,Casper Ware,24,PHI,NBA,2013-14,9,0,116,18,42,11,21,7,21,5,6,0,9,9,10,8,0,5,11,48
1087,Royce White,22,SAC,NBA,2013-14,3,0,9,0,1,0,1,0,0,0,0,0,0,0,0,0,0,0,2,0
1088,Jeff Withey,23,NOP,NBA,2013-14,58,4,684,69,129,69,128,0,1,52,73,49,101,150,26,15,50,20,73,190
1089,Nate Wolters,22,MIL,NBA,2013-14,58,31,1309,170,389,152,327,18,62,59,90,33,116,149,187,35,15,57,67,417
1090,Cody Zeller,21,CHA,NBA,2013-14,82,3,1416,172,404,172,403,0,1,146,200,118,235,353,92,40,41,87,170,490
1091,Jordan Adams,20,MEM,NBA,2014-15,30,0,248,35,86,25,61,10,25,14,23,9,19,28,16,16,7,14,24,94
1092,Furkan Aldemir,23,PHI,NBA,2014-15,41,9,540,40,78,40,73,0,5,13,27,78,98,176,28,17,16,17,96,93
1093,Kyle Anderson,21,SAS,NBA,2014-15,33,8,358,31,89,28,78,3,11,9,14,5,67,72,28,15,7,10,28,74
1094,Cameron Bairstow,24,CHI,NBA,2014-15,18,1,64,3,14,3,14,0,0,4,5,6,2,8,1,2,1,3,8,10
1095,Jerrelle Benimon,23,UTA,NBA,2014-15,2,0,3,0,0,0,0,0,0,0,0,1,2,3,0,0,0,1,0,0
1096,Sim Bhullar,22,SAC,NBA,2014-15,3,0,3,1,2,1,2,0,0,0,0,0,1,1,1,0,1,0,0,2
1097,Tarik Black,23,TOT,NBA,2014-15,63,39,1196,157,273,157,272,0,1,65,118,142,226,368,42,19,24,48,158,379
1098,Bojan Bogdanovic,25,BRK,NBA,2014-15,78,28,1854,261,576,170,320,91,256,87,106,50,163,213,68,34,9,78,104,700
1099,Jabari Brown,22,LAL,NBA,2014-15,19,5,568,70,170,47,108,23,62,64,85,3,33,36,40,12,2,32,33,227
1100,Markel Brown,23,BRK,NBA,2014-15,47,29,781,76,210,59,146,17,64,47,57,16,91,107,39,31,12,27,57,216
1101,Bruno Caboclo,19,TOR,NBA,2014-15,8,0,23,4,12,2,9,2,3,0,0,1,1,2,0,0,1,4,3,10
1102,Clint Capela,20,HOU,NBA,2014-15,12,0,90,14,29,14,29,0,0,4,23,10,26,36,2,1,9,5,14,32
1103,Will Cherry,23,CLE,NBA,2014-15,8,0,69,5,19,3,10,2,9,3,6,1,4,5,8,6,1,4,10,15
1104,Patrick Christopher,26,UTA,NBA,2014-15,4,1,29,3,12,3,8,0,4,0,0,2,4,6,0,1,0,1,6,6
1105,Jordan Clarkson,22,LAL,NBA,2014-15,59,38,1476,267,596,229,475,38,121,131,158,56,135,191,206,51,12,96,109,703
1106,Jack Cooley,23,UTA,NBA,2014-15,16,0,87,9,22,9,22,0,0,9,21,10,15,25,1,6,3,3,23,27
1107,Bryce Cotton,22,UTA,NBA,2014-15,15,0,159,29,69,22,49,7,20,15,18,3,15,18,15,4,0,12,6,80
1108,Andre Dawkins,23,MIA,NBA,2014-15,4,0,22,1,6,0,0,1,6,0,0,0,2,2,1,0,0,1,3,3
1109,Spencer Dinwiddie,21,DET,NBA,2014-15,34,1,455,51,169,39,104,12,65,31,34,4,44,48,104,19,6,33,53,145
1110,Zoran Dragic,25,TOT,NBA,2014-15,16,1,75,11,30,8,16,3,14,3,5,5,3,8,5,2,0,5,6,28
1111,Larry Drew,24,PHI,NBA,2014-15,12,1,219,20,58,16,32,4,26,2,3,1,14,15,45,6,0,25,13,46
1112,Cleanthony Early,23,NYK,NBA,2014-15,39,7,647,76,214,54,130,22,84,36,48,22,75,97,36,24,12,40,57,210
1113,James Ennis,24,MIA,NBA,2014-15,62,3,1051,101,247,70,152,31,95,79,94,51,125,176,48,25,17,39,89,312
1114,Tyler Ennis,20,TOT,NBA,2014-15,33,1,411,52,144,40,101,12,43,5,7,7,28,35,73,18,5,42,36,121
1115,Dante Exum,19,UTA,NBA,2014-15,82,41,1817,145,416,62,152,83,264,20,32,27,104,131,198,41,14,118,147,393
1116,Tim Frazier,24,TOT,NBA,2014-15,11,3,239,21,61,16,44,5,17,10,21,6,22,28,60,8,0,25,26,57
1117,Langston Galloway,23,NYK,NBA,2014-15,45,41,1457,204,511,142,335,62,176,63,78,37,153,190,150,52,12,61,129,533
1118,Aaron Gordon,19,ORL,NBA,2014-15,47,8,797,93,208,80,160,13,48,44,61,46,123,169,33,21,22,38,83,243
1119,Drew Gordon,24,PHI,NBA,2014-15,9,0,71,8,19,8,16,0,3,1,2,7,11,18,2,1,0,8,7,17
1120,Jerami Grant,20,PHI,NBA,2014-15,65,11,1377,124,352,75,196,49,156,114,193,49,149,198,79,40,68,85,144,411
1121,Erick Green,23,DEN,NBA,2014-15,43,1,410,61,162,47,115,14,47,10,12,7,24,31,39,12,0,14,26,146
1122,JaMychal Green,24,TOT,NBA,2014-15,24,1,164,27,47,27,41,0,6,8,10,19,26,45,4,5,5,14,25,62
1123,P.J. Hairston,22,CHO,NBA,2014-15,45,2,687,87,269,38,106,49,163,31,36,22,70,92,21,21,13,22,61,254
1124,Gary Harris,20,DEN,NBA,2014-15,55,6,719,66,217,45,114,21,103,35,47,21,43,64,29,39,7,38,71,188
1125,Joe Harris,23,CLE,NBA,2014-15,51,1,493,48,120,17,36,31,84,9,15,7,34,41,26,7,2,27,62,136
1126,Rodney Hood,22,UTA,NBA,2014-15,50,21,1064,155,374,93,204,62,170,61,80,9,108,117,83,30,12,45,119,433
1127,Joe Ingles,27,UTA,NBA,2014-15,79,32,1673,147,354,75,152,72,202,30,40,22,153,175,182,72,10,98,124,396
1128,Cory Jefferson,24,BRK,NBA,2014-15,50,1,531,75,167,73,152,2,15,31,54,47,98,145,16,10,21,20,61,183
1129,Grant Jerrett,21,TOT,NBA,2014-15,8,0,51,7,26,6,11,1,15,1,1,2,7,9,3,2,2,3,11,16
1130,Nick Johnson,22,HOU,NBA,2014-15,28,0,262,26,75,21,54,5,21,17,25,13,26,39,11,7,3,19,34,74
1131,Tyler Johnson,22,MIA,NBA,2014-15,32,2,603,70,167,52,119,18,48,32,47,14,67,81,42,33,9,30,42,190
1132,Sean Kilpatrick,25,MIN,NBA,2014-15,4,0,72,7,20,3,7,4,13,4,4,1,5,6,4,3,0,2,3,22
1133,Alex Kirk,23,CLE,NBA,2014-15,5,0,14,1,4,1,4,0,0,2,2,1,0,1,1,0,0,0,1,4
1134,Joffrey Lauvergne,23,DEN,NBA,2014-15,24,1,268,36,89,33,73,3,16,18,28,27,50,77,13,8,10,22,43,93
1135,Zach LaVine,19,MIN,NBA,2014-15,77,40,1902,286,677,229,510,57,167,149,177,27,187,214,276,54,10,193,158,778
1136,Kalin Lucas,25,MEM,NBA,2014-15,1,0,6,0,1,0,1,0,0,0,0,0,0,0,0,1,0,0,1,0
1137,Devyn Marble,22,ORL,NBA,2014-15,16,7,208,14,44,10,22,4,22,5,16,5,26,31,17,9,2,9,14,37
1138,James Michael McAdoo,22,GSW,NBA,2014-15,15,0,137,24,44,24,44,0,0,14,25,15,22,37,2,5,9,6,21,62
1139,K.J. McDaniels,21,TOT,NBA,2014-15,62,15,1352,172,434,129,284,43,150,100,133,65,135,200,72,44,70,105,126,487
1140,Doug McDermott,23,CHI,NBA,2014-15,36,0,321,43,107,30,66,13,41,10,15,6,37,43,6,4,1,17,29,109
1141,Mitch McGary,22,OKC,NBA,2014-15,32,2,485,88,165,88,163,0,2,25,40,53,112,165,14,16,16,31,72,201
1142,Jerel McNeal,27,PHO,NBA,2014-15,6,0,36,3,11,2,9,1,2,2,2,0,3,3,2,3,1,5,5,9
1143,Elijah Millsap,27,UTA,NBA,2014-15,47,5,924,81,238,53,148,28,90,58,86,28,122,150,58,56,16,67,124,248
1144,Nikola Mirotic,23,CHI,NBA,2014-15,82,3,1654,253,624,154,311,99,313,228,284,63,341,404,97,54,54,89,172,833
1145,Eric Moreland,23,SAC,NBA,2014-15,3,0,2,1,1,1,1,0,0,0,0,0,1,1,0,0,0,0,1,2
1146,Shabazz Napier,23,MIA,NBA,2014-15,51,10,1012,87,228,44,110,43,118,44,56,17,96,113,130,40,4,81,76,261
1147,Nerlens Noel,20,PHI,NBA,2014-15,75,71,2311,302,653,302,653,0,0,140,230,185,426,611,128,133,142,146,208,744
1148,Lucas Nogueira,22,TOR,NBA,2014-15,6,0,23,2,8,2,8,0,0,2,4,2,9,11,1,2,0,2,6,6
1149,Jusuf Nurkic,20,DEN,NBA,2014-15,62,27,1103,171,383,171,381,0,2,84,132,125,257,382,50,52,68,86,207,426
1150,Johnny O'Bryant,21,MIL,NBA,2014-15,34,15,368,44,120,44,120,0,0,12,27,26,38,64,17,5,4,25,44,100
1151,Kostas Papanikolaou,24,HOU,NBA,2014-15,43,1,795,69,197,38,91,31,106,13,18,39,79,118,85,29,13,55,71,182
1152,Jabari Parker,19,MIL,NBA,2014-15,25,25,738,129,263,125,247,4,16,46,66,50,88,138,42,31,5,47,42,308
1153,Adreian Payne,23,TOT,NBA,2014-15,32,22,739,91,220,90,211,1,9,30,46,48,114,162,30,19,9,44,88,213
1154,Elfrid Payton,20,ORL,NBA,2014-15,82,63,2489,301,708,290,666,11,42,118,214,107,242,349,533,142,20,203,193,731
1155,Dwight Powell,23,TOT,NBA,2014-15,29,0,236,31,67,28,56,3,11,25,33,18,32,50,9,9,6,11,40,90
1156,Julius Randle,20,LAL,NBA,2014-15,1,0,14,1,3,1,3,0,0,0,2,0,0,0,0,0,0,1,1,2
1157,Glenn Robinson,21,TOT,NBA,2014-15,35,1,261,26,67,21,48,5,19,16,24,15,24,39,11,6,1,11,15,73
1158,Damjan Rudez,28,IND,NBA,2014-15,68,2,1047,119,263,50,93,69,170,16,23,8,39,47,53,16,5,47,79,323
1159,JaKarr Sampson,21,PHI,NBA,2014-15,74,32,1131,146,346,115,219,31,127,63,94,35,128,163,77,38,26,76,135,386
1160,Marcus Smart,20,BOS,NBA,2014-15,67,38,1808,175,477,84,205,91,272,82,127,61,161,222,208,99,18,90,176,523
1161,Russ Smith,23,TOT,NBA,2014-15,12,0,65,8,25,6,14,2,11,12,13,1,5,6,8,3,0,12,13,30
1162,Nik Stauskas,21,SAC,NBA,2014-15,73,1,1127,108,296,60,147,48,149,55,64,11,77,88,67,20,17,40,92,319
1163,David Stockton,23,SAC,NBA,2014-15,3,0,33,2,6,1,4,1,2,3,6,0,2,2,9,2,0,4,1,8
1164,Jarnell Stokes,21,MEM,NBA,2014-15,19,2,126,21,37,21,37,0,0,15,28,16,18,34,4,5,5,7,25,57
1165,Noah Vonleh,19,CHO,NBA,2014-15,25,0,259,30,76,25,63,5,13,18,26,28,58,86,4,4,9,11,20,83
1166,T.J. Warren,21,PHO,NBA,2014-15,40,1,614,113,214,108,193,5,21,14,19,41,44,85,25,18,9,27,51,245
1167,David Wear,24,SAC,NBA,2014-15,2,0,7,0,2,0,1,0,1,0,0,2,0,2,1,0,0,0,1,0
1168,Travis Wear,24,NYK,NBA,2014-15,51,1,672,84,209,73,179,11,30,20,26,31,75,106,40,15,11,35,55,199
1169,Shayne Whittington,23,IND,NBA,2014-15,20,0,108,19,42,18,36,1,6,18,23,10,19,29,6,5,2,5,18,57
1170,Andrew Wiggins,19,MIN,NBA,2014-15,82,82,2969,497,1137,458,1011,39,126,354,466,134,240,374,170,86,50,177,190,1387
1171,C.J. Wilcox,24,LAC,NBA,2014-15,21,0,101,16,38,9,19,7,19,2,2,1,6,7,8,3,1,10,7,41
1172,James Young,19,BOS,NBA,2014-15,31,0,332,36,102,19,36,17,66,16,29,9,33,42,13,8,2,5,22,105
1173,Cliff Alexander,20,POR,NBA,2015-16,8,0,36,5,10,5,10,0,0,0,0,2,4,6,0,1,2,1,1,10
1174,Justin Anderson,22,DAL,NBA,2015-16,55,9,647,71,175,49,92,22,83,44,55,18,114,132,29,19,25,24,45,208
1175,Thanasis Antetokounmpo,23,NYK,NBA,2015-16,2,0,6,3,4,3,3,0,1,0,0,0,1,1,0,0,0,0,2,6
1176,Keith Appling,23,ORL,NBA,2015-16,5,0,27,2,8,2,5,0,3,2,2,0,1,1,1,1,0,3,5,6
1177,Nemanja Bjelica,27,MIN,NBA,2015-16,60,0,1075,110,235,62,110,48,125,40,55,49,161,210,83,26,21,47,154,308
1178,Devin Booker,19,PHO,NBA,2015-16,76,51,2108,367,867,268,578,99,289,215,256,27,160,187,200,44,20,160,225,1048
1179,Anthony Brown,23,LAL,NBA,2015-16,29,11,599,39,126,19,56,20,70,17,20,9,61,70,19,14,5,15,34,115
1180,Willie Cauley-Stein,22,SAC,NBA,2015-16,66,39,1412,191,339,191,337,0,2,81,125,134,218,352,37,48,66,46,146,463
1181,Rakeem Christmas,24,IND,NBA,2015-16,1,0,6,2,2,2,2,0,0,0,0,1,0,1,0,0,0,0,1,4
1182,Coty Clarke,23,BOS,NBA,2015-16,3,0,6,2,4,0,2,2,2,0,0,0,1,1,0,0,0,1,0,6
1183,Pat Connaughton,23,POR,NBA,2015-16,34,0,143,13,49,8,28,5,21,5,5,11,21,32,10,2,0,10,6,36
1184,Branden Dawson,22,LAC,NBA,2015-16,6,0,29,2,5,2,5,0,0,1,1,2,2,4,0,0,1,0,2,5
1185,Bryce Dejean-Jones,23,NOP,NBA,2015-16,14,11,279,28,69,16,37,12,32,11,21,8,40,48,15,10,2,11,17,79
1186,Sam Dekker,21,HOU,NBA,2015-16,3,0,6,0,0,0,0,0,0,0,0,0,1,1,0,1,0,0,0,0
1187,Duje Dukan,24,SAC,NBA,2015-16,1,0,24,2,10,0,5,2,5,0,0,2,2,4,1,1,0,0,2,6
1188,Jarell Eddie,24,WAS,NBA,2015-16,26,0,147,20,65,5,18,15,47,8,8,2,21,23,5,5,1,1,5,63
1189,Cristiano Felicio,23,CHI,NBA,2015-16,31,4,321,40,72,40,68,0,4,25,35,30,72,102,26,6,13,13,31,105
1190,Jerian Grant,23,NYK,NBA,2015-16,76,6,1265,154,391,132,291,22,100,96,123,23,120,143,177,50,10,87,97,426
1191,Montrezl Harrell,22,HOU,NBA,2015-16,39,1,379,58,90,58,89,0,1,24,46,25,40,65,17,11,11,17,48,140
1192,Aaron Harrison,21,CHO,NBA,2015-16,21,0,93,5,19,2,9,3,10,5,12,4,11,15,2,6,0,4,10,18
1193,Mario Hezonja,20,ORL,NBA,2015-16,79,9,1413,181,418,114,226,67,192,49,54,28,148,176,109,39,17,97,124,478
1194,Darrun Hilliard,22,DET,NBA,2015-16,38,2,383,52,131,33,81,19,50,29,40,5,40,45,27,9,1,19,28,152
1195,Rondae Hollis-Jefferson,21,BRK,NBA,2015-16,29,17,615,63,138,59,124,4,14,37,52,39,115,154,43,39,16,26,61,167
1196,Richaun Holmes,22,PHI,NBA,2015-16,51,1,702,114,222,106,178,8,44,51,74,62,73,135,33,19,40,32,92,287
1197,Marcelo Huertas,32,LAL,NBA,2015-16,53,0,869,97,230,81,169,16,61,27,29,18,72,90,182,26,7,80,76,237
1198,Josh Huestis,24,OKC,NBA,2015-16,5,0,55,5,12,1,6,4,6,0,4,2,8,10,0,1,2,3,3,14
1199,R.J. Hunter,22,BOS,NBA,2015-16,36,0,315,36,98,17,35,19,63,6,7,2,35,37,13,14,4,11,29,97
1200,Damien Inglis,20,MIL,NBA,2015-16,20,1,156,13,37,10,24,3,13,7,8,2,29,31,10,6,3,11,11,36
1201,Stanley Johnson,19,DET,NBA,2015-16,73,6,1687,225,600,162,395,63,205,80,102,58,248,306,118,55,12,114,178,593
1202,Nikola Jokic,20,DEN,NBA,2015-16,80,55,1733,307,600,279,516,28,84,154,190,181,379,560,189,79,50,104,208,796
1203,Tyus Jones,19,MIN,NBA,2015-16,37,0,573,56,156,40,103,16,53,28,39,7,40,47,108,31,3,33,33,156
1204,Frank Kaminsky,22,CHO,NBA,2015-16,81,3,1708,215,525,147,323,68,202,108,148,69,266,335,98,38,43,58,126,606
1205,Sasha Kaun,30,CLE,NBA,2015-16,25,0,95,9,17,9,17,0,0,5,11,12,14,26,3,4,5,7,11,23
1206,Kevon Looney,19,GSW,NBA,2015-16,5,0,21,4,7,3,5,1,2,0,0,4,6,10,0,0,0,1,2,9
1207,Trey Lyles,20,UTA,NBA,2015-16,80,33,1382,191,436,142,308,49,128,57,82,59,240,299,59,26,18,65,114,488
1208,Boban Marjanovic,27,SAS,NBA,2015-16,54,4,508,105,174,105,174,0,0,87,114,73,121,194,21,12,23,29,54,297
1209,Jarell Martin,21,MEM,NBA,2015-16,27,0,380,54,116,54,114,0,2,45,62,39,47,86,15,8,7,19,58,153
1210,T.J. McConnell,23,PHI,NBA,2015-16,81,17,1606,218,464,187,375,31,89,26,41,43,207,250,367,95,10,140,114,493
1211,Chris McCullough,20,BRK,NBA,2015-16,24,4,362,44,109,31,75,13,34,11,23,25,43,68,9,28,12,15,39,112
1212,Jordan McRae,24,TOT,NBA,2015-16,22,1,195,34,78,24,56,10,22,21,28,4,16,20,25,3,1,15,17,99
1213,Salah Mejri,29,DAL,NBA,2015-16,34,6,397,49,78,49,77,0,1,27,46,41,82,123,10,8,36,23,54,125
1214,Jordan Mickey,21,BOS,NBA,2015-16,16,0,57,8,22,8,22,0,0,5,10,6,7,13,1,0,11,1,5,21
1215,Luis Montero,22,POR,NBA,2015-16,12,0,42,5,19,4,10,1,9,3,4,0,4,4,1,0,0,4,1,14
1216,Emmanuel Mudiay,19,DEN,NBA,2015-16,68,66,2068,329,905,255,673,74,232,140,209,32,200,232,372,65,35,217,141,872
1217,Xavier Munford,23,MEM,NBA,2015-16,14,0,244,32,77,23,54,9,23,7,14,3,28,31,22,13,3,15,25,80
1218,Larry Nance Jr.,23,LAL,NBA,2015-16,63,22,1266,158,300,157,290,1,10,32,47,101,211,312,44,54,23,41,124,349
1219,Raul Neto,23,UTA,NBA,2015-16,81,53,1499,180,418,116,256,64,162,52,70,17,103,120,174,62,2,109,122,476
1220,J.J. O'Brien,23,UTA,NBA,2015-16,2,0,6,0,1,0,1,0,0,0,0,0,1,1,0,1,0,0,1,0
1221,Jahlil Okafor,20,PHI,NBA,2015-16,53,48,1591,397,781,396,775,1,6,133,194,122,251,373,65,22,61,124,140,928
1222,Kelly Oubre,20,WAS,NBA,2015-16,63,9,671,90,211,65,132,25,79,31,49,25,108,133,13,22,7,34,100,236
1223,Lamar Patterson,24,ATL,NBA,2015-16,35,0,395,28,80,16,31,12,49,16,22,4,46,50,39,9,2,23,45,84
1224,Cameron Payne,21,OKC,NBA,2015-16,57,1,698,114,278,78,167,36,111,19,24,9,76,85,108,36,6,44,80,283
1225,Tibor Pleiss,26,UTA,NBA,2015-16,12,0,82,11,25,11,23,0,2,2,2,6,9,15,2,1,2,8,19,24
1226,Bobby Portis,20,CHI,NBA,2015-16,62,4,1102,186,436,170,384,16,52,48,66,123,214,337,52,25,22,54,100,436
1227,Kristaps Porzingis,20,NYK,NBA,2015-16,72,72,2047,373,886,292,643,81,243,201,240,132,394,526,94,53,134,121,205,1028
1228,Norman Powell,22,TOR,NBA,2015-16,49,24,725,97,229,61,140,36,89,43,53,16,95,111,47,29,10,32,59,273
1229,Willie Reed,25,BRK,NBA,2015-16,39,2,426,76,133,76,133,0,0,30,55,49,73,122,10,6,30,16,47,182
1230,Josh Richardson,22,MIA,NBA,2015-16,52,2,1107,123,272,70,157,53,115,42,63,21,86,107,73,36,25,35,107,341
1231,Terry Rozier,21,BOS,NBA,2015-16,39,0,311,29,106,23,79,6,27,8,10,24,39,63,37,6,1,19,23,72
1232,D'Angelo Russell,19,LAL,NBA,2015-16,80,48,2259,392,956,262,586,130,370,140,190,47,227,274,266,93,13,196,142,1054
1233,Jonathon Simmons,26,SAS,NBA,2015-16,55,2,813,122,242,104,195,18,47,69,92,16,80,96,58,24,5,53,103,331
1234,Alex Stepheson,28,TOT,NBA,2015-16,8,0,73,9,27,9,27,0,0,4,12,19,9,28,2,1,5,0,12,22
1235,Edy Tavares,23,ATL,NBA,2015-16,11,0,73,11,19,11,19,0,0,3,8,7,14,21,3,1,6,5,8,25
1236,Axel Toupane,23,DEN,NBA,2015-16,21,0,305,25,70,12,30,13,40,13,17,8,23,31,15,7,6,6,40,76
1237,Karl-Anthony Towns,20,MIN,NBA,2015-16,82,82,2627,625,1153,595,1065,30,88,223,275,229,629,858,161,58,138,183,245,1503
1238,Myles Turner,19,IND,NBA,2015-16,60,30,1367,264,530,261,516,3,14,88,121,68,264,332,41,25,86,67,158,619
1239,Rashad Vaughn,19,MIL,NBA,2015-16,70,6,1001,81,266,38,119,43,147,12,15,11,77,88,39,29,16,28,73,217
1240,Briante Weber,23,TOT,NBA,2015-16,7,4,169,14,39,14,34,0,5,3,4,8,17,25,21,9,3,9,12,31
1241,Alan Williams,23,PHO,NBA,2015-16,10,0,68,10,24,10,24,0,0,9,14,14,24,38,5,4,5,6,15,29
1242,Justise Winslow,19,MIA,NBA,2015-16,78,8,2232,195,462,163,346,32,116,80,117,81,322,403,117,68,26,95,184,502
1243,Christian Wood,20,PHI,NBA,2015-16,17,0,145,22,53,18,42,4,11,13,21,13,25,38,3,5,7,2,11,61
1244,Delon Wright,23,TOR,NBA,2015-16,27,1,229,36,80,31,67,5,13,26,35,8,29,37,31,8,3,16,7,103
1245,Joe Young,23,IND,NBA,2015-16,41,0,384,62,169,52,123,10,46,20,25,6,44,50,65,15,0,33,30,154
1246,Alex Abrines,23,OKC,NBA,2016-17,68,6,1055,134,341,40,94,94,247,44,49,18,68,86,40,37,8,33,114,406
1247,Ron Baker,23,NYK,NBA,2016-17,52,13,857,82,217,59,131,23,86,28,43,12,86,98,107,34,8,56,74,215
1248,Wade Baldwin,20,MEM,NBA,2016-17,33,1,405,36,115,33,93,3,22,31,37,11,35,46,61,18,7,40,40,106
1249,Malik Beasley,20,DEN,NBA,2016-17,22,1,165,33,73,24,45,9,28,8,10,5,12,17,11,7,0,8,10,83
1250,DeAndre' Bembry,22,ATL,NBA,2016-17,38,1,371,47,98,46,80,1,18,6,16,14,45,59,28,8,5,16,21,101
1251,Dragan Bender,19,PHO,NBA,2016-17,43,0,574,57,161,29,60,28,101,4,11,23,80,103,23,10,22,32,74,146
1252,Ben Bentil,21,DAL,NBA,2016-17,3,0,10,0,3,0,2,0,1,0,0,0,2,2,0,0,0,1,1,0
1253,Davis Bertans,24,SAS,NBA,2016-17,67,6,808,103,234,34,61,69,173,28,34,22,77,99,46,20,28,32,75,303
1254,Joel Bolomboy,23,UTA,NBA,2016-17,12,0,53,9,16,8,12,1,4,3,6,4,13,17,2,1,2,2,1,22
1255,Malcolm Brogdon,24,MIL,NBA,2016-17,75,28,1982,290,635,212,442,78,193,109,126,47,166,213,317,84,12,113,140,767
1256,Jaylen Brown,20,BOS,NBA,2016-17,78,20,1341,192,423,146,288,46,135,85,124,45,175,220,64,35,18,68,142,515
1257,Nicolas Brussino,23,DAL,NBA,2016-17,54,2,521,52,141,23,46,29,95,17,22,26,69,95,47,17,8,26,43,150
1258,Marquese Chriss,19,PHO,NBA,2016-17,82,75,1743,284,632,212,408,72,224,113,181,96,252,348,60,67,70,108,263,753
1259,Semaj Christon,24,OKC,NBA,2016-17,64,1,973,77,223,65,160,12,63,17,31,19,69,88,130,28,6,43,79,183
1260,Quinn Cook,23,TOT,NBA,2016-17,14,0,188,33,66,22,40,11,26,2,5,1,6,7,26,4,0,13,13,79
1261,Deyonta Davis,20,MEM,NBA,2016-17,36,0,238,24,47,24,47,0,0,10,18,20,40,60,2,3,17,8,40,58
1262,Malcolm Delaney,27,ATL,NBA,2016-17,73,2,1248,145,388,119,278,26,110,75,93,11,113,124,193,39,1,95,112,391
1263,Cheick Diallo,20,NOP,NBA,2016-17,17,0,199,36,76,36,76,0,0,15,21,23,50,73,4,4,7,7,17,87
1264,Kris Dunn,22,MIN,NBA,2016-17,78,7,1333,118,313,97,240,21,73,36,59,24,142,166,188,78,36,89,178,293
1265,Henry Ellenson,20,DET,NBA,2016-17,19,2,146,23,64,13,29,10,35,4,8,8,33,41,7,1,1,14,6,60
1266,Joel Embiid,22,PHI,NBA,2016-17,31,31,786,200,429,164,331,36,98,191,244,61,182,243,66,27,76,117,112,627
1267,Kay Felder,21,CLE,NBA,2016-17,42,0,386,62,158,55,136,7,22,35,49,3,38,41,58,18,7,31,38,166
1268,Yogi Ferrell,23,TOT,NBA,2016-17,46,29,1197,160,394,92,218,68,176,74,89,20,91,111,172,42,9,70,90,462
1269,Dorian Finney-Smith,23,DAL,NBA,2016-17,81,35,1642,124,333,68,142,56,191,46,61,55,166,221,67,52,25,45,125,350
1270,Bryn Forbes,23,SAS,NBA,2016-17,36,0,285,36,99,19,46,17,53,5,6,2,21,23,23,1,0,11,20,94
1271,Patricio Garino,23,ORL,NBA,2016-17,5,0,43,0,7,0,2,0,5,0,0,1,6,7,0,0,0,3,4,0
1272,Michael Gbinije,24,DET,NBA,2016-17,9,0,32,1,10,1,6,0,4,2,2,2,1,3,2,0,0,0,2,4
1273,Marcus Georges-Hunt,22,ORL,NBA,2016-17,5,0,48,2,7,1,5,1,2,9,10,1,8,9,3,1,0,2,5,14
1274,Jonathan Gibson,29,DAL,NBA,2016-17,17,0,231,35,95,20,50,15,45,21,29,1,21,22,26,8,0,21,21,106
1275,Treveon Graham,23,CHO,NBA,2016-17,27,1,189,19,40,10,25,9,15,10,15,5,17,22,6,6,1,3,18,57
1276,A.J. Hammons,24,DAL,NBA,2016-17,22,0,163,17,42,12,32,5,10,9,20,8,28,36,4,1,13,10,21,48
1277,Andrew Harrison,22,MEM,NBA,2016-17,72,18,1474,117,360,74,204,43,156,148,194,23,113,136,198,54,20,85,194,425
1278,Juan Hernangomez,21,DEN,NBA,2016-17,62,9,842,101,224,55,111,46,113,57,76,43,144,187,29,29,12,31,62,305
1279,Willy Hernangomez,22,NYK,NBA,2016-17,72,22,1324,246,465,242,450,4,15,91,125,170,332,502,96,41,36,100,150,587
1280,Buddy Hield,23,TOT,NBA,2016-17,82,55,1888,327,768,179,389,148,379,64,76,35,234,269,121,38,9,101,115,866
1281,Danuel House,23,WAS,NBA,2016-17,1,0,1,0,0,0,0,0,0,0,0,0,1,1,0,0,0,0,0,0
1282,Brandon Ingram,19,LAL,NBA,2016-17,79,40,2279,276,686,221,499,55,187,133,214,60,257,317,166,50,36,116,158,740
1283,Demetrius Jackson,22,BOS,NBA,2016-17,5,0,17,3,4,2,3,1,1,3,6,2,2,4,3,0,0,0,0,10
1284,Pierre Jackson,25,DAL,NBA,2016-17,8,1,84,13,39,10,28,3,11,6,7,1,8,9,19,2,0,3,5,35
1285,Brice Johnson,22,LAC,NBA,2016-17,3,0,9,2,7,2,7,0,0,0,0,1,2,3,1,2,1,1,0,4
1286,Damian Jones,21,GSW,NBA,2016-17,10,0,85,8,16,8,16,0,0,3,10,9,14,23,0,1,4,6,15,19
1287,Derrick Jones,19,PHO,NBA,2016-17,32,8,545,68,121,65,110,3,11,29,41,39,40,79,12,14,13,13,63,168
1288,Mindaugas Kuzminskas,27,NYK,NBA,2016-17,68,5,1016,158,369,104,201,54,168,55,68,47,79,126,69,29,11,51,79,425
1289,Skal Labissiere,20,SAC,NBA,2016-17,33,12,612,117,218,114,210,3,8,52,74,51,111,162,27,16,13,37,64,289
1290,Nicolas Laprovittola,27,SAS,NBA,2016-17,18,3,174,20,47,10,20,10,27,9,9,1,9,10,28,4,1,19,19,59
1291,Jake Layman,22,POR,NBA,2016-17,35,1,249,26,89,13,38,13,51,13,17,6,18,24,11,9,3,11,22,78
1292,Caris LeVert,22,BRK,NBA,2016-17,57,26,1237,171,380,112,196,59,184,67,93,23,165,188,110,49,8,59,91,468
1293,Shawn Long,24,PHI,NBA,2016-17,18,0,234,61,109,54,90,7,19,19,35,41,44,85,13,9,9,13,49,148
1294,Timothe Luwawu-Cabarrot,21,PHI,NBA,2016-17,69,19,1190,145,361,95,200,50,161,105,123,25,124,149,75,32,10,73,154,445
1295,Thon Maker,19,MIL,NBA,2016-17,57,34,562,83,181,55,107,28,74,32,49,40,74,114,23,10,26,17,84,226
1296,Patrick McCaw,21,GSW,NBA,2016-17,71,20,1074,106,245,65,122,41,123,29,37,22,79,101,77,32,15,36,62,282
1297,Sheldon McClellan,24,WAS,NBA,2016-17,30,3,287,30,75,23,45,7,30,23,27,4,30,34,15,8,2,5,17,90
1298,Rodney McGruder,25,MIA,NBA,2016-17,78,65,1966,190,460,117,240,73,220,44,71,95,162,257,124,45,18,56,140,497
1299,Dejounte Murray,20,SAS,NBA,2016-17,38,8,322,50,116,41,93,9,23,21,30,6,36,42,48,8,6,38,29,130
1300,Jamal Murray,19,DEN,NBA,2016-17,82,10,1764,295,730,180,386,115,344,106,120,41,173,214,170,52,24,113,124,811
1301,Maurice Ndour,24,NYK,NBA,2016-17,32,4,331,39,86,38,79,1,7,19,26,22,42,64,8,15,8,12,30,98
1302,Georges Niang,23,IND,NBA,2016-17,23,0,93,9,36,8,24,1,12,2,2,2,15,17,5,3,0,5,6,21
1303,David Nwaba,24,LAL,NBA,2016-17,20,2,397,47,81,46,76,1,5,25,39,16,46,62,14,13,7,11,36,120
1304,Daniel Ochefu,23,WAS,NBA,2016-17,19,0,75,12,27,12,27,0,0,0,2,5,17,22,3,2,0,3,17,24
1305,Chinanu Onuaku,20,HOU,NBA,2016-17,5,1,52,5,7,5,7,0,0,4,4,2,8,10,3,3,1,4,6,14
1306,Georgios Papagiannis,19,SAC,NBA,2016-17,22,0,355,56,102,56,100,0,2,12,14,24,62,86,20,3,17,24,44,124
1307,Gary Payton,24,MIL,NBA,2016-17,6,0,99,8,22,7,13,1,9,3,5,0,12,12,13,3,4,10,9,20
1308,Marshall Plumlee,24,NYK,NBA,2016-17,21,1,170,16,30,16,30,0,0,8,19,23,28,51,10,4,4,12,23,40
1309,Jakob Poeltl,21,TOR,NBA,2016-17,54,4,626,67,115,67,115,0,0,31,57,78,87,165,12,17,20,29,113,165
1310,Alex Poythress,23,PHI,NBA,2016-17,6,1,157,25,54,19,35,6,19,8,10,11,18,29,5,3,2,3,14,64
1311,Tim Quarterman,22,POR,NBA,2016-17,16,0,80,13,29,8,16,5,13,0,3,4,10,14,11,2,3,11,6,31
1312,Chasson Randle,23,TOT,NBA,2016-17,26,0,299,40,98,24,51,16,47,41,43,6,26,32,34,9,2,19,39,137
1313,Malachi Richardson,21,SAC,NBA,2016-17,22,0,198,28,68,20,40,8,28,15,19,3,20,23,11,5,1,8,23,79
1314,Domantas Sabonis,20,OKC,NBA,2016-17,81,66,1632,192,481,141,322,51,159,44,67,45,242,287,82,39,32,83,200,479
1315,Dario Saric,22,PHI,NBA,2016-17,81,36,2129,381,927,275,586,106,341,172,220,112,401,513,182,57,30,183,162,1040
1316,Tomas Satoransky,25,WAS,NBA,2016-17,57,3,719,61,146,52,109,9,37,23,33,25,58,83,92,26,6,38,60,154
1317,Wayne Selden,22,TOT,NBA,2016-17,14,5,236,25,58,18,30,7,28,14,22,1,15,16,13,6,1,12,18,71
1318,Pascal Siakam,22,TOR,NBA,2016-17,55,38,859,103,205,102,198,1,7,22,32,64,121,185,17,26,45,33,109,229
1319,Diamond Stone,19,LAC,NBA,2016-17,7,0,24,3,13,3,13,0,0,4,4,1,5,6,0,0,1,2,5,10
1320,Isaiah Taylor,22,HOU,NBA,2016-17,4,0,52,1,7,1,5,0,2,1,2,1,2,3,3,1,1,0,6,3
1321,Mike Tobey,22,CHO,NBA,2016-17,2,0,25,1,4,1,4,0,0,0,0,2,1,3,1,0,0,1,2,2
1322,Tyler Ulis,21,PHO,NBA,2016-17,61,15,1123,184,437,163,358,21,79,55,71,20,75,95,226,48,5,77,73,444
1323,Jarrod Uthoff,23,DAL,NBA,2016-17,9,0,115,16,38,13,29,3,9,5,7,8,14,22,9,2,4,3,8,40
1324,Denzel Valentine,23,CHI,NBA,2016-17,57,0,976,102,288,29,80,73,208,14,18,11,140,151,63,30,7,49,86,291
1325,Fred VanVleet,22,TOR,NBA,2016-17,37,0,294,39,111,28,82,11,29,18,22,4,38,42,35,17,2,15,36,107
1326,Taurean Waller-Prince,22,ATL,NBA,2016-17,59,10,981,114,285,81,183,33,102,74,94,25,132,157,55,43,27,61,96,335
1327,Okaro White,24,MIA,NBA,2016-17,35,0,471,33,87,21,53,12,34,20,22,25,57,82,21,10,10,18,52,98
1328,Isaiah Whitehead,21,BRK,NBA,2016-17,73,26,1643,204,508,160,359,44,149,91,113,32,152,184,192,42,36,142,175,543
1329,Troy Williams,22,TOT,NBA,2016-17,30,16,557,73,167,55,105,18,62,21,32,15,54,69,25,27,10,33,60,185
1330,Kyle Wiltjer,24,HOU,NBA,2016-17,14,0,44,4,14,0,1,4,13,1,2,4,6,10,2,3,1,5,4,13
1331,Stephen Zimmerman,20,ORL,NBA,2016-17,19,0,108,10,31,10,31,0,0,3,5,11,24,35,4,2,5,3,17,23
1332,Paul Zipser,22,CHI,NBA,2016-17,44,18,843,88,221,55,122,33,99,31,40,15,110,125,36,15,16,40,78,240
1333,Ivica Zubac,19,LAL,NBA,2016-17,38,11,609,126,238,126,235,0,3,32,49,41,118,159,30,14,33,30,66,284
