Player,Age,Tm,Lg,Season,G,GS,MP,FG,FGA,2P,2PA,3P,3PA,FT,FTA,ORB,DRB,TRB,AST,STL,BLK,TOV,PF,PTS,FG%,2P%,3P%,FT%,eFG%
A.J. Hammons,24,DAL,NBA,2016-17,22,0,163,17,42,12,32,5,10,9,20,8,28,36,4,1,13,10,21,48,0.404761904762,0.375,0.5,0.45,0.464285714286
Aaron Gordon,19,ORL,NBA,2014-15,47,8,797,93,208,80,160,13,48,44,61,46,123,169,33,21,22,38,83,243,0.447115384615,0.5,0.270833333333,0.72131147541,0.478365384615
Aaron Harrison,21,CHO,NBA,2015-16,21,0,93,5,19,2,9,3,10,5,12,4,11,15,2,6,0,4,10,18,0.263157894737,0.222222222222,0.3,0.416666666667,0.342105263158
Adonis Thomas,20,TOT,NBA,2013-14,6,1,37,6,14,5,9,1,5,1,1,0,3,3,3,0,0,1,6,14,0.428571428571,0.555555555556,0.2,1.0,0.464285714286
Adreian Payne,23,TOT,NBA,2014-15,32,22,739,91,220,90,211,1,9,30,46,48,114,162,30,19,9,44,88,213,0.413636363636,0.42654028436,0.111111111111,0.652173913043,0.415909090909
Al-Farouq Aminu,20,LAC,NBA,2010-11,81,14,1452,160,406,115,263,45,143,92,119,75,192,267,60,59,25,103,121,457,0.394088669951,0.437262357414,0.314685314685,0.773109243697,0.449507389163
Alan Williams,23,PHO,NBA,2015-16,10,0,68,10,24,10,24,0,0,9,14,14,24,38,5,4,5,6,15,29,0.416666666667,0.416666666667,0.0,0.642857142857,0.416666666667
Alec Burks,20,UTA,NBA,2011-12,59,0,939,153,357,138,312,15,45,104,143,57,75,132,55,27,5,51,84,425,0.428571428571,0.442307692308,0.333333333333,0.727272727273,0.449579831933
Alex Kirk,23,CLE,NBA,2014-15,5,0,14,1,4,1,4,0,0,2,2,1,0,1,1,0,0,0,1,4,0.25,0.25,0.0,1.0,0.25
Alex Len,20,PHO,NBA,2013-14,42,3,362,33,78,33,78,0,0,20,31,39,60,99,4,4,18,26,68,86,0.423076923077,0.423076923077,0.0,0.645161290323,0.423076923077
Alex Poythress,23,PHI,NBA,2016-17,6,1,157,25,54,19,35,6,19,8,10,11,18,29,5,3,2,3,14,64,0.462962962963,0.542857142857,0.315789473684,0.8,0.518518518519
Alex Stepheson,28,TOT,NBA,2015-16,8,0,73,9,27,9,27,0,0,4,12,19,9,28,2,1,5,0,12,22,0.333333333333,0.333333333333,0.0,0.333333333333,0.333333333333
Allen Crabbe,21,POR,NBA,2013-14,15,0,100,12,33,6,19,6,14,3,4,1,8,9,6,2,1,3,10,33,0.363636363636,0.315789473684,0.428571428571,0.75,0.454545454545
Andre Dawkins,23,MIA,NBA,2014-15,4,0,22,1,6,0,0,1,6,0,0,0,2,2,1,0,0,1,3,3,0.166666666667,0.0,0.166666666667,0.0,0.25
Andre Drummond,19,DET,NBA,2012-13,60,10,1243,208,342,207,340,1,2,59,159,169,288,457,30,59,95,57,144,476,0.608187134503,0.608823529412,0.5,0.37106918239,0.609649122807
Andre Roberson,22,OKC,NBA,2013-14,40,16,399,33,68,31,55,2,13,7,10,36,58,94,15,19,10,19,74,75,0.485294117647,0.563636363636,0.153846153846,0.7,0.5
Andrew Goudelock,23,LAL,NBA,2011-12,40,0,419,68,174,40,99,28,75,11,12,5,26,31,20,4,0,21,32,175,0.390804597701,0.40404040404,0.373333333333,0.916666666667,0.471264367816
Andrew Harrison,22,MEM,NBA,2016-17,72,18,1474,117,360,74,204,43,156,148,194,23,113,136,198,54,20,85,194,425,0.325,0.362745098039,0.275641025641,0.762886597938,0.384722222222
Andrew Nicholson,23,ORL,NBA,2012-13,75,28,1249,256,486,256,486,0,0,75,94,69,189,258,44,24,32,79,133,587,0.526748971193,0.526748971193,0.0,0.797872340426,0.526748971193
Andrew Wiggins,19,MIN,NBA,2014-15,82,82,2969,497,1137,458,1011,39,126,354,466,134,240,374,170,86,50,177,190,1387,0.437115215479,0.453016815035,0.309523809524,0.759656652361,0.454265611258
Andy Rautins,24,NYK,NBA,2010-11,5,0,24,3,7,2,3,1,4,1,2,0,1,1,3,1,0,7,0,8,0.428571428571,0.666666666667,0.25,0.5,0.5
Anthony Bennett,20,CLE,NBA,2013-14,52,0,663,80,225,67,172,13,53,44,69,49,106,155,17,21,8,47,93,217,0.355555555556,0.389534883721,0.245283018868,0.63768115942,0.384444444444
Anthony Brown,23,LAL,NBA,2015-16,29,11,599,39,126,19,56,20,70,17,20,9,61,70,19,14,5,15,34,115,0.309523809524,0.339285714286,0.285714285714,0.85,0.388888888889
Anthony Davis,19,NOH,NBA,2012-13,64,60,1846,349,676,349,670,0,6,169,225,165,357,522,63,75,112,89,158,867,0.516272189349,0.520895522388,0.0,0.751111111111,0.516272189349
Archie Goodwin,19,PHO,NBA,2013-14,52,0,533,76,167,71,131,5,36,37,55,25,62,87,20,20,11,44,45,194,0.455089820359,0.541984732824,0.138888888889,0.672727272727,0.47005988024
Arinze Onuaku,26,TOT,NBA,2013-14,5,0,30,1,5,1,5,0,0,1,2,2,6,8,3,0,0,1,3,3,0.2,0.2,0.0,0.5,0.2
Armon Johnson,21,POR,NBA,2010-11,38,0,277,46,101,41,89,5,12,13,22,11,25,36,45,5,1,38,31,110,0.455445544554,0.460674157303,0.416666666667,0.590909090909,0.480198019802
Arnett Moultrie,22,PHI,NBA,2012-13,47,0,542,78,134,78,134,0,0,18,28,76,69,145,10,17,10,19,43,174,0.582089552239,0.582089552239,0.0,0.642857142857,0.582089552239
Austin Rivers,20,NOH,NBA,2012-13,61,26,1418,145,390,117,304,28,86,59,108,16,93,109,127,26,9,74,122,377,0.371794871795,0.384868421053,0.325581395349,0.546296296296,0.407692307692
Avery Bradley,20,BOS,NBA,2010-11,31,0,162,23,67,23,62,0,5,6,12,4,13,17,12,9,0,16,20,52,0.34328358209,0.370967741935,0.0,0.5,0.34328358209
Ben Bentil,21,DAL,NBA,2016-17,3,0,10,0,3,0,2,0,1,0,0,0,2,2,0,0,0,1,1,0,0.0,0.0,0.0,0.0,0.0
Ben Hansbrough,25,IND,NBA,2012-13,28,0,200,15,45,9,22,6,23,21,27,2,16,18,21,7,2,18,23,57,0.333333333333,0.409090909091,0.260869565217,0.777777777778,0.4
Ben McLemore,20,SAC,NBA,2013-14,82,55,2187,255,679,160,382,95,297,115,143,53,182,235,82,45,18,96,201,720,0.375552282769,0.418848167539,0.319865319865,0.804195804196,0.445508100147
Ben Uzoh,22,NJN,NBA,2010-11,42,0,438,61,144,58,136,3,8,33,56,30,31,61,69,13,8,25,29,158,0.423611111111,0.426470588235,0.375,0.589285714286,0.434027777778
Bernard James,27,DAL,NBA,2012-13,46,11,457,53,103,53,101,0,2,25,41,52,79,131,6,12,38,18,64,131,0.514563106796,0.524752475248,0.0,0.609756097561,0.514563106796
Bobby Portis,20,CHI,NBA,2015-16,62,4,1102,186,436,170,384,16,52,48,66,123,214,337,52,25,22,54,100,436,0.426605504587,0.442708333333,0.307692307692,0.727272727273,0.44495412844
Bradley Beal,19,WAS,NBA,2012-13,56,46,1745,282,687,191,451,91,236,125,159,43,168,211,137,50,29,90,113,780,0.410480349345,0.423503325942,0.385593220339,0.786163522013,0.476710334789
Branden Dawson,22,LAC,NBA,2015-16,6,0,29,2,5,2,5,0,0,1,1,2,2,4,0,0,1,0,2,5,0.4,0.4,0.0,1.0,0.4
Brandon Davies,22,PHI,NBA,2013-14,51,0,575,54,128,52,118,2,10,34,53,38,71,109,28,24,8,35,92,144,0.421875,0.440677966102,0.2,0.641509433962,0.4296875
Brandon Ingram,19,LAL,NBA,2016-17,79,40,2279,276,686,221,499,55,187,133,214,60,257,317,166,50,36,116,158,740,0.402332361516,0.442885771543,0.294117647059,0.621495327103,0.442419825073
Brandon Knight,20,DET,NBA,2011-12,66,60,2129,319,769,214,493,105,276,104,137,33,178,211,251,49,10,171,154,847,0.414824447334,0.434077079108,0.380434782609,0.759124087591,0.483094928479
Briante Weber,23,TOT,NBA,2015-16,7,4,169,14,39,14,34,0,5,3,4,8,17,25,21,9,3,9,12,31,0.358974358974,0.411764705882,0.0,0.75,0.358974358974
Brice Johnson,22,LAC,NBA,2016-17,3,0,9,2,7,2,7,0,0,0,0,1,2,3,1,2,1,1,0,4,0.285714285714,0.285714285714,0.0,0.0,0.285714285714
Bryce Cotton,22,UTA,NBA,2014-15,15,0,159,29,69,22,49,7,20,15,18,3,15,18,15,4,0,12,6,80,0.420289855072,0.448979591837,0.35,0.833333333333,0.471014492754
Bryce Dejean-Jones,23,NOP,NBA,2015-16,14,11,279,28,69,16,37,12,32,11,21,8,40,48,15,10,2,11,17,79,0.405797101449,0.432432432432,0.375,0.52380952381,0.492753623188
Bryn Forbes,23,SAS,NBA,2016-17,36,0,285,36,99,19,46,17,53,5,6,2,21,23,23,1,0,11,20,94,0.363636363636,0.413043478261,0.320754716981,0.833333333333,0.449494949495
Buddy Hield,23,TOT,NBA,2016-17,82,55,1888,327,768,179,389,148,379,64,76,35,234,269,121,38,9,101,115,866,0.42578125,0.460154241645,0.390501319261,0.842105263158,0.522135416667
C.J. McCollum,22,POR,NBA,2013-14,38,0,476,74,178,44,98,30,80,23,34,7,41,48,27,14,2,35,53,201,0.415730337079,0.448979591837,0.375,0.676470588235,0.5
C.J. Wilcox,24,LAC,NBA,2014-15,21,0,101,16,38,9,19,7,19,2,2,1,6,7,8,3,1,10,7,41,0.421052631579,0.473684210526,0.368421052632,1.0,0.513157894737
Cameron Bairstow,24,CHI,NBA,2014-15,18,1,64,3,14,3,14,0,0,4,5,6,2,8,1,2,1,3,8,10,0.214285714286,0.214285714286,0.0,0.8,0.214285714286
Cameron Payne,21,OKC,NBA,2015-16,57,1,698,114,278,78,167,36,111,19,24,9,76,85,108,36,6,44,80,283,0.410071942446,0.467065868263,0.324324324324,0.791666666667,0.474820143885
Caris LeVert,22,BRK,NBA,2016-17,57,26,1237,171,380,112,196,59,184,67,93,23,165,188,110,49,8,59,91,468,0.45,0.571428571429,0.320652173913,0.720430107527,0.527631578947
Carrick Felix,23,CLE,NBA,2013-14,7,0,38,7,14,5,9,2,5,3,4,1,5,6,4,0,0,4,4,19,0.5,0.555555555556,0.4,0.75,0.571428571429
Casper Ware,24,PHI,NBA,2013-14,9,0,116,18,42,11,21,7,21,5,6,0,9,9,10,8,0,5,11,48,0.428571428571,0.52380952381,0.333333333333,0.833333333333,0.511904761905
Chandler Parsons,23,HOU,NBA,2011-12,63,57,1804,248,549,188,371,60,178,43,78,90,210,300,134,73,29,81,142,599,0.451730418944,0.506738544474,0.337078651685,0.551282051282,0.506375227687
Charles Jenkins,22,GSW,NBA,2011-12,51,28,893,130,291,127,271,3,20,34,39,8,60,68,170,33,6,60,85,297,0.446735395189,0.468634686347,0.15,0.871794871795,0.451890034364
Chasson Randle,23,TOT,NBA,2016-17,26,0,299,40,98,24,51,16,47,41,43,6,26,32,34,9,2,19,39,137,0.408163265306,0.470588235294,0.340425531915,0.953488372093,0.489795918367
Cheick Diallo,20,NOP,NBA,2016-17,17,0,199,36,76,36,76,0,0,15,21,23,50,73,4,4,7,7,17,87,0.473684210526,0.473684210526,0.0,0.714285714286,0.473684210526
Chinanu Onuaku,20,HOU,NBA,2016-17,5,1,52,5,7,5,7,0,0,4,4,2,8,10,3,3,1,4,6,14,0.714285714286,0.714285714286,0.0,1.0,0.714285714286
Chris Babb,23,BOS,NBA,2013-14,14,0,132,8,30,2,3,6,27,0,0,4,13,17,3,6,0,3,13,22,0.266666666667,0.666666666667,0.222222222222,0.0,0.366666666667
Chris McCullough,20,BRK,NBA,2015-16,24,4,362,44,109,31,75,13,34,11,23,25,43,68,9,28,12,15,39,112,0.403669724771,0.413333333333,0.382352941176,0.478260869565,0.463302752294
Chris Singleton,22,WAS,NBA,2011-12,66,51,1431,116,312,72,185,44,127,30,44,43,190,233,49,70,30,38,176,306,0.371794871795,0.389189189189,0.346456692913,0.681818181818,0.442307692308
Chris Smith,26,NYK,NBA,2013-14,2,0,2,0,0,0,0,0,0,0,0,0,0,0,0,0,0,0,0,0,0.0,0.0,0.0,0.0,0.0
Chris Wright Dos,23,DAL,NBA,2012-13,3,0,4,1,2,1,2,0,0,0,0,0,0,0,0,0,0,1,0,2,0.5,0.5,0.0,0.0,0.5
Chris Wright Uno,23,GSW,NBA,2011-12,24,1,186,23,45,23,45,0,0,24,31,19,26,45,4,7,13,8,22,70,0.511111111111,0.511111111111,0.0,0.774193548387,0.511111111111
Christapher Johnson,22,MEM,NBA,2012-13,8,0,102,11,25,5,7,6,18,1,2,5,6,11,2,4,0,3,5,29,0.44,0.714285714286,0.333333333333,0.5,0.56
Christian Wood,20,PHI,NBA,2015-16,17,0,145,22,53,18,42,4,11,13,21,13,25,38,3,5,7,2,11,61,0.415094339623,0.428571428571,0.363636363636,0.619047619048,0.452830188679
Cleanthony Early,23,NYK,NBA,2014-15,39,7,647,76,214,54,130,22,84,36,48,22,75,97,36,24,12,40,57,210,0.355140186916,0.415384615385,0.261904761905,0.75,0.406542056075
Cliff Alexander,20,POR,NBA,2015-16,8,0,36,5,10,5,10,0,0,0,0,2,4,6,0,1,2,1,1,10,0.5,0.5,0.0,0.0,0.5
Cody Zeller,21,CHA,NBA,2013-14,82,3,1416,172,404,172,403,0,1,146,200,118,235,353,92,40,41,87,170,490,0.425742574257,0.426799007444,0.0,0.73,0.425742574257
Cole Aldrich,22,OKC,NBA,2010-11,18,0,142,8,15,8,15,0,0,2,4,13,22,35,4,5,7,8,30,18,0.533333333333,0.533333333333,0.0,0.5,0.533333333333
Cory Higgins,22,CHA,NBA,2011-12,38,0,423,52,160,48,140,4,20,42,60,7,28,35,36,5,6,39,40,150,0.325,0.342857142857,0.2,0.7,0.3375
Cory Jefferson,24,BRK,NBA,2014-15,50,1,531,75,167,73,152,2,15,31,54,47,98,145,16,10,21,20,61,183,0.449101796407,0.480263157895,0.133333333333,0.574074074074,0.455089820359
Cory Joseph,20,SAS,NBA,2011-12,29,1,266,22,70,19,55,3,15,11,17,5,20,25,34,7,3,12,16,58,0.314285714286,0.345454545455,0.2,0.647058823529,0.335714285714
Coty Clarke,23,BOS,NBA,2015-16,3,0,6,2,4,0,2,2,2,0,0,0,1,1,0,0,0,1,0,6,0.5,0.0,1.0,0.0,0.75
Courtney Fortson,23,TOT,NBA,2011-12,10,0,95,11,32,8,19,3,13,10,15,6,9,15,10,3,0,10,5,35,0.34375,0.421052631579,0.230769230769,0.666666666667,0.390625
Craig Brackins,23,PHI,NBA,2010-11,3,0,33,4,16,4,11,0,5,0,0,2,2,4,1,1,0,0,3,8,0.25,0.363636363636,0.0,0.0,0.25
D'Angelo Russell,19,LAL,NBA,2015-16,80,48,2259,392,956,262,586,130,370,140,190,47,227,274,266,93,13,196,142,1054,0.410041841004,0.447098976109,0.351351351351,0.736842105263,0.478033472803
D.J. Kennedy,22,CLE,NBA,2011-12,2,0,59,5,12,3,8,2,4,0,2,1,6,7,3,2,0,3,7,12,0.416666666667,0.375,0.5,0.0,0.5
D.J. Stephens,23,MIL,NBA,2013-14,3,0,15,3,7,3,7,0,0,1,1,1,4,5,0,0,0,0,0,7,0.428571428571,0.428571428571,0.0,1.0,0.428571428571
Damian Jones,21,GSW,NBA,2016-17,10,0,85,8,16,8,16,0,0,3,10,9,14,23,0,1,4,6,15,19,0.5,0.5,0.0,0.3,0.5
Damian Lillard,22,POR,NBA,2012-13,82,82,3167,553,1288,368,785,185,503,271,321,42,215,257,531,74,19,243,172,1562,0.429347826087,0.468789808917,0.367793240557,0.844236760125,0.501164596273
Damion James,23,NJN,NBA,2010-11,25,9,403,46,103,46,100,0,3,18,28,17,68,85,20,16,12,25,36,110,0.446601941748,0.46,0.0,0.642857142857,0.446601941748
Daniel Ochefu,23,WAS,NBA,2016-17,19,0,75,12,27,12,27,0,0,0,2,5,17,22,3,2,0,3,17,24,0.444444444444,0.444444444444,0.0,0.0,0.444444444444
Daniel Orton,21,ORL,NBA,2011-12,16,2,187,17,30,17,29,0,1,11,25,19,20,39,5,8,9,7,30,45,0.566666666667,0.586206896552,0.0,0.44,0.566666666667
Danuel House,23,WAS,NBA,2016-17,1,0,1,0,0,0,0,0,0,0,0,0,1,1,0,0,0,0,0,0,0.0,0.0,0.0,0.0,0.0
Darington Hobson,24,MIL,NBA,2011-12,5,0,39,2,13,2,7,0,6,0,0,0,3,3,6,0,0,2,1,4,0.153846153846,0.285714285714,0.0,0.0,0.153846153846
Darius Johnson-Odom,23,LAL,NBA,2012-13,4,0,6,0,4,0,3,0,1,0,0,1,3,4,1,0,0,0,0,0,0.0,0.0,0.0,0.0,0.0
Darius Miller,22,NOH,NBA,2012-13,52,2,694,44,108,22,52,22,56,8,8,8,70,78,44,17,12,23,89,118,0.407407407407,0.423076923077,0.392857142857,1.0,0.509259259259
Darius Morris,21,LAL,NBA,2011-12,19,0,169,18,42,14,33,4,9,6,9,2,14,16,21,2,0,19,16,46,0.428571428571,0.424242424242,0.444444444444,0.666666666667,0.47619047619
Darrun Hilliard,22,DET,NBA,2015-16,38,2,383,52,131,33,81,19,50,29,40,5,40,45,27,9,1,19,28,152,0.396946564885,0.407407407407,0.38,0.725,0.469465648855
David Nwaba,24,LAL,NBA,2016-17,20,2,397,47,81,46,76,1,5,25,39,16,46,62,14,13,7,11,36,120,0.58024691358,0.605263157895,0.2,0.641025641026,0.586419753086
David Stockton,23,SAC,NBA,2014-15,3,0,33,2,6,1,4,1,2,3,6,0,2,2,9,2,0,4,1,8,0.333333333333,0.25,0.5,0.5,0.416666666667
David Wear,24,SAC,NBA,2014-15,2,0,7,0,2,0,1,0,1,0,0,2,0,2,1,0,0,0,1,0,0.0,0.0,0.0,0.0,0.0
DeAndre Liggins,23,ORL,NBA,2011-12,17,0,115,12,25,12,21,0,4,9,19,6,9,15,5,6,0,10,6,33,0.48,0.571428571429,0.0,0.473684210526,0.48
DeMarcus Cousins,20,SAC,NBA,2010-11,81,62,2309,432,1004,429,986,3,18,276,402,217,482,699,204,85,68,268,332,1143,0.430278884462,0.43509127789,0.166666666667,0.686567164179,0.431772908367
DeQuan Jones,22,ORL,NBA,2012-13,63,17,803,95,218,86,183,9,35,34,51,17,88,105,16,19,22,30,55,233,0.435779816514,0.469945355191,0.257142857143,0.666666666667,0.456422018349
Dejounte Murray,20,SAS,NBA,2016-17,38,8,322,50,116,41,93,9,23,21,30,6,36,42,48,8,6,38,29,130,0.431034482759,0.440860215054,0.391304347826,0.7,0.469827586207
Delon Wright,23,TOR,NBA,2015-16,27,1,229,36,80,31,67,5,13,26,35,8,29,37,31,8,3,16,7,103,0.45,0.462686567164,0.384615384615,0.742857142857,0.48125
Demetrius Jackson,22,BOS,NBA,2016-17,5,0,17,3,4,2,3,1,1,3,6,2,2,4,3,0,0,0,0,10,0.75,0.666666666667,1.0,0.5,0.875
Dennis Horner,23,NJN,NBA,2011-12,8,0,22,1,4,1,3,0,1,3,4,2,3,5,0,0,0,1,1,5,0.25,0.333333333333,0.0,0.75,0.25
Denzel Valentine,23,CHI,NBA,2016-17,57,0,976,102,288,29,80,73,208,14,18,11,140,151,63,30,7,49,86,291,0.354166666667,0.3625,0.350961538462,0.777777777778,0.480902777778
Derrick Caracter,22,LAL,NBA,2010-11,41,0,215,32,66,32,66,0,0,17,23,19,24,43,7,4,10,19,47,81,0.484848484848,0.484848484848,0.0,0.739130434783,0.484848484848
Derrick Favors,19,TOT,NBA,2010-11,78,27,1535,215,416,215,416,0,0,103,173,171,241,412,39,29,68,77,246,533,0.516826923077,0.516826923077,0.0,0.595375722543,0.516826923077
Derrick Williams,20,MIN,NBA,2011-12,66,15,1418,205,498,168,360,37,138,136,195,77,234,311,38,30,31,77,95,583,0.411646586345,0.466666666667,0.268115942029,0.697435897436,0.448795180723
Devin Booker,19,PHO,NBA,2015-16,76,51,2108,367,867,268,578,99,289,215,256,27,160,187,200,44,20,160,225,1048,0.423298731257,0.463667820069,0.342560553633,0.83984375,0.480392156863
Devin Ebanks,21,LAL,NBA,2010-11,20,0,118,21,51,19,46,2,5,18,23,15,12,27,2,4,5,6,7,62,0.411764705882,0.413043478261,0.4,0.782608695652,0.43137254902
Dewayne Dedmon,24,TOT,NBA,2013-14,31,6,390,38,83,38,83,0,0,21,32,38,89,127,5,7,22,18,66,97,0.457831325301,0.457831325301,0.0,0.65625,0.457831325301
Dexter Pittman,22,MIA,NBA,2010-11,2,0,11,1,3,1,3,0,0,0,0,1,2,3,0,0,0,2,2,2,0.333333333333,0.333333333333,0.0,0.0,0.333333333333
Deyonta Davis,20,MEM,NBA,2016-17,36,0,238,24,47,24,47,0,0,10,18,20,40,60,2,3,17,8,40,58,0.510638297872,0.510638297872,0.0,0.555555555556,0.510638297872
Diamond Stone,19,LAC,NBA,2016-17,7,0,24,3,13,3,13,0,0,4,4,1,5,6,0,0,1,2,5,10,0.230769230769,0.230769230769,0.0,1.0,0.230769230769
Diante Garrett,24,PHO,NBA,2012-13,19,0,149,16,49,13,34,3,15,5,10,5,10,15,31,10,0,16,5,40,0.326530612245,0.382352941176,0.2,0.5,0.357142857143
Dion Waiters,21,CLE,NBA,2012-13,61,48,1756,336,815,273,612,63,203,159,213,22,127,149,183,59,16,121,113,894,0.41226993865,0.446078431373,0.310344827586,0.746478873239,0.450920245399
Domantas Sabonis,20,OKC,NBA,2016-17,81,66,1632,192,481,141,322,51,159,44,67,45,242,287,82,39,32,83,200,479,0.399168399168,0.437888198758,0.320754716981,0.65671641791,0.452182952183
Dominique Jones,22,DAL,NBA,2010-11,18,0,135,14,45,14,41,0,4,14,17,6,19,25,19,5,3,10,7,42,0.311111111111,0.341463414634,0.0,0.823529411765,0.311111111111
Donald Sloan,24,TOT,NBA,2011-12,33,11,669,79,198,77,173,2,25,23,30,18,49,67,105,13,3,49,37,183,0.39898989899,0.445086705202,0.08,0.766666666667,0.40404040404
Dorian Finney-Smith,23,DAL,NBA,2016-17,81,35,1642,124,333,68,142,56,191,46,61,55,166,221,67,52,25,45,125,350,0.372372372372,0.478873239437,0.293193717277,0.754098360656,0.456456456456
Doron Lamb,21,TOT,NBA,2012-13,47,0,577,60,163,46,126,14,37,20,34,8,38,46,32,13,0,26,52,154,0.368098159509,0.365079365079,0.378378378378,0.588235294118,0.411042944785
Doug McDermott,23,CHI,NBA,2014-15,36,0,321,43,107,30,66,13,41,10,15,6,37,43,6,4,1,17,29,109,0.401869158879,0.454545454545,0.317073170732,0.666666666667,0.46261682243
Draymond Green,22,GSW,NBA,2012-13,79,1,1061,84,257,70,190,14,67,45,55,58,202,260,53,42,25,51,159,227,0.326848249027,0.368421052632,0.208955223881,0.818181818182,0.354085603113
Drew Gordon,24,PHI,NBA,2014-15,9,0,71,8,19,8,16,0,3,1,2,7,11,18,2,1,0,8,7,17,0.421052631579,0.5,0.0,0.5,0.421052631579
Duje Dukan,24,SAC,NBA,2015-16,1,0,24,2,10,0,5,2,5,0,0,2,2,4,1,1,0,0,2,6,0.2,0.0,0.4,0.0,0.3
Dwight Buycks,24,TOR,NBA,2013-14,14,0,146,15,48,10,31,5,17,8,9,4,19,23,10,8,0,10,11,43,0.3125,0.322580645161,0.294117647059,0.888888888889,0.364583333333
Dwight Powell,23,TOT,NBA,2014-15,29,0,236,31,67,28,56,3,11,25,33,18,32,50,9,9,6,11,40,90,0.462686567164,0.5,0.272727272727,0.757575757576,0.485074626866
E'Twaun Moore,22,BOS,NBA,2011-12,38,0,331,43,113,26,68,17,45,7,7,4,29,33,34,11,3,21,33,110,0.380530973451,0.382352941176,0.377777777778,1.0,0.455752212389
Ed Davis,21,TOR,NBA,2010-11,65,17,1602,215,373,215,373,0,0,71,128,168,294,462,40,39,67,48,183,501,0.576407506702,0.576407506702,0.0,0.5546875,0.576407506702
Edwin Ubiles,25,WAS,NBA,2011-12,4,0,52,5,18,4,13,1,5,3,3,2,8,10,1,1,1,1,1,14,0.277777777778,0.307692307692,0.2,1.0,0.305555555556
Ekpe Udoh,23,GSW,NBA,2010-11,58,18,1030,97,222,97,222,0,0,42,64,80,101,181,40,22,86,48,144,236,0.436936936937,0.436936936937,0.0,0.65625,0.436936936937
Elfrid Payton,20,ORL,NBA,2014-15,82,63,2489,301,708,290,666,11,42,118,214,107,242,349,533,142,20,203,193,731,0.425141242938,0.435435435435,0.261904761905,0.551401869159,0.43290960452
Elias Harris,24,LAL,NBA,2013-14,2,0,11,0,1,0,1,0,0,0,0,1,0,1,1,1,0,0,0,0,0.0,0.0,0.0,0.0,0.0
Elijah Millsap,27,UTA,NBA,2014-15,47,5,924,81,238,53,148,28,90,58,86,28,122,150,58,56,16,67,124,248,0.340336134454,0.358108108108,0.311111111111,0.674418604651,0.399159663866
Elliot Williams,22,POR,NBA,2011-12,24,0,149,37,74,29,47,8,27,6,18,7,12,19,6,6,3,5,18,88,0.5,0.617021276596,0.296296296296,0.333333333333,0.554054054054
Eric Bledsoe,21,LAC,NBA,2010-11,81,25,1841,206,486,174,370,32,116,99,133,68,155,223,289,92,26,194,130,543,0.423868312757,0.47027027027,0.275862068966,0.744360902256,0.456790123457
Eric Moreland,23,SAC,NBA,2014-15,3,0,2,1,1,1,1,0,0,0,0,0,1,1,0,0,0,0,1,2,1.0,1.0,0.0,0.0,1.0
Erick Green,23,DEN,NBA,2014-15,43,1,410,61,162,47,115,14,47,10,12,7,24,31,39,12,0,14,26,146,0.376543209877,0.408695652174,0.297872340426,0.833333333333,0.41975308642
Erik Murphy,23,CHI,NBA,2013-14,24,0,62,3,13,3,10,0,3,0,0,2,6,8,2,0,4,2,7,6,0.230769230769,0.3,0.0,0.0,0.230769230769
Evan Turner,22,PHI,NBA,2010-11,78,14,1797,225,529,211,485,14,44,101,125,42,264,306,159,49,14,80,138,565,0.425330812854,0.435051546392,0.318181818182,0.808,0.438563327032
Fab Melo,22,BOS,NBA,2012-13,6,0,36,3,6,3,6,0,0,1,4,0,3,3,0,2,2,1,7,7,0.5,0.5,0.0,0.25,0.5
Festus Ezeli,23,GSW,NBA,2012-13,78,41,1120,74,169,74,169,0,0,43,81,141,172,313,22,23,74,63,157,191,0.437869822485,0.437869822485,0.0,0.530864197531,0.437869822485
Frank Kaminsky,22,CHO,NBA,2015-16,81,3,1708,215,525,147,323,68,202,108,148,69,266,335,98,38,43,58,126,606,0.409523809524,0.455108359133,0.336633663366,0.72972972973,0.474285714286
Fred VanVleet,22,TOR,NBA,2016-17,37,0,294,39,111,28,82,11,29,18,22,4,38,42,35,17,2,15,36,107,0.351351351351,0.341463414634,0.379310344828,0.818181818182,0.400900900901
Gani Lawal,22,PHO,NBA,2010-11,1,0,2,0,0,0,0,0,0,0,0,0,0,0,0,0,0,0,1,0,0.0,0.0,0.0,0.0,0.0
Gary Harris,20,DEN,NBA,2014-15,55,6,719,66,217,45,114,21,103,35,47,21,43,64,29,39,7,38,71,188,0.304147465438,0.394736842105,0.203883495146,0.744680851064,0.352534562212
Gary Payton,24,MIL,NBA,2016-17,6,0,99,8,22,7,13,1,9,3,5,0,12,12,13,3,4,10,9,20,0.363636363636,0.538461538462,0.111111111111,0.6,0.386363636364
Georges Niang,23,IND,NBA,2016-17,23,0,93,9,36,8,24,1,12,2,2,2,15,17,5,3,0,5,6,21,0.25,0.333333333333,0.0833333333333,1.0,0.263888888889
Glen Rice,23,WAS,NBA,2013-14,11,1,109,11,37,6,20,5,17,5,7,4,16,20,7,6,1,9,7,32,0.297297297297,0.3,0.294117647059,0.714285714286,0.364864864865
Glenn Robinson,21,TOT,NBA,2014-15,35,1,261,26,67,21,48,5,19,16,24,15,24,39,11,6,1,11,15,73,0.388059701493,0.4375,0.263157894737,0.666666666667,0.425373134328
Gordon Hayward,20,UTA,NBA,2010-11,72,17,1218,142,293,107,219,35,74,69,97,41,98,139,81,30,19,70,106,388,0.484641638225,0.488584474886,0.472972972973,0.711340206186,0.544368600683
Gorgui Dieng,24,MIN,NBA,2013-14,60,15,818,113,227,112,226,1,1,59,93,103,197,300,39,30,50,54,108,286,0.497797356828,0.495575221239,1.0,0.634408602151,0.5
Grant Jerrett,21,TOT,NBA,2014-15,8,0,51,7,26,6,11,1,15,1,1,2,7,9,3,2,2,3,11,16,0.269230769231,0.545454545455,0.0666666666667,1.0,0.288461538462
Greg Monroe,20,DET,NBA,2010-11,80,48,2222,303,550,303,549,0,1,145,233,248,353,601,105,93,45,81,196,751,0.550909090909,0.551912568306,0.0,0.622317596567,0.550909090909
Greg Smith,21,HOU,NBA,2011-12,8,0,69,7,11,7,11,0,0,0,0,5,15,20,1,2,5,1,17,14,0.636363636364,0.636363636364,0.0,0.0,0.636363636364
Greivis Vasquez,24,MEM,NBA,2010-11,70,1,860,95,233,70,147,25,86,34,44,12,61,73,151,22,4,70,83,249,0.407725321888,0.47619047619,0.290697674419,0.772727272727,0.461373390558
Hamady N'Diaye,24,WAS,NBA,2010-11,16,0,80,4,5,4,5,0,0,6,12,2,5,7,0,2,5,3,18,14,0.8,0.8,0.0,0.5,0.8
Harrison Barnes,20,GSW,NBA,2012-13,81,81,2058,276,628,224,483,52,145,144,190,53,280,333,98,52,14,101,140,748,0.43949044586,0.463768115942,0.358620689655,0.757894736842,0.480891719745
Hassan Whiteside,21,SAC,NBA,2010-11,1,0,2,0,0,0,0,0,0,0,0,0,0,0,0,0,0,0,2,0,0.0,0.0,0.0,0.0,0.0
Henry Ellenson,20,DET,NBA,2016-17,19,2,146,23,64,13,29,10,35,4,8,8,33,41,7,1,1,14,6,60,0.359375,0.448275862069,0.285714285714,0.5,0.4375
Henry Sims,22,NOH,NBA,2012-13,2,0,5,2,3,2,3,0,0,0,0,2,0,2,0,0,0,1,1,4,0.666666666667,0.666666666667,0.0,0.0,0.666666666667
Hollis Thompson,22,PHI,NBA,2013-14,77,41,1742,171,372,104,205,67,167,52,73,73,174,247,73,53,12,60,144,461,0.459677419355,0.507317073171,0.40119760479,0.712328767123,0.549731182796
Ian Clark,22,UTA,NBA,2013-14,23,0,172,26,67,15,36,11,31,5,7,3,16,19,15,8,2,14,24,68,0.388059701493,0.416666666667,0.354838709677,0.714285714286,0.470149253731
Iman Shumpert,21,NYK,NBA,2011-12,59,35,1705,214,534,166,377,48,157,87,109,42,144,186,164,101,8,111,173,563,0.40074906367,0.440318302387,0.305732484076,0.798165137615,0.445692883895
Isaiah Canaan,22,HOU,NBA,2013-14,22,0,252,31,87,13,32,18,55,21,29,7,17,24,22,8,4,21,25,101,0.35632183908,0.40625,0.327272727273,0.724137931034,0.459770114943
Isaiah Taylor,22,HOU,NBA,2016-17,4,0,52,1,7,1,5,0,2,1,2,1,2,3,3,1,1,0,6,3,0.142857142857,0.2,0.0,0.5,0.142857142857
Isaiah Thomas,22,SAC,NBA,2011-12,65,37,1656,256,571,173,352,83,219,154,185,48,120,168,266,53,8,105,121,749,0.448336252189,0.491477272727,0.37899543379,0.832432432432,0.521015761821
Isaiah Whitehead,21,BRK,NBA,2016-17,73,26,1643,204,508,160,359,44,149,91,113,32,152,184,192,42,36,142,175,543,0.40157480315,0.445682451253,0.295302013423,0.805309734513,0.444881889764
Ivan Johnson,27,ATL,NBA,2011-12,56,0,934,141,275,139,269,2,6,72,100,65,161,226,32,43,18,69,116,356,0.512727272727,0.516728624535,0.333333333333,0.72,0.516363636364
J.J. O'Brien,23,UTA,NBA,2015-16,2,0,6,0,1,0,1,0,0,0,0,0,1,1,0,1,0,0,1,0,0.0,0.0,0.0,0.0,0.0
JaJuan Johnson,22,BOS,NBA,2011-12,36,0,298,54,121,54,121,0,0,6,9,20,38,58,6,5,14,14,25,114,0.446280991736,0.446280991736,0.0,0.666666666667,0.446280991736
JaKarr Sampson,21,PHI,NBA,2014-15,74,32,1131,146,346,115,219,31,127,63,94,35,128,163,77,38,26,76,135,386,0.421965317919,0.525114155251,0.244094488189,0.670212765957,0.46676300578
JaMychal Green,24,TOT,NBA,2014-15,24,1,164,27,47,27,41,0,6,8,10,19,26,45,4,5,5,14,25,62,0.574468085106,0.658536585366,0.0,0.8,0.574468085106
Jabari Brown,22,LAL,NBA,2014-15,19,5,568,70,170,47,108,23,62,64,85,3,33,36,40,12,2,32,33,227,0.411764705882,0.435185185185,0.370967741935,0.752941176471,0.479411764706
Jabari Parker,19,MIL,NBA,2014-15,25,25,738,129,263,125,247,4,16,46,66,50,88,138,42,31,5,47,42,308,0.490494296578,0.506072874494,0.25,0.69696969697,0.498098859316
Jack Cooley,23,UTA,NBA,2014-15,16,0,87,9,22,9,22,0,0,9,21,10,15,25,1,6,3,3,23,27,0.409090909091,0.409090909091,0.0,0.428571428571,0.409090909091
Jae Crowder,22,DAL,NBA,2012-13,78,16,1353,141,367,78,175,63,192,47,73,35,152,187,94,63,17,49,128,392,0.384196185286,0.445714285714,0.328125,0.643835616438,0.470027247956
Jahlil Okafor,20,PHI,NBA,2015-16,53,48,1591,397,781,396,775,1,6,133,194,122,251,373,65,22,61,124,140,928,0.508322663252,0.510967741935,0.166666666667,0.685567010309,0.508962868118
Jake Layman,22,POR,NBA,2016-17,35,1,249,26,89,13,38,13,51,13,17,6,18,24,11,9,3,11,22,78,0.292134831461,0.342105263158,0.254901960784,0.764705882353,0.365168539326
Jakob Poeltl,21,TOR,NBA,2016-17,54,4,626,67,115,67,115,0,0,31,57,78,87,165,12,17,20,29,113,165,0.582608695652,0.582608695652,0.0,0.543859649123,0.582608695652
Jamaal Franklin,22,MEM,NBA,2013-14,21,0,161,16,39,11,28,5,11,2,2,4,19,23,6,4,2,11,23,39,0.410256410256,0.392857142857,0.454545454545,1.0,0.474358974359
Jamal Murray,19,DEN,NBA,2016-17,82,10,1764,295,730,180,386,115,344,106,120,41,173,214,170,52,24,113,124,811,0.404109589041,0.466321243523,0.334302325581,0.883333333333,0.482876712329
James Anderson,21,SAS,NBA,2010-11,26,2,286,31,81,13,35,18,46,14,18,2,21,23,18,3,6,13,24,94,0.382716049383,0.371428571429,0.391304347826,0.777777777778,0.493827160494
James Ennis,24,MIA,NBA,2014-15,62,3,1051,101,247,70,152,31,95,79,94,51,125,176,48,25,17,39,89,312,0.408906882591,0.460526315789,0.326315789474,0.840425531915,0.471659919028
James Michael McAdoo,22,GSW,NBA,2014-15,15,0,137,24,44,24,44,0,0,14,25,15,22,37,2,5,9,6,21,62,0.545454545455,0.545454545455,0.0,0.56,0.545454545455
James Nunnally,23,TOT,NBA,2013-14,13,0,165,15,46,7,21,8,25,6,9,1,18,19,8,6,2,7,11,44,0.326086956522,0.333333333333,0.32,0.666666666667,0.413043478261
James Southerland,23,TOT,NBA,2013-14,4,0,30,5,15,2,9,3,6,1,2,0,8,8,0,1,2,1,3,14,0.333333333333,0.222222222222,0.5,0.5,0.433333333333
James Young,19,BOS,NBA,2014-15,31,0,332,36,102,19,36,17,66,16,29,9,33,42,13,8,2,5,22,105,0.352941176471,0.527777777778,0.257575757576,0.551724137931,0.436274509804
Jared Cunningham,21,DAL,NBA,2012-13,8,0,26,6,14,4,11,2,3,2,2,1,2,3,1,1,0,2,3,16,0.428571428571,0.363636363636,0.666666666667,1.0,0.5
Jared Sullinger,20,BOS,NBA,2012-13,45,5,892,111,225,110,220,1,5,47,63,92,172,264,35,22,22,29,154,270,0.493333333333,0.5,0.2,0.746031746032,0.495555555556
Jarell Eddie,24,WAS,NBA,2015-16,26,0,147,20,65,5,18,15,47,8,8,2,21,23,5,5,1,1,5,63,0.307692307692,0.277777777778,0.31914893617,1.0,0.423076923077
Jarell Martin,21,MEM,NBA,2015-16,27,0,380,54,116,54,114,0,2,45,62,39,47,86,15,8,7,19,58,153,0.465517241379,0.473684210526,0.0,0.725806451613,0.465517241379
Jarnell Stokes,21,MEM,NBA,2014-15,19,2,126,21,37,21,37,0,0,15,28,16,18,34,4,5,5,7,25,57,0.567567567568,0.567567567568,0.0,0.535714285714,0.567567567568
Jarrod Uthoff,23,DAL,NBA,2016-17,9,0,115,16,38,13,29,3,9,5,7,8,14,22,9,2,4,3,8,40,0.421052631579,0.448275862069,0.333333333333,0.714285714286,0.460526315789
Jarvis Varnado,24,TOT,NBA,2012-13,13,0,58,3,7,3,7,0,0,2,4,2,7,9,3,1,2,6,10,8,0.428571428571,0.428571428571,0.0,0.5,0.428571428571
Jaylen Brown,20,BOS,NBA,2016-17,78,20,1341,192,423,146,288,46,135,85,124,45,175,220,64,35,18,68,142,515,0.45390070922,0.506944444444,0.340740740741,0.685483870968,0.508274231678
Jeff Foote,24,NOH,NBA,2011-12,4,0,39,2,6,2,6,0,0,0,0,1,5,6,0,0,1,2,5,4,0.333333333333,0.333333333333,0.0,0.0,0.333333333333
Jeff Withey,23,NOP,NBA,2013-14,58,4,684,69,129,69,128,0,1,52,73,49,101,150,26,15,50,20,73,190,0.53488372093,0.5390625,0.0,0.712328767123,0.53488372093
Jeffery Taylor,23,CHA,NBA,2012-13,77,29,1507,172,399,119,245,53,154,75,103,51,99,150,63,47,15,48,136,472,0.431077694236,0.485714285714,0.344155844156,0.728155339806,0.497493734336
Jerami Grant,20,PHI,NBA,2014-15,65,11,1377,124,352,75,196,49,156,114,193,49,149,198,79,40,68,85,144,411,0.352272727273,0.382653061224,0.314102564103,0.59067357513,0.421875
Jeremy Evans,23,UTA,NBA,2010-11,49,3,463,76,115,76,114,0,1,26,37,36,61,97,24,17,17,19,50,178,0.660869565217,0.666666666667,0.0,0.702702702703,0.660869565217
Jeremy Lamb,20,OKC,NBA,2012-13,23,0,147,24,68,15,38,9,30,14,14,5,13,18,5,2,2,6,13,71,0.352941176471,0.394736842105,0.3,1.0,0.419117647059
Jeremy Lin,22,GSW,NBA,2010-11,29,0,285,28,72,27,67,1,5,19,25,12,22,34,42,33,9,18,31,76,0.388888888889,0.402985074627,0.2,0.76,0.395833333333
Jerian Grant,23,NYK,NBA,2015-16,76,6,1265,154,391,132,291,22,100,96,123,23,120,143,177,50,10,87,97,426,0.393861892583,0.453608247423,0.22,0.780487804878,0.42199488491
Jerome Dyson,24,NOH,NBA,2011-12,9,1,180,19,48,18,40,1,8,28,36,2,17,19,18,11,2,20,19,67,0.395833333333,0.45,0.125,0.777777777778,0.40625
Jerome Jordan,25,NYK,NBA,2011-12,21,0,108,17,33,17,33,0,0,8,10,14,13,27,4,1,6,2,15,42,0.515151515152,0.515151515152,0.0,0.8,0.515151515152
Jerrelle Benimon,23,UTA,NBA,2014-15,2,0,3,0,0,0,0,0,0,0,0,1,2,3,0,0,0,1,0,0,0.0,0.0,0.0,0.0,0.0
Jerry Smith,24,NJN,NBA,2011-12,5,0,46,3,14,2,8,1,6,0,0,2,5,7,4,5,0,0,5,7,0.214285714286,0.25,0.166666666667,0.0,0.25
Jimmer Fredette,22,SAC,NBA,2011-12,61,7,1135,172,446,94,230,78,216,40,48,17,56,73,108,30,3,67,73,462,0.385650224215,0.408695652174,0.361111111111,0.833333333333,0.473094170404
Jimmy Butler,22,CHI,NBA,2011-12,42,0,359,32,79,30,68,2,11,43,56,23,33,56,14,11,5,14,20,109,0.405063291139,0.441176470588,0.181818181818,0.767857142857,0.417721518987
Joe Harris,23,CLE,NBA,2014-15,51,1,493,48,120,17,36,31,84,9,15,7,34,41,26,7,2,27,62,136,0.4,0.472222222222,0.369047619048,0.6,0.529166666667
Joel Bolomboy,23,UTA,NBA,2016-17,12,0,53,9,16,8,12,1,4,3,6,4,13,17,2,1,2,2,1,22,0.5625,0.666666666667,0.25,0.5,0.59375
Joel Embiid,22,PHI,NBA,2016-17,31,31,786,200,429,164,331,36,98,191,244,61,182,243,66,27,76,117,112,627,0.4662004662,0.495468277946,0.367346938776,0.782786885246,0.508158508159
John Henson,22,MIL,NBA,2012-13,63,9,827,162,336,162,333,0,3,56,105,116,181,297,31,19,42,47,83,380,0.482142857143,0.486486486486,0.0,0.533333333333,0.482142857143
John Jenkins,21,ATL,NBA,2012-13,61,2,902,131,294,78,156,53,138,59,70,17,77,94,56,12,10,40,37,374,0.445578231293,0.5,0.384057971014,0.842857142857,0.535714285714
John Wall,20,WAS,NBA,2010-11,69,64,2606,398,972,364,857,34,115,301,393,35,282,317,574,121,35,261,175,1131,0.409465020576,0.424737456243,0.295652173913,0.765903307888,0.42695473251
Johnny O'Bryant,21,MIL,NBA,2014-15,34,15,368,44,120,44,120,0,0,12,27,26,38,64,17,5,4,25,44,100,0.366666666667,0.366666666667,0.0,0.444444444444,0.366666666667
Jon Leuer,22,MIL,NBA,2011-12,46,12,555,97,191,94,182,3,9,21,28,45,75,120,25,14,17,18,67,218,0.507853403141,0.516483516484,0.333333333333,0.75,0.515706806283
Jonathan Gibson,29,DAL,NBA,2016-17,17,0,231,35,95,20,50,15,45,21,29,1,21,22,26,8,0,21,21,106,0.368421052632,0.4,0.333333333333,0.724137931034,0.447368421053
Jonathon Simmons,26,SAS,NBA,2015-16,55,2,813,122,242,104,195,18,47,69,92,16,80,96,58,24,5,53,103,331,0.504132231405,0.533333333333,0.382978723404,0.75,0.54132231405
Jordan Adams,20,MEM,NBA,2014-15,30,0,248,35,86,25,61,10,25,14,23,9,19,28,16,16,7,14,24,94,0.406976744186,0.409836065574,0.4,0.608695652174,0.46511627907
Jordan Clarkson,22,LAL,NBA,2014-15,59,38,1476,267,596,229,475,38,121,131,158,56,135,191,206,51,12,96,109,703,0.447986577181,0.482105263158,0.314049586777,0.829113924051,0.479865771812
Jordan Crawford,22,TOT,NBA,2010-11,42,18,1027,192,500,159,372,33,128,73,84,31,74,105,117,39,3,83,63,490,0.384,0.427419354839,0.2578125,0.869047619048,0.417
Jordan Hamilton,21,DEN,NBA,2011-12,26,2,258,48,111,31,64,17,47,2,5,11,51,62,20,4,3,16,15,115,0.432432432432,0.484375,0.36170212766,0.4,0.509009009009
Jordan McRae,24,TOT,NBA,2015-16,22,1,195,34,78,24,56,10,22,21,28,4,16,20,25,3,1,15,17,99,0.435897435897,0.428571428571,0.454545454545,0.75,0.5
Jordan Mickey,21,BOS,NBA,2015-16,16,0,57,8,22,8,22,0,0,5,10,6,7,13,1,0,11,1,5,21,0.363636363636,0.363636363636,0.0,0.5,0.363636363636
Jordan Williams,21,NJN,NBA,2011-12,43,5,635,77,152,77,152,0,0,43,66,66,90,156,11,21,15,23,61,197,0.506578947368,0.506578947368,0.0,0.651515151515,0.506578947368
Jorge Gutierrez,25,BRK,NBA,2013-14,15,2,244,25,54,22,42,3,12,9,12,3,19,22,30,10,1,14,37,62,0.462962962963,0.52380952381,0.25,0.75,0.490740740741
Josh Harrellson,22,NYK,NBA,2011-12,37,4,540,63,149,43,90,20,59,16,26,47,97,144,11,23,20,20,48,162,0.422818791946,0.477777777778,0.338983050847,0.615384615385,0.489932885906
Josh Huestis,24,OKC,NBA,2015-16,5,0,55,5,12,1,6,4,6,0,4,2,8,10,0,1,2,3,3,14,0.416666666667,0.166666666667,0.666666666667,0.0,0.583333333333
Josh Richardson,22,MIA,NBA,2015-16,52,2,1107,123,272,70,157,53,115,42,63,21,86,107,73,36,25,35,107,341,0.452205882353,0.445859872611,0.460869565217,0.666666666667,0.549632352941
Josh Selby,20,MEM,NBA,2011-12,28,0,237,25,72,23,57,2,15,11,14,2,13,15,30,7,0,29,17,63,0.347222222222,0.40350877193,0.133333333333,0.785714285714,0.361111111111
Julius Randle,20,LAL,NBA,2014-15,1,0,14,1,3,1,3,0,0,0,2,0,0,0,0,0,0,1,1,2,0.333333333333,0.333333333333,0.0,0.0,0.333333333333
Julyan Stone,23,DEN,NBA,2011-12,22,2,179,13,31,11,20,2,11,8,11,5,20,25,37,8,6,11,18,36,0.41935483871,0.55,0.181818181818,0.727272727273,0.451612903226
Justin Anderson,22,DAL,NBA,2015-16,55,9,647,71,175,49,92,22,83,44,55,18,114,132,29,19,25,24,45,208,0.405714285714,0.532608695652,0.265060240964,0.8,0.468571428571
Justin Hamilton,23,TOT,NBA,2013-14,8,0,72,9,20,6,11,3,9,5,5,4,3,7,0,5,0,4,8,26,0.45,0.545454545455,0.333333333333,1.0,0.525
Justin Harper,22,ORL,NBA,2011-12,14,0,84,9,31,7,18,2,13,0,1,3,9,12,2,2,3,6,5,20,0.290322580645,0.388888888889,0.153846153846,0.0,0.322580645161
Justin Holiday,23,PHI,NBA,2012-13,9,0,142,16,48,12,32,4,16,6,8,0,14,14,15,3,6,9,7,42,0.333333333333,0.375,0.25,0.75,0.375
Justise Winslow,19,MIA,NBA,2015-16,78,8,2232,195,462,163,346,32,116,80,117,81,322,403,117,68,26,95,184,502,0.422077922078,0.471098265896,0.275862068966,0.683760683761,0.45670995671
K.J. McDaniels,21,TOT,NBA,2014-15,62,15,1352,172,434,129,284,43,150,100,133,65,135,200,72,44,70,105,126,487,0.396313364055,0.454225352113,0.286666666667,0.751879699248,0.445852534562
Kalin Lucas,25,MEM,NBA,2014-15,1,0,6,0,1,0,1,0,0,0,0,0,0,0,0,1,0,0,1,0,0.0,0.0,0.0,0.0,0.0
Karl-Anthony Towns,20,MIN,NBA,2015-16,82,82,2627,625,1153,595,1065,30,88,223,275,229,629,858,161,58,138,183,245,1503,0.542064180399,0.558685446009,0.340909090909,0.810909090909,0.555073720729
Kawhi Leonard,20,SAS,NBA,2011-12,64,39,1534,199,404,158,295,41,109,68,88,104,223,327,70,85,24,44,88,507,0.492574257426,0.535593220339,0.376146788991,0.772727272727,0.543316831683
Kay Felder,21,CLE,NBA,2016-17,42,0,386,62,158,55,136,7,22,35,49,3,38,41,58,18,7,31,38,166,0.392405063291,0.404411764706,0.318181818182,0.714285714286,0.414556962025
Keith Appling,23,ORL,NBA,2015-16,5,0,27,2,8,2,5,0,3,2,2,0,1,1,1,1,0,3,5,6,0.25,0.4,0.0,1.0,0.25
Keith Benson,23,GSW,NBA,2011-12,3,0,9,0,1,0,1,0,0,0,0,2,1,3,0,0,0,0,0,0,0.0,0.0,0.0,0.0,0.0
Kelly Olynyk,22,BOS,NBA,2013-14,70,9,1400,234,502,194,388,40,114,99,122,140,225,365,109,35,27,106,227,607,0.466135458167,0.5,0.350877192982,0.811475409836,0.505976095618
Kelly Oubre,20,WAS,NBA,2015-16,63,9,671,90,211,65,132,25,79,31,49,25,108,133,13,22,7,34,100,236,0.42654028436,0.492424242424,0.316455696203,0.632653061224,0.485781990521
Kemba Walker,21,CHA,NBA,2011-12,66,25,1792,281,767,212,541,69,226,168,213,30,204,234,289,60,20,119,79,799,0.366362451108,0.391866913124,0.305309734513,0.788732394366,0.411342894394
Kendall Marshall,21,PHO,NBA,2012-13,48,3,702,56,151,33,78,23,73,8,14,4,38,42,143,22,4,57,48,143,0.370860927152,0.423076923077,0.315068493151,0.571428571429,0.44701986755
Kenneth Faried,22,DEN,NBA,2011-12,46,39,1037,181,309,181,309,0,0,109,164,142,210,352,36,34,47,54,116,471,0.585760517799,0.585760517799,0.0,0.664634146341,0.585760517799
Kent Bazemore,23,GSW,NBA,2012-13,61,0,267,43,116,33,82,10,34,27,44,5,17,22,22,17,4,18,27,123,0.370689655172,0.40243902439,0.294117647059,0.613636363636,0.413793103448
Kentavious Caldwell-Pope,20,DET,NBA,2013-14,80,41,1583,182,460,123,275,59,185,47,61,38,118,156,55,75,12,28,145,470,0.395652173913,0.447272727273,0.318918918919,0.770491803279,0.459782608696
Kevin Jones,23,CLE,NBA,2012-13,32,0,334,43,107,43,107,0,0,9,15,38,40,78,10,9,5,8,25,95,0.401869158879,0.401869158879,0.0,0.6,0.401869158879
Kevin Murphy,22,UTA,NBA,2012-13,17,0,52,7,28,6,23,1,5,0,0,0,4,4,2,1,0,3,4,15,0.25,0.260869565217,0.2,0.0,0.267857142857
Kevon Looney,19,GSW,NBA,2015-16,5,0,21,4,7,3,5,1,2,0,0,4,6,10,0,0,0,1,2,9,0.571428571429,0.6,0.5,0.0,0.642857142857
Khris Middleton,21,DET,NBA,2012-13,27,0,475,62,141,48,96,14,45,27,32,4,46,50,28,15,4,11,53,165,0.439716312057,0.5,0.311111111111,0.84375,0.489361702128
Kim English,24,DET,NBA,2012-13,41,0,407,42,112,28,62,14,50,21,29,8,29,37,26,16,3,19,46,119,0.375,0.451612903226,0.28,0.724137931034,0.4375
Klay Thompson,21,GSW,NBA,2011-12,66,29,1608,318,718,207,450,111,268,79,91,24,137,161,133,49,20,103,155,826,0.442896935933,0.46,0.414179104478,0.868131868132,0.520194986072
Kris Dunn,22,MIN,NBA,2016-17,78,7,1333,118,313,97,240,21,73,36,59,24,142,166,188,78,36,89,178,293,0.376996805112,0.404166666667,0.287671232877,0.610169491525,0.41054313099
Kris Joseph,24,TOT,NBA,2012-13,10,0,54,2,14,2,11,0,3,5,8,1,6,7,1,3,0,2,3,9,0.142857142857,0.181818181818,0.0,0.625,0.142857142857
Kyle Anderson,21,SAS,NBA,2014-15,33,8,358,31,89,28,78,3,11,9,14,5,67,72,28,15,7,10,28,74,0.348314606742,0.358974358974,0.272727272727,0.642857142857,0.365168539326
Kyle O'Quinn,22,ORL,NBA,2012-13,57,5,638,101,197,101,196,0,1,30,45,65,144,209,52,11,26,37,107,232,0.51269035533,0.515306122449,0.0,0.666666666667,0.51269035533
Kyle Singler,24,DET,NBA,2012-13,82,74,2293,275,642,205,442,70,200,100,124,109,221,330,77,57,37,98,217,720,0.428348909657,0.463800904977,0.35,0.806451612903,0.482866043614
Kyle Wiltjer,24,HOU,NBA,2016-17,14,0,44,4,14,0,1,4,13,1,2,4,6,10,2,3,1,5,4,13,0.285714285714,0.0,0.307692307692,0.5,0.428571428571
Kyrie Irving,19,CLE,NBA,2011-12,51,51,1558,350,747,277,564,73,183,171,196,44,147,191,275,54,20,160,110,944,0.468540829987,0.491134751773,0.398907103825,0.872448979592,0.517402945114
Lamar Patterson,24,ATL,NBA,2015-16,35,0,395,28,80,16,31,12,49,16,22,4,46,50,39,9,2,23,45,84,0.35,0.516129032258,0.244897959184,0.727272727273,0.425
Lance Stephenson,20,IND,NBA,2010-11,12,0,115,13,39,13,34,0,5,11,14,1,17,18,21,4,0,16,14,37,0.333333333333,0.382352941176,0.0,0.785714285714,0.333333333333
Lance Thomas,23,NOH,NBA,2011-12,42,10,630,57,126,57,125,0,1,52,62,49,77,126,12,10,7,24,78,166,0.452380952381,0.456,0.0,0.838709677419,0.452380952381
Landry Fields,22,NYK,NBA,2010-11,82,81,2541,299,602,213,383,86,219,113,147,105,416,521,155,80,17,107,114,797,0.496677740864,0.556135770235,0.392694063927,0.768707482993,0.568106312292
Langston Galloway,23,NYK,NBA,2014-15,45,41,1457,204,511,142,335,62,176,63,78,37,153,190,150,52,12,61,129,533,0.399217221135,0.423880597015,0.352272727273,0.807692307692,0.45988258317
Larry Drew,24,PHI,NBA,2014-15,12,1,219,20,58,16,32,4,26,2,3,1,14,15,45,6,0,25,13,46,0.344827586207,0.5,0.153846153846,0.666666666667,0.379310344828
Larry Sanders,22,MIL,NBA,2010-11,60,12,872,116,268,116,268,0,0,28,50,59,119,178,16,22,72,38,117,260,0.432835820896,0.432835820896,0.0,0.56,0.432835820896
Lavoy Allen,22,PHI,NBA,2011-12,41,15,624,79,167,79,167,0,0,11,14,47,124,171,34,13,18,20,73,169,0.473053892216,0.473053892216,0.0,0.785714285714,0.473053892216
Lazar Hayward,24,MIN,NBA,2010-11,42,0,419,55,154,38,94,17,60,33,42,23,47,70,28,12,7,19,44,160,0.357142857143,0.404255319149,0.283333333333,0.785714285714,0.412337662338
Lorenzo Brown,23,PHI,NBA,2013-14,26,0,224,26,86,23,56,3,30,9,13,8,20,28,41,13,3,16,19,64,0.302325581395,0.410714285714,0.1,0.692307692308,0.31976744186
Luke Babbitt,21,POR,NBA,2010-11,24,0,137,15,55,12,39,3,16,3,9,6,24,30,6,2,2,8,15,36,0.272727272727,0.307692307692,0.1875,0.333333333333,0.3
Luke Harangody,23,TOT,NBA,2010-11,49,0,640,79,206,63,140,16,66,19,26,40,103,143,30,15,17,16,80,193,0.383495145631,0.45,0.242424242424,0.730769230769,0.422330097087
Maalik Wayns,21,TOT,NBA,2012-13,27,1,202,26,88,19,57,7,31,17,19,1,6,7,27,6,0,15,26,76,0.295454545455,0.333333333333,0.225806451613,0.894736842105,0.335227272727
Malachi Richardson,21,SAC,NBA,2016-17,22,0,198,28,68,20,40,8,28,15,19,3,20,23,11,5,1,8,23,79,0.411764705882,0.5,0.285714285714,0.789473684211,0.470588235294
Malcolm Brogdon,24,MIL,NBA,2016-17,75,28,1982,290,635,212,442,78,193,109,126,47,166,213,317,84,12,113,140,767,0.456692913386,0.47963800905,0.40414507772,0.865079365079,0.51811023622
Malcolm Delaney,27,ATL,NBA,2016-17,73,2,1248,145,388,119,278,26,110,75,93,11,113,124,193,39,1,95,112,391,0.373711340206,0.428057553957,0.236363636364,0.806451612903,0.407216494845
Malcolm Lee,21,MIN,NBA,2011-12,19,0,243,23,59,21,49,2,10,14,17,9,17,26,31,8,4,17,22,62,0.389830508475,0.428571428571,0.2,0.823529411765,0.406779661017
Malcolm Thomas,23,SAS,NBA,2011-12,3,0,15,0,3,0,3,0,0,1,2,1,2,3,1,1,1,0,0,1,0.0,0.0,0.0,0.5,0.0
Malik Beasley,20,DEN,NBA,2016-17,22,1,165,33,73,24,45,9,28,8,10,5,12,17,11,7,0,8,10,83,0.452054794521,0.533333333333,0.321428571429,0.8,0.513698630137
Manny Harris,21,CLE,NBA,2010-11,54,15,933,108,289,74,197,34,92,71,93,36,104,140,85,31,7,63,65,321,0.373702422145,0.375634517766,0.369565217391,0.763440860215,0.432525951557
Marcus Georges-Hunt,22,ORL,NBA,2016-17,5,0,48,2,7,1,5,1,2,9,10,1,8,9,3,1,0,2,5,14,0.285714285714,0.2,0.5,0.9,0.357142857143
Marcus Morris,22,HOU,NBA,2011-12,17,0,126,16,54,14,37,2,17,6,8,5,11,16,3,2,2,4,12,40,0.296296296296,0.378378378378,0.117647058824,0.75,0.314814814815
Marcus Smart,20,BOS,NBA,2014-15,67,38,1808,175,477,84,205,91,272,82,127,61,161,222,208,99,18,90,176,523,0.366876310273,0.409756097561,0.334558823529,0.645669291339,0.462264150943
Markel Brown,23,BRK,NBA,2014-15,47,29,781,76,210,59,146,17,64,47,57,16,91,107,39,31,12,27,57,216,0.361904761905,0.404109589041,0.265625,0.824561403509,0.402380952381
Markieff Morris,22,PHO,NBA,2011-12,63,7,1227,174,436,131,312,43,124,76,106,69,210,279,65,41,42,70,179,467,0.399082568807,0.419871794872,0.346774193548,0.716981132075,0.448394495413
Marquese Chriss,19,PHO,NBA,2016-17,82,75,1743,284,632,212,408,72,224,113,181,96,252,348,60,67,70,108,263,753,0.449367088608,0.519607843137,0.321428571429,0.624309392265,0.506329113924
Marquis Teague,19,CHI,NBA,2012-13,48,0,392,43,113,39,90,4,23,9,16,3,41,44,63,9,7,35,47,99,0.380530973451,0.433333333333,0.173913043478,0.5625,0.398230088496
Marshall Plumlee,24,NYK,NBA,2016-17,21,1,170,16,30,16,30,0,0,8,19,23,28,51,10,4,4,12,23,40,0.533333333333,0.533333333333,0.0,0.421052631579,0.533333333333
Mason Plumlee,23,BRK,NBA,2013-14,70,22,1275,199,302,199,299,0,3,122,195,99,209,308,60,49,55,77,171,520,0.658940397351,0.665551839465,0.0,0.625641025641,0.658940397351
Matthew Dellavedova,23,CLE,NBA,2013-14,72,4,1271,122,296,65,141,57,155,38,48,29,94,123,187,33,5,60,121,339,0.412162162162,0.460992907801,0.367741935484,0.791666666667,0.508445945946
Maurice Harkless,19,ORL,NBA,2012-13,76,59,1974,260,564,228,447,32,117,73,128,122,213,335,50,88,62,69,144,625,0.460992907801,0.510067114094,0.273504273504,0.5703125,0.489361702128
Maurice Ndour,24,NYK,NBA,2016-17,32,4,331,39,86,38,79,1,7,19,26,22,42,64,8,15,8,12,30,98,0.453488372093,0.481012658228,0.142857142857,0.730769230769,0.459302325581
Meyers Leonard,20,POR,NBA,2012-13,69,9,1206,151,277,148,270,3,7,72,89,80,175,255,33,11,38,49,168,377,0.545126353791,0.548148148148,0.428571428571,0.808988764045,0.550541516245
Michael Carter-Williams,22,PHI,NBA,2013-14,70,70,2414,427,1054,372,846,55,208,258,367,101,336,437,441,130,43,247,213,1167,0.405123339658,0.439716312057,0.264423076923,0.702997275204,0.431214421252
Michael Gbinije,24,DET,NBA,2016-17,9,0,32,1,10,1,6,0,4,2,2,2,1,3,2,0,0,0,2,4,0.1,0.166666666667,0.0,1.0,0.1
Michael Kidd-Gilchrist,19,CHA,NBA,2012-13,78,77,2025,281,613,279,604,2,9,140,187,131,324,455,117,54,70,101,164,704,0.458401305057,0.461920529801,0.222222222222,0.748663101604,0.460032626427
Mike Muscala,22,ATL,NBA,2013-14,20,0,215,31,73,31,70,0,3,14,14,17,35,52,7,3,10,12,29,76,0.424657534247,0.442857142857,0.0,1.0,0.424657534247
Mike Scott,24,ATL,NBA,2012-13,40,1,376,70,147,70,146,0,1,43,56,39,71,110,12,4,2,21,32,183,0.47619047619,0.479452054795,0.0,0.767857142857,0.47619047619
Mike Tobey,22,CHO,NBA,2016-17,2,0,25,1,4,1,4,0,0,0,0,2,1,3,1,0,0,1,2,2,0.25,0.25,0.0,0.0,0.25
Miles Plumlee,24,IND,NBA,2012-13,14,0,55,5,21,5,21,0,0,3,4,12,10,22,2,0,3,3,5,13,0.238095238095,0.238095238095,0.0,0.75,0.238095238095
Mitch McGary,22,OKC,NBA,2014-15,32,2,485,88,165,88,163,0,2,25,40,53,112,165,14,16,16,31,72,201,0.533333333333,0.539877300613,0.0,0.625,0.533333333333
Montrezl Harrell,22,HOU,NBA,2015-16,39,1,379,58,90,58,89,0,1,24,46,25,40,65,17,11,11,17,48,140,0.644444444444,0.651685393258,0.0,0.521739130435,0.644444444444
Mychel Thompson,23,CLE,NBA,2011-12,5,3,95,7,24,3,13,4,11,0,0,0,5,5,7,2,1,5,8,18,0.291666666667,0.230769230769,0.363636363636,0.0,0.375
Myles Turner,19,IND,NBA,2015-16,60,30,1367,264,530,261,516,3,14,88,121,68,264,332,41,25,86,67,158,619,0.498113207547,0.505813953488,0.214285714286,0.727272727273,0.500943396226
Nate Wolters,22,MIL,NBA,2013-14,58,31,1309,170,389,152,327,18,62,59,90,33,116,149,187,35,15,57,67,417,0.437017994859,0.464831804281,0.290322580645,0.655555555556,0.460154241645
Nerlens Noel,20,PHI,NBA,2014-15,75,71,2311,302,653,302,653,0,0,140,230,185,426,611,128,133,142,146,208,744,0.46248085758,0.46248085758,0.0,0.608695652174,0.46248085758
Nick Johnson,22,HOU,NBA,2014-15,28,0,262,26,75,21,54,5,21,17,25,13,26,39,11,7,3,19,34,74,0.346666666667,0.388888888889,0.238095238095,0.68,0.38
Nik Stauskas,21,SAC,NBA,2014-15,73,1,1127,108,296,60,147,48,149,55,64,11,77,88,67,20,17,40,92,319,0.364864864865,0.408163265306,0.322147651007,0.859375,0.445945945946
Nikola Vucevic,21,PHI,NBA,2011-12,51,15,812,131,291,128,283,3,8,18,34,88,158,246,31,20,34,33,111,283,0.450171821306,0.452296819788,0.375,0.529411764706,0.455326460481
Noah Vonleh,19,CHO,NBA,2014-15,25,0,259,30,76,25,63,5,13,18,26,28,58,86,4,4,9,11,20,83,0.394736842105,0.396825396825,0.384615384615,0.692307692308,0.427631578947
Nolan Smith,23,POR,NBA,2011-12,44,4,541,67,180,54,135,13,45,20,28,17,39,56,62,18,3,42,55,167,0.372222222222,0.4,0.288888888889,0.714285714286,0.408333333333
Norman Powell,22,TOR,NBA,2015-16,49,24,725,97,229,61,140,36,89,43,53,16,95,111,47,29,10,32,59,273,0.423580786026,0.435714285714,0.404494382022,0.811320754717,0.502183406114
Norris Cole,23,MIA,NBA,2011-12,65,2,1260,177,450,156,374,21,76,66,85,21,70,91,133,44,2,105,124,441,0.393333333333,0.417112299465,0.276315789474,0.776470588235,0.416666666667
Okaro White,24,MIA,NBA,2016-17,35,0,471,33,87,21,53,12,34,20,22,25,57,82,21,10,10,18,52,98,0.379310344828,0.396226415094,0.352941176471,0.909090909091,0.448275862069
Orlando Johnson,23,IND,NBA,2012-13,51,0,619,72,180,36,86,36,94,23,32,20,90,110,47,11,9,29,51,203,0.4,0.418604651163,0.382978723404,0.71875,0.5
Otto Porter,20,WAS,NBA,2013-14,37,0,319,33,91,29,70,4,21,8,12,21,36,57,10,8,1,14,26,78,0.362637362637,0.414285714286,0.190476190476,0.666666666667,0.384615384615
P.J. Hairston,22,CHO,NBA,2014-15,45,2,687,87,269,38,106,49,163,31,36,22,70,92,21,21,13,22,61,254,0.323420074349,0.358490566038,0.300613496933,0.861111111111,0.414498141264
Pascal Siakam,22,TOR,NBA,2016-17,55,38,859,103,205,102,198,1,7,22,32,64,121,185,17,26,45,33,109,229,0.50243902439,0.515151515152,0.142857142857,0.6875,0.50487804878
Pat Connaughton,23,POR,NBA,2015-16,34,0,143,13,49,8,28,5,21,5,5,11,21,32,10,2,0,10,6,36,0.265306122449,0.285714285714,0.238095238095,1.0,0.316326530612
Patricio Garino,23,ORL,NBA,2016-17,5,0,43,0,7,0,2,0,5,0,0,1,6,7,0,0,0,3,4,0,0.0,0.0,0.0,0.0,0.0
Patrick Christopher,26,UTA,NBA,2014-15,4,1,29,3,12,3,8,0,4,0,0,2,4,6,0,1,0,1,6,6,0.25,0.375,0.0,0.0,0.25
Patrick McCaw,21,GSW,NBA,2016-17,71,20,1074,106,245,65,122,41,123,29,37,22,79,101,77,32,15,36,62,282,0.432653061224,0.532786885246,0.333333333333,0.783783783784,0.516326530612
Patrick Patterson,21,HOU,NBA,2010-11,52,6,868,149,267,149,265,0,2,30,42,86,114,200,41,17,37,31,77,328,0.558052434457,0.562264150943,0.0,0.714285714286,0.558052434457
Paul George,20,IND,NBA,2010-11,61,19,1265,179,395,138,257,41,138,77,101,37,187,224,65,62,26,70,127,476,0.453164556962,0.536964980545,0.297101449275,0.762376237624,0.505063291139
Perry Jones,21,OKC,NBA,2012-13,38,1,280,39,99,39,97,0,2,10,15,12,50,62,10,5,6,15,23,88,0.393939393939,0.40206185567,0.0,0.666666666667,0.393939393939
Peyton Siva,23,DET,NBA,2013-14,24,0,224,18,57,11,32,7,25,11,15,2,12,14,34,9,1,18,27,54,0.315789473684,0.34375,0.28,0.733333333333,0.377192982456
Phil Pressey,22,BOS,NBA,2013-14,75,11,1132,78,253,50,147,28,106,29,45,20,85,105,241,68,5,87,97,213,0.308300395257,0.340136054422,0.264150943396,0.644444444444,0.363636363636
Pierre Jackson,25,DAL,NBA,2016-17,8,1,84,13,39,10,28,3,11,6,7,1,8,9,19,2,0,3,5,35,0.333333333333,0.357142857143,0.272727272727,0.857142857143,0.371794871795
Quincy Acy,22,TOR,NBA,2012-13,29,0,342,42,75,41,73,1,2,31,38,30,47,77,11,13,15,17,53,116,0.56,0.561643835616,0.5,0.815789473684,0.566666666667
Quincy Miller,20,DEN,NBA,2012-13,7,0,26,4,12,4,11,0,1,1,2,1,1,2,3,1,0,1,3,9,0.333333333333,0.363636363636,0.0,0.5,0.333333333333
Quincy Pondexter,22,NOH,NBA,2010-11,66,6,734,73,180,55,130,18,50,24,34,23,65,88,28,17,10,16,63,188,0.405555555556,0.423076923077,0.36,0.705882352941,0.455555555556
Quinn Cook,23,TOT,NBA,2016-17,14,0,188,33,66,22,40,11,26,2,5,1,6,7,26,4,0,13,13,79,0.5,0.55,0.423076923077,0.4,0.583333333333
R.J. Hunter,22,BOS,NBA,2015-16,36,0,315,36,98,17,35,19,63,6,7,2,35,37,13,14,4,11,29,97,0.367346938776,0.485714285714,0.301587301587,0.857142857143,0.464285714286
Rakeem Christmas,24,IND,NBA,2015-16,1,0,6,2,2,2,2,0,0,0,0,1,0,1,0,0,0,0,1,4,1.0,1.0,0.0,0.0,1.0
Rashad Vaughn,19,MIL,NBA,2015-16,70,6,1001,81,266,38,119,43,147,12,15,11,77,88,39,29,16,28,73,217,0.304511278195,0.319327731092,0.292517006803,0.8,0.385338345865
Ray McCallum,22,SAC,NBA,2013-14,45,10,897,113,300,91,241,22,59,32,43,18,61,79,120,22,9,39,69,280,0.376666666667,0.377593360996,0.372881355932,0.744186046512,0.413333333333
Reggie Bullock,22,LAC,NBA,2013-14,43,0,395,43,121,21,48,22,73,7,9,11,43,54,12,9,1,13,26,115,0.355371900826,0.4375,0.301369863014,0.777777777778,0.446280991736
Reggie Jackson,21,OKC,NBA,2011-12,45,0,501,51,159,38,97,13,62,25,29,14,39,53,71,25,1,36,31,140,0.320754716981,0.39175257732,0.209677419355,0.862068965517,0.361635220126
Richaun Holmes,22,PHI,NBA,2015-16,51,1,702,114,222,106,178,8,44,51,74,62,73,135,33,19,40,32,92,287,0.513513513514,0.595505617978,0.181818181818,0.689189189189,0.531531531532
Robbie Hummel,24,MIN,NBA,2013-14,53,5,655,67,177,35,88,32,89,15,16,35,97,132,23,16,2,10,57,181,0.378531073446,0.397727272727,0.359550561798,0.9375,0.468926553672
Robert Covington,23,HOU,NBA,2013-14,7,0,34,6,14,2,3,4,11,0,0,2,3,5,0,2,0,1,3,16,0.428571428571,0.666666666667,0.363636363636,0.0,0.571428571429
Robert Sacre,23,LAL,NBA,2012-13,32,3,203,18,48,18,48,0,0,7,11,9,25,34,6,0,10,10,38,43,0.375,0.375,0.0,0.636363636364,0.375
Rodney Hood,22,UTA,NBA,2014-15,50,21,1064,155,374,93,204,62,170,61,80,9,108,117,83,30,12,45,119,433,0.414438502674,0.455882352941,0.364705882353,0.7625,0.497326203209
Rodney McGruder,25,MIA,NBA,2016-17,78,65,1966,190,460,117,240,73,220,44,71,95,162,257,124,45,18,56,140,497,0.413043478261,0.4875,0.331818181818,0.619718309859,0.492391304348
Ron Baker,23,NYK,NBA,2016-17,52,13,857,82,217,59,131,23,86,28,43,12,86,98,107,34,8,56,74,215,0.377880184332,0.450381679389,0.267441860465,0.651162790698,0.430875576037
Rondae Hollis-Jefferson,21,BRK,NBA,2015-16,29,17,615,63,138,59,124,4,14,37,52,39,115,154,43,39,16,26,61,167,0.45652173913,0.475806451613,0.285714285714,0.711538461538,0.471014492754
Royce White,22,SAC,NBA,2013-14,3,0,9,0,1,0,1,0,0,0,0,0,0,0,0,0,0,0,2,0,0.0,0.0,0.0,0.0,0.0
Russ Smith,23,TOT,NBA,2014-15,12,0,65,8,25,6,14,2,11,12,13,1,5,6,8,3,0,12,13,30,0.32,0.428571428571,0.181818181818,0.923076923077,0.36
Ryan Kelly,22,LAL,NBA,2013-14,59,25,1312,157,371,109,229,48,142,110,135,42,177,219,95,32,45,47,147,472,0.423180592992,0.475982532751,0.338028169014,0.814814814815,0.487870619946
Ryan Reid,25,OKC,NBA,2011-12,5,0,17,4,5,4,5,0,0,0,0,1,1,2,0,0,0,1,1,8,0.8,0.8,0.0,0.0,0.8
Sam Dekker,21,HOU,NBA,2015-16,3,0,6,0,0,0,0,0,0,0,0,0,1,1,0,1,0,0,0,0,0.0,0.0,0.0,0.0,0.0
Samardo Samuels,22,CLE,NBA,2010-11,37,10,701,110,241,110,238,0,3,68,110,75,83,158,17,15,18,53,88,288,0.45643153527,0.46218487395,0.0,0.618181818182,0.45643153527
Scott Machado,22,HOU,NBA,2012-13,6,0,21,3,6,3,5,0,1,2,2,0,1,1,6,2,0,8,0,8,0.5,0.6,0.0,1.0,0.5
Scotty Hopson,24,CLE,NBA,2013-14,2,0,7,0,4,0,2,0,2,1,2,0,0,0,1,1,0,0,0,1,0.0,0.0,0.0,0.5,0.0
Sean Kilpatrick,25,MIN,NBA,2014-15,4,0,72,7,20,3,7,4,13,4,4,1,5,6,4,3,0,2,3,22,0.35,0.428571428571,0.307692307692,1.0,0.45
Semaj Christon,24,OKC,NBA,2016-17,64,1,973,77,223,65,160,12,63,17,31,19,69,88,130,28,6,43,79,183,0.345291479821,0.40625,0.190476190476,0.548387096774,0.372197309417
Seth Curry,23,TOT,NBA,2013-14,2,0,13,1,3,0,2,1,1,0,0,0,1,1,0,2,0,0,0,3,0.333333333333,0.0,1.0,0.0,0.5
Shabazz Muhammad,21,MIN,NBA,2013-14,37,0,290,57,124,54,113,3,11,26,40,24,29,53,6,8,1,16,24,143,0.459677419355,0.477876106195,0.272727272727,0.65,0.471774193548
Shabazz Napier,23,MIA,NBA,2014-15,51,10,1012,87,228,44,110,43,118,44,56,17,96,113,130,40,4,81,76,261,0.381578947368,0.4,0.364406779661,0.785714285714,0.475877192982
Shane Larkin,21,DAL,NBA,2013-14,48,0,489,52,137,40,99,12,38,16,25,11,31,42,71,26,1,39,46,132,0.379562043796,0.40404040404,0.315789473684,0.64,0.423357664234
Shawn Long,24,PHI,NBA,2016-17,18,0,234,61,109,54,90,7,19,19,35,41,44,85,13,9,9,13,49,148,0.559633027523,0.6,0.368421052632,0.542857142857,0.591743119266
Shayne Whittington,23,IND,NBA,2014-15,20,0,108,19,42,18,36,1,6,18,23,10,19,29,6,5,2,5,18,57,0.452380952381,0.5,0.166666666667,0.782608695652,0.464285714286
Sheldon McClellan,24,WAS,NBA,2016-17,30,3,287,30,75,23,45,7,30,23,27,4,30,34,15,8,2,5,17,90,0.4,0.511111111111,0.233333333333,0.851851851852,0.446666666667
Shelvin Mack,21,WAS,NBA,2011-12,64,0,779,88,220,76,178,12,42,42,59,12,80,92,131,28,2,48,50,230,0.4,0.426966292135,0.285714285714,0.71186440678,0.427272727273
Sherron Collins,23,CHA,NBA,2010-11,20,0,66,7,25,5,15,2,10,1,1,0,5,5,8,2,0,4,2,17,0.28,0.333333333333,0.2,1.0,0.32
Sim Bhullar,22,SAC,NBA,2014-15,3,0,3,1,2,1,2,0,0,0,0,0,1,1,1,0,1,0,0,2,0.5,0.5,0.0,0.0,0.5
Skal Labissiere,20,SAC,NBA,2016-17,33,12,612,117,218,114,210,3,8,52,74,51,111,162,27,16,13,37,64,289,0.536697247706,0.542857142857,0.375,0.702702702703,0.543577981651
Solomon Alabi,22,TOR,NBA,2010-11,12,0,59,3,15,3,15,0,0,0,2,7,7,14,2,2,2,3,5,6,0.2,0.2,0.0,0.0,0.2
Solomon Hill,22,IND,NBA,2013-14,28,0,226,17,40,10,17,7,23,6,7,9,32,41,12,5,2,13,19,47,0.425,0.588235294118,0.304347826087,0.857142857143,0.5125
Spencer Dinwiddie,21,DET,NBA,2014-15,34,1,455,51,169,39,104,12,65,31,34,4,44,48,104,19,6,33,53,145,0.301775147929,0.375,0.184615384615,0.911764705882,0.337278106509
Stanley Johnson,19,DET,NBA,2015-16,73,6,1687,225,600,162,395,63,205,80,102,58,248,306,118,55,12,114,178,593,0.375,0.410126582278,0.307317073171,0.78431372549,0.4275
Steven Adams,20,OKC,NBA,2013-14,81,20,1197,93,185,93,185,0,0,79,136,142,190,332,43,40,57,71,203,265,0.502702702703,0.502702702703,0.0,0.580882352941,0.502702702703
T.J. McConnell,23,PHI,NBA,2015-16,81,17,1606,218,464,187,375,31,89,26,41,43,207,250,367,95,10,140,114,493,0.469827586207,0.498666666667,0.348314606742,0.634146341463,0.503232758621
T.J. Warren,21,PHO,NBA,2014-15,40,1,614,113,214,108,193,5,21,14,19,41,44,85,25,18,9,27,51,245,0.528037383178,0.559585492228,0.238095238095,0.736842105263,0.539719626168
Tarik Black,23,TOT,NBA,2014-15,63,39,1196,157,273,157,272,0,1,65,118,142,226,368,42,19,24,48,158,379,0.575091575092,0.577205882353,0.0,0.550847457627,0.575091575092
Terrence Jones,21,HOU,NBA,2012-13,19,0,276,43,94,38,75,5,19,13,17,28,37,65,15,12,19,13,21,104,0.457446808511,0.506666666667,0.263157894737,0.764705882353,0.484042553191
Terrence Ross,21,TOR,NBA,2012-13,73,2,1239,186,457,121,261,65,196,30,42,35,109,144,53,43,14,48,122,467,0.407002188184,0.463601532567,0.331632653061,0.714285714286,0.478118161926
Terry Rozier,21,BOS,NBA,2015-16,39,0,311,29,106,23,79,6,27,8,10,24,39,63,37,6,1,19,23,72,0.27358490566,0.291139240506,0.222222222222,0.8,0.301886792453
Thomas Robinson,21,TOT,NBA,2012-13,70,0,1056,138,321,138,320,0,1,57,109,122,193,315,46,41,26,88,124,333,0.429906542056,0.43125,0.0,0.522935779817,0.429906542056
Tim Frazier,24,TOT,NBA,2014-15,11,3,239,21,61,16,44,5,17,10,21,6,22,28,60,8,0,25,26,57,0.344262295082,0.363636363636,0.294117647059,0.47619047619,0.385245901639
Tim Hardaway,21,NYK,NBA,2013-14,81,1,1875,294,687,164,329,130,358,106,128,19,102,121,66,44,7,47,144,824,0.427947598253,0.498480243161,0.36312849162,0.828125,0.522561863173
Tim Quarterman,22,POR,NBA,2016-17,16,0,80,13,29,8,16,5,13,0,3,4,10,14,11,2,3,11,6,31,0.448275862069,0.5,0.384615384615,0.0,0.534482758621
Tobias Harris,19,MIL,NBA,2011-12,42,9,479,79,169,73,146,6,23,44,54,30,71,101,22,13,7,31,45,208,0.467455621302,0.5,0.260869565217,0.814814814815,0.485207100592
Tony Mitchell,24,MIL,NBA,2013-14,3,0,10,3,5,3,4,0,1,0,0,1,0,1,1,1,0,0,0,6,0.6,0.75,0.0,0.0,0.6
Tony Mitchell Jr.,21,DET,NBA,2013-14,21,0,79,5,12,4,11,1,1,11,19,15,11,26,2,6,3,4,9,22,0.416666666667,0.363636363636,1.0,0.578947368421,0.458333333333
Tony Snell,22,CHI,NBA,2013-14,77,12,1231,129,336,72,158,57,178,31,41,19,105,124,68,29,15,44,84,346,0.383928571429,0.455696202532,0.320224719101,0.756097560976,0.46875
Tony Wroten,19,MEM,NBA,2012-13,35,0,272,33,86,29,70,4,16,21,29,13,15,28,43,8,4,29,34,91,0.383720930233,0.414285714286,0.25,0.724137931034,0.406976744186
Toure' Murry,24,NYK,NBA,2013-14,51,0,373,56,129,51,117,5,12,23,39,13,31,44,49,19,1,34,46,140,0.434108527132,0.435897435897,0.416666666667,0.589743589744,0.453488372093
Travis Leslie,21,LAC,NBA,2011-12,10,0,45,5,14,5,14,0,0,4,9,6,3,9,5,2,2,2,4,14,0.357142857143,0.357142857143,0.0,0.444444444444,0.357142857143
Travis Wear,24,NYK,NBA,2014-15,51,1,672,84,209,73,179,11,30,20,26,31,75,106,40,15,11,35,55,199,0.401913875598,0.40782122905,0.366666666667,0.769230769231,0.428229665072
Treveon Graham,23,CHO,NBA,2016-17,27,1,189,19,40,10,25,9,15,10,15,5,17,22,6,6,1,3,18,57,0.475,0.4,0.6,0.666666666667,0.5875
Trevor Booker,23,WAS,NBA,2010-11,65,14,1063,139,253,139,252,0,1,68,101,98,153,251,35,29,42,38,115,346,0.549407114625,0.551587301587,0.0,0.673267326733,0.549407114625
Trey Burke,21,UTA,NBA,2013-14,70,68,2262,341,897,230,561,111,336,102,113,37,171,208,396,42,6,131,145,895,0.380156075808,0.409982174688,0.330357142857,0.902654867257,0.442028985507
Trey Lyles,20,UTA,NBA,2015-16,80,33,1382,191,436,142,308,49,128,57,82,59,240,299,59,26,18,65,114,488,0.438073394495,0.461038961039,0.3828125,0.69512195122,0.494266055046
Trey Thompkins,21,LAC,NBA,2011-12,24,0,119,24,61,20,48,4,13,5,7,4,20,24,3,3,3,6,10,57,0.393442622951,0.416666666667,0.307692307692,0.714285714286,0.426229508197
Tristan Thompson,20,CLE,NBA,2011-12,60,25,1424,194,442,194,440,0,2,106,192,187,202,389,27,27,62,81,134,494,0.438914027149,0.440909090909,0.0,0.552083333333,0.438914027149
Troy Daniels,22,HOU,NBA,2013-14,5,1,75,15,31,3,6,12,25,0,0,0,4,4,5,0,0,3,6,42,0.483870967742,0.5,0.48,0.0,0.677419354839
Troy Williams,22,TOT,NBA,2016-17,30,16,557,73,167,55,105,18,62,21,32,15,54,69,25,27,10,33,60,185,0.437125748503,0.52380952381,0.290322580645,0.65625,0.491017964072
Tyler Ennis,20,TOT,NBA,2014-15,33,1,411,52,144,40,101,12,43,5,7,7,28,35,73,18,5,42,36,121,0.361111111111,0.39603960396,0.279069767442,0.714285714286,0.402777777778
Tyler Honeycutt,21,SAC,NBA,2011-12,15,0,88,8,24,7,21,1,3,3,5,3,11,14,7,4,3,2,3,20,0.333333333333,0.333333333333,0.333333333333,0.6,0.354166666667
Tyler Johnson,22,MIA,NBA,2014-15,32,2,603,70,167,52,119,18,48,32,47,14,67,81,42,33,9,30,42,190,0.419161676647,0.436974789916,0.375,0.68085106383,0.473053892216
Tyler Ulis,21,PHO,NBA,2016-17,61,15,1123,184,437,163,358,21,79,55,71,20,75,95,226,48,5,77,73,444,0.421052631579,0.45530726257,0.26582278481,0.774647887324,0.445080091533
Tyler Zeller,23,CLE,NBA,2012-13,77,55,2033,245,559,245,555,0,4,120,157,159,279,438,96,35,70,95,251,610,0.438282647585,0.441441441441,0.0,0.764331210191,0.438282647585
Tyshawn Taylor,22,BRK,NBA,2012-13,38,0,221,32,87,26,74,6,13,15,27,2,16,18,21,13,0,25,25,85,0.367816091954,0.351351351351,0.461538461538,0.555555555556,0.402298850575
Tyus Jones,19,MIN,NBA,2015-16,37,0,573,56,156,40,103,16,53,28,39,7,40,47,108,31,3,33,33,156,0.358974358974,0.388349514563,0.301886792453,0.717948717949,0.410256410256
Vander Blue,21,BOS,NBA,2013-14,3,0,15,2,4,2,3,0,1,1,5,0,3,3,1,0,0,2,1,5,0.5,0.666666666667,0.0,0.2,0.5
Vernon Macklin,25,DET,NBA,2011-12,23,0,135,19,35,19,35,0,0,8,14,14,20,34,5,4,4,3,9,46,0.542857142857,0.542857142857,0.0,0.571428571429,0.542857142857
Victor Oladipo,21,ORL,NBA,2013-14,80,44,2487,392,936,318,710,74,226,248,318,43,286,329,327,129,37,256,210,1106,0.418803418803,0.447887323944,0.327433628319,0.779874213836,0.458333333333
Wade Baldwin,20,MEM,NBA,2016-17,33,1,405,36,115,33,93,3,22,31,37,11,35,46,61,18,7,40,40,106,0.313043478261,0.354838709677,0.136363636364,0.837837837838,0.326086956522
Wayne Selden,22,TOT,NBA,2016-17,14,5,236,25,58,18,30,7,28,14,22,1,15,16,13,6,1,12,18,71,0.431034482759,0.6,0.25,0.636363636364,0.491379310345
Wesley Johnson,23,MIN,NBA,2010-11,79,63,2069,271,682,168,393,103,289,64,92,51,189,240,148,58,54,95,163,709,0.397360703812,0.427480916031,0.356401384083,0.695652173913,0.472873900293
Will Barton,22,POR,NBA,2012-13,73,5,894,118,309,109,244,9,65,50,65,36,109,145,58,34,9,60,56,295,0.381877022654,0.446721311475,0.138461538462,0.769230769231,0.39644012945
Will Cherry,23,CLE,NBA,2014-15,8,0,69,5,19,3,10,2,9,3,6,1,4,5,8,6,1,4,10,15,0.263157894737,0.3,0.222222222222,0.5,0.315789473684
Willie Cauley-Stein,22,SAC,NBA,2015-16,66,39,1412,191,339,191,337,0,2,81,125,134,218,352,37,48,66,46,146,463,0.563421828909,0.566765578635,0.0,0.648,0.563421828909
Willie Reed,25,BRK,NBA,2015-16,39,2,426,76,133,76,133,0,0,30,55,49,73,122,10,6,30,16,47,182,0.571428571429,0.571428571429,0.0,0.545454545455,0.571428571429
Willie Warren,21,LAC,NBA,2010-11,19,0,134,13,35,8,20,5,15,6,8,1,11,12,27,6,0,8,16,37,0.371428571429,0.4,0.333333333333,0.75,0.442857142857
Xavier Henry,19,MEM,NBA,2010-11,38,16,527,65,160,63,143,2,17,33,52,9,28,37,18,11,3,13,48,165,0.40625,0.440559440559,0.117647058824,0.634615384615,0.4125
Xavier Munford,23,MEM,NBA,2015-16,14,0,244,32,77,23,54,9,23,7,14,3,28,31,22,13,3,15,25,80,0.415584415584,0.425925925926,0.391304347826,0.5,0.474025974026
Xavier Silas,24,PHI,NBA,2011-12,2,0,39,4,15,3,9,1,6,2,3,2,2,4,3,0,0,3,5,11,0.266666666667,0.333333333333,0.166666666667,0.666666666667,0.3
Yogi Ferrell,23,TOT,NBA,2016-17,46,29,1197,160,394,92,218,68,176,74,89,20,91,111,172,42,9,70,90,462,0.406091370558,0.422018348624,0.386363636364,0.831460674157,0.492385786802
Zach LaVine,19,MIN,NBA,2014-15,77,40,1902,286,677,229,510,57,167,149,177,27,187,214,276,54,10,193,158,778,0.422451994092,0.449019607843,0.341317365269,0.841807909605,0.464549483013
