Player,Age,Tm,Lg,Season,G,GS,MP,FG,FGA,2P,2PA,3P,3PA,FT,FTA,ORB,DRB,TRB,AST,STL,BLK,TOV,PF,PTS,FG%,2P%,3P%,FT%,eFG%
A.J. Guyton,22,CHI,NBA,2000-01,33,8,630,78,192,51,123,27,69,15,18,10,26,36,64,9,5,24,35,198,0.40625,0.414634146,0.391304348,0.833333333,0.4765625
A.J. Hammons,24,DAL,NBA,2016-17,22,0,163,17,42,12,32,5,10,9,20,8,28,36,4,1,13,10,21,48,0.404761905,0.375,0.5,0.45,0.464285714
A.J. Price,23,IND,NBA,2009-10,56,2,865,145,354,85,180,60,174,60,75,12,76,88,106,35,3,59,53,410,0.40960452,0.472222222,0.344827586,0.8,0.494350282
Aaron Brooks,23,HOU,NBA,2007-08,51,0,608,93,225,57,116,36,109,42,49,13,43,56,87,13,5,44,69,264,0.413333333,0.49137931,0.330275229,0.857142857,0.493333333
Aaron Gordon,19,ORL,NBA,2014-15,47,8,797,93,208,80,160,13,48,44,61,46,123,169,33,21,22,38,83,243,0.447115385,0.5,0.270833333,0.721311475,0.478365385
Aaron Gray,23,CHI,NBA,2007-08,61,1,613,103,204,103,203,0,1,56,99,70,98,168,41,21,16,57,117,262,0.504901961,0.507389163,0.0,0.565656566,0.504901961
Aaron Harrison,21,CHO,NBA,2015-16,21,0,93,5,19,2,9,3,10,5,12,4,11,15,2,6,0,4,10,18,0.263157895,0.222222222,0.3,0.416666667,0.342105263
Aaron Miles,22,GSW,NBA,2005-06,19,0,118,6,18,6,18,0,0,4,4,0,14,14,24,4,1,11,13,16,0.333333333,0.333333333,0.0,1.0,0.333333333
Acie Law,23,ATL,NBA,2007-08,56,6,865,95,237,88,203,7,34,38,48,12,45,57,113,29,0,56,73,235,0.400843882,0.433497537,0.205882353,0.791666667,0.415611814
Adam Harrington,22,TOT,NBA,2002-03,19,0,111,11,37,6,23,5,14,3,4,1,7,8,12,2,1,2,8,30,0.297297297,0.260869565,0.357142857,0.75,0.364864865
Adam Morrison,22,CHA,NBA,2006-07,78,23,2326,355,944,268,686,87,258,120,169,54,176,230,163,28,6,130,179,917,0.376059322,0.390670554,0.337209302,0.710059172,0.422139831
Adonis Thomas,20,TOT,NBA,2013-14,6,1,37,6,14,5,9,1,5,1,1,0,3,3,3,0,0,1,6,14,0.428571429,0.555555556,0.2,1.0,0.464285714
Adreian Payne,23,TOT,NBA,2014-15,32,22,739,91,220,90,211,1,9,30,46,48,114,162,30,19,9,44,88,213,0.413636364,0.426540284,0.111111111,0.652173913,0.415909091
Al Horford,21,ATL,NBA,2007-08,81,77,2540,333,668,333,663,0,5,155,212,248,537,785,124,60,76,137,267,821,0.498502994,0.502262443,0.0,0.731132075,0.498502994
Al Jefferson,20,BOS,NBA,2004-05,71,1,1051,195,369,195,366,0,3,85,135,119,193,312,24,22,55,66,195,475,0.528455285,0.532786885,0.0,0.62962963,0.528455285
Al Thornton,24,LAC,NBA,2007-08,79,31,2158,374,871,331,741,43,130,214,288,98,260,358,98,46,43,128,195,1005,0.429391504,0.446693657,0.330769231,0.743055556,0.454075775
Al-Farouq Aminu,20,LAC,NBA,2010-11,81,14,1452,160,406,115,263,45,143,92,119,75,192,267,60,59,25,103,121,457,0.39408867,0.437262357,0.314685315,0.773109244,0.449507389
Alan Anderson,23,CHA,NBA,2005-06,36,7,564,75,181,51,123,24,58,33,41,23,47,70,32,11,4,32,48,207,0.414364641,0.414634146,0.413793103,0.804878049,0.480662983
Alan Williams,23,PHO,NBA,2015-16,10,0,68,10,24,10,24,0,0,9,14,14,24,38,5,4,5,6,15,29,0.416666667,0.416666667,0.0,0.642857143,0.416666667
Alando Tucker,23,PHO,NBA,2007-08,6,0,48,8,22,7,18,1,4,5,6,4,4,8,0,0,1,0,2,22,0.363636364,0.388888889,0.25,0.833333333,0.386363636
Alec Burks,20,UTA,NBA,2011-12,59,0,939,153,357,138,312,15,45,104,143,57,75,132,55,27,5,51,84,425,0.428571429,0.442307692,0.333333333,0.727272727,0.449579832
Alex Abrines,23,OKC,NBA,2016-17,68,6,1055,134,341,40,94,94,247,44,49,18,68,86,40,37,8,33,114,406,0.392961877,0.425531915,0.380566802,0.897959184,0.530791789
Alex Acker,23,DET,NBA,2005-06,5,0,35,4,16,3,11,1,5,0,0,1,4,5,4,1,0,4,4,9,0.25,0.272727273,0.2,0.0,0.28125
Alex Garcia,23,SAS,NBA,2003-04,2,0,13,1,7,1,7,0,0,1,2,0,0,0,0,2,0,1,0,3,0.142857143,0.142857143,0.0,0.5,0.142857143
Alex Kirk,23,CLE,NBA,2014-15,5,0,14,1,4,1,4,0,0,2,2,1,0,1,1,0,0,0,1,4,0.25,0.25,0.0,1.0,0.25
Alex Len,20,PHO,NBA,2013-14,42,3,362,33,78,33,78,0,0,20,31,39,60,99,4,4,18,26,68,86,0.423076923,0.423076923,0.0,0.64516129,0.423076923
Alex Poythress,23,PHI,NBA,2016-17,6,1,157,25,54,19,35,6,19,8,10,11,18,29,5,3,2,3,14,64,0.462962963,0.542857143,0.315789474,0.8,0.518518519
Alex Scales,27,SAS,NBA,2005-06,1,0,0,0,0,0,0,0,0,0,0,0,0,0,0,0,0,0,0,0,0.0,0.0,0.0,0.0,0.0
Alex Stepheson,28,TOT,NBA,2015-16,8,0,73,9,27,9,27,0,0,4,12,19,9,28,2,1,5,0,12,22,0.333333333,0.333333333,0.0,0.333333333,0.333333333
Alexander Johnson,23,MEM,NBA,2006-07,59,19,753,91,169,91,169,0,0,78,118,50,131,181,17,25,35,47,137,260,0.538461538,0.538461538,0.0,0.661016949,0.538461538
Alexey Shved,24,MIN,NBA,2012-13,77,16,1840,236,635,151,347,85,288,108,150,41,134,175,286,54,27,147,117,665,0.371653543,0.435158501,0.295138889,0.72,0.438582677
Alexis Ajinca,20,CHA,NBA,2008-09,31,4,182,25,69,25,67,0,2,20,28,9,21,30,3,7,6,12,34,70,0.362318841,0.373134328,0.0,0.714285714,0.362318841
Allan Ray,22,BOS,NBA,2006-07,47,5,710,100,259,52,143,48,116,42,55,18,51,69,43,20,3,42,85,290,0.386100386,0.363636364,0.413793103,0.763636364,0.478764479
Allen Crabbe,21,POR,NBA,2013-14,15,0,100,12,33,6,19,6,14,3,4,1,8,9,6,2,1,3,10,33,0.363636364,0.315789474,0.428571429,0.75,0.454545455
Alonzo Gee,22,WAS,NBA,2009-10,11,2,182,28,59,21,50,7,9,18,29,15,18,33,7,7,1,10,13,81,0.474576271,0.42,0.777777778,0.620689655,0.533898305
Alton Ford,20,PHO,NBA,2001-02,53,0,452,61,118,61,118,0,0,42,57,32,75,107,7,6,7,32,99,164,0.516949153,0.516949153,0.0,0.736842105,0.516949153
Alvin Jones,23,PHI,NBA,2001-02,23,2,126,8,20,8,20,0,0,10,20,13,23,36,3,3,9,11,35,26,0.4,0.4,0.0,0.5,0.4
Amar'e Stoudemire,20,PHO,NBA,2002-03,82,71,2570,392,830,390,820,2,10,320,484,250,471,721,78,62,87,189,269,1106,0.472289157,0.475609756,0.2,0.661157025,0.473493976
Amir Johnson,18,DET,NBA,2005-06,3,0,39,7,10,5,7,2,3,4,4,3,1,4,3,0,2,4,7,20,0.7,0.714285714,0.666666667,1.0,0.8
Anderson Varejao,22,CLE,NBA,2004-05,54,0,863,99,193,99,191,0,2,68,127,109,148,257,27,41,38,26,122,266,0.512953368,0.518324607,0.0,0.535433071,0.512953368
Andray Blatche,19,WAS,NBA,2005-06,29,0,175,26,67,23,54,3,13,10,12,12,26,38,10,5,7,12,36,65,0.388059701,0.425925926,0.230769231,0.833333333,0.410447761
Andre Barrett,22,TOT,NBA,2004-05,38,1,483,45,124,31,72,14,52,14,19,11,29,40,69,19,1,27,51,118,0.362903226,0.430555556,0.269230769,0.736842105,0.419354839
Andre Brown,25,SEA,NBA,2006-07,38,0,271,42,74,42,73,0,1,9,15,26,48,74,2,6,4,29,26,93,0.567567568,0.575342466,0.0,0.6,0.567567568
Andre Dawkins,23,MIA,NBA,2014-15,4,0,22,1,6,0,0,1,6,0,0,0,2,2,1,0,0,1,3,3,0.166666667,0.0,0.166666667,0.0,0.25
Andre Drummond,19,DET,NBA,2012-13,60,10,1243,208,342,207,340,1,2,59,159,169,288,457,30,59,95,57,144,476,0.608187135,0.608823529,0.5,0.371069182,0.609649123
Andre Emmett,22,MEM,NBA,2004-05,8,0,28,2,6,2,6,0,0,3,5,0,2,2,0,0,0,1,4,7,0.333333333,0.333333333,0.0,0.6,0.333333333
Andre Iguodala,21,PHI,NBA,2004-05,82,82,2686,269,546,222,404,47,142,156,210,89,375,464,246,138,48,139,204,741,0.492673993,0.54950495,0.330985915,0.742857143,0.535714286
Andre Owens,25,UTA,NBA,2005-06,23,2,210,27,74,24,58,3,16,12,18,11,10,21,8,5,0,13,25,69,0.364864865,0.413793103,0.1875,0.666666667,0.385135135
Andre Roberson,22,OKC,NBA,2013-14,40,16,399,33,68,31,55,2,13,7,10,36,58,94,15,19,10,19,74,75,0.485294118,0.563636364,0.153846154,0.7,0.5
Andrea Bargnani,21,TOR,NBA,2006-07,65,2,1629,267,625,167,357,100,268,117,142,52,203,255,50,32,53,107,180,751,0.4272,0.467787115,0.373134328,0.823943662,0.5072
Andreas Glyniadakis,25,SEA,NBA,2006-07,13,4,81,8,17,8,17,0,0,1,2,2,6,8,1,0,0,9,19,17,0.470588235,0.470588235,0.0,0.5,0.470588235
Andrei Kirilenko,20,UTA,NBA,2001-02,82,40,2151,285,633,260,533,25,100,285,371,149,253,402,94,116,159,108,156,880,0.450236967,0.487804878,0.25,0.76819407,0.469984202
Andres Nocioni,25,CHI,NBA,2004-05,81,38,1892,241,601,216,504,25,97,170,222,69,317,386,122,37,34,135,208,677,0.400998336,0.428571429,0.257731959,0.765765766,0.421797005
Andrew Bogut,21,MIL,NBA,2005-06,82,77,2348,323,606,323,603,0,3,122,194,189,384,573,192,49,68,125,259,768,0.5330033,0.535655058,0.0,0.628865979,0.5330033
Andrew Bynum,18,LAL,NBA,2005-06,46,0,338,33,82,33,82,0,0,8,27,34,46,80,9,4,22,17,56,74,0.402439024,0.402439024,0.0,0.296296296,0.402439024
Andrew Goudelock,23,LAL,NBA,2011-12,40,0,419,68,174,40,99,28,75,11,12,5,26,31,20,4,0,21,32,175,0.390804598,0.404040404,0.373333333,0.916666667,0.471264368
Andrew Harrison,22,MEM,NBA,2016-17,72,18,1474,117,360,74,204,43,156,148,194,23,113,136,198,54,20,85,194,425,0.325,0.362745098,0.275641026,0.762886598,0.384722222
Andrew Nicholson,23,ORL,NBA,2012-13,75,28,1249,256,486,256,486,0,0,75,94,69,189,258,44,24,32,79,133,587,0.526748971,0.526748971,0.0,0.79787234,0.526748971
Andrew Wiggins,19,MIN,NBA,2014-15,82,82,2969,497,1137,458,1011,39,126,354,466,134,240,374,170,86,50,177,190,1387,0.437115215,0.453016815,0.30952381,0.759656652,0.454265611
Andris Biedrins,18,GSW,NBA,2004-05,30,1,384,45,78,45,77,0,1,19,40,47,71,118,12,12,24,12,87,109,0.576923077,0.584415584,0.0,0.475,0.576923077
Andy Panko,23,ATL,NBA,2000-01,1,0,1,0,0,0,0,0,0,0,0,0,0,0,0,0,0,0,0,0,0.0,0.0,0.0,0.0,0.0
Andy Rautins,24,NYK,NBA,2010-11,5,0,24,3,7,2,3,1,4,1,2,0,1,1,3,1,0,7,0,8,0.428571429,0.666666667,0.25,0.5,0.5
Ansu Sesay,25,SEA,NBA,2001-02,9,0,142,22,44,22,44,0,0,14,20,7,13,20,8,3,2,2,18,58,0.5,0.5,0.0,0.7,0.5
Anthony Bennett,20,CLE,NBA,2013-14,52,0,663,80,225,67,172,13,53,44,69,49,106,155,17,21,8,47,93,217,0.355555556,0.389534884,0.245283019,0.637681159,0.384444444
Anthony Brown,23,LAL,NBA,2015-16,29,11,599,39,126,19,56,20,70,17,20,9,61,70,19,14,5,15,34,115,0.30952381,0.339285714,0.285714286,0.85,0.388888889
Anthony Davis,19,NOH,NBA,2012-13,64,60,1846,349,676,349,670,0,6,169,225,165,357,522,63,75,112,89,158,867,0.516272189,0.520895522,0.0,0.751111111,0.516272189
Anthony Grundy,26,ATL,NBA,2005-06,12,0,108,19,38,14,23,5,15,9,14,1,16,17,9,7,0,9,14,52,0.5,0.608695652,0.333333333,0.642857143,0.565789474
Anthony Morrow,23,GSW,NBA,2008-09,67,17,1515,255,534,169,350,86,184,80,92,78,121,199,80,36,12,52,130,676,0.47752809,0.482857143,0.467391304,0.869565217,0.558052434
Anthony Randolph,19,GSW,NBA,2008-09,63,22,1129,199,431,199,427,0,4,101,141,128,235,363,49,42,74,80,141,499,0.461716937,0.466042155,0.0,0.716312057,0.461716937
Anthony Roberson,22,MEM,NBA,2005-06,16,0,88,14,31,9,21,5,10,2,2,0,6,6,5,1,0,3,6,35,0.451612903,0.428571429,0.5,1.0,0.532258065
Anthony Tolliver,23,SAS,NBA,2008-09,19,0,208,19,65,10,24,9,41,5,10,12,29,41,17,5,1,7,16,52,0.292307692,0.416666667,0.219512195,0.5,0.361538462
Antoine Rigaudeau,31,DAL,NBA,2002-03,11,0,91,8,35,7,30,1,5,0,0,4,4,8,6,3,0,6,11,17,0.228571429,0.233333333,0.2,0.0,0.242857143
Antoine Wright,21,NJN,NBA,2005-06,39,0,370,29,81,28,66,1,15,11,22,8,22,30,12,4,3,21,42,70,0.358024691,0.424242424,0.066666667,0.5,0.364197531
Antonio Anderson,24,OKC,NBA,2009-10,1,0,15,1,3,1,3,0,0,0,0,1,0,1,0,0,0,1,1,2,0.333333333,0.333333333,0.0,0.0,0.333333333
Antonio Burks,24,MEM,NBA,2004-05,24,0,219,28,60,25,49,3,11,14,19,1,11,12,28,13,1,12,25,73,0.466666667,0.510204082,0.272727273,0.736842105,0.491666667
Antonis Fotsis,20,MEM,NBA,2001-02,28,1,320,42,104,35,81,7,23,17,20,25,37,62,10,9,11,21,22,108,0.403846154,0.432098765,0.304347826,0.85,0.4375
Archie Goodwin,19,PHO,NBA,2013-14,52,0,533,76,167,71,131,5,36,37,55,25,62,87,20,20,11,44,45,194,0.45508982,0.541984733,0.138888889,0.672727273,0.47005988
Arinze Onuaku,26,TOT,NBA,2013-14,5,0,30,1,5,1,5,0,0,1,2,2,6,8,3,0,0,1,3,3,0.2,0.2,0.0,0.5,0.2
Armon Johnson,21,POR,NBA,2010-11,38,0,277,46,101,41,89,5,12,13,22,11,25,36,45,5,1,38,31,110,0.455445545,0.460674157,0.416666667,0.590909091,0.48019802
Arnett Moultrie,22,PHI,NBA,2012-13,47,0,542,78,134,78,134,0,0,18,28,76,69,145,10,17,10,19,43,174,0.582089552,0.582089552,0.0,0.642857143,0.582089552
Aron Baynes,26,SAS,NBA,2012-13,16,0,141,18,36,18,35,0,1,7,12,12,20,32,5,1,6,11,23,43,0.5,0.514285714,0.0,0.583333333,0.5
Arron Afflalo,22,DET,NBA,2007-08,75,9,970,99,241,89,193,10,48,68,87,36,101,137,52,31,8,34,83,276,0.410788382,0.461139896,0.208333333,0.781609195,0.43153527
Art Long,28,SAC,NBA,2000-01,9,0,20,0,4,0,4,0,0,0,2,2,6,8,1,0,3,2,5,0,0.0,0.0,0.0,0.0,0.0
Arvydas Macijauskas,26,NOK,NBA,2005-06,19,0,135,14,41,11,29,3,12,13,15,3,7,10,5,7,0,8,10,44,0.341463415,0.379310345,0.25,0.866666667,0.37804878
Austin Daye,21,DET,NBA,2009-10,69,4,915,137,295,108,200,29,95,46,56,34,140,174,34,25,26,48,114,349,0.46440678,0.54,0.305263158,0.821428571,0.513559322
Austin Rivers,20,NOH,NBA,2012-13,61,26,1418,145,390,117,304,28,86,59,108,16,93,109,127,26,9,74,122,377,0.371794872,0.384868421,0.325581395,0.546296296,0.407692308
Avery Bradley,20,BOS,NBA,2010-11,31,0,162,23,67,23,62,0,5,6,12,4,13,17,12,9,0,16,20,52,0.343283582,0.370967742,0.0,0.5,0.343283582
Awvee Storey,27,NJN,NBA,2004-05,9,0,32,3,10,2,8,1,2,1,2,4,1,5,1,0,0,0,3,8,0.3,0.25,0.5,0.5,0.35
Axel Toupane,23,DEN,NBA,2015-16,21,0,305,25,70,12,30,13,40,13,17,8,23,31,15,7,6,6,40,76,0.357142857,0.4,0.325,0.764705882,0.45
Ben Bentil,21,DAL,NBA,2016-17,3,0,10,0,3,0,2,0,1,0,0,0,2,2,0,0,0,1,1,0,0.0,0.0,0.0,0.0,0.0
Ben Gordon,21,CHI,NBA,2004-05,82,3,2002,434,1056,300,725,134,331,233,270,55,160,215,164,53,10,186,224,1235,0.410984848,0.413793103,0.404833837,0.862962963,0.474431818
Ben Handlogten,30,UTA,NBA,2003-04,17,0,172,25,47,25,47,0,0,18,27,22,33,55,6,3,4,10,32,68,0.531914894,0.531914894,0.0,0.666666667,0.531914894
Ben Hansbrough,25,IND,NBA,2012-13,28,0,200,15,45,9,22,6,23,21,27,2,16,18,21,7,2,18,23,57,0.333333333,0.409090909,0.260869565,0.777777778,0.4
Ben McLemore,20,SAC,NBA,2013-14,82,55,2187,255,679,160,382,95,297,115,143,53,182,235,82,45,18,96,201,720,0.375552283,0.418848168,0.31986532,0.804195804,0.4455081
Ben Uzoh,22,NJN,NBA,2010-11,42,0,438,61,144,58,136,3,8,33,56,30,31,61,69,13,8,25,29,158,0.423611111,0.426470588,0.375,0.589285714,0.434027778
Beno Udrih,22,SAS,NBA,2004-05,80,2,1149,173,390,115,248,58,142,67,89,16,67,83,150,41,10,77,96,471,0.443589744,0.463709677,0.408450704,0.752808989,0.517948718
Bernard James,27,DAL,NBA,2012-13,46,11,457,53,103,53,101,0,2,25,41,52,79,131,6,12,38,18,64,131,0.514563107,0.524752475,0.0,0.609756098,0.514563107
Bernard Robinson,24,CHA,NBA,2004-05,31,1,328,36,81,33,73,3,8,18,26,14,34,48,30,11,4,20,42,93,0.444444444,0.452054795,0.375,0.692307692,0.462962963
Billy Thomas,29,NJN,NBA,2004-05,25,0,356,34,94,17,38,17,56,7,9,7,29,36,17,14,1,9,29,92,0.361702128,0.447368421,0.303571429,0.777777778,0.45212766
Bismack Biyombo,19,CHA,NBA,2011-12,63,41,1455,129,278,129,278,0,0,69,143,113,255,368,27,20,115,71,145,327,0.464028777,0.464028777,0.0,0.482517483,0.464028777
Blake Ahearn,23,MIA,NBA,2007-08,12,0,177,15,57,5,23,10,34,30,31,1,18,19,19,6,0,16,20,70,0.263157895,0.217391304,0.294117647,0.967741935,0.350877193
Blake Griffin,21,LAC,NBA,2010-11,82,82,3112,696,1376,689,1352,7,24,446,695,270,719,989,312,63,45,223,252,1845,0.505813953,0.509615385,0.291666667,0.641726619,0.508357558
Boban Marjanovic,27,SAS,NBA,2015-16,54,4,508,105,174,105,174,0,0,87,114,73,121,194,21,12,23,29,54,297,0.603448276,0.603448276,0.0,0.763157895,0.603448276
Bobby Brown,24,TOT,NBA,2008-09,68,2,931,141,360,96,230,45,130,34,43,14,38,52,117,21,3,63,95,361,0.391666667,0.417391304,0.346153846,0.790697674,0.454166667
Bobby Jones,23,PHI,NBA,2006-07,44,5,336,43,93,42,84,1,9,23,41,22,35,57,16,11,1,18,59,110,0.462365591,0.5,0.111111111,0.56097561,0.467741935
Bobby Portis,20,CHI,NBA,2015-16,62,4,1102,186,436,170,384,16,52,48,66,123,214,337,52,25,22,54,100,436,0.426605505,0.442708333,0.307692308,0.727272727,0.444954128
Bobby Simmons,21,WAS,NBA,2001-02,30,3,343,43,95,39,81,4,14,22,30,25,27,52,17,13,5,14,31,112,0.452631579,0.481481481,0.285714286,0.733333333,0.473684211
Bojan Bogdanovic,25,BRK,NBA,2014-15,78,28,1854,261,576,170,320,91,256,87,106,50,163,213,68,34,9,78,104,700,0.453125,0.53125,0.35546875,0.820754717,0.532118056
Boniface N'Dong,28,LAC,NBA,2005-06,23,1,152,22,53,22,52,0,1,6,9,15,22,37,7,2,5,6,23,50,0.41509434,0.423076923,0.0,0.666666667,0.41509434
Boris Diaw,21,ATL,NBA,2003-04,76,37,1919,140,313,134,287,6,26,56,93,111,231,342,182,59,37,126,191,342,0.447284345,0.466898955,0.230769231,0.602150538,0.45686901
Bostjan Nachbar,22,HOU,NBA,2002-03,14,1,77,11,31,9,21,2,10,5,10,3,8,11,3,2,2,6,13,29,0.35483871,0.428571429,0.2,0.5,0.387096774
Bracey Wright,21,MIN,NBA,2005-06,7,0,135,21,51,15,34,6,17,14,16,3,15,18,5,1,0,8,8,62,0.411764706,0.441176471,0.352941176,0.875,0.470588235
Bradley Beal,19,WAS,NBA,2012-13,56,46,1745,282,687,191,451,91,236,125,159,43,168,211,137,50,29,90,113,780,0.410480349,0.423503326,0.38559322,0.786163522,0.476710335
Brandan Wright,20,GSW,NBA,2007-08,38,6,376,62,112,62,112,0,0,27,40,38,61,99,9,6,22,13,36,151,0.553571429,0.553571429,0.0,0.675,0.553571429
Branden Dawson,22,LAC,NBA,2015-16,6,0,29,2,5,2,5,0,0,1,1,2,2,4,0,0,1,0,2,5,0.4,0.4,0.0,1.0,0.4
Brandin Knight,23,HOU,NBA,2004-05,1,0,3,0,1,0,1,0,0,0,0,0,0,0,1,0,0,0,0,0,0.0,0.0,0.0,0.0,0.0
Brandon Armstrong,21,NJN,NBA,2001-02,35,0,196,27,85,22,68,5,17,5,10,10,6,16,8,7,1,8,26,64,0.317647059,0.323529412,0.294117647,0.5,0.347058824
Brandon Bass,20,NOK,NBA,2005-06,29,1,268,28,70,28,70,0,0,12,19,18,50,68,3,3,7,11,18,68,0.4,0.4,0.0,0.631578947,0.4
Brandon Davies,22,PHI,NBA,2013-14,51,0,575,54,128,52,118,2,10,34,53,38,71,109,28,24,8,35,92,144,0.421875,0.440677966,0.2,0.641509434,0.4296875
Brandon Hunter,23,BOS,NBA,2003-04,36,12,406,53,116,53,113,0,3,19,43,50,68,118,19,13,1,22,40,125,0.456896552,0.469026549,0.0,0.441860465,0.456896552
Brandon Ingram,19,LAL,NBA,2016-17,79,40,2279,276,686,221,499,55,187,133,214,60,257,317,166,50,36,116,158,740,0.402332362,0.442885772,0.294117647,0.621495327,0.442419825
Brandon Jennings,20,MIL,NBA,2009-10,82,82,2671,451,1216,306,828,145,388,223,273,49,233,282,470,105,18,200,191,1270,0.370888158,0.369565217,0.37371134,0.816849817,0.430509868
Brandon Knight,20,DET,NBA,2011-12,66,60,2129,319,769,214,493,105,276,104,137,33,178,211,251,49,10,171,154,847,0.414824447,0.434077079,0.380434783,0.759124088,0.483094928
Brandon Roy,22,POR,NBA,2006-07,57,55,2015,349,765,294,619,55,146,202,241,58,192,250,230,67,10,116,139,955,0.45620915,0.474959612,0.376712329,0.838174274,0.492156863
Brandon Rush,23,IND,NBA,2008-09,75,19,1803,243,575,165,366,78,209,46,66,34,199,233,66,38,37,75,128,610,0.422608696,0.450819672,0.373205742,0.696969697,0.490434783
Brendan Haywood,22,WAS,NBA,2001-02,62,2,1266,109,221,109,221,0,0,97,160,143,179,322,29,21,91,50,158,315,0.49321267,0.49321267,0.0,0.60625,0.49321267
Brian Cardinal,23,DET,NBA,2000-01,15,0,126,10,31,10,26,0,5,11,18,8,15,23,3,7,2,9,27,31,0.322580645,0.384615385,0.0,0.611111111,0.322580645
Brian Cook,23,LAL,NBA,2003-04,35,2,442,67,141,67,136,0,5,21,28,31,70,101,20,16,16,17,64,155,0.475177305,0.492647059,0.0,0.75,0.475177305
Brian Roberts,27,NOH,NBA,2012-13,78,5,1324,213,511,154,358,59,153,70,77,17,80,97,219,37,3,71,108,555,0.416829746,0.430167598,0.385620915,0.909090909,0.474559687
Brian Scalabrine,23,NJN,NBA,2001-02,28,0,290,23,67,20,57,3,10,11,15,12,39,51,21,9,2,24,39,60,0.343283582,0.350877193,0.3,0.733333333,0.365671642
Briante Weber,23,TOT,NBA,2015-16,7,4,169,14,39,14,34,0,5,3,4,8,17,25,21,9,3,9,12,31,0.358974359,0.411764706,0.0,0.75,0.358974359
Brice Johnson,22,LAC,NBA,2016-17,3,0,9,2,7,2,7,0,0,0,0,1,2,3,1,2,1,1,0,4,0.285714286,0.285714286,0.0,0.0,0.285714286
Britton Johnsen,24,ORL,NBA,2003-04,20,4,290,17,59,16,47,1,12,7,16,15,30,45,12,7,1,14,28,42,0.288135593,0.340425532,0.083333333,0.4375,0.296610169
Brook Lopez,20,NJN,NBA,2008-09,82,75,2501,448,844,448,842,0,2,172,217,225,440,665,86,44,151,147,257,1068,0.530805687,0.532066508,0.0,0.792626728,0.530805687
Bruno Caboclo,19,TOR,NBA,2014-15,8,0,23,4,12,2,9,2,3,0,0,1,1,2,0,0,1,4,3,10,0.333333333,0.222222222,0.666666667,0.0,0.416666667
Bryce Cotton,22,UTA,NBA,2014-15,15,0,159,29,69,22,49,7,20,15,18,3,15,18,15,4,0,12,6,80,0.420289855,0.448979592,0.35,0.833333333,0.471014493
Bryce Dejean-Jones,23,NOP,NBA,2015-16,14,11,279,28,69,16,37,12,32,11,21,8,40,48,15,10,2,11,17,79,0.405797101,0.432432432,0.375,0.523809524,0.492753623
Bryn Forbes,23,SAS,NBA,2016-17,36,0,285,36,99,19,46,17,53,5,6,2,21,23,23,1,0,11,20,94,0.363636364,0.413043478,0.320754717,0.833333333,0.449494949
Buddy Hield,23,TOT,NBA,2016-17,82,55,1888,327,768,179,389,148,379,64,76,35,234,269,121,38,9,101,115,866,0.42578125,0.460154242,0.390501319,0.842105263,0.522135417
Byron Mullens,20,OKC,NBA,2009-10,13,0,54,7,19,7,19,0,0,0,0,3,7,10,1,2,0,4,13,14,0.368421053,0.368421053,0.0,0.0,0.368421053
C.J. McCollum,22,POR,NBA,2013-14,38,0,476,74,178,44,98,30,80,23,34,7,41,48,27,14,2,35,53,201,0.415730337,0.448979592,0.375,0.676470588,0.5
C.J. Miles,18,UTA,NBA,2005-06,23,0,203,28,76,23,56,5,20,18,24,18,20,38,16,7,2,9,20,79,0.368421053,0.410714286,0.25,0.75,0.401315789
C.J. Watson,23,GSW,NBA,2007-08,32,0,368,43,101,34,75,9,26,23,29,13,19,32,35,15,0,18,19,118,0.425742574,0.453333333,0.346153846,0.793103448,0.47029703
C.J. Wilcox,24,LAC,NBA,2014-15,21,0,101,16,38,9,19,7,19,2,2,1,6,7,8,3,1,10,7,41,0.421052632,0.473684211,0.368421053,1.0,0.513157895
Cameron Bairstow,24,CHI,NBA,2014-15,18,1,64,3,14,3,14,0,0,4,5,6,2,8,1,2,1,3,8,10,0.214285714,0.214285714,0.0,0.8,0.214285714
Cameron Payne,21,OKC,NBA,2015-16,57,1,698,114,278,78,167,36,111,19,24,9,76,85,108,36,6,44,80,283,0.410071942,0.467065868,0.324324324,0.791666667,0.474820144
Caris LeVert,22,BRK,NBA,2016-17,57,26,1237,171,380,112,196,59,184,67,93,23,165,188,110,49,8,59,91,468,0.45,0.571428571,0.320652174,0.720430108,0.527631579
Carl Landry,24,HOU,NBA,2007-08,42,0,711,135,219,135,218,0,1,72,109,96,111,207,21,17,7,26,98,342,0.616438356,0.619266055,0.0,0.660550459,0.616438356
Carldell Johnson,29,NOH,NBA,2011-12,15,0,119,11,35,7,20,4,15,1,3,1,8,9,22,8,0,7,11,27,0.314285714,0.35,0.266666667,0.333333333,0.371428571
Carlos Arroyo,22,TOT,NBA,2001-02,37,1,371,49,111,49,109,0,2,13,18,12,28,40,70,11,1,23,30,111,0.441441441,0.449541284,0.0,0.722222222,0.441441441
Carlos Boozer,21,CLE,NBA,2002-03,81,54,2049,331,618,331,617,0,1,148,192,202,407,609,106,59,50,103,224,810,0.535598706,0.536466775,0.0,0.770833333,0.535598706
Carlos Delfino,22,DET,NBA,2004-05,30,4,459,42,117,33,82,9,35,23,40,13,42,55,38,22,6,23,44,116,0.358974359,0.402439024,0.257142857,0.575,0.397435897
Carmelo Anthony,19,DEN,NBA,2003-04,82,82,2995,624,1465,555,1251,69,214,408,525,183,315,498,227,97,41,247,225,1725,0.425938567,0.443645084,0.322429907,0.777142857,0.449488055
Caron Butler,22,MIA,NBA,2002-03,78,78,2858,429,1032,395,925,34,107,309,375,135,262,397,213,137,31,192,230,1201,0.415697674,0.427027027,0.317757009,0.824,0.432170543
Carrick Felix,23,CLE,NBA,2013-14,7,0,38,7,14,5,9,2,5,3,4,1,5,6,4,0,0,4,4,19,0.5,0.555555556,0.4,0.75,0.571428571
Cartier Martin,24,CHA,NBA,2008-09,33,1,266,28,77,18,44,10,33,20,25,7,26,33,13,8,4,9,33,86,0.363636364,0.409090909,0.303030303,0.8,0.428571429
Casey Jacobsen,21,PHO,NBA,2002-03,72,0,1147,122,327,70,162,52,165,72,105,29,54,83,73,35,6,55,90,368,0.373088685,0.432098765,0.315151515,0.685714286,0.452599388
Casper Ware,24,PHI,NBA,2013-14,9,0,116,18,42,11,21,7,21,5,6,0,9,9,10,8,0,5,11,48,0.428571429,0.523809524,0.333333333,0.833333333,0.511904762
Cedric Bozeman,23,ATL,NBA,2006-07,23,5,199,11,39,9,26,2,13,2,6,3,20,23,9,5,2,9,32,26,0.282051282,0.346153846,0.153846154,0.333333333,0.307692308
Cedric Jackson,23,TOT,NBA,2009-10,12,0,74,6,20,5,14,1,6,7,12,2,6,8,14,3,2,11,7,20,0.3,0.357142857,0.166666667,0.583333333,0.325
Cedric Simmons,21,NOK,NBA,2006-07,43,4,534,55,132,55,132,0,0,16,33,44,63,107,12,8,23,22,75,126,0.416666667,0.416666667,0.0,0.484848485,0.416666667
Cezary Trybanski,23,MEM,NBA,2002-03,15,0,86,5,20,5,20,0,0,4,10,6,8,14,1,0,6,8,13,14,0.25,0.25,0.0,0.4,0.25
Chandler Parsons,23,HOU,NBA,2011-12,63,57,1804,248,549,188,371,60,178,43,78,90,210,300,134,73,29,81,142,599,0.451730419,0.506738544,0.337078652,0.551282051,0.506375228
Channing Frye,22,NYK,NBA,2005-06,65,14,1572,305,640,302,631,3,9,189,229,138,236,374,53,30,47,97,200,802,0.4765625,0.478605388,0.333333333,0.825327511,0.47890625
Charles Jenkins,22,GSW,NBA,2011-12,51,28,893,130,291,127,271,3,20,34,39,8,60,68,170,33,6,60,85,297,0.446735395,0.468634686,0.15,0.871794872,0.451890034
Charlie Bell,22,TOT,NBA,2001-02,7,0,44,3,11,3,5,0,6,2,2,2,3,5,2,0,0,5,3,8,0.272727273,0.6,0.0,1.0,0.272727273
Charlie Villanueva,21,TOR,NBA,2005-06,81,36,2361,435,940,365,726,70,214,113,160,181,340,521,88,60,63,99,247,1053,0.462765957,0.502754821,0.327102804,0.70625,0.5
Chase Budinger,21,HOU,NBA,2009-10,74,4,1488,249,565,157,316,92,249,67,87,38,182,220,88,34,11,48,85,657,0.440707965,0.496835443,0.369477912,0.770114943,0.522123894
Chasson Randle,23,TOT,NBA,2016-17,26,0,299,40,98,24,51,16,47,41,43,6,26,32,34,9,2,19,39,137,0.408163265,0.470588235,0.340425532,0.953488372,0.489795918
Cheick Diallo,20,NOP,NBA,2016-17,17,0,199,36,76,36,76,0,0,15,21,23,50,73,4,4,7,7,17,87,0.473684211,0.473684211,0.0,0.714285714,0.473684211
Cheikh Samb,23,DET,NBA,2007-08,4,0,31,3,4,3,4,0,0,1,2,3,4,7,0,1,2,1,8,7,0.75,0.75,0.0,0.5,0.75
Chinanu Onuaku,20,HOU,NBA,2016-17,5,1,52,5,7,5,7,0,0,4,4,2,8,10,3,3,1,4,6,14,0.714285714,0.714285714,0.0,1.0,0.714285714
Chris Andersen,23,DEN,NBA,2001-02,24,1,262,25,74,25,70,0,4,22,28,38,38,76,7,7,28,13,35,72,0.337837838,0.357142857,0.0,0.785714286,0.337837838
Chris Babb,23,BOS,NBA,2013-14,14,0,132,8,30,2,3,6,27,0,0,4,13,17,3,6,0,3,13,22,0.266666667,0.666666667,0.222222222,0.0,0.366666667
Chris Bosh,19,TOR,NBA,2003-04,75,63,2510,327,712,322,698,5,14,202,288,191,366,557,78,59,106,107,215,861,0.459269663,0.461318052,0.357142857,0.701388889,0.462780899
Chris Copeland,28,NYK,NBA,2012-13,56,13,862,182,380,123,240,59,140,63,83,34,85,119,27,16,12,50,104,486,0.478947368,0.5125,0.421428571,0.759036145,0.556578947
Chris Douglas-Roberts,22,NJN,NBA,2008-09,44,3,585,81,176,78,164,3,12,51,62,14,36,50,52,12,7,31,34,216,0.460227273,0.475609756,0.25,0.822580645,0.46875
Chris Duhon,22,CHI,NBA,2004-05,82,73,2177,172,488,78,223,94,265,49,67,23,190,213,398,82,3,119,205,487,0.352459016,0.349775785,0.354716981,0.731343284,0.448770492
Chris Hunter,25,GSW,NBA,2009-10,60,9,783,109,217,109,213,0,4,52,69,56,111,167,37,13,35,30,132,270,0.502304147,0.511737089,0.0,0.753623188,0.502304147
Chris Jefferies,22,TOR,NBA,2002-03,51,10,666,75,194,57,140,18,54,29,43,16,43,59,22,19,16,45,56,197,0.386597938,0.407142857,0.333333333,0.674418605,0.432989691
Chris Johnson,25,TOT,NBA,2010-11,14,1,138,9,21,9,21,0,0,15,20,12,20,32,3,3,9,10,21,33,0.428571429,0.428571429,0.0,0.75,0.428571429
Chris Kaman,21,LAC,NBA,2003-04,82,61,1843,200,435,200,433,0,2,99,142,126,335,461,85,23,73,155,211,499,0.459770115,0.461893764,0.0,0.697183099,0.459770115
Chris McCray,22,MIL,NBA,2006-07,5,0,12,0,3,0,3,0,0,0,0,0,0,0,0,0,0,2,1,0,0.0,0.0,0.0,0.0,0.0
Chris McCullough,20,BRK,NBA,2015-16,24,4,362,44,109,31,75,13,34,11,23,25,43,68,9,28,12,15,39,112,0.403669725,0.413333333,0.382352941,0.47826087,0.463302752
Chris Mihm,21,CLE,NBA,2000-01,59,43,1166,173,391,173,390,0,1,100,126,106,174,280,16,20,53,80,156,446,0.442455243,0.443589744,0.0,0.793650794,0.442455243
Chris Owens,23,MEM,NBA,2002-03,1,0,6,2,3,2,3,0,0,0,0,1,0,1,0,0,0,1,0,4,0.666666667,0.666666667,0.0,0.0,0.666666667
Chris Paul,20,NOK,NBA,2005-06,78,78,2808,407,947,357,770,50,177,394,465,61,339,400,611,175,6,183,218,1258,0.429778247,0.463636364,0.282485876,0.847311828,0.456177402
Chris Porter,22,GSW,NBA,2000-01,51,35,1147,173,445,173,440,0,5,94,141,89,100,189,61,45,6,59,111,440,0.388764045,0.393181818,0.0,0.666666667,0.388764045
Chris Quinn,23,MIA,NBA,2006-07,42,1,408,48,131,28,74,20,57,25,37,6,24,30,65,15,0,21,32,141,0.366412214,0.378378378,0.350877193,0.675675676,0.442748092
Chris Richard,23,MIN,NBA,2007-08,52,3,556,41,87,41,87,0,0,16,27,52,83,135,18,10,12,24,83,98,0.471264368,0.471264368,0.0,0.592592593,0.471264368
Chris Singleton,22,WAS,NBA,2011-12,66,51,1431,116,312,72,185,44,127,30,44,43,190,233,49,70,30,38,176,306,0.371794872,0.389189189,0.346456693,0.681818182,0.442307692
Chris Smith,26,NYK,NBA,2013-14,2,0,2,0,0,0,0,0,0,0,0,0,0,0,0,0,0,0,0,0,0.0,0.0,0.0,0.0,0.0
Chris Taft,20,GSW,NBA,2005-06,17,0,144,23,38,23,38,0,0,1,6,19,17,36,2,2,7,2,25,47,0.605263158,0.605263158,0.0,0.166666667,0.605263158
Chris Wilcox,20,LAC,NBA,2002-03,46,3,479,73,140,73,140,0,0,25,50,32,72,104,21,7,12,26,65,171,0.521428571,0.521428571,0.0,0.5,0.521428571
Chris Wright Dos,23,DAL,NBA,2012-13,3,0,4,1,2,1,2,0,0,0,0,0,0,0,0,0,0,1,0,2,0.5,0.5,0.0,0.0,0.5
Chris Wright Uno,23,GSW,NBA,2011-12,24,1,186,23,45,23,45,0,0,24,31,19,26,45,4,7,13,8,22,70,0.511111111,0.511111111,0.0,0.774193548,0.511111111
Christapher Johnson,22,MEM,NBA,2012-13,8,0,102,11,25,5,7,6,18,1,2,5,6,11,2,4,0,3,5,29,0.44,0.714285714,0.333333333,0.5,0.56
Christian Eyenga,21,CLE,NBA,2010-11,44,18,947,130,306,105,215,25,91,18,28,27,96,123,35,34,28,47,78,303,0.424836601,0.488372093,0.274725275,0.642857143,0.465686275
Christian Wood,20,PHI,NBA,2015-16,17,0,145,22,53,18,42,4,11,13,21,13,25,38,3,5,7,2,11,61,0.41509434,0.428571429,0.363636364,0.619047619,0.452830189
Chuck Hayes,22,HOU,NBA,2005-06,40,0,535,59,105,59,104,0,1,29,45,67,112,179,14,26,14,12,76,147,0.561904762,0.567307692,0.0,0.644444444,0.561904762
Cleanthony Early,23,NYK,NBA,2014-15,39,7,647,76,214,54,130,22,84,36,48,22,75,97,36,24,12,40,57,210,0.355140187,0.415384615,0.261904762,0.75,0.406542056
Cliff Alexander,20,POR,NBA,2015-16,8,0,36,5,10,5,10,0,0,0,0,2,4,6,0,1,2,1,1,10,0.5,0.5,0.0,0.0,0.5
Clint Capela,20,HOU,NBA,2014-15,12,0,90,14,29,14,29,0,0,4,23,10,26,36,2,1,9,5,14,32,0.482758621,0.482758621,0.0,0.173913043,0.482758621
Coby Karl,24,LAL,NBA,2007-08,17,0,71,9,26,5,13,4,13,8,10,3,11,14,9,4,2,5,4,30,0.346153846,0.384615385,0.307692308,0.8,0.423076923
Cody Zeller,21,CHA,NBA,2013-14,82,3,1416,172,404,172,403,0,1,146,200,118,235,353,92,40,41,87,170,490,0.425742574,0.426799007,0.0,0.73,0.425742574
Cole Aldrich,22,OKC,NBA,2010-11,18,0,142,8,15,8,15,0,0,2,4,13,22,35,4,5,7,8,30,18,0.533333333,0.533333333,0.0,0.5,0.533333333
Corey Brewer,21,MIN,NBA,2007-08,79,35,1803,182,486,175,450,7,36,88,110,82,210,292,111,76,25,89,188,459,0.374485597,0.388888889,0.194444444,0.8,0.381687243
Corsley Edwards,25,NOH,NBA,2004-05,10,0,110,10,31,10,31,0,0,7,12,12,13,25,3,3,4,2,19,27,0.322580645,0.322580645,0.0,0.583333333,0.322580645
Cory Higgins,22,CHA,NBA,2011-12,38,0,423,52,160,48,140,4,20,42,60,7,28,35,36,5,6,39,40,150,0.325,0.342857143,0.2,0.7,0.3375
Cory Jefferson,24,BRK,NBA,2014-15,50,1,531,75,167,73,152,2,15,31,54,47,98,145,16,10,21,20,61,183,0.449101796,0.480263158,0.133333333,0.574074074,0.45508982
Cory Joseph,20,SAS,NBA,2011-12,29,1,266,22,70,19,55,3,15,11,17,5,20,25,34,7,3,12,16,58,0.314285714,0.345454545,0.2,0.647058824,0.335714286
Coty Clarke,23,BOS,NBA,2015-16,3,0,6,2,4,0,2,2,2,0,0,0,1,1,0,0,0,1,0,6,0.5,0.0,1.0,0.0,0.75
Courtney Alexander,23,TOT,NBA,2000-01,65,24,1382,239,573,222,527,17,46,123,150,42,101,143,62,45,5,75,139,618,0.417102967,0.421252372,0.369565217,0.82,0.431937173
Courtney Fortson,23,TOT,NBA,2011-12,10,0,95,11,32,8,19,3,13,10,15,6,9,15,10,3,0,10,5,35,0.34375,0.421052632,0.230769231,0.666666667,0.390625
Courtney Lee,23,ORL,NBA,2008-09,77,42,1939,243,540,161,337,82,203,78,94,18,160,178,91,76,14,69,157,646,0.45,0.477744807,0.403940887,0.829787234,0.525925926
Courtney Sims,24,IND,NBA,2007-08,3,0,11,0,1,0,1,0,0,0,0,1,1,2,1,0,0,0,2,0,0.0,0.0,0.0,0.0,0.0
Craig Brackins,23,PHI,NBA,2010-11,3,0,33,4,16,4,11,0,5,0,0,2,2,4,1,1,0,0,3,8,0.25,0.363636364,0.0,0.0,0.25
Craig Smith,23,MIN,NBA,2006-07,82,5,1537,246,463,246,457,0,6,116,186,149,267,416,49,51,18,74,223,608,0.531317495,0.538293217,0.0,0.623655914,0.531317495
Cristiano Felicio,23,CHI,NBA,2015-16,31,4,321,40,72,40,68,0,4,25,35,30,72,102,26,6,13,13,31,105,0.555555556,0.588235294,0.0,0.714285714,0.555555556
Curtis Borchardt,23,UTA,NBA,2003-04,16,0,258,22,56,22,55,0,1,14,18,13,41,54,15,4,14,18,40,58,0.392857143,0.4,0.0,0.777777778,0.392857143
D'Angelo Russell,19,LAL,NBA,2015-16,80,48,2259,392,956,262,586,130,370,140,190,47,227,274,266,93,13,196,142,1054,0.410041841,0.447098976,0.351351351,0.736842105,0.478033473
D.J. Augustin,21,CHA,NBA,2008-09,72,12,1908,267,621,159,375,108,246,208,233,17,116,133,250,42,2,119,140,850,0.429951691,0.424,0.43902439,0.892703863,0.516908213
D.J. Kennedy,22,CLE,NBA,2011-12,2,0,59,5,12,3,8,2,4,0,2,1,6,7,3,2,0,3,7,12,0.416666667,0.375,0.5,0.0,0.5
D.J. Stephens,23,MIL,NBA,2013-14,3,0,15,3,7,3,7,0,0,1,1,1,4,5,0,0,0,0,0,7,0.428571429,0.428571429,0.0,1.0,0.428571429
D.J. Strawberry,22,PHO,NBA,2007-08,33,0,270,29,92,23,67,6,25,9,19,9,19,28,30,12,6,11,36,73,0.315217391,0.343283582,0.24,0.473684211,0.347826087
D.J. White,22,OKC,NBA,2008-09,7,0,130,26,50,26,50,0,0,10,13,10,22,32,6,3,5,3,10,62,0.52,0.52,0.0,0.769230769,0.52
DaJuan Summers,22,DET,NBA,2009-10,44,0,405,46,130,31,88,15,42,27,38,14,31,45,16,8,7,16,52,134,0.353846154,0.352272727,0.357142857,0.710526316,0.411538462
Daequan Cook,20,MIA,NBA,2007-08,59,19,1441,196,514,117,276,79,238,47,57,20,157,177,75,23,9,63,157,518,0.381322957,0.423913043,0.331932773,0.824561404,0.458171206
Dahntay Jones,23,MEM,NBA,2003-04,20,0,154,15,53,14,49,1,4,5,11,7,16,23,12,5,6,12,23,36,0.283018868,0.285714286,0.25,0.454545455,0.29245283
Dajuan Wagner,19,CLE,NBA,2002-03,47,24,1385,223,605,168,431,55,174,128,160,20,62,82,130,38,7,85,107,629,0.368595041,0.389791183,0.316091954,0.8,0.414049587
Dalibor Bagaric,20,CHI,NBA,2000-01,35,0,259,17,65,17,64,0,1,13,28,22,34,56,10,9,16,21,44,47,0.261538462,0.265625,0.0,0.464285714,0.261538462
Damian Jones,21,GSW,NBA,2016-17,10,0,85,8,16,8,16,0,0,3,10,9,14,23,0,1,4,6,15,19,0.5,0.5,0.0,0.3,0.5
Damian Lillard,22,POR,NBA,2012-13,82,82,3167,553,1288,368,785,185,503,271,321,42,215,257,531,74,19,243,172,1562,0.429347826,0.468789809,0.367793241,0.84423676,0.501164596
Damien Inglis,20,MIL,NBA,2015-16,20,1,156,13,37,10,24,3,13,7,8,2,29,31,10,6,3,11,11,36,0.351351351,0.416666667,0.230769231,0.875,0.391891892
Damien Wilkins,25,SEA,NBA,2004-05,29,7,520,73,168,57,109,16,59,21,34,29,37,66,26,22,10,16,55,183,0.43452381,0.52293578,0.271186441,0.617647059,0.482142857
Damion James,23,NJN,NBA,2010-11,25,9,403,46,103,46,100,0,3,18,28,17,68,85,20,16,12,25,36,110,0.446601942,0.46,0.0,0.642857143,0.446601942
Damir Markota,21,MIL,NBA,2006-07,30,0,170,19,52,13,36,6,16,7,11,11,20,31,6,3,1,15,22,51,0.365384615,0.361111111,0.375,0.636363636,0.423076923
Damjan Rudez,28,IND,NBA,2014-15,68,2,1047,119,263,50,93,69,170,16,23,8,39,47,53,16,5,47,79,323,0.452471483,0.537634409,0.405882353,0.695652174,0.58365019
Damone Brown,22,PHI,NBA,2001-02,17,0,67,8,21,8,20,0,1,7,8,2,2,4,2,1,1,9,11,23,0.380952381,0.4,0.0,0.875,0.380952381
Dan Dickau,24,ATL,NBA,2002-03,50,0,515,70,170,48,109,22,61,21,26,9,34,43,85,14,2,53,66,183,0.411764706,0.440366972,0.360655738,0.807692308,0.476470588
Dan Gadzuric,24,MIL,NBA,2002-03,49,30,760,70,145,70,144,0,1,29,56,66,131,197,9,22,52,27,125,169,0.482758621,0.486111111,0.0,0.517857143,0.482758621
Dan Langhi,23,HOU,NBA,2000-01,33,0,241,37,99,37,98,0,1,16,29,13,28,41,4,7,1,8,16,90,0.373737374,0.37755102,0.0,0.551724138,0.373737374
Dan McClintock,23,DEN,NBA,2000-01,6,1,58,9,18,9,18,0,0,0,5,10,7,17,1,0,2,3,11,18,0.5,0.5,0.0,0.0,0.5
Daniel Ewing,22,LAC,NBA,2005-06,66,5,971,97,255,75,177,22,78,36,46,23,62,85,84,37,6,57,86,252,0.380392157,0.423728814,0.282051282,0.782608696,0.423529412
Daniel Gibson,20,CLE,NBA,2006-07,60,16,988,98,231,46,107,52,124,28,39,28,64,92,69,23,8,44,94,276,0.424242424,0.429906542,0.419354839,0.717948718,0.536796537
Daniel Ochefu,23,WAS,NBA,2016-17,19,0,75,12,27,12,27,0,0,0,2,5,17,22,3,2,0,3,17,24,0.444444444,0.444444444,0.0,0.0,0.444444444
Daniel Orton,21,ORL,NBA,2011-12,16,2,187,17,30,17,29,0,1,11,25,19,20,39,5,8,9,7,30,45,0.566666667,0.586206897,0.0,0.44,0.566666667
Daniel Santiago,24,PHO,NBA,2000-01,54,2,581,64,134,64,134,0,0,42,61,35,67,102,11,17,21,47,101,170,0.47761194,0.47761194,0.0,0.68852459,0.47761194
Danilo Gallinari,20,NYK,NBA,2008-09,28,2,412,56,125,24,53,32,72,26,27,13,42,55,15,14,4,15,48,170,0.448,0.452830189,0.444444444,0.962962963,0.576
Danny Granger,22,IND,NBA,2005-06,78,17,1765,221,478,191,385,30,93,115,148,131,253,384,90,58,62,80,211,587,0.462343096,0.496103896,0.322580645,0.777027027,0.493723849
Danny Green,22,CLE,NBA,2009-10,20,0,115,15,39,9,17,6,22,4,6,8,9,17,5,6,3,5,9,40,0.384615385,0.529411765,0.272727273,0.666666667,0.461538462
Dante Cunningham,22,POR,NBA,2009-10,63,2,707,106,214,106,212,0,2,31,48,54,106,160,14,24,22,15,97,243,0.495327103,0.5,0.0,0.645833333,0.495327103
Dante Exum,19,UTA,NBA,2014-15,82,41,1817,145,416,62,152,83,264,20,32,27,104,131,198,41,14,118,147,393,0.348557692,0.407894737,0.314393939,0.625,0.448317308
Danuel House,23,WAS,NBA,2016-17,1,0,1,0,0,0,0,0,0,0,0,0,1,1,0,0,0,0,0,0,0.0,0.0,0.0,0.0,0.0
Darington Hobson,24,MIL,NBA,2011-12,5,0,39,2,13,2,7,0,6,0,0,0,3,3,6,0,0,2,1,4,0.153846154,0.285714286,0.0,0.0,0.153846154
Dario Saric,22,PHI,NBA,2016-17,81,36,2129,381,927,275,586,106,341,172,220,112,401,513,182,57,30,183,162,1040,0.411003236,0.469283276,0.31085044,0.781818182,0.468176915
Darius Johnson-Odom,23,LAL,NBA,2012-13,4,0,6,0,4,0,3,0,1,0,0,1,3,4,1,0,0,0,0,0,0.0,0.0,0.0,0.0,0.0
Darius Miles,19,LAC,NBA,2000-01,81,21,2133,318,630,317,611,1,19,124,238,127,350,477,99,51,125,147,191,761,0.504761905,0.518821604,0.052631579,0.521008403,0.505555556
Darius Miller,22,NOH,NBA,2012-13,52,2,694,44,108,22,52,22,56,8,8,8,70,78,44,17,12,23,89,118,0.407407407,0.423076923,0.392857143,1.0,0.509259259
Darius Morris,21,LAL,NBA,2011-12,19,0,169,18,42,14,33,4,9,6,9,2,14,16,21,2,0,19,16,46,0.428571429,0.424242424,0.444444444,0.666666667,0.476190476
Darius Songaila,25,SAC,NBA,2003-04,73,7,976,133,273,133,273,0,0,71,88,91,134,225,48,42,12,43,126,337,0.487179487,0.487179487,0.0,0.806818182,0.487179487
Darius Washington,22,SAS,NBA,2007-08,18,0,146,21,48,17,36,4,12,7,13,4,16,20,15,5,0,14,16,53,0.4375,0.472222222,0.333333333,0.538461538,0.479166667
Darko Milicic,18,DET,NBA,2003-04,34,0,159,17,65,17,64,0,1,14,24,11,32,43,7,7,15,13,33,48,0.261538462,0.265625,0.0,0.583333333,0.261538462
Darnell Jackson,23,CLE,NBA,2008-09,51,2,430,37,86,37,84,0,2,24,35,32,55,87,8,10,4,14,77,98,0.430232558,0.44047619,0.0,0.685714286,0.430232558
Darrell Arthur,20,MEM,NBA,2008-09,76,64,1464,191,436,191,434,0,2,40,60,108,238,346,43,52,52,47,206,422,0.438073394,0.440092166,0.0,0.666666667,0.438073394
Darren Collison,22,NOH,NBA,2009-10,76,37,2109,376,789,330,674,46,115,148,174,41,151,192,432,78,4,202,92,946,0.476552598,0.489614243,0.4,0.850574713,0.505703422
Darrun Hilliard,22,DET,NBA,2015-16,38,2,383,52,131,33,81,19,50,29,40,5,40,45,27,9,1,19,28,152,0.396946565,0.407407407,0.38,0.725,0.469465649
Darryl Watkins,23,SAC,NBA,2007-08,9,0,71,5,15,5,15,0,0,2,5,5,7,12,0,2,2,7,8,12,0.333333333,0.333333333,0.0,0.4,0.333333333
David Andersen,29,HOU,NBA,2009-10,63,0,891,147,340,120,262,27,78,46,67,54,154,208,44,15,12,37,119,367,0.432352941,0.458015267,0.346153846,0.686567164,0.472058824
David Harrison,22,IND,NBA,2004-05,43,14,760,106,184,106,184,0,0,52,91,48,87,135,13,16,55,53,134,264,0.576086957,0.576086957,0.0,0.571428571,0.576086957
David Lee,22,NYK,NBA,2005-06,67,14,1129,137,230,137,230,0,0,71,123,109,194,303,43,30,20,51,124,345,0.595652174,0.595652174,0.0,0.577235772,0.595652174
David Noel,22,MIL,NBA,2006-07,68,0,792,65,177,48,124,17,53,37,43,42,81,123,65,25,9,40,77,184,0.367231638,0.387096774,0.320754717,0.860465116,0.415254237
David Nwaba,24,LAL,NBA,2016-17,20,2,397,47,81,46,76,1,5,25,39,16,46,62,14,13,7,11,36,120,0.580246914,0.605263158,0.2,0.641025641,0.586419753
David Stockton,23,SAC,NBA,2014-15,3,0,33,2,6,1,4,1,2,3,6,0,2,2,9,2,0,4,1,8,0.333333333,0.25,0.5,0.5,0.416666667
David Vanterpool,27,WAS,NBA,2000-01,22,0,411,46,110,46,104,0,6,30,50,15,22,37,66,23,3,37,44,122,0.418181818,0.442307692,0.0,0.6,0.418181818
David Wear,24,SAC,NBA,2014-15,2,0,7,0,2,0,1,0,1,0,0,2,0,2,1,0,0,0,1,0,0.0,0.0,0.0,0.0,0.0
David West,23,NOH,NBA,2003-04,71,1,930,108,228,108,226,0,2,57,80,117,180,297,60,27,28,48,117,273,0.473684211,0.477876106,0.0,0.7125,0.473684211
Davis Bertans,24,SAS,NBA,2016-17,67,6,808,103,234,34,61,69,173,28,34,22,77,99,46,20,28,32,75,303,0.44017094,0.557377049,0.398843931,0.823529412,0.587606838
DeAndre Jordan,20,LAC,NBA,2008-09,53,13,771,93,147,93,147,0,0,42,109,72,165,237,11,11,59,41,96,228,0.632653061,0.632653061,0.0,0.385321101,0.632653061
DeAndre Liggins,23,ORL,NBA,2011-12,17,0,115,12,25,12,21,0,4,9,19,6,9,15,5,6,0,10,6,33,0.48,0.571428571,0.0,0.473684211,0.48
DeAndre' Bembry,22,ATL,NBA,2016-17,38,1,371,47,98,46,80,1,18,6,16,14,45,59,28,8,5,16,21,101,0.479591837,0.575,0.055555556,0.375,0.484693878
DeJuan Blair,20,SAS,NBA,2009-10,82,23,1494,275,495,275,493,0,2,88,161,200,326,526,65,50,39,112,224,638,0.555555556,0.557809331,0.0,0.546583851,0.555555556
DeMar DeRozan,20,TOR,NBA,2009-10,77,65,1664,255,512,251,496,4,16,148,194,66,157,223,53,43,18,62,176,662,0.498046875,0.506048387,0.25,0.762886598,0.501953125
DeMarcus Cousins,20,SAC,NBA,2010-11,81,62,2309,432,1004,429,986,3,18,276,402,217,482,699,204,85,68,268,332,1143,0.430278884,0.435091278,0.166666667,0.686567164,0.431772908
DeMarcus Nelson,23,GSW,NBA,2008-09,13,5,171,24,54,24,51,0,3,5,14,6,18,24,13,9,2,15,24,53,0.444444444,0.470588235,0.0,0.357142857,0.444444444
DeMarre Carroll,23,MEM,NBA,2009-10,71,1,795,88,222,88,216,0,6,33,53,53,97,150,33,28,9,24,107,209,0.396396396,0.407407407,0.0,0.622641509,0.396396396
DeQuan Jones,22,ORL,NBA,2012-13,63,17,803,95,218,86,183,9,35,34,51,17,88,105,16,19,22,30,55,233,0.435779817,0.469945355,0.257142857,0.666666667,0.456422018
DeSagana Diop,20,CLE,NBA,2001-02,18,1,109,12,29,12,29,0,0,1,5,5,12,17,5,1,10,12,19,25,0.413793103,0.413793103,0.0,0.2,0.413793103
DeShawn Stevenson,19,UTA,NBA,2000-01,40,2,293,31,91,30,79,1,12,26,38,9,19,28,18,10,2,28,29,89,0.340659341,0.379746835,0.083333333,0.684210526,0.346153846
Dean Oliver,23,GSW,NBA,2001-02,20,0,139,17,46,15,33,2,13,6,9,0,8,8,21,3,0,11,16,42,0.369565217,0.454545455,0.153846154,0.666666667,0.391304348
Dee Brown,22,UTA,NBA,2006-07,49,0,450,32,98,26,70,6,28,24,37,8,32,40,83,22,7,31,51,94,0.326530612,0.371428571,0.214285714,0.648648649,0.357142857
Dejounte Murray,20,SAS,NBA,2016-17,38,8,322,50,116,41,93,9,23,21,30,6,36,42,48,8,6,38,29,130,0.431034483,0.440860215,0.391304348,0.7,0.469827586
Delon Wright,23,TOR,NBA,2015-16,27,1,229,36,80,31,67,5,13,26,35,8,29,37,31,8,3,16,7,103,0.45,0.462686567,0.384615385,0.742857143,0.48125
Delonte West,21,BOS,NBA,2004-05,39,7,507,66,155,42,88,24,67,19,27,14,51,65,53,21,8,24,69,175,0.425806452,0.477272727,0.358208955,0.703703704,0.503225806
Demetris Nichols,23,TOT,NBA,2007-08,14,0,44,6,23,3,10,3,13,0,0,0,5,5,1,0,3,4,4,15,0.260869565,0.3,0.230769231,0.0,0.326086957
Demetrius Jackson,22,BOS,NBA,2016-17,5,0,17,3,4,2,3,1,1,3,6,2,2,4,3,0,0,0,0,10,0.75,0.666666667,1.0,0.5,0.875
Deng Gai,23,PHI,NBA,2005-06,2,0,5,0,0,0,0,0,0,0,0,0,0,0,0,0,0,0,0,0,0.0,0.0,0.0,0.0,0.0
Dennis Horner,23,NJN,NBA,2011-12,8,0,22,1,4,1,3,0,1,3,4,2,3,5,0,0,0,1,1,5,0.25,0.333333333,0.0,0.75,0.25
Dennis Schroder,20,ATL,NBA,2013-14,49,0,641,72,188,62,146,10,42,29,43,5,55,60,93,17,0,61,54,183,0.382978723,0.424657534,0.238095238,0.674418605,0.409574468
Denzel Valentine,23,CHI,NBA,2016-17,57,0,976,102,288,29,80,73,208,14,18,11,140,151,63,30,7,49,86,291,0.354166667,0.3625,0.350961538,0.777777778,0.480902778
DerMarr Johnson,20,ATL,NBA,2000-01,78,21,1313,146,390,105,263,41,127,64,87,56,122,178,64,43,30,93,134,397,0.374358974,0.399239544,0.322834646,0.735632184,0.426923077
Deron Williams,21,UTA,NBA,2005-06,80,47,2307,339,805,248,586,91,219,95,135,35,159,194,359,60,17,145,233,864,0.421118012,0.423208191,0.415525114,0.703703704,0.477639752
Derrick Brown,22,CHA,NBA,2009-10,57,0,535,68,147,66,140,2,7,48,72,31,47,78,19,21,10,19,53,186,0.462585034,0.471428571,0.285714286,0.666666667,0.469387755
Derrick Byars,27,SAS,NBA,2011-12,2,0,37,3,11,3,5,0,6,4,4,6,5,11,1,2,0,0,2,10,0.272727273,0.6,0.0,1.0,0.272727273
Derrick Caracter,22,LAL,NBA,2010-11,41,0,215,32,66,32,66,0,0,17,23,19,24,43,7,4,10,19,47,81,0.484848485,0.484848485,0.0,0.739130435,0.484848485
Derrick Favors,19,TOT,NBA,2010-11,78,27,1535,215,416,215,416,0,0,103,173,171,241,412,39,29,68,77,246,533,0.516826923,0.516826923,0.0,0.595375723,0.516826923
Derrick Jones,19,PHO,NBA,2016-17,32,8,545,68,121,65,110,3,11,29,41,39,40,79,12,14,13,13,63,168,0.561983471,0.590909091,0.272727273,0.707317073,0.574380165
Derrick Rose,20,CHI,NBA,2008-09,81,80,3000,574,1208,558,1136,16,72,197,250,96,221,317,512,66,18,202,125,1361,0.475165563,0.491197183,0.222222222,0.788,0.481788079
Derrick Williams,20,MIN,NBA,2011-12,66,15,1418,205,498,168,360,37,138,136,195,77,234,311,38,30,31,77,95,583,0.411646586,0.466666667,0.268115942,0.697435897,0.448795181
Derrick Zimmerman,24,NJN,NBA,2005-06,2,0,32,2,3,2,3,0,0,0,0,1,3,4,7,0,0,4,4,4,0.666666667,0.666666667,0.0,0.0,0.666666667
Desmon Farmer,25,SEA,NBA,2006-07,8,0,32,5,15,3,7,2,8,1,1,0,1,1,9,1,0,1,2,13,0.333333333,0.428571429,0.25,1.0,0.4
Desmond Ferguson,26,POR,NBA,2003-04,7,0,32,5,12,2,4,3,8,0,2,0,4,4,1,0,0,1,0,13,0.416666667,0.5,0.375,0.0,0.541666667
Desmond Mason,23,SEA,NBA,2000-01,78,14,1522,189,439,171,372,18,67,67,91,72,177,249,63,39,20,53,146,463,0.430523918,0.459677419,0.268656716,0.736263736,0.451025057
Desmond Penigar,22,ORL,NBA,2003-04,10,0,89,14,28,14,28,0,0,4,4,6,18,24,3,2,2,6,14,32,0.5,0.5,0.0,1.0,0.5
Devin Booker,19,PHO,NBA,2015-16,76,51,2108,367,867,268,578,99,289,215,256,27,160,187,200,44,20,160,225,1048,0.423298731,0.46366782,0.342560554,0.83984375,0.480392157
Devin Brown,24,TOT,NBA,2002-03,10,2,93,12,35,12,34,0,1,6,8,8,10,18,7,4,1,9,14,30,0.342857143,0.352941176,0.0,0.75,0.342857143
Devin Ebanks,21,LAL,NBA,2010-11,20,0,118,21,51,19,46,2,5,18,23,15,12,27,2,4,5,6,7,62,0.411764706,0.413043478,0.4,0.782608696,0.431372549
Devin Green,23,LAL,NBA,2005-06,27,0,135,6,28,6,26,0,2,13,21,10,14,24,7,3,0,5,13,25,0.214285714,0.230769231,0.0,0.619047619,0.214285714
Devin Harris,21,DAL,NBA,2004-05,76,19,1173,157,366,113,235,44,131,78,103,28,74,102,169,77,19,82,139,436,0.428961749,0.480851064,0.335877863,0.757281553,0.489071038
Devyn Marble,22,ORL,NBA,2014-15,16,7,208,14,44,10,22,4,22,5,16,5,26,31,17,9,2,9,14,37,0.318181818,0.454545455,0.181818182,0.3125,0.363636364
Dewayne Dedmon,24,TOT,NBA,2013-14,31,6,390,38,83,38,83,0,0,21,32,38,89,127,5,7,22,18,66,97,0.457831325,0.457831325,0.0,0.65625,0.457831325
Dexter Pittman,22,MIA,NBA,2010-11,2,0,11,1,3,1,3,0,0,0,0,1,2,3,0,0,0,2,2,2,0.333333333,0.333333333,0.0,0.0,0.333333333
Deyonta Davis,20,MEM,NBA,2016-17,36,0,238,24,47,24,47,0,0,10,18,20,40,60,2,3,17,8,40,58,0.510638298,0.510638298,0.0,0.555555556,0.510638298
Diamond Stone,19,LAC,NBA,2016-17,7,0,24,3,13,3,13,0,0,4,4,1,5,6,0,0,1,2,5,10,0.230769231,0.230769231,0.0,1.0,0.230769231
Diante Garrett,24,PHO,NBA,2012-13,19,0,149,16,49,13,34,3,15,5,10,5,10,15,31,10,0,16,5,40,0.326530612,0.382352941,0.2,0.5,0.357142857
Didier Ilunga-Mbenga,24,DAL,NBA,2004-05,15,1,58,6,14,6,14,0,0,3,4,3,5,8,0,0,5,5,13,15,0.428571429,0.428571429,0.0,0.75,0.428571429
Dijon Thompson,22,PHO,NBA,2005-06,10,0,43,11,25,7,14,4,11,2,2,4,7,11,1,3,1,2,6,28,0.44,0.5,0.363636364,1.0,0.52
Dion Waiters,21,CLE,NBA,2012-13,61,48,1756,336,815,273,612,63,203,159,213,22,127,149,183,59,16,121,113,894,0.412269939,0.446078431,0.310344828,0.746478873,0.450920245
Dionte Christmas,27,PHO,NBA,2013-14,31,0,198,22,62,13,31,9,31,18,24,13,25,38,8,2,3,6,19,71,0.35483871,0.419354839,0.290322581,0.75,0.427419355
Domantas Sabonis,20,OKC,NBA,2016-17,81,66,1632,192,481,141,322,51,159,44,67,45,242,287,82,39,32,83,200,479,0.399168399,0.437888199,0.320754717,0.656716418,0.452182952
Dominic McGuire,22,WAS,NBA,2007-08,70,1,695,39,103,38,97,1,6,14,32,53,86,139,40,20,26,40,76,93,0.378640777,0.391752577,0.166666667,0.4375,0.383495146
Dominique Jones,22,DAL,NBA,2010-11,18,0,135,14,45,14,41,0,4,14,17,6,19,25,19,5,3,10,7,42,0.311111111,0.341463415,0.0,0.823529412,0.311111111
Donald Sloan,24,TOT,NBA,2011-12,33,11,669,79,198,77,173,2,25,23,30,18,49,67,105,13,3,49,37,183,0.398989899,0.445086705,0.08,0.766666667,0.404040404
Donatas Motiejunas,22,HOU,NBA,2012-13,44,14,538,97,213,73,130,24,83,32,51,36,57,93,31,7,10,37,73,250,0.455399061,0.561538462,0.289156627,0.62745098,0.511737089
Donell Taylor,23,WAS,NBA,2005-06,51,1,465,53,136,49,119,4,17,30,43,16,37,53,45,30,4,34,47,140,0.389705882,0.411764706,0.235294118,0.697674419,0.404411765
Donnell Harvey,20,DAL,NBA,2000-01,18,0,65,8,14,8,14,0,0,6,16,6,14,20,2,3,1,7,15,22,0.571428571,0.571428571,0.0,0.375,0.571428571
Donta Smith,21,ATL,NBA,2004-05,38,0,433,44,113,38,91,6,22,33,48,19,33,52,39,23,5,25,50,127,0.389380531,0.417582418,0.272727273,0.6875,0.415929204
Donte Greene,20,SAC,NBA,2008-09,55,4,725,77,236,51,136,26,100,29,34,19,67,86,30,16,14,37,68,209,0.326271186,0.375,0.26,0.852941176,0.381355932
Dontell Jefferson,25,CHA,NBA,2008-09,6,0,84,11,22,10,20,1,2,6,9,1,11,12,9,4,1,6,9,29,0.5,0.5,0.5,0.666666667,0.522727273
Dorell Wright,19,MIA,NBA,2004-05,3,0,27,3,11,3,7,0,4,1,1,0,1,1,3,4,0,3,2,7,0.272727273,0.428571429,0.0,1.0,0.272727273
Dorian Finney-Smith,23,DAL,NBA,2016-17,81,35,1642,124,333,68,142,56,191,46,61,55,166,221,67,52,25,45,125,350,0.372372372,0.478873239,0.293193717,0.754098361,0.456456456
Doron Lamb,21,TOT,NBA,2012-13,47,0,577,60,163,46,126,14,37,20,34,8,38,46,32,13,0,26,52,154,0.36809816,0.365079365,0.378378378,0.588235294,0.411042945
Doug McDermott,23,CHI,NBA,2014-15,36,0,321,43,107,30,66,13,41,10,15,6,37,43,6,4,1,17,29,109,0.401869159,0.454545455,0.317073171,0.666666667,0.462616822
Dragan Bender,19,PHO,NBA,2016-17,43,0,574,57,161,29,60,28,101,4,11,23,80,103,23,10,22,32,74,146,0.354037267,0.483333333,0.277227723,0.363636364,0.440993789
Dragan Tarlac,27,CHI,NBA,2000-01,43,12,598,39,99,39,99,0,0,25,33,37,85,122,31,7,19,38,95,103,0.393939394,0.393939394,0.0,0.757575758,0.393939394
Draymond Green,22,GSW,NBA,2012-13,79,1,1061,84,257,70,190,14,67,45,55,58,202,260,53,42,25,51,159,227,0.326848249,0.368421053,0.208955224,0.818181818,0.354085603
Drew Gooden,21,TOT,NBA,2002-03,70,47,1873,355,777,341,729,14,48,151,212,163,292,455,83,53,35,150,172,875,0.456885457,0.46776406,0.291666667,0.712264151,0.465894466
Drew Gordon,24,PHI,NBA,2014-15,9,0,71,8,19,8,16,0,3,1,2,7,11,18,2,1,0,8,7,17,0.421052632,0.5,0.0,0.5,0.421052632
Duje Dukan,24,SAC,NBA,2015-16,1,0,24,2,10,0,5,2,5,0,0,2,2,4,1,1,0,0,2,6,0.2,0.0,0.4,0.0,0.3
Dwayne Jones,22,BOS,NBA,2005-06,14,0,87,4,10,4,10,0,0,6,13,10,21,31,2,1,3,3,14,14,0.4,0.4,0.0,0.461538462,0.4
Dwight Buycks,24,TOR,NBA,2013-14,14,0,146,15,48,10,31,5,17,8,9,4,19,23,10,8,0,10,11,43,0.3125,0.322580645,0.294117647,0.888888889,0.364583333
Dwight Howard,19,ORL,NBA,2004-05,82,82,2670,352,677,352,675,0,2,277,413,287,536,823,75,77,136,165,232,981,0.519940916,0.521481481,0.0,0.670702179,0.519940916
Dwight Powell,23,TOT,NBA,2014-15,29,0,236,31,67,28,56,3,11,25,33,18,32,50,9,9,6,11,40,90,0.462686567,0.5,0.272727273,0.757575758,0.485074627
Dwyane Wade,22,MIA,NBA,2003-04,61,56,2126,371,798,355,745,16,53,233,312,85,162,247,275,86,34,196,140,991,0.464912281,0.476510067,0.301886792,0.746794872,0.474937343
E'Twaun Moore,22,BOS,NBA,2011-12,38,0,331,43,113,26,68,17,45,7,7,4,29,33,34,11,3,21,33,110,0.380530973,0.382352941,0.377777778,1.0,0.455752212
Earl Barron,24,MIA,NBA,2005-06,8,0,45,5,16,5,16,0,0,3,4,2,8,10,0,0,0,5,10,13,0.3125,0.3125,0.0,0.75,0.3125
Earl Clark,22,PHO,NBA,2009-10,51,0,383,56,151,54,146,2,5,26,36,18,44,62,21,7,13,23,25,140,0.370860927,0.369863014,0.4,0.722222222,0.377483444
Earl Watson,22,SEA,NBA,2001-02,64,0,964,96,212,80,168,16,44,23,36,31,52,83,125,60,5,51,93,231,0.452830189,0.476190476,0.363636364,0.638888889,0.490566038
Ed Davis,21,TOR,NBA,2010-11,65,17,1602,215,373,215,373,0,0,71,128,168,294,462,40,39,67,48,183,501,0.576407507,0.576407507,0.0,0.5546875,0.576407507
Eddie Basden,22,CHI,NBA,2005-06,19,0,141,15,37,14,30,1,7,8,10,7,21,28,8,9,2,9,17,39,0.405405405,0.466666667,0.142857143,0.8,0.418918919
Eddie Gill,22,NJN,NBA,2000-01,8,0,152,16,41,13,32,3,9,4,5,0,9,9,24,4,1,10,9,39,0.390243902,0.40625,0.333333333,0.8,0.426829268
Eddie Griffin,19,HOU,NBA,2001-02,73,24,1896,244,666,154,393,90,273,64,86,117,299,416,53,17,134,47,117,642,0.366366366,0.391857506,0.32967033,0.744186047,0.433933934
Eddie House,22,MIA,NBA,2000-01,50,0,550,104,247,85,192,19,55,24,35,5,37,42,52,13,0,35,58,251,0.421052632,0.442708333,0.345454545,0.685714286,0.45951417
Eddy Curry,19,CHI,NBA,2001-02,72,31,1150,189,377,189,377,0,0,105,160,111,161,272,25,16,53,69,173,483,0.50132626,0.50132626,0.0,0.65625,0.50132626
Eduardo Najera,24,DAL,NBA,2000-01,40,4,431,58,111,57,108,1,3,14,33,41,54,95,27,13,8,17,48,131,0.522522523,0.527777778,0.333333333,0.424242424,0.527027027
Edwin Ubiles,25,WAS,NBA,2011-12,4,0,52,5,18,4,13,1,5,3,3,2,8,10,1,1,1,1,1,14,0.277777778,0.307692308,0.2,1.0,0.305555556
Edy Tavares,23,ATL,NBA,2015-16,11,0,73,11,19,11,19,0,0,3,8,7,14,21,3,1,6,5,8,25,0.578947368,0.578947368,0.0,0.375,0.578947368
Efthimi Rentzias,27,PHI,NBA,2002-03,35,0,144,20,59,16,51,4,8,8,9,10,16,26,7,6,2,4,21,52,0.338983051,0.31372549,0.5,0.888888889,0.372881356
Ekpe Udoh,23,GSW,NBA,2010-11,58,18,1030,97,222,97,222,0,0,42,64,80,101,181,40,22,86,48,144,236,0.436936937,0.436936937,0.0,0.65625,0.436936937
Elfrid Payton,20,ORL,NBA,2014-15,82,63,2489,301,708,290,666,11,42,118,214,107,242,349,533,142,20,203,193,731,0.425141243,0.435435435,0.261904762,0.551401869,0.432909605
Elias Harris,24,LAL,NBA,2013-14,2,0,11,0,1,0,1,0,0,0,0,1,0,1,1,1,0,0,0,0,0.0,0.0,0.0,0.0,0.0
Elijah Millsap,27,UTA,NBA,2014-15,47,5,924,81,238,53,148,28,90,58,86,28,122,150,58,56,16,67,124,248,0.340336134,0.358108108,0.311111111,0.674418605,0.399159664
Elliot Williams,22,POR,NBA,2011-12,24,0,149,37,74,29,47,8,27,6,18,7,12,19,6,6,3,5,18,88,0.5,0.617021277,0.296296296,0.333333333,0.554054054
Emeka Okafor,22,CHA,NBA,2004-05,73,73,2600,448,1003,448,1002,0,1,209,343,275,520,795,64,62,125,125,214,1105,0.44666002,0.447105788,0.0,0.609329446,0.44666002
Emmanuel Mudiay,19,DEN,NBA,2015-16,68,66,2068,329,905,255,673,74,232,140,209,32,200,232,372,65,35,217,141,872,0.363535912,0.378900446,0.318965517,0.669856459,0.40441989
Enes Kanter,19,UTA,NBA,2011-12,66,0,874,117,236,117,235,0,1,70,105,107,171,278,8,18,23,54,87,304,0.495762712,0.49787234,0.0,0.666666667,0.495762712
Eric Bledsoe,21,LAC,NBA,2010-11,81,25,1841,206,486,174,370,32,116,99,133,68,155,223,289,92,26,194,130,543,0.423868313,0.47027027,0.275862069,0.744360902,0.456790123
Eric Dawson,27,SAS,NBA,2011-12,4,0,39,7,12,7,12,0,0,1,2,5,5,10,0,1,2,3,6,15,0.583333333,0.583333333,0.0,0.5,0.583333333
Eric Gordon,20,LAC,NBA,2008-09,78,65,2677,411,901,280,564,131,337,299,350,45,156,201,215,78,35,164,172,1252,0.456159822,0.496453901,0.388724036,0.854285714,0.528856826
Eric Maynor,22,TOT,NBA,2009-10,81,2,1269,154,368,132,297,22,71,52,72,21,108,129,266,40,10,85,115,382,0.418478261,0.444444444,0.309859155,0.722222222,0.448369565
Eric Moreland,23,SAC,NBA,2014-15,3,0,2,1,1,1,1,0,0,0,0,0,1,1,0,0,0,0,1,2,1.0,1.0,0.0,0.0,1.0
Erick Barkley,22,POR,NBA,2000-01,8,0,38,8,22,5,14,3,8,0,0,0,3,3,6,2,0,5,2,19,0.363636364,0.357142857,0.375,0.0,0.431818182
Erick Green,23,DEN,NBA,2014-15,43,1,410,61,162,47,115,14,47,10,12,7,24,31,39,12,0,14,26,146,0.37654321,0.408695652,0.29787234,0.833333333,0.419753086
Erik Daniels,22,SAC,NBA,2004-05,21,0,72,6,18,5,16,1,2,0,0,7,11,18,4,2,0,6,7,13,0.333333333,0.3125,0.5,0.0,0.361111111
Erik Murphy,23,CHI,NBA,2013-14,24,0,62,3,13,3,10,0,3,0,0,2,6,8,2,0,4,2,7,6,0.230769231,0.3,0.0,0.0,0.230769231
Ernest Brown,22,MIA,NBA,2001-02,3,0,21,1,6,1,6,0,0,1,4,1,5,6,0,0,1,3,4,3,0.166666667,0.166666667,0.0,0.25,0.166666667
Ersan Ilyasova,19,MIL,NBA,2006-07,66,14,973,139,363,85,215,54,148,70,89,58,131,189,49,27,17,51,147,402,0.38292011,0.395348837,0.364864865,0.786516854,0.457300275
Esteban Batista,22,ATL,NBA,2005-06,57,3,495,34,80,34,79,0,1,33,53,61,83,144,7,15,11,38,111,101,0.425,0.430379747,0.0,0.622641509,0.425
Etan Thomas,23,WAS,NBA,2001-02,47,0,618,81,151,81,151,0,0,41,74,55,126,181,6,17,35,26,76,203,0.536423841,0.536423841,0.0,0.554054054,0.536423841
Eugene Jeter,27,SAC,NBA,2010-11,62,1,858,106,259,100,229,6,30,37,41,9,61,70,162,29,2,51,54,255,0.409266409,0.436681223,0.2,0.902439024,0.420849421
Evan Fournier,20,DEN,NBA,2012-13,38,4,428,75,152,53,98,22,54,30,39,6,29,35,44,19,1,32,65,202,0.493421053,0.540816327,0.407407407,0.769230769,0.565789474
Evan Turner,22,PHI,NBA,2010-11,78,14,1797,225,529,211,485,14,44,101,125,42,264,306,159,49,14,80,138,565,0.425330813,0.435051546,0.318181818,0.808,0.438563327
Fab Melo,22,BOS,NBA,2012-13,6,0,36,3,6,3,6,0,0,1,4,0,3,3,0,2,2,1,7,7,0.5,0.5,0.0,0.25,0.5
Fabricio Oberto,30,SAS,NBA,2005-06,59,0,490,44,93,44,91,0,2,15,27,57,66,123,27,9,11,28,91,103,0.47311828,0.483516484,0.0,0.555555556,0.47311828
Festus Ezeli,23,GSW,NBA,2012-13,78,41,1120,74,169,74,169,0,0,43,81,141,172,313,22,23,74,63,157,191,0.437869822,0.437869822,0.0,0.530864198,0.437869822
Francisco Elson,27,DEN,NBA,2003-04,62,14,875,94,199,94,198,0,1,30,45,65,138,203,32,35,39,35,145,218,0.472361809,0.474747475,0.0,0.666666667,0.472361809
Francisco Garcia,24,SAC,NBA,2005-06,67,11,1301,130,325,91,188,39,137,78,101,39,146,185,94,41,47,75,135,377,0.4,0.484042553,0.284671533,0.772277228,0.46
Frank Kaminsky,22,CHO,NBA,2015-16,81,3,1708,215,525,147,323,68,202,108,148,69,266,335,98,38,43,58,126,606,0.40952381,0.455108359,0.336633663,0.72972973,0.474285714
Frank Williams,22,NYK,NBA,2002-03,21,0,167,9,33,3,17,6,16,4,6,3,15,18,34,7,2,17,20,28,0.272727273,0.176470588,0.375,0.666666667,0.363636364
Fred Jones,23,IND,NBA,2002-03,19,1,115,9,24,7,17,2,7,3,4,4,5,9,5,6,1,6,13,23,0.375,0.411764706,0.285714286,0.75,0.416666667
Fred VanVleet,22,TOR,NBA,2016-17,37,0,294,39,111,28,82,11,29,18,22,4,38,42,35,17,2,15,36,107,0.351351351,0.341463415,0.379310345,0.818181818,0.400900901
Furkan Aldemir,23,PHI,NBA,2014-15,41,9,540,40,78,40,73,0,5,13,27,78,98,176,28,17,16,17,96,93,0.512820513,0.547945205,0.0,0.481481481,0.512820513
Gabe Pruitt,21,BOS,NBA,2007-08,15,0,95,14,39,11,27,3,12,1,2,1,7,8,13,5,0,5,10,32,0.358974359,0.407407407,0.25,0.5,0.397435897
Gal Mekel,25,DAL,NBA,2013-14,31,1,292,30,86,25,66,5,20,8,12,5,22,27,63,4,1,31,31,73,0.348837209,0.378787879,0.25,0.666666667,0.377906977
Gani Lawal,22,PHO,NBA,2010-11,1,0,2,0,0,0,0,0,0,0,0,0,0,0,0,0,0,0,1,0,0.0,0.0,0.0,0.0,0.0
Garret Siler,24,PHO,NBA,2010-11,21,0,101,17,31,17,31,0,0,11,22,16,12,28,3,1,4,10,20,45,0.548387097,0.548387097,0.0,0.5,0.548387097
Garrett Temple,23,TOT,NBA,2009-10,27,4,334,44,101,31,64,13,37,35,50,6,25,31,21,13,6,27,42,136,0.435643564,0.484375,0.351351351,0.7,0.5
Garth Joseph,27,TOT,NBA,2000-01,4,0,16,1,5,1,5,0,0,0,2,2,0,2,1,0,1,2,1,2,0.2,0.2,0.0,0.0,0.2
Gary Forbes,25,DEN,NBA,2010-11,63,11,791,124,273,105,215,19,58,59,87,28,88,116,49,23,6,46,77,326,0.454212454,0.488372093,0.327586207,0.67816092,0.489010989
Gary Harris,20,DEN,NBA,2014-15,55,6,719,66,217,45,114,21,103,35,47,21,43,64,29,39,7,38,71,188,0.304147465,0.394736842,0.203883495,0.744680851,0.352534562
Gary Neal,26,SAS,NBA,2010-11,80,1,1685,285,632,156,324,129,308,84,104,21,175,196,96,27,4,78,148,783,0.450949367,0.481481481,0.418831169,0.807692308,0.553006329
Gary Payton,24,MIL,NBA,2016-17,6,0,99,8,22,7,13,1,9,3,5,0,12,12,13,3,4,10,9,20,0.363636364,0.538461538,0.111111111,0.6,0.386363636
Geno Carlisle,28,POR,NBA,2004-05,6,0,16,2,3,2,3,0,0,4,6,1,0,1,1,0,0,1,1,8,0.666666667,0.666666667,0.0,0.666666667,0.666666667
George Hill,22,SAS,NBA,2008-09,77,7,1270,150,372,126,299,24,73,114,146,30,128,158,136,45,21,74,150,438,0.403225806,0.421404682,0.328767123,0.780821918,0.435483871
Georges Niang,23,IND,NBA,2016-17,23,0,93,9,36,8,24,1,12,2,2,2,15,17,5,3,0,5,6,21,0.25,0.333333333,0.083333333,1.0,0.263888889
Georgios Papagiannis,19,SAC,NBA,2016-17,22,0,355,56,102,56,100,0,2,12,14,24,62,86,20,3,17,24,44,124,0.549019608,0.56,0.0,0.857142857,0.549019608
Gerald Fitch,23,MIA,NBA,2005-06,18,1,239,30,89,23,63,7,26,17,23,7,23,30,33,7,5,15,28,84,0.337078652,0.365079365,0.269230769,0.739130435,0.376404494
Gerald Green,20,BOS,NBA,2005-06,32,3,374,66,138,60,118,6,20,29,37,10,31,41,18,13,4,22,41,167,0.47826087,0.508474576,0.3,0.783783784,0.5
Gerald Henderson,22,CHA,NBA,2009-10,43,0,355,37,104,33,85,4,19,35,47,15,40,55,13,10,9,14,25,113,0.355769231,0.388235294,0.210526316,0.744680851,0.375
Gerald Wallace,19,SAC,NBA,2001-02,54,1,430,75,175,75,168,0,7,23,46,49,40,89,27,19,6,22,46,173,0.428571429,0.446428571,0.0,0.5,0.428571429
Giannis Antetokounmpo,19,MIL,NBA,2013-14,77,23,1897,173,418,132,300,41,118,138,202,78,261,339,150,60,61,122,173,525,0.413875598,0.44,0.347457627,0.683168317,0.46291866
Gilbert Arenas,20,GSW,NBA,2001-02,47,30,1155,174,384,135,271,39,113,124,160,41,91,132,174,69,11,97,115,511,0.453125,0.498154982,0.345132743,0.775,0.50390625
Glen Davis,22,BOS,NBA,2007-08,69,1,940,107,221,107,221,0,0,99,150,95,113,208,28,31,20,65,160,313,0.484162896,0.484162896,0.0,0.66,0.484162896
Glen Rice,23,WAS,NBA,2013-14,11,1,109,11,37,6,20,5,17,5,7,4,16,20,7,6,1,9,7,32,0.297297297,0.3,0.294117647,0.714285714,0.364864865
Glenn Robinson,21,TOT,NBA,2014-15,35,1,261,26,67,21,48,5,19,16,24,15,24,39,11,6,1,11,15,73,0.388059701,0.4375,0.263157895,0.666666667,0.425373134
Goran Dragic,22,PHO,NBA,2008-09,55,1,728,88,224,68,170,20,54,50,65,33,70,103,111,29,3,73,87,246,0.392857143,0.4,0.37037037,0.769230769,0.4375
Gordan Giricek,25,TOT,NBA,2002-03,76,62,2148,350,803,265,554,85,249,150,183,36,202,238,137,52,8,145,159,935,0.435865504,0.47833935,0.341365462,0.819672131,0.48879203
Gordon Hayward,20,UTA,NBA,2010-11,72,17,1218,142,293,107,219,35,74,69,97,41,98,139,81,30,19,70,106,388,0.484641638,0.488584475,0.472972973,0.711340206,0.544368601
Gorgui Dieng,24,MIN,NBA,2013-14,60,15,818,113,227,112,226,1,1,59,93,103,197,300,39,30,50,54,108,286,0.497797357,0.495575221,1.0,0.634408602,0.5
Grant Jerrett,21,TOT,NBA,2014-15,8,0,51,7,26,6,11,1,15,1,1,2,7,9,3,2,2,3,11,16,0.269230769,0.545454545,0.066666667,1.0,0.288461538
Greg Monroe,20,DET,NBA,2010-11,80,48,2222,303,550,303,549,0,1,145,233,248,353,601,105,93,45,81,196,751,0.550909091,0.551912568,0.0,0.622317597,0.550909091
Greg Oden,21,POR,NBA,2008-09,61,39,1314,198,351,198,351,0,0,144,226,169,255,424,31,25,69,87,238,540,0.564102564,0.564102564,0.0,0.637168142,0.564102564
Greg Smith,21,HOU,NBA,2011-12,8,0,69,7,11,7,11,0,0,0,0,5,15,20,1,2,5,1,17,14,0.636363636,0.636363636,0.0,0.0,0.636363636
Greg Stiemsma,26,BOS,NBA,2011-12,55,3,766,66,121,66,121,0,0,29,41,48,129,177,28,37,85,33,144,161,0.545454545,0.545454545,0.0,0.707317073,0.545454545
Greivis Vasquez,24,MEM,NBA,2010-11,70,1,860,95,233,70,147,25,86,34,44,12,61,73,151,22,4,70,83,249,0.407725322,0.476190476,0.290697674,0.772727273,0.461373391
Guillermo Diaz,22,LAC,NBA,2007-08,6,0,18,1,4,1,3,0,1,3,5,2,0,2,1,0,0,0,0,5,0.25,0.333333333,0.0,0.6,0.25
Gustavo Ayon,26,NOH,NBA,2011-12,54,24,1088,140,261,140,260,0,1,39,63,86,179,265,74,53,46,46,118,319,0.536398467,0.538461538,0.0,0.619047619,0.536398467
Guy Rucker,25,GSW,NBA,2002-03,3,0,4,0,0,0,0,0,0,0,0,0,1,1,1,0,0,0,1,0,0.0,0.0,0.0,0.0,0.0
Ha Seung-Jin,19,POR,NBA,2004-05,19,0,104,10,23,10,23,0,0,6,11,6,12,18,2,1,5,12,21,26,0.434782609,0.434782609,0.0,0.545454545,0.434782609
Hakim Warrick,23,MEM,NBA,2005-06,68,2,724,101,228,101,228,0,0,76,115,43,101,144,30,14,21,56,113,278,0.442982456,0.442982456,0.0,0.660869565,0.442982456
Hamady N'Diaye,24,WAS,NBA,2010-11,16,0,80,4,5,4,5,0,0,6,12,2,5,7,0,2,5,3,18,14,0.8,0.8,0.0,0.5,0.8
Hamed Haddadi,23,MEM,NBA,2008-09,19,0,120,15,31,15,31,0,0,18,30,16,31,47,8,1,12,9,20,48,0.483870968,0.483870968,0.0,0.6,0.483870968
Hanno Mottola,24,ATL,NBA,2000-01,73,3,989,123,277,123,274,0,3,73,90,49,125,174,25,11,9,67,163,319,0.444043321,0.448905109,0.0,0.811111111,0.444043321
Harrison Barnes,20,GSW,NBA,2012-13,81,81,2058,276,628,224,483,52,145,144,190,53,280,333,98,52,14,101,140,748,0.439490446,0.463768116,0.35862069,0.757894737,0.48089172
Hasheem Thabeet,22,MEM,NBA,2009-10,68,13,883,77,131,77,131,0,0,54,93,85,158,243,11,15,89,43,162,208,0.58778626,0.58778626,0.0,0.580645161,0.58778626
Hassan Adams,22,NJN,NBA,2006-07,61,8,495,75,135,75,134,0,1,24,36,35,42,77,13,17,4,22,47,174,0.555555556,0.559701493,0.0,0.666666667,0.555555556
Hassan Whiteside,21,SAC,NBA,2010-11,1,0,2,0,0,0,0,0,0,0,0,0,0,0,0,0,0,0,2,0,0.0,0.0,0.0,0.0,0.0
Hedo Turkoglu,21,SAC,NBA,2000-01,74,7,1245,138,335,110,249,28,86,87,112,49,161,210,69,52,24,55,139,391,0.411940299,0.441767068,0.325581395,0.776785714,0.453731343
Henry Ellenson,20,DET,NBA,2016-17,19,2,146,23,64,13,29,10,35,4,8,8,33,41,7,1,1,14,6,60,0.359375,0.448275862,0.285714286,0.5,0.4375
Henry Sims,22,NOH,NBA,2012-13,2,0,5,2,3,2,3,0,0,0,0,2,0,2,0,0,0,1,1,4,0.666666667,0.666666667,0.0,0.0,0.666666667
Henry Walker,21,BOS,NBA,2008-09,29,0,216,36,58,36,57,0,1,16,23,8,21,29,13,6,2,18,51,88,0.620689655,0.631578947,0.0,0.695652174,0.620689655
Hilton Armstrong,22,NOK,NBA,2006-07,56,5,634,68,125,68,125,0,0,40,67,58,91,149,10,12,26,35,79,176,0.544,0.544,0.0,0.597014925,0.544
Hiram Fuller,22,ATL,NBA,2003-04,4,0,43,3,8,3,8,0,0,2,6,4,7,11,2,0,1,4,5,8,0.375,0.375,0.0,0.333333333,0.375
Hollis Thompson,22,PHI,NBA,2013-14,77,41,1742,171,372,104,205,67,167,52,73,73,174,247,73,53,12,60,144,461,0.459677419,0.507317073,0.401197605,0.712328767,0.549731183
Horace Jenkins,30,DET,NBA,2004-05,15,0,104,15,45,15,36,0,9,12,13,3,6,9,9,5,1,7,6,42,0.333333333,0.416666667,0.0,0.923076923,0.333333333
Ian Clark,22,UTA,NBA,2013-14,23,0,172,26,67,15,36,11,31,5,7,3,16,19,15,8,2,14,24,68,0.388059701,0.416666667,0.35483871,0.714285714,0.470149254
Ian Mahinmi,21,SAS,NBA,2007-08,6,0,23,6,12,6,12,0,0,9,9,0,5,5,1,0,4,2,4,21,0.5,0.5,0.0,1.0,0.5
Ibo Kutluay,30,SEA,NBA,2004-05,5,0,12,0,1,0,1,0,0,0,0,0,1,1,0,0,0,2,1,0,0.0,0.0,0.0,0.0,0.0
Igor Rakocevic,24,MIN,NBA,2002-03,42,0,244,22,58,17,46,5,12,29,36,4,13,17,33,4,0,23,25,78,0.379310345,0.369565217,0.416666667,0.805555556,0.422413793
Ike Diogu,22,GSW,NBA,2005-06,69,14,1031,175,334,175,334,0,0,136,168,95,134,229,29,15,30,78,164,486,0.523952096,0.523952096,0.0,0.80952381,0.523952096
Iman Shumpert,21,NYK,NBA,2011-12,59,35,1705,214,534,166,377,48,157,87,109,42,144,186,164,101,8,111,173,563,0.400749064,0.440318302,0.305732484,0.798165138,0.445692884
Ime Udoka,26,LAL,NBA,2003-04,4,0,28,3,9,3,8,0,1,2,4,1,4,5,2,2,1,3,3,8,0.333333333,0.375,0.0,0.5,0.333333333
Ira Newble,26,SAS,NBA,2000-01,27,6,184,21,55,17,46,4,9,8,16,13,22,35,6,2,4,7,18,54,0.381818182,0.369565217,0.444444444,0.5,0.418181818
Isaac Fontaine,26,MEM,NBA,2001-02,6,0,75,3,14,2,9,1,5,4,6,0,5,5,4,0,0,4,6,11,0.214285714,0.222222222,0.2,0.666666667,0.25
Isaiah Canaan,22,HOU,NBA,2013-14,22,0,252,31,87,13,32,18,55,21,29,7,17,24,22,8,4,21,25,101,0.356321839,0.40625,0.327272727,0.724137931,0.459770115
Isaiah Taylor,22,HOU,NBA,2016-17,4,0,52,1,7,1,5,0,2,1,2,1,2,3,3,1,1,0,6,3,0.142857143,0.2,0.0,0.5,0.142857143
Isaiah Thomas,22,SAC,NBA,2011-12,65,37,1656,256,571,173,352,83,219,154,185,48,120,168,266,53,8,105,121,749,0.448336252,0.491477273,0.378995434,0.832432432,0.521015762
Isaiah Whitehead,21,BRK,NBA,2016-17,73,26,1643,204,508,160,359,44,149,91,113,32,152,184,192,42,36,142,175,543,0.401574803,0.445682451,0.295302013,0.805309735,0.44488189
Ish Smith,22,TOT,NBA,2010-11,43,3,442,43,115,40,105,3,10,12,21,7,40,47,79,18,2,34,37,101,0.373913043,0.380952381,0.3,0.571428571,0.386956522
Ivan Johnson,27,ATL,NBA,2011-12,56,0,934,141,275,139,269,2,6,72,100,65,161,226,32,43,18,69,116,356,0.512727273,0.516728625,0.333333333,0.72,0.516363636
Ivan McFarlin,24,PHI,NBA,2006-07,11,0,41,5,13,5,12,0,1,5,7,7,4,11,1,0,0,1,8,15,0.384615385,0.416666667,0.0,0.714285714,0.384615385
Ivica Zubac,19,LAL,NBA,2016-17,38,11,609,126,238,126,235,0,3,32,49,41,118,159,30,14,33,30,66,284,0.529411765,0.536170213,0.0,0.653061224,0.529411765
J.J. Barea,22,DAL,NBA,2006-07,33,1,191,28,78,22,57,6,21,16,24,7,18,25,24,1,1,14,19,78,0.358974359,0.385964912,0.285714286,0.666666667,0.397435897
J.J. Hickson,20,CLE,NBA,2008-09,62,0,705,100,194,100,194,0,0,45,67,52,113,165,9,14,30,45,81,245,0.515463918,0.515463918,0.0,0.671641791,0.515463918
J.J. O'Brien,23,UTA,NBA,2015-16,2,0,6,0,1,0,1,0,0,0,0,0,1,1,0,1,0,0,1,0,0.0,0.0,0.0,0.0,0.0
J.J. Redick,22,ORL,NBA,2006-07,42,0,622,80,195,42,97,38,98,54,60,10,42,52,36,12,0,21,52,252,0.41025641,0.432989691,0.387755102,0.9,0.507692308
J.R. Bremer,22,BOS,NBA,2002-03,64,41,1503,171,464,70,178,101,286,85,111,18,127,145,164,38,3,59,80,528,0.368534483,0.393258427,0.353146853,0.765765766,0.47737069
J.R. Giddens,23,BOS,NBA,2008-09,6,0,8,2,3,2,3,0,0,0,0,2,1,3,0,1,0,1,1,4,0.666666667,0.666666667,0.0,0.0,0.666666667
J.R. Smith,19,NOH,NBA,2004-05,76,56,1859,295,748,214,467,81,281,111,161,39,113,152,142,55,11,109,135,782,0.394385027,0.458244111,0.288256228,0.689440994,0.448529412
JaJuan Johnson,22,BOS,NBA,2011-12,36,0,298,54,121,54,121,0,0,6,9,20,38,58,6,5,14,14,25,114,0.446280992,0.446280992,0.0,0.666666667,0.446280992
JaKarr Sampson,21,PHI,NBA,2014-15,74,32,1131,146,346,115,219,31,127,63,94,35,128,163,77,38,26,76,135,386,0.421965318,0.525114155,0.244094488,0.670212766,0.466763006
JaMychal Green,24,TOT,NBA,2014-15,24,1,164,27,47,27,41,0,6,8,10,19,26,45,4,5,5,14,25,62,0.574468085,0.658536585,0.0,0.8,0.574468085
JaVale McGee,21,WAS,NBA,2008-09,75,14,1143,191,387,191,387,0,0,107,162,120,174,294,23,33,75,61,155,489,0.493540052,0.493540052,0.0,0.660493827,0.493540052
Jabari Brown,22,LAL,NBA,2014-15,19,5,568,70,170,47,108,23,62,64,85,3,33,36,40,12,2,32,33,227,0.411764706,0.435185185,0.370967742,0.752941176,0.479411765
Jabari Parker,19,MIL,NBA,2014-15,25,25,738,129,263,125,247,4,16,46,66,50,88,138,42,31,5,47,42,308,0.490494297,0.506072874,0.25,0.696969697,0.498098859
Jabari Smith,23,SAC,NBA,2000-01,9,0,66,11,22,11,22,0,0,4,6,1,7,8,6,4,0,3,7,26,0.5,0.5,0.0,0.666666667,0.5
Jack Cooley,23,UTA,NBA,2014-15,16,0,87,9,22,9,22,0,0,9,21,10,15,25,1,6,3,3,23,27,0.409090909,0.409090909,0.0,0.428571429,0.409090909
Jackie Butler,19,NYK,NBA,2004-05,3,0,5,4,4,4,4,0,0,2,2,0,0,0,0,1,0,1,0,10,1.0,1.0,0.0,1.0,1.0
Jackson Vroman,23,TOT,NBA,2004-05,46,18,705,82,199,82,196,0,3,48,75,64,111,175,40,25,19,64,105,212,0.412060302,0.418367347,0.0,0.64,0.412060302
Jae Crowder,22,DAL,NBA,2012-13,78,16,1353,141,367,78,175,63,192,47,73,35,152,187,94,63,17,49,128,392,0.384196185,0.445714286,0.328125,0.643835616,0.470027248
Jahlil Okafor,20,PHI,NBA,2015-16,53,48,1591,397,781,396,775,1,6,133,194,122,251,373,65,22,61,124,140,928,0.508322663,0.510967742,0.166666667,0.68556701,0.508962868
Jake Layman,22,POR,NBA,2016-17,35,1,249,26,89,13,38,13,51,13,17,6,18,24,11,9,3,11,22,78,0.292134831,0.342105263,0.254901961,0.764705882,0.365168539
Jake Tsakalidis,21,PHO,NBA,2000-01,57,39,947,101,215,101,215,0,0,54,91,83,159,242,19,10,55,66,137,256,0.469767442,0.469767442,0.0,0.593406593,0.469767442
Jake Voskuhl,23,CHI,NBA,2000-01,16,2,143,11,25,11,25,0,0,8,14,12,22,34,5,5,6,12,38,30,0.44,0.44,0.0,0.571428571,0.44
Jakob Poeltl,21,TOR,NBA,2016-17,54,4,626,67,115,67,115,0,0,31,57,78,87,165,12,17,20,29,113,165,0.582608696,0.582608696,0.0,0.543859649,0.582608696
Jamaal Franklin,22,MEM,NBA,2013-14,21,0,161,16,39,11,28,5,11,2,2,4,19,23,6,4,2,11,23,39,0.41025641,0.392857143,0.454545455,1.0,0.474358974
Jamaal Magloire,22,CHH,NBA,2000-01,74,0,1095,122,271,122,269,0,2,95,145,103,192,295,27,18,78,61,139,339,0.450184502,0.453531599,0.0,0.655172414,0.450184502
Jamaal Tinsley,23,IND,NBA,2001-02,80,78,2442,289,760,247,585,42,175,131,186,78,220,298,647,138,40,270,248,751,0.380263158,0.422222222,0.24,0.704301075,0.407894737
Jamal Crawford,20,CHI,NBA,2000-01,61,8,1050,107,304,66,187,41,117,27,34,9,80,89,141,43,14,85,68,282,0.351973684,0.352941176,0.35042735,0.794117647,0.419407895
Jamal Murray,19,DEN,NBA,2016-17,82,10,1764,295,730,180,386,115,344,106,120,41,173,214,170,52,24,113,124,811,0.404109589,0.466321244,0.334302326,0.883333333,0.482876712
Jamal Robinson,27,MIA,NBA,2000-01,6,0,72,3,22,3,20,0,2,0,0,3,8,11,2,6,0,3,7,6,0.136363636,0.15,0.0,0.0,0.136363636
Jamal Sampson,19,MIL,NBA,2002-03,5,0,8,0,2,0,2,0,0,0,0,1,1,2,1,1,0,0,0,0,0.0,0.0,0.0,0.0,0.0
Jamario Moon,27,TOR,NBA,2007-08,78,75,2166,279,575,239,453,40,122,63,85,92,392,484,90,80,108,51,152,661,0.485217391,0.527593819,0.327868852,0.741176471,0.52
Jameer Nelson,22,ORL,NBA,2004-05,79,21,1612,286,628,242,487,44,141,73,107,52,141,193,237,78,3,117,199,689,0.455414013,0.496919918,0.312056738,0.682242991,0.49044586
James Anderson,21,SAS,NBA,2010-11,26,2,286,31,81,13,35,18,46,14,18,2,21,23,18,3,6,13,24,94,0.382716049,0.371428571,0.391304348,0.777777778,0.49382716
James Augustine,22,ORL,NBA,2006-07,2,0,7,1,3,1,3,0,0,0,0,1,2,3,2,0,0,0,2,2,0.333333333,0.333333333,0.0,0.0,0.333333333
James Ennis,24,MIA,NBA,2014-15,62,3,1051,101,247,70,152,31,95,79,94,51,125,176,48,25,17,39,89,312,0.408906883,0.460526316,0.326315789,0.840425532,0.471659919
James Harden,20,OKC,NBA,2009-10,76,0,1738,233,578,140,330,93,248,194,240,47,197,244,137,80,20,106,200,753,0.403114187,0.424242424,0.375,0.808333333,0.483564014
James Johnson,22,CHI,NBA,2009-10,65,11,757,95,210,80,164,15,46,51,70,34,94,128,48,21,43,62,126,256,0.452380952,0.487804878,0.326086957,0.728571429,0.488095238
James Jones,23,IND,NBA,2003-04,6,0,26,2,9,1,5,1,4,2,2,0,2,2,0,1,0,0,1,7,0.222222222,0.2,0.25,1.0,0.277777778
James Lang,23,WAS,NBA,2006-07,11,0,55,4,9,4,9,0,0,3,5,5,6,11,2,0,3,2,14,11,0.444444444,0.444444444,0.0,0.6,0.444444444
James Michael McAdoo,22,GSW,NBA,2014-15,15,0,137,24,44,24,44,0,0,14,25,15,22,37,2,5,9,6,21,62,0.545454545,0.545454545,0.0,0.56,0.545454545
James Nunnally,23,TOT,NBA,2013-14,13,0,165,15,46,7,21,8,25,6,9,1,18,19,8,6,2,7,11,44,0.326086957,0.333333333,0.32,0.666666667,0.413043478
James Singleton,24,LAC,NBA,2005-06,59,10,753,77,151,67,131,10,20,39,50,63,134,197,29,19,21,28,95,203,0.509933775,0.511450382,0.5,0.78,0.543046358
James Southerland,23,TOT,NBA,2013-14,4,0,30,5,15,2,9,3,6,1,2,0,8,8,0,1,2,1,3,14,0.333333333,0.222222222,0.5,0.5,0.433333333
James Thomas,24,TOT,NBA,2004-05,11,2,117,12,20,12,20,0,0,2,6,17,20,37,4,4,4,7,13,26,0.6,0.6,0.0,0.333333333,0.6
James White,24,SAS,NBA,2006-07,6,2,137,18,41,16,34,2,7,12,15,3,17,20,5,3,1,5,7,50,0.43902439,0.470588235,0.285714286,0.8,0.463414634
James Young,19,BOS,NBA,2014-15,31,0,332,36,102,19,36,17,66,16,29,9,33,42,13,8,2,5,22,105,0.352941176,0.527777778,0.257575758,0.551724138,0.43627451
JamesOn Curry,24,LAC,NBA,2009-10,1,0,0,0,0,0,0,0,0,0,0,0,0,0,0,0,0,0,0,0,0.0,0.0,0.0,0.0,0.0
Jamison Brewer,21,IND,NBA,2001-02,13,0,43,2,5,2,4,0,1,0,0,2,6,8,9,2,0,3,3,4,0.4,0.5,0.0,0.0,0.4
Jan Vesely,21,WAS,NBA,2011-12,57,20,1078,117,218,117,217,0,1,33,62,101,148,249,47,39,32,60,156,267,0.536697248,0.539170507,0.0,0.532258065,0.536697248
Jannero Pargo,23,LAL,NBA,2002-03,34,0,342,37,93,30,69,7,24,4,4,9,28,37,39,13,2,23,45,85,0.397849462,0.434782609,0.291666667,1.0,0.435483871
Jared Cunningham,21,DAL,NBA,2012-13,8,0,26,6,14,4,11,2,3,2,2,1,2,3,1,1,0,2,3,16,0.428571429,0.363636364,0.666666667,1.0,0.5
Jared Dudley,22,CHA,NBA,2007-08,73,14,1384,163,348,154,307,9,41,87,118,121,165,286,81,55,10,50,128,422,0.468390805,0.501628664,0.219512195,0.737288136,0.481321839
Jared Jeffries,21,WAS,NBA,2002-03,20,1,292,30,63,27,57,3,6,16,29,26,32,58,16,8,5,21,28,79,0.476190476,0.473684211,0.5,0.551724138,0.5
Jared Reiner,22,CHI,NBA,2004-05,19,2,132,10,30,10,30,0,0,1,4,13,25,38,1,3,7,9,35,21,0.333333333,0.333333333,0.0,0.25,0.333333333
Jared Sullinger,20,BOS,NBA,2012-13,45,5,892,111,225,110,220,1,5,47,63,92,172,264,35,22,22,29,154,270,0.493333333,0.5,0.2,0.746031746,0.495555556
Jarell Eddie,24,WAS,NBA,2015-16,26,0,147,20,65,5,18,15,47,8,8,2,21,23,5,5,1,1,5,63,0.307692308,0.277777778,0.319148936,1.0,0.423076923
Jarell Martin,21,MEM,NBA,2015-16,27,0,380,54,116,54,114,0,2,45,62,39,47,86,15,8,7,19,58,153,0.465517241,0.473684211,0.0,0.725806452,0.465517241
Jarnell Stokes,21,MEM,NBA,2014-15,19,2,126,21,37,21,37,0,0,15,28,16,18,34,4,5,5,7,25,57,0.567567568,0.567567568,0.0,0.535714286,0.567567568
Jarrett Jack,22,POR,NBA,2005-06,79,4,1599,189,428,169,352,20,76,128,160,18,142,160,219,41,2,102,138,526,0.441588785,0.480113636,0.263157895,0.8,0.464953271
Jarrod Uthoff,23,DAL,NBA,2016-17,9,0,115,16,38,13,29,3,9,5,7,8,14,22,9,2,4,3,8,40,0.421052632,0.448275862,0.333333333,0.714285714,0.460526316
Jarron Collins,23,UTA,NBA,2001-02,70,68,1440,158,343,158,342,0,1,134,181,138,158,296,58,29,22,56,234,450,0.460641399,0.461988304,0.0,0.740331492,0.460641399
Jarvis Hayes,22,WAS,NBA,2003-04,70,42,2044,278,695,238,564,40,131,77,98,71,193,264,106,71,11,110,157,673,0.4,0.421985816,0.305343511,0.785714286,0.428776978
Jarvis Varnado,24,TOT,NBA,2012-13,13,0,58,3,7,3,7,0,0,2,4,2,7,9,3,1,2,6,10,8,0.428571429,0.428571429,0.0,0.5,0.428571429
Jason Collier,23,HOU,NBA,2000-01,23,0,222,27,71,27,70,0,1,17,24,12,25,37,6,2,3,11,27,71,0.38028169,0.385714286,0.0,0.708333333,0.38028169
Jason Collins,23,NJN,NBA,2001-02,77,9,1407,117,278,116,276,1,2,115,164,132,169,301,81,29,47,72,173,350,0.420863309,0.420289855,0.5,0.701219512,0.422661871
Jason Hart,22,MIL,NBA,2000-01,1,0,10,1,1,1,1,0,0,0,0,0,0,0,1,0,0,2,0,2,1.0,1.0,0.0,0.0,1.0
Jason Kapono,22,CLE,NBA,2003-04,41,3,427,52,129,31,85,21,44,20,24,19,36,55,14,13,2,21,41,145,0.403100775,0.364705882,0.477272727,0.833333333,0.484496124
Jason Maxiell,22,DET,NBA,2005-06,26,0,159,23,54,23,54,0,0,14,42,12,16,28,3,4,5,11,14,60,0.425925926,0.425925926,0.0,0.333333333,0.425925926
Jason Richardson,21,GSW,NBA,2001-02,80,75,2629,464,1090,382,844,82,246,141,210,124,216,340,236,106,31,160,195,1151,0.425688073,0.452606635,0.333333333,0.671428571,0.463302752
Jason Smith,21,PHI,NBA,2007-08,76,1,1107,141,310,137,296,4,14,54,82,77,153,230,20,22,50,48,142,340,0.45483871,0.462837838,0.285714286,0.658536585,0.461290323
Jason Thompson,22,SAC,NBA,2008-09,82,56,2303,356,717,356,709,0,8,198,286,234,372,606,93,46,59,146,314,910,0.49651325,0.502115656,0.0,0.692307692,0.49651325
Javaris Crittenton,20,TOT,NBA,2007-08,50,0,679,98,233,88,196,10,37,72,104,27,83,110,51,19,2,55,47,278,0.420600858,0.448979592,0.27027027,0.692307692,0.442060086
Jawad Williams,25,CLE,NBA,2008-09,10,0,20,5,12,3,6,2,6,0,0,1,1,2,0,1,0,1,2,12,0.416666667,0.5,0.333333333,0.0,0.5
Jay Williams,21,CHI,NBA,2002-03,75,54,1961,273,685,208,483,65,202,103,161,27,168,195,350,86,17,171,179,714,0.398540146,0.430641822,0.321782178,0.639751553,0.445985401
Jaylen Brown,20,BOS,NBA,2016-17,78,20,1341,192,423,146,288,46,135,85,124,45,175,220,64,35,18,68,142,515,0.453900709,0.506944444,0.340740741,0.685483871,0.508274232
Jeff Adrien,24,GSW,NBA,2010-11,23,0,196,23,54,23,54,0,0,11,19,23,35,58,10,4,5,9,28,57,0.425925926,0.425925926,0.0,0.578947368,0.425925926
Jeff Ayres,22,POR,NBA,2009-10,39,4,405,43,65,43,65,0,0,18,20,25,73,98,1,7,16,12,76,104,0.661538462,0.661538462,0.0,0.9,0.661538462
Jeff Foote,24,NOH,NBA,2011-12,4,0,39,2,6,2,6,0,0,0,0,1,5,6,0,0,1,2,5,4,0.333333333,0.333333333,0.0,0.0,0.333333333
Jeff Green,21,SEA,NBA,2007-08,80,52,2253,320,749,299,673,21,76,177,238,101,278,379,119,46,49,158,198,838,0.427236315,0.444279346,0.276315789,0.743697479,0.441255007
Jeff Teague,21,ATL,NBA,2009-10,71,3,719,90,227,83,195,7,32,41,49,5,62,67,122,34,11,50,82,228,0.396475771,0.425641026,0.21875,0.836734694,0.411894273
Jeff Trepagnier,22,CLE,NBA,2001-02,12,0,77,7,23,7,22,0,1,4,7,3,9,12,12,8,4,11,8,18,0.304347826,0.318181818,0.0,0.571428571,0.304347826
Jeff Withey,23,NOP,NBA,2013-14,58,4,684,69,129,69,128,0,1,52,73,49,101,150,26,15,50,20,73,190,0.534883721,0.5390625,0.0,0.712328767,0.534883721
Jeffery Taylor,23,CHA,NBA,2012-13,77,29,1507,172,399,119,245,53,154,75,103,51,99,150,63,47,15,48,136,472,0.431077694,0.485714286,0.344155844,0.72815534,0.497493734
Jerami Grant,20,PHI,NBA,2014-15,65,11,1377,124,352,75,196,49,156,114,193,49,149,198,79,40,68,85,144,411,0.352272727,0.382653061,0.314102564,0.590673575,0.421875
Jerel McNeal,27,PHO,NBA,2014-15,6,0,36,3,11,2,9,1,2,2,2,0,3,3,2,3,1,5,5,9,0.272727273,0.222222222,0.5,1.0,0.318181818
Jeremy Evans,23,UTA,NBA,2010-11,49,3,463,76,115,76,114,0,1,26,37,36,61,97,24,17,17,19,50,178,0.660869565,0.666666667,0.0,0.702702703,0.660869565
Jeremy Lamb,20,OKC,NBA,2012-13,23,0,147,24,68,15,38,9,30,14,14,5,13,18,5,2,2,6,13,71,0.352941176,0.394736842,0.3,1.0,0.419117647
Jeremy Lin,22,GSW,NBA,2010-11,29,0,285,28,72,27,67,1,5,19,25,12,22,34,42,33,9,18,31,76,0.388888889,0.402985075,0.2,0.76,0.395833333
Jeremy Pargo,25,MEM,NBA,2011-12,44,5,424,50,150,40,112,10,38,16,27,12,25,37,55,15,0,46,46,126,0.333333333,0.357142857,0.263157895,0.592592593,0.366666667
Jeremy Richardson,22,TOT,NBA,2006-07,6,0,20,3,6,1,3,2,3,0,0,1,1,2,0,1,0,1,2,8,0.5,0.333333333,0.666666667,0.0,0.666666667
Jeremy Tyler,20,GSW,NBA,2011-12,42,23,568,88,209,88,208,0,1,29,52,54,86,140,16,16,20,36,84,205,0.421052632,0.423076923,0.0,0.557692308,0.421052632
Jerian Grant,23,NYK,NBA,2015-16,76,6,1265,154,391,132,291,22,100,96,123,23,120,143,177,50,10,87,97,426,0.393861893,0.453608247,0.22,0.780487805,0.421994885
Jermaine Taylor,23,HOU,NBA,2009-10,31,4,303,45,119,40,97,5,22,33,46,21,25,46,16,10,3,19,15,128,0.378151261,0.412371134,0.227272727,0.717391304,0.399159664
Jermareo Davidson,23,CHA,NBA,2007-08,38,2,322,51,125,51,125,0,0,18,28,21,41,62,13,7,15,17,46,120,0.408,0.408,0.0,0.642857143,0.408
Jerome Beasley,23,MIA,NBA,2003-04,2,0,5,1,3,1,3,0,0,0,0,0,1,1,0,0,0,0,0,2,0.333333333,0.333333333,0.0,0.0,0.333333333
Jerome Dyson,24,NOH,NBA,2011-12,9,1,180,19,48,18,40,1,8,28,36,2,17,19,18,11,2,20,19,67,0.395833333,0.45,0.125,0.777777778,0.40625
Jerome Jordan,25,NYK,NBA,2011-12,21,0,108,17,33,17,33,0,0,8,10,14,13,27,4,1,6,2,15,42,0.515151515,0.515151515,0.0,0.8,0.515151515
Jerome Moiso,22,BOS,NBA,2000-01,24,0,135,12,30,12,29,0,1,11,26,12,30,42,3,3,4,18,29,35,0.4,0.413793103,0.0,0.423076923,0.4
Jerrelle Benimon,23,UTA,NBA,2014-15,2,0,3,0,0,0,0,0,0,0,0,1,2,3,0,0,0,1,0,0,0.0,0.0,0.0,0.0,0.0
Jerry Smith,24,NJN,NBA,2011-12,5,0,46,3,14,2,8,1,6,0,0,2,5,7,4,5,0,0,5,7,0.214285714,0.25,0.166666667,0.0,0.25
Jerryd Bayless,20,POR,NBA,2008-09,53,0,655,69,189,62,162,7,27,83,103,8,49,57,78,16,2,56,81,228,0.365079365,0.382716049,0.259259259,0.805825243,0.383597884
Jeryl Sasser,22,ORL,NBA,2001-02,7,0,36,3,14,3,14,0,0,4,5,3,4,7,2,3,0,2,3,10,0.214285714,0.214285714,0.0,0.8,0.214285714
Jimmer Fredette,22,SAC,NBA,2011-12,61,7,1135,172,446,94,230,78,216,40,48,17,56,73,108,30,3,67,73,462,0.385650224,0.408695652,0.361111111,0.833333333,0.47309417
Jimmy Butler,22,CHI,NBA,2011-12,42,0,359,32,79,30,68,2,11,43,56,23,33,56,14,11,5,14,20,109,0.405063291,0.441176471,0.181818182,0.767857143,0.417721519
Jiri Welsch,23,GSW,NBA,2002-03,37,0,234,19,75,18,71,1,4,22,29,12,16,28,27,8,2,19,32,61,0.253333333,0.253521127,0.25,0.75862069,0.26
Joakim Noah,22,CHI,NBA,2007-08,74,31,1534,177,367,177,366,0,1,134,194,174,242,416,84,68,64,89,173,488,0.482288828,0.483606557,0.0,0.690721649,0.482288828
Jodie Meeks,22,TOT,NBA,2009-10,60,0,719,104,268,62,136,42,132,31,39,9,90,99,39,18,5,25,52,281,0.388059701,0.455882353,0.318181818,0.794871795,0.46641791
Joe Alexander,22,MIL,NBA,2008-09,59,0,716,102,245,86,199,16,46,58,83,44,71,115,42,15,29,52,107,278,0.416326531,0.432160804,0.347826087,0.698795181,0.448979592
Joe Crawford,22,NYK,NBA,2008-09,2,0,23,3,10,2,6,1,4,2,2,1,3,4,1,1,0,0,2,9,0.3,0.333333333,0.25,1.0,0.35
Joe Crispin,22,TOT,NBA,2001-02,21,0,156,26,68,11,29,15,39,12,13,2,9,11,26,5,0,10,10,79,0.382352941,0.379310345,0.384615385,0.923076923,0.492647059
Joe Harris,23,CLE,NBA,2014-15,51,1,493,48,120,17,36,31,84,9,15,7,34,41,26,7,2,27,62,136,0.4,0.472222222,0.369047619,0.6,0.529166667
Joe Ingles,27,UTA,NBA,2014-15,79,32,1673,147,354,75,152,72,202,30,40,22,153,175,182,72,10,98,124,396,0.415254237,0.493421053,0.356435644,0.75,0.516949153
Joe Johnson,20,TOT,NBA,2001-02,77,60,1916,251,584,213,454,38,130,41,53,75,182,257,179,59,20,71,114,581,0.429794521,0.469162996,0.292307692,0.773584906,0.462328767
Joe Young,23,IND,NBA,2015-16,41,0,384,62,169,52,123,10,46,20,25,6,44,50,65,15,0,33,30,154,0.366863905,0.422764228,0.217391304,0.8,0.396449704
Joel Anthony,25,MIA,NBA,2007-08,24,1,498,28,60,28,60,0,0,29,49,38,55,93,3,9,31,17,55,85,0.466666667,0.466666667,0.0,0.591836735,0.466666667
Joel Bolomboy,23,UTA,NBA,2016-17,12,0,53,9,16,8,12,1,4,3,6,4,13,17,2,1,2,2,1,22,0.5625,0.666666667,0.25,0.5,0.59375
Joel Embiid,22,PHI,NBA,2016-17,31,31,786,200,429,164,331,36,98,191,244,61,182,243,66,27,76,117,112,627,0.466200466,0.495468278,0.367346939,0.782786885,0.508158508
Joel Freeland,25,POR,NBA,2012-13,51,1,477,58,142,58,142,0,0,18,27,40,79,119,13,13,11,19,67,134,0.408450704,0.408450704,0.0,0.666666667,0.408450704
Joel Przybilla,21,MIL,NBA,2000-01,33,13,270,12,35,12,35,0,0,3,11,29,42,71,2,3,30,13,56,27,0.342857143,0.342857143,0.0,0.272727273,0.342857143
Joey Dorsey,25,HOU,NBA,2008-09,3,0,6,1,2,1,2,0,0,0,0,0,1,1,1,0,0,0,0,2,0.5,0.5,0.0,0.0,0.5
Joey Graham,23,TOR,NBA,2005-06,80,24,1581,198,414,169,327,29,87,108,133,57,187,244,60,37,13,92,228,533,0.47826087,0.516819572,0.333333333,0.812030075,0.513285024
Joffrey Lauvergne,23,DEN,NBA,2014-15,24,1,268,36,89,33,73,3,16,18,28,27,50,77,13,8,10,22,43,93,0.404494382,0.452054795,0.1875,0.642857143,0.421348315
Johan Petro,20,SEA,NBA,2005-06,68,41,1282,153,300,153,300,0,0,47,75,109,187,296,15,25,51,60,213,353,0.51,0.51,0.0,0.626666667,0.51
John Edwards,23,IND,NBA,2004-05,25,1,139,11,30,11,30,0,0,7,14,8,11,19,3,3,4,8,12,29,0.366666667,0.366666667,0.0,0.5,0.366666667
John Henson,22,MIL,NBA,2012-13,63,9,827,162,336,162,333,0,3,56,105,116,181,297,31,19,42,47,83,380,0.482142857,0.486486486,0.0,0.533333333,0.482142857
John Jenkins,21,ATL,NBA,2012-13,61,2,902,131,294,78,156,53,138,59,70,17,77,94,56,12,10,40,37,374,0.445578231,0.5,0.384057971,0.842857143,0.535714286
John Lucas III,23,HOU,NBA,2005-06,13,0,107,14,36,12,27,2,9,0,0,2,3,5,12,5,0,7,6,30,0.388888889,0.444444444,0.222222222,0.0,0.416666667
John Salmons,23,PHI,NBA,2002-03,64,1,504,48,116,38,85,10,31,26,35,16,43,59,47,17,6,29,53,132,0.413793103,0.447058824,0.322580645,0.742857143,0.456896552
John Wall,20,WAS,NBA,2010-11,69,64,2606,398,972,364,857,34,115,301,393,35,282,317,574,121,35,261,175,1131,0.409465021,0.424737456,0.295652174,0.765903308,0.426954733
Johnny O'Bryant,21,MIL,NBA,2014-15,34,15,368,44,120,44,120,0,0,12,27,26,38,64,17,5,4,25,44,100,0.366666667,0.366666667,0.0,0.444444444,0.366666667
Jon Brockman,22,SAC,NBA,2009-10,52,4,654,55,103,55,103,0,0,37,62,105,108,213,22,15,5,23,115,147,0.533980583,0.533980583,0.0,0.596774194,0.533980583
Jon Leuer,22,MIL,NBA,2011-12,46,12,555,97,191,94,182,3,9,21,28,45,75,120,25,14,17,18,67,218,0.507853403,0.516483516,0.333333333,0.75,0.515706806
Jonas Jerebko,22,DET,NBA,2009-10,80,73,2232,290,603,254,488,36,115,125,176,194,284,478,58,79,29,82,230,741,0.48092869,0.520491803,0.313043478,0.710227273,0.510779436
Jonas Valanciunas,20,TOR,NBA,2012-13,62,57,1482,204,366,204,366,0,0,146,185,121,251,372,45,17,78,94,188,554,0.557377049,0.557377049,0.0,0.789189189,0.557377049
Jonathan Gibson,29,DAL,NBA,2016-17,17,0,231,35,95,20,50,15,45,21,29,1,21,22,26,8,0,21,21,106,0.368421053,0.4,0.333333333,0.724137931,0.447368421
Jonathon Simmons,26,SAS,NBA,2015-16,55,2,813,122,242,104,195,18,47,69,92,16,80,96,58,24,5,53,103,331,0.504132231,0.533333333,0.382978723,0.75,0.541322314
Jonny Flynn,20,MIN,NBA,2009-10,81,81,2339,397,952,320,737,77,215,223,270,24,167,191,356,82,2,233,98,1094,0.417016807,0.434192673,0.358139535,0.825925926,0.457457983
Jordan Adams,20,MEM,NBA,2014-15,30,0,248,35,86,25,61,10,25,14,23,9,19,28,16,16,7,14,24,94,0.406976744,0.409836066,0.4,0.608695652,0.465116279
Jordan Clarkson,22,LAL,NBA,2014-15,59,38,1476,267,596,229,475,38,121,131,158,56,135,191,206,51,12,96,109,703,0.447986577,0.482105263,0.314049587,0.829113924,0.479865772
Jordan Crawford,22,TOT,NBA,2010-11,42,18,1027,192,500,159,372,33,128,73,84,31,74,105,117,39,3,83,63,490,0.384,0.427419355,0.2578125,0.869047619,0.417
Jordan Farmar,20,LAL,NBA,2006-07,72,2,1090,124,294,79,157,45,137,27,38,22,97,119,137,44,7,73,77,320,0.421768707,0.503184713,0.328467153,0.710526316,0.49829932
Jordan Hamilton,21,DEN,NBA,2011-12,26,2,258,48,111,31,64,17,47,2,5,11,51,62,20,4,3,16,15,115,0.432432432,0.484375,0.361702128,0.4,0.509009009
Jordan Hill,22,TOT,NBA,2009-10,47,0,624,99,201,99,199,0,2,46,68,76,99,175,20,14,21,30,92,244,0.492537313,0.497487437,0.0,0.676470588,0.492537313
Jordan McRae,24,TOT,NBA,2015-16,22,1,195,34,78,24,56,10,22,21,28,4,16,20,25,3,1,15,17,99,0.435897436,0.428571429,0.454545455,0.75,0.5
Jordan Mickey,21,BOS,NBA,2015-16,16,0,57,8,22,8,22,0,0,5,10,6,7,13,1,0,11,1,5,21,0.363636364,0.363636364,0.0,0.5,0.363636364
Jordan Williams,21,NJN,NBA,2011-12,43,5,635,77,152,77,152,0,0,43,66,66,90,156,11,21,15,23,61,197,0.506578947,0.506578947,0.0,0.651515152,0.506578947
Jorge Garbajosa,29,TOR,NBA,2006-07,67,60,1909,222,529,156,336,66,193,57,78,48,282,330,125,78,15,64,90,567,0.419659735,0.464285714,0.341968912,0.730769231,0.482041588
Jorge Gutierrez,25,BRK,NBA,2013-14,15,2,244,25,54,22,42,3,12,9,12,3,19,22,30,10,1,14,37,62,0.462962963,0.523809524,0.25,0.75,0.490740741
Jose Calderon,24,TOR,NBA,2005-06,64,11,1487,132,312,125,269,7,43,78,92,30,111,141,288,42,4,101,93,349,0.423076923,0.464684015,0.162790698,0.847826087,0.434294872
Joseph Forte,20,BOS,NBA,2001-02,8,0,39,1,12,1,9,0,3,4,4,1,5,6,6,2,0,3,1,6,0.083333333,0.111111111,0.0,1.0,0.083333333
Josh Akognon,26,DAL,NBA,2012-13,3,0,9,2,4,1,2,1,2,0,0,0,1,1,1,0,0,0,3,5,0.5,0.5,0.5,0.0,0.625
Josh Boone,22,NJN,NBA,2006-07,61,0,669,99,171,99,171,0,0,56,103,64,112,176,10,11,21,33,94,254,0.578947368,0.578947368,0.0,0.54368932,0.578947368
Josh Childress,21,ATL,NBA,2004-05,80,44,2376,302,642,289,586,13,56,190,231,195,287,482,151,74,35,106,184,807,0.470404984,0.493174061,0.232142857,0.822510823,0.480529595
Josh Davis,23,ATL,NBA,2003-04,4,1,23,2,5,2,3,0,2,1,1,1,4,5,0,0,0,2,3,5,0.4,0.666666667,0.0,1.0,0.4
Josh Harrellson,22,NYK,NBA,2011-12,37,4,540,63,149,43,90,20,59,16,26,47,97,144,11,23,20,20,48,162,0.422818792,0.477777778,0.338983051,0.615384615,0.489932886
Josh Howard,23,DAL,NBA,2003-04,67,29,1589,229,532,209,466,20,66,97,138,149,219,368,97,69,54,67,168,575,0.430451128,0.448497854,0.303030303,0.702898551,0.44924812
Josh Huestis,24,OKC,NBA,2015-16,5,0,55,5,12,1,6,4,6,0,4,2,8,10,0,1,2,3,3,14,0.416666667,0.166666667,0.666666667,0.0,0.583333333
Josh McRoberts,20,POR,NBA,2007-08,8,0,28,6,10,6,9,0,1,0,0,2,8,10,2,1,0,2,1,12,0.6,0.666666667,0.0,0.0,0.6
Josh Powell,23,DAL,NBA,2005-06,37,2,429,37,81,37,81,0,0,36,45,28,53,81,9,7,4,22,52,110,0.456790123,0.456790123,0.0,0.8,0.456790123
Josh Richardson,22,MIA,NBA,2015-16,52,2,1107,123,272,70,157,53,115,42,63,21,86,107,73,36,25,35,107,341,0.452205882,0.445859873,0.460869565,0.666666667,0.549632353
Josh Selby,20,MEM,NBA,2011-12,28,0,237,25,72,23,57,2,15,11,14,2,13,15,30,7,0,29,17,63,0.347222222,0.403508772,0.133333333,0.785714286,0.361111111
Josh Smith,19,ATL,NBA,2004-05,74,59,2050,274,602,270,579,4,23,163,237,147,310,457,127,59,144,135,157,715,0.455149502,0.466321244,0.173913043,0.687763713,0.458471761
Jrue Holiday,19,PHI,NBA,2009-10,73,51,1767,230,520,168,361,62,159,65,86,56,135,191,280,79,18,156,153,587,0.442307692,0.465373961,0.389937107,0.755813953,0.501923077
Juan Carlos Navarro,27,MEM,NBA,2007-08,82,30,2117,308,766,152,334,156,432,124,146,34,176,210,177,48,1,134,94,896,0.402088773,0.45508982,0.361111111,0.849315068,0.503916449
Juan Dixon,24,WAS,NBA,2002-03,42,3,647,104,271,79,187,25,84,37,46,13,59,72,40,26,3,42,54,270,0.383763838,0.422459893,0.297619048,0.804347826,0.429889299
Juan Hernangomez,21,DEN,NBA,2016-17,62,9,842,101,224,55,111,46,113,57,76,43,144,187,29,29,12,31,62,305,0.450892857,0.495495495,0.407079646,0.75,0.553571429
Juaquin Hawkins,29,HOU,NBA,2002-03,58,10,685,57,148,47,124,10,24,10,20,16,62,78,47,29,6,29,57,134,0.385135135,0.379032258,0.416666667,0.5,0.418918919
Julian Wright,20,NOH,NBA,2007-08,57,1,640,90,169,80,145,10,24,33,52,33,84,117,40,29,12,34,43,223,0.532544379,0.551724138,0.416666667,0.634615385,0.562130178
Julius Hodge,22,DEN,NBA,2005-06,14,0,33,5,13,5,13,0,0,3,8,5,2,7,6,2,0,8,7,13,0.384615385,0.384615385,0.0,0.375,0.384615385
Julius Randle,20,LAL,NBA,2014-15,1,0,14,1,3,1,3,0,0,0,2,0,0,0,0,0,0,1,1,2,0.333333333,0.333333333,0.0,0.0,0.333333333
Julyan Stone,23,DEN,NBA,2011-12,22,2,179,13,31,11,20,2,11,8,11,5,20,25,37,8,6,11,18,36,0.419354839,0.55,0.181818182,0.727272727,0.451612903
Junior Harrington,22,DEN,NBA,2002-03,82,51,2003,169,467,162,439,7,28,73,112,44,206,250,277,80,15,157,250,418,0.361884368,0.369020501,0.25,0.651785714,0.369379015
Justin Anderson,22,DAL,NBA,2015-16,55,9,647,71,175,49,92,22,83,44,55,18,114,132,29,19,25,24,45,208,0.405714286,0.532608696,0.265060241,0.8,0.468571429
Justin Dentmon,26,TOT,NBA,2011-12,6,0,91,10,28,8,14,2,14,4,6,0,8,8,10,2,0,7,10,26,0.357142857,0.571428571,0.142857143,0.666666667,0.392857143
Justin Hamilton,23,TOT,NBA,2013-14,8,0,72,9,20,6,11,3,9,5,5,4,3,7,0,5,0,4,8,26,0.45,0.545454545,0.333333333,1.0,0.525
Justin Harper,22,ORL,NBA,2011-12,14,0,84,9,31,7,18,2,13,0,1,3,9,12,2,2,3,6,5,20,0.290322581,0.388888889,0.153846154,0.0,0.322580645
Justin Holiday,23,PHI,NBA,2012-13,9,0,142,16,48,12,32,4,16,6,8,0,14,14,15,3,6,9,7,42,0.333333333,0.375,0.25,0.75,0.375
Justin Reed,23,BOS,NBA,2004-05,23,0,121,15,29,15,26,0,3,11,15,8,8,16,10,3,1,5,12,41,0.517241379,0.576923077,0.0,0.733333333,0.517241379
Justin Williams,22,SAC,NBA,2006-07,26,1,333,54,88,54,87,0,1,23,63,51,64,115,2,5,16,15,51,131,0.613636364,0.620689655,0.0,0.365079365,0.613636364
Justise Winslow,19,MIA,NBA,2015-16,78,8,2232,195,462,163,346,32,116,80,117,81,322,403,117,68,26,95,184,502,0.422077922,0.471098266,0.275862069,0.683760684,0.456709957
Jusuf Nurkic,20,DEN,NBA,2014-15,62,27,1103,171,383,171,381,0,2,84,132,125,257,382,50,52,68,86,207,426,0.446475196,0.448818898,0.0,0.636363636,0.446475196
K.J. McDaniels,21,TOT,NBA,2014-15,62,15,1352,172,434,129,284,43,150,100,133,65,135,200,72,44,70,105,126,487,0.396313364,0.454225352,0.286666667,0.751879699,0.445852535
Kalin Lucas,25,MEM,NBA,2014-15,1,0,6,0,1,0,1,0,0,0,0,0,0,0,0,1,0,0,1,0,0.0,0.0,0.0,0.0,0.0
Kaniel Dickens,25,POR,NBA,2003-04,3,0,12,3,3,3,3,0,0,1,2,2,0,2,0,0,0,1,3,7,1.0,1.0,0.0,0.5,1.0
Kareem Rush,22,LAL,NBA,2002-03,76,0,872,96,244,77,176,19,68,16,23,26,68,94,68,10,11,63,71,227,0.393442623,0.4375,0.279411765,0.695652174,0.432377049
Karl-Anthony Towns,20,MIN,NBA,2015-16,82,82,2627,625,1153,595,1065,30,88,223,275,229,629,858,161,58,138,183,245,1503,0.54206418,0.558685446,0.340909091,0.810909091,0.555073721
Kasib Powell,26,MIA,NBA,2007-08,11,4,304,35,95,27,62,8,33,6,9,8,36,44,18,9,2,5,18,84,0.368421053,0.435483871,0.242424242,0.666666667,0.410526316
Kawhi Leonard,20,SAS,NBA,2011-12,64,39,1534,199,404,158,295,41,109,68,88,104,223,327,70,85,24,44,88,507,0.492574257,0.53559322,0.376146789,0.772727273,0.543316832
Kay Felder,21,CLE,NBA,2016-17,42,0,386,62,158,55,136,7,22,35,49,3,38,41,58,18,7,31,38,166,0.392405063,0.404411765,0.318181818,0.714285714,0.414556962
Kedrick Brown,20,BOS,NBA,2001-02,29,5,245,23,70,18,43,5,27,12,20,11,39,50,15,18,7,7,18,63,0.328571429,0.418604651,0.185185185,0.6,0.364285714
Keith Appling,23,ORL,NBA,2015-16,5,0,27,2,8,2,5,0,3,2,2,0,1,1,1,1,0,3,5,6,0.25,0.4,0.0,1.0,0.25
Keith Benson,23,GSW,NBA,2011-12,3,0,9,0,1,0,1,0,0,0,0,2,1,3,0,0,0,0,0,0,0.0,0.0,0.0,0.0,0.0
Keith Bogans,23,ORL,NBA,2003-04,73,36,1787,183,454,116,267,67,187,65,103,106,211,317,98,46,10,75,128,498,0.4030837,0.434456929,0.35828877,0.631067961,0.476872247
Keith Langford,24,SAS,NBA,2007-08,2,0,10,1,4,1,4,0,0,0,0,0,2,2,0,0,0,0,1,2,0.25,0.25,0.0,0.0,0.25
Keith McLeod,24,MIN,NBA,2003-04,33,0,391,27,82,26,72,1,10,33,43,5,29,34,59,16,1,29,39,88,0.329268293,0.361111111,0.1,0.76744186,0.335365854
Kelenna Azubuike,23,GSW,NBA,2006-07,41,9,669,98,220,64,141,34,79,61,78,26,68,94,28,22,10,39,49,291,0.445454545,0.453900709,0.430379747,0.782051282,0.522727273
Kelly Olynyk,22,BOS,NBA,2013-14,70,9,1400,234,502,194,388,40,114,99,122,140,225,365,109,35,27,106,227,607,0.466135458,0.5,0.350877193,0.81147541,0.505976096
Kelly Oubre,20,WAS,NBA,2015-16,63,9,671,90,211,65,132,25,79,31,49,25,108,133,13,22,7,34,100,236,0.426540284,0.492424242,0.316455696,0.632653061,0.485781991
Kemba Walker,21,CHA,NBA,2011-12,66,25,1792,281,767,212,541,69,226,168,213,30,204,234,289,60,20,119,79,799,0.366362451,0.391866913,0.305309735,0.788732394,0.411342894
Ken Johnson,24,MIA,NBA,2002-03,16,0,156,15,37,15,37,0,0,2,6,4,28,32,0,1,12,6,20,32,0.405405405,0.405405405,0.0,0.333333333,0.405405405
Kendall Marshall,21,PHO,NBA,2012-13,48,3,702,56,151,33,78,23,73,8,14,4,38,42,143,22,4,57,48,143,0.370860927,0.423076923,0.315068493,0.571428571,0.447019868
Kendrick Perkins,19,BOS,NBA,2003-04,10,0,35,8,15,8,15,0,0,6,9,5,9,14,3,0,2,5,6,22,0.533333333,0.533333333,0.0,0.666666667,0.533333333
Kenneth Faried,22,DEN,NBA,2011-12,46,39,1037,181,309,181,309,0,0,109,164,142,210,352,36,34,47,54,116,471,0.585760518,0.585760518,0.0,0.664634146,0.585760518
Kenny Satterfield,20,DEN,NBA,2001-02,36,4,560,73,199,66,172,7,27,36,46,17,35,52,108,31,1,53,43,189,0.366834171,0.38372093,0.259259259,0.782608696,0.384422111
Kent Bazemore,23,GSW,NBA,2012-13,61,0,267,43,116,33,82,10,34,27,44,5,17,22,22,17,4,18,27,123,0.370689655,0.402439024,0.294117647,0.613636364,0.413793103
Kentavious Caldwell-Pope,20,DET,NBA,2013-14,80,41,1583,182,460,123,275,59,185,47,61,38,118,156,55,75,12,28,145,470,0.395652174,0.447272727,0.318918919,0.770491803,0.459782609
Kenyon Martin,23,NJN,NBA,2000-01,68,68,2272,346,777,345,766,1,11,121,192,137,365,502,131,78,113,138,281,814,0.445302445,0.450391645,0.090909091,0.630208333,0.445945946
Kevin Burleson,26,CHA,NBA,2005-06,39,1,340,22,88,12,34,10,54,16,17,4,22,26,48,26,2,25,63,70,0.25,0.352941176,0.185185185,0.941176471,0.306818182
Kevin Durant,19,SEA,NBA,2007-08,80,80,2768,587,1366,528,1161,59,205,391,448,70,278,348,192,78,75,232,122,1624,0.429721816,0.454780362,0.287804878,0.872767857,0.451317716
Kevin Jones,23,CLE,NBA,2012-13,32,0,334,43,107,43,107,0,0,9,15,38,40,78,10,9,5,8,25,95,0.401869159,0.401869159,0.0,0.6,0.401869159
Kevin Love,20,MIN,NBA,2008-09,81,37,2048,316,688,314,669,2,19,265,336,274,460,734,84,35,50,118,205,899,0.459302326,0.46935725,0.105263158,0.788690476,0.460755814
Kevin Martin,21,SAC,NBA,2004-05,45,0,455,45,117,40,92,5,25,36,55,29,29,58,22,16,3,24,35,131,0.384615385,0.434782609,0.2,0.654545455,0.405982906
Kevin Murphy,22,UTA,NBA,2012-13,17,0,52,7,28,6,23,1,5,0,0,0,4,4,2,1,0,3,4,15,0.25,0.260869565,0.2,0.0,0.267857143
Kevin Seraphin,21,WAS,NBA,2010-11,58,1,635,66,147,66,147,0,0,22,31,80,72,152,10,17,28,42,126,154,0.448979592,0.448979592,0.0,0.709677419,0.448979592
Kevinn Pinkney,23,BOS,NBA,2006-07,6,0,100,12,27,11,25,1,2,6,9,7,8,15,5,3,3,4,12,31,0.444444444,0.44,0.5,0.666666667,0.462962963
Kevon Looney,19,GSW,NBA,2015-16,5,0,21,4,7,3,5,1,2,0,0,4,6,10,0,0,0,1,2,9,0.571428571,0.6,0.5,0.0,0.642857143
Keyon Dooling,20,LAC,NBA,2000-01,76,1,1237,148,362,120,282,28,80,125,179,8,81,89,177,41,11,94,107,449,0.408839779,0.425531915,0.35,0.698324022,0.447513812
Khalid El-Amin,21,CHI,NBA,2000-01,50,14,936,115,311,87,227,28,84,56,72,21,60,81,145,48,2,54,99,314,0.36977492,0.383259912,0.333333333,0.777777778,0.414790997
Khris Middleton,21,DET,NBA,2012-13,27,0,475,62,141,48,96,14,45,27,32,4,46,50,28,15,4,11,53,165,0.439716312,0.5,0.311111111,0.84375,0.489361702
Kim English,24,DET,NBA,2012-13,41,0,407,42,112,28,62,14,50,21,29,8,29,37,26,16,3,19,46,119,0.375,0.451612903,0.28,0.724137931,0.4375
Kirk Haston,22,CHH,NBA,2001-02,15,0,77,11,39,11,36,0,3,4,8,5,15,20,5,0,1,3,9,26,0.282051282,0.305555556,0.0,0.5,0.282051282
Kirk Hinrich,23,CHI,NBA,2003-04,76,66,2706,318,823,174,454,144,369,135,168,42,217,259,517,101,21,204,276,915,0.386391252,0.383259912,0.390243902,0.803571429,0.473876063
Kirk Penney,23,MIA,NBA,2003-04,2,0,18,1,6,0,3,1,3,0,0,0,1,1,1,1,0,3,1,3,0.166666667,0.0,0.333333333,0.0,0.25
Kirk Snyder,21,UTA,NBA,2004-05,68,7,906,122,328,92,243,30,85,64,96,50,71,121,36,26,19,58,116,338,0.37195122,0.378600823,0.352941176,0.666666667,0.417682927
Klay Thompson,21,GSW,NBA,2011-12,66,29,1608,318,718,207,450,111,268,79,91,24,137,161,133,49,20,103,155,826,0.442896936,0.46,0.414179104,0.868131868,0.520194986
Kosta Koufos,19,UTA,NBA,2008-09,48,7,565,94,185,94,185,0,0,36,51,50,88,138,20,12,31,26,70,224,0.508108108,0.508108108,0.0,0.705882353,0.508108108
Kosta Perovic,22,GSW,NBA,2007-08,7,0,38,3,10,3,10,0,0,4,6,6,7,13,1,0,2,1,6,10,0.3,0.3,0.0,0.666666667,0.3
Kostas Papanikolaou,24,HOU,NBA,2014-15,43,1,795,69,197,38,91,31,106,13,18,39,79,118,85,29,13,55,71,182,0.350253807,0.417582418,0.29245283,0.722222222,0.42893401
Kris Dunn,22,MIN,NBA,2016-17,78,7,1333,118,313,97,240,21,73,36,59,24,142,166,188,78,36,89,178,293,0.376996805,0.404166667,0.287671233,0.610169492,0.410543131
Kris Humphries,19,UTA,NBA,2004-05,67,4,873,116,287,114,281,2,6,44,101,73,124,197,43,25,18,52,96,278,0.404181185,0.40569395,0.333333333,0.435643564,0.407665505
Kris Joseph,24,TOT,NBA,2012-13,10,0,54,2,14,2,11,0,3,5,8,1,6,7,1,3,0,2,3,9,0.142857143,0.181818182,0.0,0.625,0.142857143
Kristaps Porzingis,20,NYK,NBA,2015-16,72,72,2047,373,886,292,643,81,243,201,240,132,394,526,94,53,134,121,205,1028,0.420993228,0.454121306,0.333333333,0.8375,0.466704289
Kwame Brown,19,WAS,NBA,2001-02,57,3,817,94,243,94,242,0,1,70,99,63,135,198,43,16,26,43,105,258,0.386831276,0.388429752,0.0,0.707070707,0.386831276
Kyle Anderson,21,SAS,NBA,2014-15,33,8,358,31,89,28,78,3,11,9,14,5,67,72,28,15,7,10,28,74,0.348314607,0.358974359,0.272727273,0.642857143,0.365168539
Kyle Korver,22,PHI,NBA,2003-04,74,0,882,115,327,34,120,81,207,19,24,30,81,111,40,25,8,41,102,330,0.351681957,0.283333333,0.391304348,0.791666667,0.475535168
Kyle Lowry,20,MEM,NBA,2006-07,10,0,175,14,38,11,30,3,8,25,28,12,19,31,32,14,1,12,20,56,0.368421053,0.366666667,0.375,0.892857143,0.407894737
Kyle O'Quinn,22,ORL,NBA,2012-13,57,5,638,101,197,101,196,0,1,30,45,65,144,209,52,11,26,37,107,232,0.512690355,0.515306122,0.0,0.666666667,0.512690355
Kyle Singler,24,DET,NBA,2012-13,82,74,2293,275,642,205,442,70,200,100,124,109,221,330,77,57,37,98,217,720,0.42834891,0.463800905,0.35,0.806451613,0.482866044
Kyle Weaver,22,OKC,NBA,2008-09,56,19,1166,113,246,81,153,32,93,41,58,31,99,130,101,47,25,69,81,299,0.459349593,0.529411765,0.344086022,0.706896552,0.524390244
Kyle Wiltjer,24,HOU,NBA,2016-17,14,0,44,4,14,0,1,4,13,1,2,4,6,10,2,3,1,5,4,13,0.285714286,0.0,0.307692308,0.5,0.428571429
Kyrie Irving,19,CLE,NBA,2011-12,51,51,1558,350,747,277,564,73,183,171,196,44,147,191,275,54,20,160,110,944,0.46854083,0.491134752,0.398907104,0.87244898,0.517402945
Kyrylo Fesenko,21,UTA,NBA,2007-08,9,0,70,6,16,6,16,0,0,2,4,14,11,25,2,0,3,8,19,14,0.375,0.375,0.0,0.5,0.375
LaMarcus Aldridge,21,POR,NBA,2006-07,63,22,1392,241,479,241,477,0,2,83,115,144,168,312,24,22,73,43,186,565,0.503131524,0.50524109,0.0,0.72173913,0.503131524
Lamar Patterson,24,ATL,NBA,2015-16,35,0,395,28,80,16,31,12,49,16,22,4,46,50,39,9,2,23,45,84,0.35,0.516129032,0.244897959,0.727272727,0.425
Lance Allred,26,CLE,NBA,2007-08,3,0,10,1,4,1,4,0,0,1,2,0,1,1,0,0,0,0,1,3,0.25,0.25,0.0,0.5,0.25
Lance Stephenson,20,IND,NBA,2010-11,12,0,115,13,39,13,34,0,5,11,14,1,17,18,21,4,0,16,14,37,0.333333333,0.382352941,0.0,0.785714286,0.333333333
Lance Thomas,23,NOH,NBA,2011-12,42,10,630,57,126,57,125,0,1,52,62,49,77,126,12,10,7,24,78,166,0.452380952,0.456,0.0,0.838709677,0.452380952
Landry Fields,22,NYK,NBA,2010-11,82,81,2541,299,602,213,383,86,219,113,147,105,416,521,155,80,17,107,114,797,0.496677741,0.55613577,0.392694064,0.768707483,0.568106312
Langston Galloway,23,NYK,NBA,2014-15,45,41,1457,204,511,142,335,62,176,63,78,37,153,190,150,52,12,61,129,533,0.399217221,0.423880597,0.352272727,0.807692308,0.459882583
Larry Drew,24,PHI,NBA,2014-15,12,1,219,20,58,16,32,4,26,2,3,1,14,15,45,6,0,25,13,46,0.344827586,0.5,0.153846154,0.666666667,0.379310345
Larry Nance Jr.,23,LAL,NBA,2015-16,63,22,1266,158,300,157,290,1,10,32,47,101,211,312,44,54,23,41,124,349,0.526666667,0.54137931,0.1,0.680851064,0.528333333
Larry Owens,28,TOT,NBA,2010-11,12,0,143,15,32,9,19,6,13,4,9,1,14,15,8,9,5,5,18,40,0.46875,0.473684211,0.461538462,0.444444444,0.5625
Larry Sanders,22,MIL,NBA,2010-11,60,12,872,116,268,116,268,0,0,28,50,59,119,178,16,22,72,38,117,260,0.432835821,0.432835821,0.0,0.56,0.432835821
Lavor Postell,22,NYK,NBA,2000-01,26,0,169,17,54,14,43,3,11,22,27,8,17,25,5,4,2,17,12,59,0.314814815,0.325581395,0.272727273,0.814814815,0.342592593
Lavoy Allen,22,PHI,NBA,2011-12,41,15,624,79,167,79,167,0,0,11,14,47,124,171,34,13,18,20,73,169,0.473053892,0.473053892,0.0,0.785714286,0.473053892
Lawrence Roberts,23,MEM,NBA,2005-06,33,0,181,20,44,20,42,0,2,11,23,26,23,49,5,8,2,5,30,51,0.454545455,0.476190476,0.0,0.47826087,0.454545455
Lazar Hayward,24,MIN,NBA,2010-11,42,0,419,55,154,38,94,17,60,33,42,23,47,70,28,12,7,19,44,160,0.357142857,0.404255319,0.283333333,0.785714286,0.412337662
LeBron James,19,CLE,NBA,2003-04,79,79,3122,622,1492,559,1275,63,217,347,460,99,333,432,465,130,58,273,149,1654,0.41689008,0.438431373,0.290322581,0.754347826,0.438002681
Leandro Barbosa,21,PHO,NBA,2003-04,70,46,1500,210,470,127,260,83,210,47,61,23,100,123,165,93,7,120,184,550,0.446808511,0.488461538,0.395238095,0.770491803,0.535106383
Lee Nailon,25,CHH,NBA,2000-01,42,0,469,66,136,66,135,0,1,32,43,29,63,92,24,9,5,27,60,164,0.485294118,0.488888889,0.0,0.744186047,0.485294118
Leon Powe,23,BOS,NBA,2006-07,63,2,720,79,177,79,175,0,2,106,144,97,118,215,10,14,22,47,104,264,0.446327684,0.451428571,0.0,0.736111111,0.446327684
Leon Smith,21,ATL,NBA,2001-02,14,0,100,10,26,10,26,0,0,11,17,10,21,31,3,5,1,3,12,31,0.384615385,0.384615385,0.0,0.647058824,0.384615385
Lester Hudson,25,TOT,NBA,2009-10,25,0,131,21,53,16,37,5,16,11,13,7,11,18,13,8,3,14,12,58,0.396226415,0.432432432,0.3125,0.846153846,0.443396226
Linas Kleiza,21,DEN,NBA,2005-06,61,2,519,77,173,75,160,2,13,57,81,38,78,116,15,10,13,16,87,213,0.445086705,0.46875,0.153846154,0.703703704,0.450867052
Linton Johnson,23,CHI,NBA,2003-04,41,20,734,72,203,65,170,7,33,22,37,59,124,183,27,37,32,37,90,173,0.354679803,0.382352941,0.212121212,0.594594595,0.371921182
Lionel Chalmers,24,LAC,NBA,2004-05,36,0,433,42,125,30,76,12,49,15,24,4,27,31,51,13,0,24,30,111,0.336,0.394736842,0.244897959,0.625,0.384
Lonny Baxter,24,CHI,NBA,2002-03,55,0,682,96,206,96,204,0,2,70,103,65,100,165,16,9,22,46,135,262,0.466019417,0.470588235,0.0,0.67961165,0.466019417
Loren Woods,23,MIN,NBA,2001-02,60,0,516,33,96,33,94,0,2,44,60,46,76,122,22,17,34,36,60,110,0.34375,0.35106383,0.0,0.733333333,0.34375
Lorenzo Brown,23,PHI,NBA,2013-14,26,0,224,26,86,23,56,3,30,9,13,8,20,28,41,13,3,16,19,64,0.302325581,0.410714286,0.1,0.692307692,0.319767442
Lou Amundson,24,TOT,NBA,2006-07,11,0,89,6,15,6,15,0,0,4,10,13,15,28,1,1,8,5,15,16,0.4,0.4,0.0,0.4,0.4
Lou Williams,19,PHI,NBA,2005-06,30,0,145,23,52,21,43,2,9,8,13,3,16,19,10,5,0,13,13,56,0.442307692,0.488372093,0.222222222,0.615384615,0.461538462
Luc Mbah a Moute,22,MIL,NBA,2008-09,82,52,2114,227,491,227,487,0,4,140,192,189,298,487,87,87,45,100,204,594,0.462321792,0.466119097,0.0,0.729166667,0.462321792
Lucas Nogueira,22,TOR,NBA,2014-15,6,0,23,2,8,2,8,0,0,2,4,2,9,11,1,2,0,2,6,6,0.25,0.25,0.0,0.5,0.25
Luigi Datome,26,DET,NBA,2013-14,34,0,238,34,97,27,58,7,39,8,10,14,32,46,11,6,1,11,20,83,0.350515464,0.465517241,0.179487179,0.8,0.386597938
Luis Flores,23,TOT,NBA,2004-05,16,0,77,14,29,9,19,5,10,2,2,1,2,3,11,2,0,11,9,35,0.482758621,0.473684211,0.5,1.0,0.568965517
Luis Montero,22,POR,NBA,2015-16,12,0,42,5,19,4,10,1,9,3,4,0,4,4,1,0,0,4,1,14,0.263157895,0.4,0.111111111,0.75,0.289473684
Luis Scola,27,HOU,NBA,2007-08,82,39,2024,345,670,345,667,0,3,157,235,174,351,525,106,60,19,105,235,847,0.514925373,0.517241379,0.0,0.668085106,0.514925373
Luke Babbitt,21,POR,NBA,2010-11,24,0,137,15,55,12,39,3,16,3,9,6,24,30,6,2,2,8,15,36,0.272727273,0.307692308,0.1875,0.333333333,0.3
Luke Harangody,23,TOT,NBA,2010-11,49,0,640,79,206,63,140,16,66,19,26,40,103,143,30,15,17,16,80,193,0.383495146,0.45,0.242424242,0.730769231,0.422330097
Luke Jackson,23,CLE,NBA,2004-05,10,0,43,10,27,6,21,4,6,5,6,2,4,6,3,0,0,2,4,29,0.37037037,0.285714286,0.666666667,0.833333333,0.444444444
Luke Ridnour,22,SEA,NBA,2003-04,69,6,1114,145,350,118,270,27,80,65,79,35,73,108,163,52,7,80,105,382,0.414285714,0.437037037,0.3375,0.82278481,0.452857143
Luke Schenscher,23,CHI,NBA,2005-06,20,0,149,16,26,16,26,0,0,4,13,8,21,29,7,1,3,5,21,36,0.615384615,0.615384615,0.0,0.307692308,0.615384615
Luke Walton,23,LAL,NBA,2003-04,72,2,730,65,153,52,114,13,39,31,44,39,88,127,113,28,8,44,70,174,0.424836601,0.456140351,0.333333333,0.704545455,0.467320261
Luke Zeller,25,PHO,NBA,2012-13,16,0,58,9,26,8,21,1,5,0,0,1,9,10,3,0,0,0,5,19,0.346153846,0.380952381,0.2,0.0,0.365384615
Luol Deng,19,CHI,NBA,2004-05,61,45,1663,280,645,249,528,31,117,120,162,92,230,322,135,48,27,118,98,711,0.434108527,0.471590909,0.264957265,0.740740741,0.458139535
Luther Head,23,HOU,NBA,2005-06,80,27,2310,254,630,141,317,113,313,86,123,33,233,266,215,89,9,119,169,707,0.403174603,0.444794953,0.361022364,0.699186992,0.492857143
Lynn Greer,27,MIL,NBA,2006-07,41,0,432,61,141,43,89,18,52,27,32,2,25,27,53,17,1,18,32,167,0.432624113,0.483146067,0.346153846,0.84375,0.496453901
Maalik Wayns,21,TOT,NBA,2012-13,27,1,202,26,88,19,57,7,31,17,19,1,6,7,27,6,0,15,26,76,0.295454545,0.333333333,0.225806452,0.894736842,0.335227273
Maceo Baston,27,TOR,NBA,2002-03,16,0,106,15,25,15,25,0,0,10,12,4,19,23,0,4,11,6,16,40,0.6,0.6,0.0,0.833333333,0.6
Maciej Lampe,18,PHO,NBA,2003-04,21,0,224,43,88,43,84,0,4,10,13,9,35,44,9,3,3,15,28,96,0.488636364,0.511904762,0.0,0.769230769,0.488636364
Malachi Richardson,21,SAC,NBA,2016-17,22,0,198,28,68,20,40,8,28,15,19,3,20,23,11,5,1,8,23,79,0.411764706,0.5,0.285714286,0.789473684,0.470588235
Malcolm Brogdon,24,MIL,NBA,2016-17,75,28,1982,290,635,212,442,78,193,109,126,47,166,213,317,84,12,113,140,767,0.456692913,0.479638009,0.404145078,0.865079365,0.518110236
Malcolm Delaney,27,ATL,NBA,2016-17,73,2,1248,145,388,119,278,26,110,75,93,11,113,124,193,39,1,95,112,391,0.37371134,0.428057554,0.236363636,0.806451613,0.407216495
Malcolm Lee,21,MIN,NBA,2011-12,19,0,243,23,59,21,49,2,10,14,17,9,17,26,31,8,4,17,22,62,0.389830508,0.428571429,0.2,0.823529412,0.406779661
Malcolm Thomas,23,SAS,NBA,2011-12,3,0,15,0,3,0,3,0,0,1,2,1,2,3,1,1,1,0,0,1,0.0,0.0,0.0,0.5,0.0
Malik Allen,23,MIA,NBA,2001-02,12,2,161,22,51,22,50,0,1,8,10,15,23,38,5,3,8,2,16,52,0.431372549,0.44,0.0,0.8,0.431372549
Malik Beasley,20,DEN,NBA,2016-17,22,1,165,33,73,24,45,9,28,8,10,5,12,17,11,7,0,8,10,83,0.452054795,0.533333333,0.321428571,0.8,0.51369863
Malik Hairston,21,SAS,NBA,2008-09,15,0,155,24,49,24,48,0,1,2,7,11,17,28,13,6,7,12,19,50,0.489795918,0.5,0.0,0.285714286,0.489795918
Mamadou N'Diaye,25,TOR,NBA,2000-01,3,0,10,1,4,1,4,0,0,2,2,1,1,2,0,0,0,0,3,4,0.25,0.25,0.0,1.0,0.25
Manny Harris,21,CLE,NBA,2010-11,54,15,933,108,289,74,197,34,92,71,93,36,104,140,85,31,7,63,65,321,0.373702422,0.375634518,0.369565217,0.76344086,0.432525952
Manu Ginobili,25,SAS,NBA,2002-03,69,5,1431,174,397,123,249,51,148,126,171,47,114,161,138,96,17,100,170,525,0.438287154,0.493975904,0.344594595,0.736842105,0.502518892
MarShon Brooks,23,NJN,NBA,2011-12,56,47,1648,274,640,227,490,47,150,113,148,70,130,200,131,52,15,118,116,708,0.428125,0.463265306,0.313333333,0.763513514,0.46484375
Marc Gasol,24,MEM,NBA,2008-09,82,75,2521,350,661,350,660,0,1,275,375,201,404,605,143,63,90,164,265,975,0.529500756,0.53030303,0.0,0.733333333,0.529500756
Marc Jackson,26,GSW,NBA,2000-01,48,35,1410,237,508,232,485,5,23,154,192,119,242,361,59,34,27,93,138,633,0.466535433,0.478350515,0.217391304,0.802083333,0.471456693
Marcelo Huertas,32,LAL,NBA,2015-16,53,0,869,97,230,81,169,16,61,27,29,18,72,90,182,26,7,80,76,237,0.42173913,0.479289941,0.262295082,0.931034483,0.456521739
Marcin Gortat,23,ORL,NBA,2007-08,6,0,41,8,17,8,17,0,0,2,3,8,8,16,2,1,1,2,4,18,0.470588235,0.470588235,0.0,0.666666667,0.470588235
Marco Belinelli,21,GSW,NBA,2007-08,33,0,241,36,93,20,52,16,41,7,9,3,11,14,15,5,0,12,15,95,0.387096774,0.384615385,0.390243902,0.777777778,0.47311828
Marcus Banks,22,BOS,NBA,2003-04,81,2,1385,177,442,150,356,27,86,99,131,30,103,133,175,88,13,125,171,480,0.400452489,0.421348315,0.313953488,0.755725191,0.430995475
Marcus Cousin,24,UTA,NBA,2010-11,4,0,18,2,3,2,3,0,0,0,0,0,3,3,0,0,1,1,1,4,0.666666667,0.666666667,0.0,0.0,0.666666667
Marcus Fizer,22,CHI,NBA,2000-01,72,13,1580,278,646,268,607,10,39,117,161,76,237,313,76,30,19,124,175,683,0.430340557,0.441515651,0.256410256,0.726708075,0.438080495
Marcus Georges-Hunt,22,ORL,NBA,2016-17,5,0,48,2,7,1,5,1,2,9,10,1,8,9,3,1,0,2,5,14,0.285714286,0.2,0.5,0.9,0.357142857
Marcus Haislip,22,MIL,NBA,2002-03,39,8,441,66,153,63,141,3,12,26,38,21,32,53,9,7,18,21,55,161,0.431372549,0.446808511,0.25,0.684210526,0.441176471
Marcus Landry,24,TOT,NBA,2009-10,18,0,111,16,43,7,15,9,28,3,5,5,14,19,0,1,2,6,14,44,0.372093023,0.466666667,0.321428571,0.6,0.476744186
Marcus Morris,22,HOU,NBA,2011-12,17,0,126,16,54,14,37,2,17,6,8,5,11,16,3,2,2,4,12,40,0.296296296,0.378378378,0.117647059,0.75,0.314814815
Marcus Smart,20,BOS,NBA,2014-15,67,38,1808,175,477,84,205,91,272,82,127,61,161,222,208,99,18,90,176,523,0.36687631,0.409756098,0.334558824,0.645669291,0.462264151
Marcus Thornton,22,NOH,NBA,2009-10,73,17,1872,398,883,281,570,117,313,144,177,72,139,211,114,58,11,76,127,1057,0.450736127,0.492982456,0.373801917,0.813559322,0.516987542
Marcus Vinicius,22,NOK,NBA,2006-07,13,0,103,7,15,4,8,3,7,5,7,2,9,11,5,2,1,6,10,22,0.466666667,0.5,0.428571429,0.714285714,0.566666667
Marcus Williams,21,NJN,NBA,2006-07,79,2,1315,208,526,162,363,46,163,72,85,29,134,163,260,29,2,142,96,534,0.395437262,0.446280992,0.282208589,0.847058824,0.439163498
Marcus Williams,21,TOT,NBA,2007-08,11,0,36,5,20,5,20,0,0,0,0,4,8,12,3,1,1,0,3,10,0.25,0.25,0.0,0.0,0.25
Mardy Collins,22,NYK,NBA,2006-07,52,9,777,87,228,74,181,13,47,48,82,28,76,104,83,32,3,57,75,235,0.381578947,0.408839779,0.276595745,0.585365854,0.410087719
Mario Chalmers,22,MIA,NBA,2008-09,82,82,2626,278,662,164,351,114,311,148,193,37,191,228,403,160,8,165,240,818,0.419939577,0.467236467,0.366559486,0.766839378,0.506042296
Mario Hezonja,20,ORL,NBA,2015-16,79,9,1413,181,418,114,226,67,192,49,54,28,148,176,109,39,17,97,124,478,0.433014354,0.504424779,0.348958333,0.907407407,0.513157895
Mario Kasun,24,ORL,NBA,2004-05,45,0,356,47,98,47,97,0,1,24,43,52,76,128,8,8,13,26,86,118,0.479591837,0.484536082,0.0,0.558139535,0.479591837
Mario West,23,ATL,NBA,2007-08,64,2,269,21,49,21,45,0,4,17,26,26,22,48,13,12,4,9,61,59,0.428571429,0.466666667,0.0,0.653846154,0.428571429
Mark Blount,25,BOS,NBA,2000-01,64,50,1098,101,200,101,200,0,0,46,66,97,134,231,32,39,76,62,183,248,0.505,0.505,0.0,0.696969697,0.505
Mark Jones,29,ORL,NBA,2004-05,10,0,116,9,31,9,27,0,4,5,10,6,7,13,6,5,2,3,16,23,0.290322581,0.333333333,0.0,0.5,0.290322581
Mark Madsen,25,LAL,NBA,2000-01,70,3,641,55,113,54,112,1,1,26,37,74,78,152,24,8,8,27,111,137,0.486725664,0.482142857,1.0,0.702702703,0.491150442
Markel Brown,23,BRK,NBA,2014-15,47,29,781,76,210,59,146,17,64,47,57,16,91,107,39,31,12,27,57,216,0.361904762,0.404109589,0.265625,0.824561404,0.402380952
Markieff Morris,22,PHO,NBA,2011-12,63,7,1227,174,436,131,312,43,124,76,106,69,210,279,65,41,42,70,179,467,0.399082569,0.419871795,0.346774194,0.716981132,0.448394495
Marko Jaric,24,LAC,NBA,2002-03,66,12,1379,179,446,126,280,53,166,79,105,35,125,160,193,97,11,103,125,490,0.401345291,0.45,0.319277108,0.752380952,0.460762332
Marquese Chriss,19,PHO,NBA,2016-17,82,75,1743,284,632,212,408,72,224,113,181,96,252,348,60,67,70,108,263,753,0.449367089,0.519607843,0.321428571,0.624309392,0.506329114
Marquis Daniels,23,DAL,NBA,2003-04,56,15,1039,203,411,192,375,11,36,60,78,66,80,146,116,53,12,44,51,477,0.493917275,0.512,0.305555556,0.769230769,0.50729927
Marquis Teague,19,CHI,NBA,2012-13,48,0,392,43,113,39,90,4,23,9,16,3,41,44,63,9,7,35,47,99,0.380530973,0.433333333,0.173913043,0.5625,0.398230088
Marreese Speights,21,PHI,NBA,2008-09,79,2,1263,252,502,250,494,2,8,102,132,123,170,293,30,27,56,46,181,608,0.501992032,0.506072874,0.25,0.772727273,0.503984064
Marshall Plumlee,24,NYK,NBA,2016-17,21,1,170,16,30,16,30,0,0,8,19,23,28,51,10,4,4,12,23,40,0.533333333,0.533333333,0.0,0.421052632,0.533333333
Martell Webster,19,POR,NBA,2005-06,61,18,1070,139,348,74,166,65,182,61,71,29,101,130,34,21,14,43,90,404,0.399425287,0.445783133,0.357142857,0.85915493,0.492816092
Martynas Andriuskevicius,19,CLE,NBA,2005-06,6,0,9,0,1,0,1,0,0,0,0,1,3,4,0,2,0,0,1,0,0.0,0.0,0.0,0.0,0.0
Marvin Williams,19,ATL,NBA,2005-06,79,7,1952,235,531,222,478,13,53,189,253,122,261,383,63,48,24,83,227,672,0.442561205,0.464435146,0.245283019,0.747035573,0.45480226
Mason Plumlee,23,BRK,NBA,2013-14,70,22,1275,199,302,199,299,0,3,122,195,99,209,308,60,49,55,77,171,520,0.658940397,0.665551839,0.0,0.625641026,0.658940397
Mateen Cleaves,23,DET,NBA,2000-01,78,8,1268,160,400,155,383,5,17,97,137,26,106,132,207,49,1,139,153,422,0.4,0.404699739,0.294117647,0.708029197,0.40625
Matt Barnes,23,LAC,NBA,2003-04,38,9,724,63,138,61,125,2,13,43,61,53,98,151,48,27,3,44,76,171,0.456521739,0.488,0.153846154,0.704918033,0.463768116
Matt Bonner,24,TOR,NBA,2004-05,82,0,1553,247,463,208,371,39,92,56,71,108,177,285,48,39,19,40,220,589,0.533477322,0.5606469,0.423913043,0.788732394,0.575593952
Matt Carroll,23,TOT,NBA,2003-04,16,0,70,7,16,6,13,1,3,4,6,1,5,6,2,1,0,6,8,19,0.4375,0.461538462,0.333333333,0.666666667,0.46875
Matt Freije,23,NOH,NBA,2004-05,23,11,441,37,127,23,73,14,54,5,8,16,45,61,20,13,2,17,40,93,0.291338583,0.315068493,0.259259259,0.625,0.346456693
Matt Walsh,23,MIA,NBA,2005-06,2,0,3,1,1,1,1,0,0,0,2,0,0,0,0,0,0,1,0,2,1.0,1.0,0.0,0.0,1.0
Matthew Dellavedova,23,CLE,NBA,2013-14,72,4,1271,122,296,65,141,57,155,38,48,29,94,123,187,33,5,60,121,339,0.412162162,0.460992908,0.367741935,0.791666667,0.508445946
Maurice Ager,22,DAL,NBA,2006-07,32,1,214,22,70,17,55,5,15,20,33,1,20,21,7,4,3,15,27,69,0.314285714,0.309090909,0.333333333,0.606060606,0.35
Maurice Baker,25,TOT,NBA,2004-05,5,0,19,0,1,0,1,0,0,0,0,1,1,2,1,1,0,1,3,0,0.0,0.0,0.0,0.0,0.0
Maurice Carter,27,TOT,NBA,2003-04,10,0,110,11,35,7,24,4,11,16,20,2,9,11,4,0,0,9,10,42,0.314285714,0.291666667,0.363636364,0.8,0.371428571
Maurice Evans,23,MIN,NBA,2001-02,10,0,45,9,19,9,16,0,3,3,4,3,1,4,4,0,0,2,9,21,0.473684211,0.5625,0.0,0.75,0.473684211
Maurice Harkless,19,ORL,NBA,2012-13,76,59,1974,260,564,228,447,32,117,73,128,122,213,335,50,88,62,69,144,625,0.460992908,0.510067114,0.273504274,0.5703125,0.489361702
Maurice Ndour,24,NYK,NBA,2016-17,32,4,331,39,86,38,79,1,7,19,26,22,42,64,8,15,8,12,30,98,0.453488372,0.481012658,0.142857143,0.730769231,0.459302326
Mehmet Okur,23,DET,NBA,2002-03,72,9,1366,180,423,142,311,38,112,96,131,117,218,335,71,25,39,66,167,494,0.425531915,0.45659164,0.339285714,0.732824427,0.470449173
Melvin Ely,24,LAC,NBA,2002-03,52,7,802,92,186,92,186,0,0,52,74,64,110,174,15,10,32,50,95,236,0.494623656,0.494623656,0.0,0.702702703,0.494623656
Melvin Sanders,25,SAS,NBA,2005-06,16,0,113,16,33,14,30,2,3,7,10,4,19,23,3,5,0,8,20,41,0.484848485,0.466666667,0.666666667,0.7,0.515151515
Mengke Bateer,26,DEN,NBA,2001-02,27,10,408,53,132,49,120,4,12,29,37,32,64,96,22,10,5,32,94,139,0.401515152,0.408333333,0.333333333,0.783783784,0.416666667
Meyers Leonard,20,POR,NBA,2012-13,69,9,1206,151,277,148,270,3,7,72,89,80,175,255,33,11,38,49,168,377,0.545126354,0.548148148,0.428571429,0.808988764,0.550541516
Michael Beasley,20,MIA,NBA,2008-09,81,19,2009,452,957,419,876,33,81,186,241,110,329,439,83,41,37,121,184,1123,0.4723093,0.478310502,0.407407407,0.771784232,0.489550679
Michael Bradley,22,TOR,NBA,2001-02,26,0,118,13,25,13,23,0,2,4,8,7,17,24,3,0,6,6,10,30,0.52,0.565217391,0.0,0.5,0.52
Michael Carter-Williams,22,PHI,NBA,2013-14,70,70,2414,427,1054,372,846,55,208,258,367,101,336,437,441,130,43,247,213,1167,0.40512334,0.439716312,0.264423077,0.702997275,0.431214421
Michael Gbinije,24,DET,NBA,2016-17,9,0,32,1,10,1,6,0,4,2,2,2,1,3,2,0,0,0,2,4,0.1,0.166666667,0.0,1.0,0.1
Michael Kidd-Gilchrist,19,CHA,NBA,2012-13,78,77,2025,281,613,279,604,2,9,140,187,131,324,455,117,54,70,101,164,704,0.458401305,0.46192053,0.222222222,0.748663102,0.460032626
Michael Redd,21,MIL,NBA,2000-01,6,0,35,5,19,5,16,0,3,3,6,3,1,4,1,1,0,1,2,13,0.263157895,0.3125,0.0,0.5,0.263157895
Mickael Gelabale,23,SEA,NBA,2006-07,70,14,1239,122,264,111,217,11,47,66,82,59,114,173,56,24,22,49,108,321,0.462121212,0.511520737,0.234042553,0.804878049,0.482954545
Mickael Pietrus,21,GSW,NBA,2003-04,53,22,748,96,231,61,126,35,105,52,75,48,71,119,27,32,12,40,100,279,0.415584416,0.484126984,0.333333333,0.693333333,0.491341991
Mickell Gladness,25,TOT,NBA,2011-12,26,7,252,25,59,25,59,0,0,6,12,14,44,58,5,4,20,7,32,56,0.423728814,0.423728814,0.0,0.5,0.423728814
Mike Batiste,25,MEM,NBA,2002-03,75,2,1248,197,467,179,386,18,81,69,88,82,175,257,52,42,16,69,120,481,0.421841542,0.46373057,0.222222222,0.784090909,0.44111349
Mike Conley,20,MEM,NBA,2007-08,53,46,1381,189,442,159,351,30,91,90,123,21,118,139,222,44,2,89,85,498,0.42760181,0.452991453,0.32967033,0.731707317,0.461538462
Mike Dunleavy,22,GSW,NBA,2002-03,82,3,1305,168,417,116,267,52,150,78,100,66,148,214,106,53,19,86,120,466,0.402877698,0.434456929,0.346666667,0.78,0.465227818
Mike Hall,22,WAS,NBA,2006-07,2,0,13,1,4,1,4,0,0,0,0,1,1,2,1,0,0,0,1,2,0.25,0.25,0.0,0.0,0.25
Mike Harris,24,HOU,NBA,2007-08,17,0,159,27,54,27,52,0,2,8,13,24,30,54,3,6,3,9,16,62,0.5,0.519230769,0.0,0.615384615,0.5
Mike James,26,MIA,NBA,2001-02,15,0,119,15,43,7,22,8,21,4,7,2,12,14,19,6,1,13,17,42,0.348837209,0.318181818,0.380952381,0.571428571,0.441860465
Mike Miller,20,ORL,NBA,2000-01,82,62,2390,368,845,220,481,148,364,91,128,66,261,327,140,51,19,97,200,975,0.435502959,0.457380457,0.406593407,0.7109375,0.523076923
Mike Muscala,22,ATL,NBA,2013-14,20,0,215,31,73,31,70,0,3,14,14,17,35,52,7,3,10,12,29,76,0.424657534,0.442857143,0.0,1.0,0.424657534
Mike Penberthy,26,LAL,NBA,2000-01,53,0,851,92,222,37,83,55,139,28,31,10,53,63,71,22,2,34,57,267,0.414414414,0.445783133,0.395683453,0.903225806,0.538288288
Mike Scott,24,ATL,NBA,2012-13,40,1,376,70,147,70,146,0,1,43,56,39,71,110,12,4,2,21,32,183,0.476190476,0.479452055,0.0,0.767857143,0.476190476
Mike Smith,24,WAS,NBA,2000-01,17,0,180,19,59,16,41,3,18,10,16,10,12,22,10,5,3,7,8,51,0.322033898,0.390243902,0.166666667,0.625,0.347457627
Mike Sweetney,21,NYK,NBA,2003-04,42,1,494,69,140,69,139,0,1,42,58,68,89,157,14,18,12,32,57,180,0.492857143,0.496402878,0.0,0.724137931,0.492857143
Mike Taylor,23,LAC,NBA,2008-09,51,5,771,110,267,97,227,13,40,56,81,22,65,87,106,36,0,73,84,289,0.411985019,0.427312775,0.325,0.691358025,0.436329588
Mike Tobey,22,CHO,NBA,2016-17,2,0,25,1,4,1,4,0,0,0,0,2,1,3,1,0,0,1,2,2,0.25,0.25,0.0,0.0,0.25
Mike Wilks,23,TOT,NBA,2002-03,46,7,688,50,148,40,113,10,35,37,47,20,51,71,92,27,4,28,69,147,0.337837838,0.353982301,0.285714286,0.787234043,0.371621622
Mile Ilic,22,NJN,NBA,2006-07,5,0,6,0,3,0,3,0,0,0,0,0,1,1,0,0,0,3,1,0,0.0,0.0,0.0,0.0,0.0
Miles Plumlee,24,IND,NBA,2012-13,14,0,55,5,21,5,21,0,0,3,4,12,10,22,2,0,3,3,5,13,0.238095238,0.238095238,0.0,0.75,0.238095238
Mindaugas Kuzminskas,27,NYK,NBA,2016-17,68,5,1016,158,369,104,201,54,168,55,68,47,79,126,69,29,11,51,79,425,0.428184282,0.517412935,0.321428571,0.808823529,0.501355014
Miroslav Raduljica,26,MIL,NBA,2013-14,48,2,465,68,126,68,126,0,0,45,55,54,54,108,23,7,13,28,84,181,0.53968254,0.53968254,0.0,0.818181818,0.53968254
Mirza Teletovic,27,BRK,NBA,2012-13,53,0,499,71,185,34,77,37,108,9,11,33,62,95,23,13,8,20,53,188,0.383783784,0.441558442,0.342592593,0.818181818,0.483783784
Mitch McGary,22,OKC,NBA,2014-15,32,2,485,88,165,88,163,0,2,25,40,53,112,165,14,16,16,31,72,201,0.533333333,0.539877301,0.0,0.625,0.533333333
Mo Williams,21,UTA,NBA,2003-04,57,0,772,115,303,105,264,10,39,44,56,23,49,72,76,28,2,51,87,284,0.379537954,0.397727273,0.256410256,0.785714286,0.396039604
Monta Ellis,20,GSW,NBA,2005-06,49,3,886,132,318,104,236,28,82,42,59,22,83,105,78,32,11,58,69,334,0.41509434,0.440677966,0.341463415,0.711864407,0.459119497
Montrezl Harrell,22,HOU,NBA,2015-16,39,1,379,58,90,58,89,0,1,24,46,25,40,65,17,11,11,17,48,140,0.644444444,0.651685393,0.0,0.52173913,0.644444444
Morris Almond,22,UTA,NBA,2007-08,9,0,39,4,15,3,11,1,4,4,6,0,2,2,3,1,0,2,5,13,0.266666667,0.272727273,0.25,0.666666667,0.3
Morris Peterson,23,TOR,NBA,2000-01,80,49,1809,290,673,227,508,63,165,104,145,112,147,259,105,63,20,78,164,747,0.430906389,0.446850394,0.381818182,0.717241379,0.477711738
Mouhamed Sene,20,SEA,NBA,2006-07,28,3,169,18,49,18,49,0,0,17,29,16,29,45,0,3,12,11,33,53,0.367346939,0.367346939,0.0,0.586206897,0.367346939
Mustafa Shakur,26,WAS,NBA,2010-11,22,0,159,21,59,20,49,1,10,8,15,7,15,22,25,5,3,18,15,51,0.355932203,0.408163265,0.1,0.533333333,0.36440678
Mychel Thompson,23,CLE,NBA,2011-12,5,3,95,7,24,3,13,4,11,0,0,0,5,5,7,2,1,5,8,18,0.291666667,0.230769231,0.363636364,0.0,0.375
Myles Turner,19,IND,NBA,2015-16,60,30,1367,264,530,261,516,3,14,88,121,68,264,332,41,25,86,67,158,619,0.498113208,0.505813953,0.214285714,0.727272727,0.500943396
Nando De Colo,25,SAS,NBA,2012-13,72,6,920,105,241,74,159,31,82,35,44,23,115,138,138,41,6,81,87,276,0.435684647,0.465408805,0.37804878,0.795454545,0.5
Nate Huffman,27,TOR,NBA,2002-03,7,0,76,9,25,9,25,0,0,5,8,9,14,23,5,1,3,3,13,23,0.36,0.36,0.0,0.625,0.36
Nate Robinson,21,NYK,NBA,2005-06,72,26,1544,230,565,172,419,58,146,152,202,56,111,167,147,59,1,114,201,670,0.407079646,0.410501193,0.397260274,0.752475248,0.45840708
Nate Wolters,22,MIL,NBA,2013-14,58,31,1309,170,389,152,327,18,62,59,90,33,116,149,187,35,15,57,67,417,0.437017995,0.464831804,0.290322581,0.655555556,0.460154242
Nathan Jawai,22,TOR,NBA,2008-09,6,0,19,1,4,1,4,0,0,0,0,1,1,2,0,0,0,2,3,2,0.25,0.25,0.0,0.0,0.25
Ndudi Ebi,19,MIN,NBA,2003-04,17,0,32,6,14,6,14,0,0,1,4,2,1,3,3,0,4,3,6,13,0.428571429,0.428571429,0.0,0.25,0.428571429
Nemanja Bjelica,27,MIN,NBA,2015-16,60,0,1075,110,235,62,110,48,125,40,55,49,161,210,83,26,21,47,154,308,0.468085106,0.563636364,0.384,0.727272727,0.570212766
Nemanja Nedovic,22,GSW,NBA,2013-14,24,0,142,8,39,5,21,3,18,7,8,3,12,15,13,0,1,13,13,26,0.205128205,0.238095238,0.166666667,0.875,0.243589744
Nenad Krstic,21,NJN,NBA,2004-05,75,57,1965,281,570,281,568,0,2,185,255,161,240,401,77,32,63,112,280,747,0.492982456,0.49471831,0.0,0.725490196,0.492982456
Nene Hilario,20,DEN,NBA,2002-03,80,53,2258,321,619,321,616,0,3,197,341,208,283,491,149,127,65,181,295,839,0.518578352,0.521103896,0.0,0.57771261,0.518578352
Nerlens Noel,20,PHI,NBA,2014-15,75,71,2311,302,653,302,653,0,0,140,230,185,426,611,128,133,142,146,208,744,0.462480858,0.462480858,0.0,0.608695652,0.462480858
Nick Calathes,24,MEM,NBA,2013-14,71,7,1173,142,311,123,250,19,61,44,72,23,114,137,207,66,8,101,117,347,0.45659164,0.492,0.31147541,0.611111111,0.487138264
Nick Collison,24,SEA,NBA,2004-05,82,4,1396,190,354,190,351,0,3,83,118,156,220,376,32,34,50,62,252,463,0.536723164,0.541310541,0.0,0.703389831,0.536723164
Nick Fazekas,22,TOT,NBA,2007-08,26,0,269,46,82,46,80,0,2,15,22,34,55,89,11,8,11,13,25,107,0.56097561,0.575,0.0,0.681818182,0.56097561
Nick Johnson,22,HOU,NBA,2014-15,28,0,262,26,75,21,54,5,21,17,25,13,26,39,11,7,3,19,34,74,0.346666667,0.388888889,0.238095238,0.68,0.38
Nick Young,22,WAS,NBA,2007-08,75,2,1158,210,478,170,378,40,100,101,124,23,92,115,63,35,7,94,130,561,0.439330544,0.44973545,0.4,0.814516129,0.481171548
Nicolas Batum,20,POR,NBA,2008-09,79,76,1454,161,361,99,193,62,168,42,52,84,136,220,74,50,40,50,139,426,0.44598338,0.512953368,0.369047619,0.807692308,0.531855956
Nicolas Brussino,23,DAL,NBA,2016-17,54,2,521,52,141,23,46,29,95,17,22,26,69,95,47,17,8,26,43,150,0.368794326,0.5,0.305263158,0.772727273,0.471631206
Nicolas Laprovittola,27,SAS,NBA,2016-17,18,3,174,20,47,10,20,10,27,9,9,1,9,10,28,4,1,19,19,59,0.425531915,0.5,0.37037037,1.0,0.531914894
Nik Stauskas,21,SAC,NBA,2014-15,73,1,1127,108,296,60,147,48,149,55,64,11,77,88,67,20,17,40,92,319,0.364864865,0.408163265,0.322147651,0.859375,0.445945946
Nikola Jokic,20,DEN,NBA,2015-16,80,55,1733,307,600,279,516,28,84,154,190,181,379,560,189,79,50,104,208,796,0.511666667,0.540697674,0.333333333,0.810526316,0.535
Nikola Mirotic,23,CHI,NBA,2014-15,82,3,1654,253,624,154,311,99,313,228,284,63,341,404,97,54,54,89,172,833,0.405448718,0.495176849,0.31629393,0.802816901,0.484775641
Nikola Pekovic,25,MIN,NBA,2010-11,65,11,887,136,263,136,263,0,0,87,114,90,103,193,27,18,35,91,181,359,0.517110266,0.517110266,0.0,0.763157895,0.517110266
Nikola Vucevic,21,PHI,NBA,2011-12,51,15,812,131,291,128,283,3,8,18,34,88,158,246,31,20,34,33,111,283,0.450171821,0.45229682,0.375,0.529411765,0.45532646
Nikoloz Tskitishvili,19,DEN,NBA,2002-03,81,16,1320,115,393,78,241,37,152,48,65,64,117,181,91,31,29,84,136,315,0.292620865,0.323651452,0.243421053,0.738461538,0.339694656
Noah Vonleh,19,CHO,NBA,2014-15,25,0,259,30,76,25,63,5,13,18,26,28,58,86,4,4,9,11,20,83,0.394736842,0.396825397,0.384615385,0.692307692,0.427631579
Noel Felix,24,SEA,NBA,2005-06,12,0,82,6,25,5,22,1,3,5,8,3,10,13,2,2,3,8,13,18,0.24,0.227272727,0.333333333,0.625,0.26
Nolan Smith,23,POR,NBA,2011-12,44,4,541,67,180,54,135,13,45,20,28,17,39,56,62,18,3,42,55,167,0.372222222,0.4,0.288888889,0.714285714,0.408333333
Norm Richardson,22,TOT,NBA,2001-02,11,0,67,10,26,6,18,4,8,6,9,3,5,8,2,0,0,3,5,30,0.384615385,0.333333333,0.5,0.666666667,0.461538462
Norman Powell,22,TOR,NBA,2015-16,49,24,725,97,229,61,140,36,89,43,53,16,95,111,47,29,10,32,59,273,0.423580786,0.435714286,0.404494382,0.811320755,0.502183406
Norris Cole,23,MIA,NBA,2011-12,65,2,1260,177,450,156,374,21,76,66,85,21,70,91,133,44,2,105,124,441,0.393333333,0.417112299,0.276315789,0.776470588,0.416666667
O.J. Mayo,21,MEM,NBA,2008-09,82,82,3120,562,1283,417,905,145,378,247,281,56,252,308,262,91,13,226,204,1516,0.438035853,0.460773481,0.383597884,0.879003559,0.494544037
Ognjen Kuzmic,23,GSW,NBA,2013-14,21,0,92,5,13,5,13,0,0,5,11,10,11,21,2,3,4,10,17,15,0.384615385,0.384615385,0.0,0.454545455,0.384615385
Okaro White,24,MIA,NBA,2016-17,35,0,471,33,87,21,53,12,34,20,22,25,57,82,21,10,10,18,52,98,0.379310345,0.396226415,0.352941176,0.909090909,0.448275862
Oleksiy Pecherov,22,WAS,NBA,2007-08,35,0,320,44,125,27,65,17,60,20,31,21,45,66,7,6,5,17,30,125,0.352,0.415384615,0.283333333,0.64516129,0.42
Oliver Lafayette,25,BOS,NBA,2009-10,1,0,22,3,6,2,4,1,2,0,0,1,3,4,2,0,0,1,0,7,0.5,0.5,0.5,0.0,0.583333333
Olumide Oyedeji,19,SEA,NBA,2000-01,30,1,221,18,37,18,37,0,0,9,12,24,43,67,2,7,10,11,40,45,0.486486486,0.486486486,0.0,0.75,0.486486486
Omar Cook,22,POR,NBA,2003-04,17,0,139,7,27,7,26,0,1,0,0,3,3,6,24,10,0,10,14,14,0.259259259,0.269230769,0.0,0.0,0.259259259
Omer Asik,24,CHI,NBA,2010-11,82,0,989,78,141,78,141,0,0,73,145,112,194,306,32,20,56,64,153,229,0.553191489,0.553191489,0.0,0.503448276,0.553191489
Omri Casspi,21,SAC,NBA,2009-10,77,31,1931,300,672,225,469,75,203,117,174,75,274,349,95,54,17,98,125,792,0.446428571,0.479744136,0.369458128,0.672413793,0.502232143
Orien Greene,23,BOS,NBA,2005-06,80,5,1235,100,253,91,213,9,40,45,68,37,108,145,129,77,10,109,181,254,0.395256917,0.427230047,0.225,0.661764706,0.413043478
Orlando Johnson,23,IND,NBA,2012-13,51,0,619,72,180,36,86,36,94,23,32,20,90,110,47,11,9,29,51,203,0.4,0.418604651,0.382978723,0.71875,0.5
Oscar Torres,25,HOU,NBA,2001-02,65,13,1075,135,341,98,215,37,126,82,105,47,75,122,40,25,9,49,64,389,0.395894428,0.455813953,0.293650794,0.780952381,0.450146628
Othello Hunter,22,ATL,NBA,2008-09,16,0,92,11,20,11,20,0,0,0,5,9,15,24,1,2,5,2,11,22,0.55,0.55,0.0,0.0,0.55
Othyus Jeffers,24,UTA,NBA,2009-10,14,0,73,12,29,12,29,0,0,13,19,8,11,19,1,4,0,6,10,37,0.413793103,0.413793103,0.0,0.684210526,0.413793103
Otto Porter,20,WAS,NBA,2013-14,37,0,319,33,91,29,70,4,21,8,12,21,36,57,10,8,1,14,26,78,0.362637363,0.414285714,0.19047619,0.666666667,0.384615385
P.J. Hairston,22,CHO,NBA,2014-15,45,2,687,87,269,38,106,49,163,31,36,22,70,92,21,21,13,22,61,254,0.323420074,0.358490566,0.300613497,0.861111111,0.414498141
P.J. Tucker,21,TOR,NBA,2006-07,17,0,83,11,22,11,22,0,0,8,14,11,12,23,3,2,0,6,12,30,0.5,0.5,0.0,0.571428571,0.5
Pablo Prigioni,35,NYK,NBA,2012-13,78,18,1263,100,220,47,86,53,134,22,25,41,102,143,236,69,2,86,127,275,0.454545455,0.546511628,0.395522388,0.88,0.575
Pape Sow,23,TOR,NBA,2004-05,27,4,255,23,58,23,58,0,0,16,27,18,39,57,2,12,4,10,46,62,0.396551724,0.396551724,0.0,0.592592593,0.396551724
Pape Sy,22,ATL,NBA,2010-11,3,0,21,2,6,2,5,0,1,3,3,2,1,3,2,1,0,3,1,7,0.333333333,0.4,0.0,1.0,0.333333333
Pascal Siakam,22,TOR,NBA,2016-17,55,38,859,103,205,102,198,1,7,22,32,64,121,185,17,26,45,33,109,229,0.502439024,0.515151515,0.142857143,0.6875,0.504878049
Pat Burke,29,ORL,NBA,2002-03,62,8,783,113,296,112,289,1,7,40,58,57,89,146,23,19,25,47,99,267,0.381756757,0.387543253,0.142857143,0.689655172,0.383445946
Pat Connaughton,23,POR,NBA,2015-16,34,0,143,13,49,8,28,5,21,5,5,11,21,32,10,2,0,10,6,36,0.265306122,0.285714286,0.238095238,1.0,0.316326531
Patricio Garino,23,ORL,NBA,2016-17,5,0,43,0,7,0,2,0,5,0,0,1,6,7,0,0,0,3,4,0,0.0,0.0,0.0,0.0,0.0
Patrick Beverley,24,HOU,NBA,2012-13,41,0,713,79,189,43,93,36,96,34,41,45,64,109,117,37,21,44,83,228,0.417989418,0.462365591,0.375,0.829268293,0.513227513
Patrick Christopher,26,UTA,NBA,2014-15,4,1,29,3,12,3,8,0,4,0,0,2,4,6,0,1,0,1,6,6,0.25,0.375,0.0,0.0,0.25
Patrick Ewing,26,NOH,NBA,2010-11,7,0,19,0,5,0,3,0,2,3,4,1,1,2,2,0,1,1,1,3,0.0,0.0,0.0,0.75,0.0
Patrick McCaw,21,GSW,NBA,2016-17,71,20,1074,106,245,65,122,41,123,29,37,22,79,101,77,32,15,36,62,282,0.432653061,0.532786885,0.333333333,0.783783784,0.516326531
Patrick O'Bryant,20,GSW,NBA,2006-07,16,0,119,10,32,10,32,0,0,11,17,7,14,21,9,6,8,8,26,31,0.3125,0.3125,0.0,0.647058824,0.3125
Patrick Patterson,21,HOU,NBA,2010-11,52,6,868,149,267,149,265,0,2,30,42,86,114,200,41,17,37,31,77,328,0.558052434,0.562264151,0.0,0.714285714,0.558052434
Patty Mills,21,POR,NBA,2009-10,10,0,38,10,24,8,20,2,4,4,7,1,1,2,5,0,0,4,6,26,0.416666667,0.4,0.5,0.571428571,0.458333333
Pau Gasol,21,MEM,NBA,2001-02,82,79,3007,551,1064,550,1059,1,5,338,477,238,492,730,223,41,169,224,195,1441,0.517857143,0.519357885,0.2,0.708595388,0.518327068
Paul Davis,22,LAC,NBA,2006-07,31,0,180,22,52,22,52,0,0,7,10,21,23,44,7,6,5,8,28,51,0.423076923,0.423076923,0.0,0.7,0.423076923
Paul George,20,IND,NBA,2010-11,61,19,1265,179,395,138,257,41,138,77,101,37,187,224,65,62,26,70,127,476,0.453164557,0.536964981,0.297101449,0.762376238,0.505063291
Paul McPherson,22,TOT,NBA,2000-01,55,0,595,109,216,107,204,2,12,42,58,40,39,79,38,25,4,47,80,262,0.50462963,0.524509804,0.166666667,0.724137931,0.509259259
Paul Millsap,21,UTA,NBA,2006-07,82,1,1472,209,398,208,395,1,3,140,208,183,240,423,62,67,74,94,236,559,0.525125628,0.526582278,0.333333333,0.673076923,0.52638191
Paul Shirley,25,ATL,NBA,2002-03,2,0,5,0,4,0,4,0,0,0,0,0,1,1,0,0,0,0,0,0,0.0,0.0,0.0,0.0,0.0
Paul Zipser,22,CHI,NBA,2016-17,44,18,843,88,221,55,122,33,99,31,40,15,110,125,36,15,16,40,78,240,0.398190045,0.450819672,0.333333333,0.775,0.472850679
Pavel Podkolzin,20,DAL,NBA,2004-05,5,0,10,0,0,0,0,0,0,1,2,0,2,2,0,0,0,2,4,1,0.0,0.0,0.0,0.5,0.0
Pepe Sanchez,23,TOT,NBA,2000-01,29,0,150,9,28,9,27,0,1,2,2,3,12,15,41,11,1,6,21,20,0.321428571,0.333333333,0.0,1.0,0.321428571
Pero Antic,31,ATL,NBA,2013-14,50,26,925,123,294,67,123,56,171,50,66,57,152,209,58,19,12,55,126,352,0.418367347,0.544715447,0.32748538,0.757575758,0.513605442
Perry Jones,21,OKC,NBA,2012-13,38,1,280,39,99,39,97,0,2,10,15,12,50,62,10,5,6,15,23,88,0.393939394,0.402061856,0.0,0.666666667,0.393939394
Peter John Ramos,19,WAS,NBA,2004-05,6,0,20,5,10,5,10,0,0,1,2,1,3,4,0,0,1,3,4,11,0.5,0.5,0.0,0.5,0.5
Peyton Siva,23,DET,NBA,2013-14,24,0,224,18,57,11,32,7,25,11,15,2,12,14,34,9,1,18,27,54,0.315789474,0.34375,0.28,0.733333333,0.377192982
Phil Pressey,22,BOS,NBA,2013-14,75,11,1132,78,253,50,147,28,106,29,45,20,85,105,241,68,5,87,97,213,0.308300395,0.340136054,0.264150943,0.644444444,0.363636364
Pierre Jackson,25,DAL,NBA,2016-17,8,1,84,13,39,10,28,3,11,6,7,1,8,9,19,2,0,3,5,35,0.333333333,0.357142857,0.272727273,0.857142857,0.371794872
Pops Mensah-Bonsu,23,DAL,NBA,2006-07,12,0,71,11,17,11,17,0,0,7,18,9,12,21,0,1,0,9,8,29,0.647058824,0.647058824,0.0,0.388888889,0.647058824
Predrag Drobnjak,26,SEA,NBA,2001-02,64,12,1174,191,414,191,412,0,2,55,73,75,144,219,51,20,31,51,109,437,0.461352657,0.463592233,0.0,0.753424658,0.461352657
Predrag Savovic,26,DEN,NBA,2002-03,27,0,256,29,93,25,67,4,26,21,29,9,16,25,22,14,1,21,33,83,0.311827957,0.373134328,0.153846154,0.724137931,0.333333333
Primoz Brezec,22,IND,NBA,2001-02,22,4,160,14,29,14,29,0,0,15,25,16,12,28,6,0,7,6,28,43,0.482758621,0.482758621,0.0,0.6,0.482758621
Quentin Richardson,20,LAC,NBA,2000-01,76,28,1358,232,525,182,374,50,151,99,158,105,152,257,62,42,7,64,98,613,0.441904762,0.486631016,0.331125828,0.626582278,0.48952381
Quincy Acy,22,TOR,NBA,2012-13,29,0,342,42,75,41,73,1,2,31,38,30,47,77,11,13,15,17,53,116,0.56,0.561643836,0.5,0.815789474,0.566666667
Quincy Douby,22,SAC,NBA,2006-07,42,0,359,48,126,36,76,12,50,11,15,11,26,37,15,15,4,15,21,119,0.380952381,0.473684211,0.24,0.733333333,0.428571429
Quincy Miller,20,DEN,NBA,2012-13,7,0,26,4,12,4,11,0,1,1,2,1,1,2,3,1,0,1,3,9,0.333333333,0.363636364,0.0,0.5,0.333333333
Quincy Pondexter,22,NOH,NBA,2010-11,66,6,734,73,180,55,130,18,50,24,34,23,65,88,28,17,10,16,63,188,0.405555556,0.423076923,0.36,0.705882353,0.455555556
Quinn Cook,23,TOT,NBA,2016-17,14,0,188,33,66,22,40,11,26,2,5,1,6,7,26,4,0,13,13,79,0.5,0.55,0.423076923,0.4,0.583333333
Quinton Ross,23,LAC,NBA,2004-05,78,19,1659,161,373,160,369,1,4,74,110,59,151,210,109,51,22,54,165,397,0.431635389,0.433604336,0.25,0.672727273,0.432975871
Qyntel Woods,21,POR,NBA,2002-03,53,0,334,59,118,56,109,3,9,7,20,15,38,53,12,15,1,23,36,128,0.5,0.513761468,0.333333333,0.35,0.512711864
R.J. Hunter,22,BOS,NBA,2015-16,36,0,315,36,98,17,35,19,63,6,7,2,35,37,13,14,4,11,29,97,0.367346939,0.485714286,0.301587302,0.857142857,0.464285714
Rafael Araujo,24,TOR,NBA,2004-05,59,41,736,76,175,75,172,1,3,43,55,59,126,185,16,21,8,52,157,196,0.434285714,0.436046512,0.333333333,0.781818182,0.437142857
Raja Bell,24,PHI,NBA,2000-01,5,0,30,2,7,1,4,1,3,0,0,0,1,1,0,1,0,2,1,5,0.285714286,0.25,0.333333333,0.0,0.357142857
Rajon Rondo,20,BOS,NBA,2006-07,78,25,1831,188,450,182,421,6,29,119,184,74,218,292,297,128,8,137,181,501,0.417777778,0.432304038,0.206896552,0.64673913,0.424444444
Rakeem Christmas,24,IND,NBA,2015-16,1,0,6,2,2,2,2,0,0,0,0,1,0,1,0,0,0,0,1,4,1.0,1.0,0.0,0.0,1.0
Ramon Sessions,21,MIL,NBA,2007-08,17,7,450,51,117,48,110,3,7,32,41,8,50,58,127,17,3,36,26,137,0.435897436,0.436363636,0.428571429,0.780487805,0.448717949
Randolph Morris,21,NYK,NBA,2006-07,5,0,44,1,6,1,6,0,0,2,6,1,8,9,1,2,1,2,4,4,0.166666667,0.166666667,0.0,0.333333333,0.166666667
Randy Foye,23,MIN,NBA,2006-07,82,12,1879,300,691,232,506,68,185,164,192,49,169,218,232,53,21,152,184,832,0.434153401,0.458498024,0.367567568,0.854166667,0.483357453
Randy Holcomb,26,CHI,NBA,2005-06,4,0,11,1,1,1,1,0,0,0,0,1,0,1,0,0,0,0,2,2,1.0,1.0,0.0,0.0,1.0
Rashad McCants,21,MIN,NBA,2005-06,79,12,1362,241,535,174,355,67,180,78,106,29,114,143,63,44,22,86,176,627,0.45046729,0.490140845,0.372222222,0.735849057,0.513084112
Rashad Vaughn,19,MIL,NBA,2015-16,70,6,1001,81,266,38,119,43,147,12,15,11,77,88,39,29,16,28,73,217,0.304511278,0.319327731,0.292517007,0.8,0.385338346
Rasual Butler,23,MIA,NBA,2002-03,72,28,1514,207,572,157,401,50,171,76,104,29,157,186,93,21,43,77,105,540,0.361888112,0.391521197,0.292397661,0.730769231,0.405594406
Ratko Varda,22,DET,NBA,2001-02,1,0,6,2,3,2,3,0,0,1,1,0,1,1,0,0,0,1,3,5,0.666666667,0.666666667,0.0,1.0,0.666666667
Raul Lopez,23,UTA,NBA,2003-04,82,11,1617,223,517,198,432,25,85,101,117,24,131,155,305,62,2,174,200,572,0.431334623,0.458333333,0.294117647,0.863247863,0.455512573
Raul Neto,23,UTA,NBA,2015-16,81,53,1499,180,418,116,256,64,162,52,70,17,103,120,174,62,2,109,122,476,0.43062201,0.453125,0.395061728,0.742857143,0.507177033
Rawle Marshall,23,DAL,NBA,2005-06,23,9,241,24,60,23,57,1,3,22,29,8,23,31,10,8,7,15,17,71,0.4,0.403508772,0.333333333,0.75862069,0.408333333
Ray McCallum,22,SAC,NBA,2013-14,45,10,897,113,300,91,241,22,59,32,43,18,61,79,120,22,9,39,69,280,0.376666667,0.377593361,0.372881356,0.744186047,0.413333333
Raymond Felton,21,CHA,NBA,2005-06,80,54,2406,345,883,248,612,97,271,161,222,77,188,265,446,102,8,182,181,948,0.390713477,0.405228758,0.357933579,0.725225225,0.445639864
Reece Gaines,23,ORL,NBA,2003-04,38,1,364,25,86,22,76,3,10,16,25,8,31,39,40,11,2,18,22,69,0.290697674,0.289473684,0.3,0.64,0.308139535
Reggie Bullock,22,LAC,NBA,2013-14,43,0,395,43,121,21,48,22,73,7,9,11,43,54,12,9,1,13,26,115,0.355371901,0.4375,0.301369863,0.777777778,0.446280992
Reggie Evans,22,SEA,NBA,2002-03,67,60,1365,66,140,66,140,0,0,80,154,167,278,445,34,38,11,52,173,212,0.471428571,0.471428571,0.0,0.519480519,0.471428571
Reggie Jackson,21,OKC,NBA,2011-12,45,0,501,51,159,38,97,13,62,25,29,14,39,53,71,25,1,36,31,140,0.320754717,0.391752577,0.209677419,0.862068966,0.36163522
Reggie Williams,23,GSW,NBA,2009-10,24,10,782,140,283,107,191,33,92,52,62,18,92,110,66,23,6,29,49,365,0.494699647,0.560209424,0.358695652,0.838709677,0.553003534
Renaldo Balkman,22,NYK,NBA,2006-07,68,1,1064,139,275,134,248,5,27,51,90,97,197,294,44,57,44,49,146,334,0.505454545,0.540322581,0.185185185,0.566666667,0.514545455
Renaldo Major,24,GSW,NBA,2006-07,1,0,27,2,10,2,10,0,0,1,2,0,2,2,0,2,0,1,4,5,0.2,0.2,0.0,0.5,0.2
Richard Jefferson,21,NJN,NBA,2001-02,79,9,1917,270,591,257,535,13,56,189,265,85,208,293,140,64,48,107,211,742,0.456852792,0.480373832,0.232142857,0.713207547,0.4678511
Richaun Holmes,22,PHI,NBA,2015-16,51,1,702,114,222,106,178,8,44,51,74,62,73,135,33,19,40,32,92,287,0.513513514,0.595505618,0.181818182,0.689189189,0.531531532
Richie Frahm,26,SEA,NBA,2003-04,54,0,469,63,139,29,47,34,92,23,26,12,44,56,24,16,4,7,50,183,0.45323741,0.617021277,0.369565217,0.884615385,0.575539568
Ricky Ledo,21,DAL,NBA,2013-14,11,0,33,6,17,3,9,3,8,4,4,0,2,2,2,1,0,2,2,19,0.352941176,0.333333333,0.375,1.0,0.441176471
Ricky Rubio,21,MIN,NBA,2011-12,41,31,1404,139,389,107,295,32,94,126,157,21,150,171,336,91,8,131,97,436,0.357326478,0.362711864,0.340425532,0.802547771,0.398457584
Rob Kurz,23,GSW,NBA,2008-09,40,5,442,51,131,36,93,15,38,40,50,33,48,81,20,14,19,16,78,157,0.389312977,0.387096774,0.394736842,0.8,0.446564885
Robbie Hummel,24,MIN,NBA,2013-14,53,5,655,67,177,35,88,32,89,15,16,35,97,132,23,16,2,10,57,181,0.378531073,0.397727273,0.359550562,0.9375,0.468926554
Robert Archibald,22,MEM,NBA,2002-03,12,0,72,6,20,6,20,0,0,7,18,6,11,17,3,0,3,7,9,19,0.3,0.3,0.0,0.388888889,0.3
Robert Covington,23,HOU,NBA,2013-14,7,0,34,6,14,2,3,4,11,0,0,2,3,5,0,2,0,1,3,16,0.428571429,0.666666667,0.363636364,0.0,0.571428571
Robert Hite,23,MIA,NBA,2006-07,12,0,136,19,60,14,37,5,23,8,12,4,12,16,8,3,2,6,8,51,0.316666667,0.378378378,0.217391304,0.666666667,0.358333333
Robert Sacre,23,LAL,NBA,2012-13,32,3,203,18,48,18,48,0,0,7,11,9,25,34,6,0,10,10,38,43,0.375,0.375,0.0,0.636363636,0.375
Robert Swift,19,SEA,NBA,2004-05,16,0,72,5,11,5,11,0,0,5,9,1,4,5,2,1,7,4,16,15,0.454545455,0.454545455,0.0,0.555555556,0.454545455
Robert Whaley,23,UTA,NBA,2005-06,23,0,212,23,57,23,57,0,0,3,6,16,27,43,17,7,8,14,41,49,0.403508772,0.403508772,0.0,0.5,0.403508772
Robin Lopez,20,PHO,NBA,2008-09,60,7,614,71,137,71,136,0,1,47,68,52,66,118,8,11,41,28,97,189,0.518248175,0.522058824,0.0,0.691176471,0.518248175
Rodney Carney,22,PHI,NBA,2006-07,67,35,1169,182,392,157,320,25,72,53,87,39,89,128,26,38,23,43,118,442,0.464285714,0.490625,0.347222222,0.609195402,0.496173469
Rodney Hood,22,UTA,NBA,2014-15,50,21,1064,155,374,93,204,62,170,61,80,9,108,117,83,30,12,45,119,433,0.414438503,0.455882353,0.364705882,0.7625,0.497326203
Rodney McGruder,25,MIA,NBA,2016-17,78,65,1966,190,460,117,240,73,220,44,71,95,162,257,124,45,18,56,140,497,0.413043478,0.4875,0.331818182,0.61971831,0.492391304
Rodney Stuckey,21,DET,NBA,2007-08,57,2,1081,153,382,150,366,3,16,127,156,32,97,129,160,49,6,78,113,436,0.40052356,0.409836066,0.1875,0.814102564,0.404450262
Rodney White,21,DET,NBA,2001-02,16,0,129,21,60,19,51,2,9,12,14,2,16,18,12,9,2,14,6,56,0.35,0.37254902,0.222222222,0.857142857,0.366666667
Rodrigue Beaubois,21,DAL,NBA,2009-10,56,16,700,155,299,110,189,45,110,42,52,12,66,78,74,29,12,54,84,397,0.518394649,0.582010582,0.409090909,0.807692308,0.593645485
Roger Mason,22,CHI,NBA,2002-03,17,0,113,11,31,5,13,6,18,2,2,2,10,12,12,4,0,5,20,30,0.35483871,0.384615385,0.333333333,1.0,0.451612903
Roger Powell,24,UTA,NBA,2006-07,3,0,13,0,3,0,2,0,1,2,2,3,0,3,0,0,0,3,2,2,0.0,0.0,0.0,1.0,0.0
Roko Ukic,24,TOR,NBA,2008-09,72,0,890,123,324,112,262,11,62,44,60,27,48,75,153,30,2,60,77,301,0.37962963,0.427480916,0.177419355,0.733333333,0.396604938
Ron Baker,23,NYK,NBA,2016-17,52,13,857,82,217,59,131,23,86,28,43,12,86,98,107,34,8,56,74,215,0.377880184,0.450381679,0.26744186,0.651162791,0.430875576
Ronald Dupree,23,CHI,NBA,2003-04,47,8,893,111,282,107,273,4,9,66,105,55,112,167,55,32,18,51,134,292,0.393617021,0.391941392,0.444444444,0.628571429,0.40070922
Ronald Murray,23,TOT,NBA,2002-03,14,0,62,11,31,11,26,0,5,5,8,0,4,4,5,4,0,8,0,27,0.35483871,0.423076923,0.0,0.625,0.35483871
Rondae Hollis-Jefferson,21,BRK,NBA,2015-16,29,17,615,63,138,59,124,4,14,37,52,39,115,154,43,39,16,26,61,167,0.456521739,0.475806452,0.285714286,0.711538462,0.471014493
Ronnie Brewer,21,UTA,NBA,2006-07,56,14,675,102,193,102,184,0,9,56,83,37,38,75,24,37,6,24,44,260,0.528497409,0.554347826,0.0,0.674698795,0.528497409
Ronnie Price,22,SAC,NBA,2005-06,29,0,150,21,58,15,31,6,27,12,12,5,10,15,11,6,0,10,10,60,0.362068966,0.483870968,0.222222222,1.0,0.413793103
Ronny Turiaf,23,LAL,NBA,2005-06,23,1,161,15,30,15,30,0,0,15,27,11,26,37,8,3,10,7,30,45,0.5,0.5,0.0,0.555555556,0.5
Roy Hibbert,22,IND,NBA,2008-09,70,42,1009,198,420,198,420,0,0,98,147,115,128,243,49,20,76,55,215,494,0.471428571,0.471428571,0.0,0.666666667,0.471428571
Royal Ivey,23,ATL,NBA,2004-05,62,5,809,85,198,82,189,3,9,47,67,19,65,84,103,39,7,58,140,220,0.429292929,0.433862434,0.333333333,0.701492537,0.436868687
Royce White,22,SAC,NBA,2013-14,3,0,9,0,1,0,1,0,0,0,0,0,0,0,0,0,0,0,2,0,0.0,0.0,0.0,0.0,0.0
Ruben Boumtje-Boumtje,23,POR,NBA,2001-02,33,1,245,13,32,13,32,0,0,13,25,21,34,55,4,3,16,14,38,39,0.40625,0.40625,0.0,0.52,0.40625
Ruben Garces,27,TOT,NBA,2000-01,13,0,73,7,22,7,22,0,0,2,8,16,13,29,5,3,2,5,14,16,0.318181818,0.318181818,0.0,0.25,0.318181818
Ruben Wolkowyski,27,SEA,NBA,2000-01,34,1,305,25,79,25,77,0,2,25,34,12,34,46,3,6,18,12,38,75,0.316455696,0.324675325,0.0,0.735294118,0.316455696
Rudy Fernandez,23,POR,NBA,2008-09,78,4,1993,268,630,109,232,159,398,120,143,47,160,207,159,69,12,86,111,815,0.425396825,0.469827586,0.399497487,0.839160839,0.551587302
Rudy Gay,20,MEM,NBA,2006-07,78,43,2103,321,760,269,617,52,143,152,209,93,255,348,100,71,74,140,192,846,0.422368421,0.435980551,0.363636364,0.727272727,0.456578947
Rudy Gobert,21,UTA,NBA,2013-14,45,0,434,36,74,36,74,0,0,32,65,51,104,155,7,8,41,32,57,104,0.486486486,0.486486486,0.0,0.492307692,0.486486486
Russ Smith,23,TOT,NBA,2014-15,12,0,65,8,25,6,14,2,11,12,13,1,5,6,8,3,0,12,13,30,0.32,0.428571429,0.181818182,0.923076923,0.36
Russell Westbrook,20,OKC,NBA,2008-09,82,65,2668,436,1095,401,966,35,129,349,428,178,221,399,435,110,16,274,191,1256,0.398173516,0.415113872,0.271317829,0.815420561,0.414155251
Ryan Anderson,20,NJN,NBA,2008-09,66,30,1312,160,407,91,218,69,189,98,116,104,207,311,52,44,20,63,157,487,0.393120393,0.417431193,0.365079365,0.844827586,0.477886978
Ryan Gomes,23,BOS,NBA,2005-06,61,33,1376,173,355,170,346,3,9,112,149,102,196,298,58,35,5,55,83,461,0.487323944,0.49132948,0.333333333,0.751677852,0.491549296
Ryan Hollins,22,CHA,NBA,2006-07,27,0,185,20,36,20,36,0,0,24,40,11,20,31,1,4,7,16,40,64,0.555555556,0.555555556,0.0,0.6,0.555555556
Ryan Humphrey,23,TOT,NBA,2002-03,48,1,444,35,120,35,120,0,0,23,39,34,65,99,11,9,18,23,75,93,0.291666667,0.291666667,0.0,0.58974359,0.291666667
Ryan Kelly,22,LAL,NBA,2013-14,59,25,1312,157,371,109,229,48,142,110,135,42,177,219,95,32,45,47,147,472,0.423180593,0.475982533,0.338028169,0.814814815,0.48787062
Ryan Reid,25,OKC,NBA,2011-12,5,0,17,4,5,4,5,0,0,0,0,1,1,2,0,0,0,1,1,8,0.8,0.8,0.0,0.0,0.8
Salah Mejri,29,DAL,NBA,2015-16,34,6,397,49,78,49,77,0,1,27,46,41,82,123,10,8,36,23,54,125,0.628205128,0.636363636,0.0,0.586956522,0.628205128
Salim Stoudamire,23,ATL,NBA,2005-06,61,1,1236,204,492,122,276,82,216,99,110,12,104,116,75,27,3,82,118,589,0.414634146,0.442028986,0.37962963,0.9,0.49796748
Sam Dekker,21,HOU,NBA,2015-16,3,0,6,0,0,0,0,0,0,0,0,0,1,1,0,1,0,0,0,0,0.0,0.0,0.0,0.0,0.0
Sam Young,24,MEM,NBA,2009-10,80,1,1321,224,497,213,441,11,56,136,175,77,124,201,52,34,20,94,106,595,0.450704225,0.482993197,0.196428571,0.777142857,0.461770624
Samardo Samuels,22,CLE,NBA,2010-11,37,10,701,110,241,110,238,0,3,68,110,75,83,158,17,15,18,53,88,288,0.456431535,0.462184874,0.0,0.618181818,0.456431535
Samuel Dalembert,20,PHI,NBA,2001-02,34,0,177,22,50,22,50,0,0,7,18,25,43,68,5,6,13,14,30,51,0.44,0.44,0.0,0.388888889,0.44
Sarunas Jasikevicius,29,IND,NBA,2005-06,75,15,1557,170,429,84,193,86,236,121,133,19,134,153,227,40,4,116,108,547,0.396270396,0.435233161,0.36440678,0.909774436,0.496503497
Sasha Kaun,30,CLE,NBA,2015-16,25,0,95,9,17,9,17,0,0,5,11,12,14,26,3,4,5,7,11,23,0.529411765,0.529411765,0.0,0.454545455,0.529411765
Sasha Pavlovic,20,UTA,NBA,2003-04,79,14,1144,149,376,130,306,19,70,65,84,44,115,159,60,41,16,67,187,382,0.396276596,0.424836601,0.271428571,0.773809524,0.421542553
Sasha Vujacic,20,LAL,NBA,2004-05,35,3,403,33,117,16,54,17,63,18,19,13,49,62,51,12,2,15,41,101,0.282051282,0.296296296,0.26984127,0.947368421,0.354700855
Scott Machado,22,HOU,NBA,2012-13,6,0,21,3,6,3,5,0,1,2,2,0,1,1,6,2,0,8,0,8,0.5,0.6,0.0,1.0,0.5
Scotty Hopson,24,CLE,NBA,2013-14,2,0,7,0,4,0,2,0,2,1,2,0,0,0,1,1,0,0,0,1,0.0,0.0,0.0,0.5,0.0
Sean Colson,25,TOT,NBA,2000-01,13,0,44,6,24,5,19,1,5,2,4,2,4,6,10,1,0,2,6,15,0.25,0.263157895,0.2,0.5,0.270833333
Sean Kilpatrick,25,MIN,NBA,2014-15,4,0,72,7,20,3,7,4,13,4,4,1,5,6,4,3,0,2,3,22,0.35,0.428571429,0.307692308,1.0,0.45
Sean Lampley,23,MIA,NBA,2002-03,35,0,487,56,129,56,125,0,4,57,82,26,57,83,31,7,3,25,43,169,0.434108527,0.448,0.0,0.695121951,0.434108527
Sean May,21,CHA,NBA,2005-06,23,1,398,70,171,70,166,0,5,49,64,42,67,109,22,17,12,33,58,189,0.409356725,0.421686747,0.0,0.765625,0.409356725
Sean Singletary,23,TOT,NBA,2008-09,37,2,303,31,85,21,60,10,25,18,21,10,25,35,29,11,0,23,45,90,0.364705882,0.35,0.4,0.857142857,0.423529412
Sean Williams,21,NJN,NBA,2007-08,73,29,1278,164,305,164,305,0,0,81,133,115,207,322,28,28,106,70,193,409,0.537704918,0.537704918,0.0,0.609022556,0.537704918
Sebastian Telfair,19,POR,NBA,2004-05,68,26,1330,169,430,152,361,17,69,105,133,10,94,104,224,35,4,125,120,460,0.393023256,0.421052632,0.246376812,0.789473684,0.412790698
Semaj Christon,24,OKC,NBA,2016-17,64,1,973,77,223,65,160,12,63,17,31,19,69,88,130,28,6,43,79,183,0.34529148,0.40625,0.19047619,0.548387097,0.372197309
Semih Erden,24,TOT,NBA,2010-11,41,8,595,62,111,62,111,0,0,39,60,37,81,118,20,15,24,34,104,163,0.558558559,0.558558559,0.0,0.65,0.558558559
Serge Ibaka,20,OKC,NBA,2009-10,73,0,1323,201,370,200,368,1,2,58,92,138,259,397,10,25,97,68,194,461,0.543243243,0.543478261,0.5,0.630434783,0.544594595
Sergei Monia,22,TOT,NBA,2005-06,26,15,343,29,87,20,53,9,34,10,14,11,41,52,19,7,5,12,41,77,0.333333333,0.377358491,0.264705882,0.714285714,0.385057471
Sergey Karasev,20,CLE,NBA,2013-14,22,1,156,12,35,8,16,4,19,9,10,0,16,16,6,3,1,11,22,37,0.342857143,0.5,0.210526316,0.9,0.4
Sergio Rodriguez,20,POR,NBA,2006-07,67,1,862,101,239,77,154,24,85,21,26,20,71,91,218,35,2,77,72,247,0.422594142,0.5,0.282352941,0.807692308,0.472803347
Seth Curry,23,TOT,NBA,2013-14,2,0,13,1,3,0,2,1,1,0,0,0,1,1,0,2,0,0,0,3,0.333333333,0.0,1.0,0.0,0.5
Shabazz Muhammad,21,MIN,NBA,2013-14,37,0,290,57,124,54,113,3,11,26,40,24,29,53,6,8,1,16,24,143,0.459677419,0.477876106,0.272727273,0.65,0.471774194
Shabazz Napier,23,MIA,NBA,2014-15,51,10,1012,87,228,44,110,43,118,44,56,17,96,113,130,40,4,81,76,261,0.381578947,0.4,0.36440678,0.785714286,0.475877193
Shane Battier,23,MEM,NBA,2001-02,78,78,3097,412,961,309,685,103,276,198,283,180,238,418,216,121,81,155,215,1125,0.428720083,0.451094891,0.373188406,0.699646643,0.482310094
Shane Edwards,26,CLE,NBA,2013-14,2,0,12,1,3,1,3,0,0,0,0,1,1,2,0,0,0,1,1,2,0.333333333,0.333333333,0.0,0.0,0.333333333
Shane Larkin,21,DAL,NBA,2013-14,48,0,489,52,137,40,99,12,38,16,25,11,31,42,71,26,1,39,46,132,0.379562044,0.404040404,0.315789474,0.64,0.423357664
Shannon Brown,21,CLE,NBA,2006-07,23,5,202,28,74,21,49,7,25,10,14,6,15,21,10,7,3,14,24,73,0.378378378,0.428571429,0.28,0.714285714,0.425675676
Sharrod Ford,24,PHO,NBA,2005-06,3,0,13,2,3,2,3,0,0,0,0,1,2,3,0,0,1,2,7,4,0.666666667,0.666666667,0.0,0.0,0.666666667
Shaun Livingston,19,LAC,NBA,2004-05,30,15,814,89,215,89,213,0,2,44,59,22,67,89,151,32,11,75,82,222,0.413953488,0.417840376,0.0,0.745762712,0.413953488
Shavlik Randolph,22,PHI,NBA,2005-06,57,1,487,44,97,44,97,0,0,43,71,55,78,133,19,19,12,21,83,131,0.453608247,0.453608247,0.0,0.605633803,0.453608247
Shawn Long,24,PHI,NBA,2016-17,18,0,234,61,109,54,90,7,19,19,35,41,44,85,13,9,9,13,49,148,0.559633028,0.6,0.368421053,0.542857143,0.591743119
Shawne Williams,20,IND,NBA,2006-07,46,3,556,75,160,56,108,19,52,11,20,33,50,83,22,6,8,24,69,180,0.46875,0.518518519,0.365384615,0.55,0.528125
Shayne Whittington,23,IND,NBA,2014-15,20,0,108,19,42,18,36,1,6,18,23,10,19,29,6,5,2,5,18,57,0.452380952,0.5,0.166666667,0.782608696,0.464285714
Shelden Williams,23,ATL,NBA,2006-07,81,31,1514,166,365,164,361,2,4,110,144,131,304,435,44,52,39,96,199,444,0.454794521,0.454293629,0.5,0.763888889,0.457534247
Sheldon McClellan,24,WAS,NBA,2016-17,30,3,287,30,75,23,45,7,30,23,27,4,30,34,15,8,2,5,17,90,0.4,0.511111111,0.233333333,0.851851852,0.446666667
Shelvin Mack,21,WAS,NBA,2011-12,64,0,779,88,220,76,178,12,42,42,59,12,80,92,131,28,2,48,50,230,0.4,0.426966292,0.285714286,0.711864407,0.427272727
Sherron Collins,23,CHA,NBA,2010-11,20,0,66,7,25,5,15,2,10,1,1,0,5,5,8,2,0,4,2,17,0.28,0.333333333,0.2,1.0,0.32
Sim Bhullar,22,SAC,NBA,2014-15,3,0,3,1,2,1,2,0,0,0,0,0,1,1,1,0,1,0,0,2,0.5,0.5,0.0,0.0,0.5
Skal Labissiere,20,SAC,NBA,2016-17,33,12,612,117,218,114,210,3,8,52,74,51,111,162,27,16,13,37,64,289,0.536697248,0.542857143,0.375,0.702702703,0.543577982
Slavko Vranes,21,POR,NBA,2003-04,1,0,3,0,1,0,1,0,0,0,0,0,0,0,0,0,0,0,1,0,0.0,0.0,0.0,0.0,0.0
Smush Parker,21,CLE,NBA,2002-03,66,18,1103,136,338,98,220,38,118,98,118,29,90,119,162,48,12,133,106,408,0.402366864,0.445454545,0.322033898,0.830508475,0.458579882
Solomon Alabi,22,TOR,NBA,2010-11,12,0,59,3,15,3,15,0,0,0,2,7,7,14,2,2,2,3,5,6,0.2,0.2,0.0,0.0,0.2
Solomon Hill,22,IND,NBA,2013-14,28,0,226,17,40,10,17,7,23,6,7,9,32,41,12,5,2,13,19,47,0.425,0.588235294,0.304347826,0.857142857,0.5125
Solomon Jones,22,ATL,NBA,2006-07,58,8,666,65,128,65,127,0,1,59,75,49,87,136,11,11,42,25,124,189,0.5078125,0.511811024,0.0,0.786666667,0.5078125
Sonny Weems,22,DEN,NBA,2008-09,12,0,55,8,25,8,22,0,3,3,8,0,4,4,3,1,0,6,8,19,0.32,0.363636364,0.0,0.375,0.32
Soumaila Samake,22,NJN,NBA,2000-01,34,0,226,18,48,18,48,0,0,10,24,22,31,53,1,2,14,4,23,46,0.375,0.375,0.0,0.416666667,0.375
Speedy Claxton,23,PHI,NBA,2001-02,67,18,1528,181,452,177,419,4,33,114,136,46,114,160,198,95,6,95,145,480,0.400442478,0.422434368,0.121212121,0.838235294,0.404867257
Spencer Dinwiddie,21,DET,NBA,2014-15,34,1,455,51,169,39,104,12,65,31,34,4,44,48,104,19,6,33,53,145,0.301775148,0.375,0.184615385,0.911764706,0.337278107
Spencer Hawes,19,SAC,NBA,2007-08,71,8,931,146,318,142,297,4,21,38,58,68,162,230,44,14,40,56,128,334,0.459119497,0.478114478,0.19047619,0.655172414,0.465408805
Stanislav Medvedenko,21,LAL,NBA,2000-01,7,0,39,12,25,11,24,1,1,7,12,1,8,9,2,1,1,3,9,32,0.48,0.458333333,1.0,0.583333333,0.5
Stanley Johnson,19,DET,NBA,2015-16,73,6,1687,225,600,162,395,63,205,80,102,58,248,306,118,55,12,114,178,593,0.375,0.410126582,0.307317073,0.784313725,0.4275
Stephane Lasme,25,TOT,NBA,2007-08,16,4,303,32,71,32,71,0,0,19,32,26,27,53,3,13,22,15,35,83,0.450704225,0.450704225,0.0,0.59375,0.450704225
Stephen Curry,21,GSW,NBA,2009-10,80,77,2896,528,1143,362,763,166,380,177,200,48,308,356,472,152,19,243,252,1399,0.461942257,0.474442988,0.436842105,0.885,0.53455818
Stephen Graham,23,TOT,NBA,2005-06,22,0,175,21,54,19,44,2,10,14,15,5,22,27,7,5,2,13,31,58,0.388888889,0.431818182,0.2,0.933333333,0.407407407
Stephen Jackson,22,NJN,NBA,2000-01,77,40,1660,243,572,191,417,52,155,97,135,41,167,208,140,86,14,130,166,635,0.424825175,0.458033573,0.335483871,0.718518519,0.47027972
Stephen Zimmerman,20,ORL,NBA,2016-17,19,0,108,10,31,10,31,0,0,3,5,11,24,35,4,2,5,3,17,23,0.322580645,0.322580645,0.0,0.6,0.322580645
Steve Blake,23,WAS,NBA,2003-04,75,14,1392,157,407,82,205,75,202,55,67,18,99,117,209,57,7,128,100,444,0.385749386,0.4,0.371287129,0.820895522,0.477886978
Steve Goodrich,24,CHI,NBA,2000-01,12,0,133,7,18,6,15,1,3,4,7,7,14,21,6,2,1,8,14,19,0.388888889,0.4,0.333333333,0.571428571,0.416666667
Steve Novak,23,HOU,NBA,2006-07,35,1,191,18,50,5,11,13,39,2,2,4,22,26,6,5,0,4,21,51,0.36,0.454545455,0.333333333,1.0,0.49
Steven Adams,20,OKC,NBA,2013-14,81,20,1197,93,185,93,185,0,0,79,136,142,190,332,43,40,57,71,203,265,0.502702703,0.502702703,0.0,0.580882353,0.502702703
Steven Hill,23,OKC,NBA,2008-09,1,0,2,1,1,1,1,0,0,0,0,2,1,3,0,0,0,0,0,2,1.0,1.0,0.0,0.0,1.0
Steven Hunter,20,ORL,NBA,2001-02,53,21,516,67,147,67,147,0,0,55,94,40,57,97,5,5,43,16,81,189,0.455782313,0.455782313,0.0,0.585106383,0.455782313
Steven Smith,23,PHI,NBA,2006-07,8,0,28,2,8,2,8,0,0,1,2,1,5,6,0,1,0,2,4,5,0.25,0.25,0.0,0.5,0.25
Stromile Swift,21,VAN,NBA,2000-01,80,6,1312,153,339,153,335,0,4,85,141,109,175,284,28,62,82,64,160,391,0.451327434,0.456716418,0.0,0.602836879,0.451327434
Sun Yue,23,LAL,NBA,2008-09,10,0,28,3,11,3,5,0,6,0,0,0,0,0,2,1,1,3,10,6,0.272727273,0.6,0.0,0.0,0.272727273
Sundiata Gaines,23,UTA,NBA,2009-10,32,0,217,38,82,31,56,7,26,23,46,6,23,29,39,12,0,14,17,106,0.463414634,0.553571429,0.269230769,0.5,0.506097561
T.J. Ford,20,MIL,NBA,2003-04,55,55,1472,153,398,148,377,5,21,80,98,37,140,177,356,60,3,139,123,391,0.384422111,0.392572944,0.238095238,0.816326531,0.390703518
T.J. McConnell,23,PHI,NBA,2015-16,81,17,1606,218,464,187,375,31,89,26,41,43,207,250,367,95,10,140,114,493,0.469827586,0.498666667,0.348314607,0.634146341,0.503232759
T.J. Warren,21,PHO,NBA,2014-15,40,1,614,113,214,108,193,5,21,14,19,41,44,85,25,18,9,27,51,245,0.528037383,0.559585492,0.238095238,0.736842105,0.539719626
Taj Gibson,24,CHI,NBA,2009-10,82,70,2204,311,629,311,629,0,0,113,175,226,385,611,70,50,104,114,282,735,0.494435612,0.494435612,0.0,0.645714286,0.494435612
Tamar Slay,22,NJN,NBA,2002-03,36,0,274,39,103,32,78,7,25,7,10,8,23,31,14,14,3,20,31,92,0.378640777,0.41025641,0.28,0.7,0.412621359
Tang Hamilton,23,MIA,NBA,2001-02,9,2,98,10,19,10,18,0,1,0,1,6,12,18,5,4,0,2,10,20,0.526315789,0.555555556,0.0,0.0,0.526315789
Tarence Kinsey,22,MEM,NBA,2006-07,48,12,967,139,304,126,258,13,46,78,98,29,68,97,41,53,1,46,57,369,0.457236842,0.488372093,0.282608696,0.795918367,0.478618421
Tarik Black,23,TOT,NBA,2014-15,63,39,1196,157,273,157,272,0,1,65,118,142,226,368,42,19,24,48,158,379,0.575091575,0.577205882,0.0,0.550847458,0.575091575
Taurean Green,21,TOT,NBA,2007-08,17,0,74,7,25,5,14,2,11,11,12,0,10,10,11,2,0,9,5,27,0.28,0.357142857,0.181818182,0.916666667,0.32
Taurean Waller-Prince,22,ATL,NBA,2016-17,59,10,981,114,285,81,183,33,102,74,94,25,132,157,55,43,27,61,96,335,0.4,0.442622951,0.323529412,0.787234043,0.457894737
Taylor Griffin,23,PHO,NBA,2009-10,8,0,32,4,10,4,8,0,2,2,4,0,2,2,1,0,2,1,4,10,0.4,0.5,0.0,0.5,0.4
Tayshaun Prince,22,DET,NBA,2002-03,42,5,435,53,118,33,71,20,47,11,17,5,40,45,24,10,14,21,25,137,0.449152542,0.464788732,0.425531915,0.647058824,0.533898305
Terence Morris,23,HOU,NBA,2001-02,68,12,1110,111,289,96,211,15,78,18,28,77,134,211,64,21,27,45,72,255,0.384083045,0.454976303,0.192307692,0.642857143,0.410034602
Terrance Roberson,24,CHH,NBA,2000-01,3,0,13,0,2,0,1,0,1,0,0,0,1,1,1,0,0,2,3,0,0.0,0.0,0.0,0.0,0.0
Terrel Harris,24,MIA,NBA,2011-12,22,1,318,29,83,21,44,8,39,14,21,18,33,51,26,9,2,25,34,80,0.34939759,0.477272727,0.205128205,0.666666667,0.397590361
Terrence Jones,21,HOU,NBA,2012-13,19,0,276,43,94,38,75,5,19,13,17,28,37,65,15,12,19,13,21,104,0.457446809,0.506666667,0.263157895,0.764705882,0.484042553
Terrence Ross,21,TOR,NBA,2012-13,73,2,1239,186,457,121,261,65,196,30,42,35,109,144,53,43,14,48,122,467,0.407002188,0.463601533,0.331632653,0.714285714,0.478118162
Terrence Williams,22,NJN,NBA,2009-10,78,9,1764,261,651,230,551,31,100,103,144,46,302,348,223,43,10,124,126,656,0.400921659,0.417422868,0.31,0.715277778,0.424731183
Terry Rozier,21,BOS,NBA,2015-16,39,0,311,29,106,23,79,6,27,8,10,24,39,63,37,6,1,19,23,72,0.273584906,0.291139241,0.222222222,0.8,0.301886792
Thabo Sefolosha,22,CHI,NBA,2006-07,71,4,868,109,256,94,214,15,42,23,45,35,118,153,60,33,11,60,100,256,0.42578125,0.439252336,0.357142857,0.511111111,0.455078125
Thaddeus Young,19,PHI,NBA,2007-08,74,22,1554,264,490,258,471,6,19,76,103,120,192,312,58,73,8,64,126,610,0.53877551,0.547770701,0.315789474,0.737864078,0.544897959
Thanasis Antetokounmpo,23,NYK,NBA,2015-16,2,0,6,3,4,3,3,0,1,0,0,0,1,1,0,0,0,0,2,6,0.75,1.0,0.0,0.0,0.75
Theron Smith,23,MEM,NBA,2003-04,20,0,178,16,43,10,31,6,12,6,8,13,28,41,7,5,5,14,18,44,0.372093023,0.322580645,0.5,0.75,0.441860465
Thomas Gardner,22,CHI,NBA,2007-08,4,0,45,9,23,6,11,3,12,0,2,3,1,4,1,0,0,4,4,21,0.391304348,0.545454545,0.25,0.0,0.456521739
Thomas Robinson,21,TOT,NBA,2012-13,70,0,1056,138,321,138,320,0,1,57,109,122,193,315,46,41,26,88,124,333,0.429906542,0.43125,0.0,0.52293578,0.429906542
Thon Maker,19,MIL,NBA,2016-17,57,34,562,83,181,55,107,28,74,32,49,40,74,114,23,10,26,17,84,226,0.458563536,0.514018692,0.378378378,0.653061224,0.535911602
Tiago Splitter,26,SAS,NBA,2010-11,60,6,738,101,191,101,190,0,1,76,140,72,129,201,26,29,17,32,91,278,0.528795812,0.531578947,0.0,0.542857143,0.528795812
Tibor Pleiss,26,UTA,NBA,2015-16,12,0,82,11,25,11,23,0,2,2,2,6,9,15,2,1,2,8,19,24,0.44,0.47826087,0.0,1.0,0.44
Tierre Brown,22,HOU,NBA,2001-02,40,1,403,49,115,45,103,4,12,21,28,12,30,42,70,19,3,40,26,123,0.426086957,0.436893204,0.333333333,0.75,0.443478261
Tim Frazier,24,TOT,NBA,2014-15,11,3,239,21,61,16,44,5,17,10,21,6,22,28,60,8,0,25,26,57,0.344262295,0.363636364,0.294117647,0.476190476,0.385245902
Tim Hardaway,21,NYK,NBA,2013-14,81,1,1875,294,687,164,329,130,358,106,128,19,102,121,66,44,7,47,144,824,0.427947598,0.498480243,0.363128492,0.828125,0.522561863
Tim Ohlbrecht,24,HOU,NBA,2012-13,3,0,12,1,3,1,3,0,0,1,1,0,1,1,1,1,0,4,1,3,0.333333333,0.333333333,0.0,1.0,0.333333333
Tim Quarterman,22,POR,NBA,2016-17,16,0,80,13,29,8,16,5,13,0,3,4,10,14,11,2,3,11,6,31,0.448275862,0.5,0.384615385,0.0,0.534482759
Timofey Mozgov,24,TOT,NBA,2010-11,45,14,524,63,133,63,133,0,0,37,52,46,75,121,15,15,25,35,84,163,0.473684211,0.473684211,0.0,0.711538462,0.473684211
Timothe Luwawu-Cabarrot,21,PHI,NBA,2016-17,69,19,1190,145,361,95,200,50,161,105,123,25,124,149,75,32,10,73,154,445,0.40166205,0.475,0.310559006,0.853658537,0.470914127
Tito Maddox,21,HOU,NBA,2002-03,9,0,35,3,12,3,9,0,3,5,8,1,6,7,5,3,1,3,4,11,0.25,0.333333333,0.0,0.625,0.25
Tobias Harris,19,MIL,NBA,2011-12,42,9,479,79,169,73,146,6,23,44,54,30,71,101,22,13,7,31,45,208,0.467455621,0.5,0.260869565,0.814814815,0.485207101
Tomas Satoransky,25,WAS,NBA,2016-17,57,3,719,61,146,52,109,9,37,23,33,25,58,83,92,26,6,38,60,154,0.417808219,0.47706422,0.243243243,0.696969697,0.448630137
Toney Douglas,23,NYK,NBA,2009-10,56,12,1087,179,391,111,216,68,175,55,68,40,68,108,112,42,3,55,116,481,0.457800512,0.513888889,0.388571429,0.808823529,0.544757033
Tony Allen,23,BOS,NBA,2004-05,77,34,1262,184,387,172,356,12,31,112,152,85,136,221,64,76,24,77,156,492,0.475452196,0.483146067,0.387096774,0.736842105,0.490956072
Tony Bobbitt,25,LAL,NBA,2004-05,2,0,12,2,5,1,3,1,2,0,0,0,3,3,0,0,0,0,1,5,0.4,0.333333333,0.5,0.0,0.5
Tony Mitchell,24,MIL,NBA,2013-14,3,0,10,3,5,3,4,0,1,0,0,1,0,1,1,1,0,0,0,6,0.6,0.75,0.0,0.0,0.6
Tony Mitchell Jr.,21,DET,NBA,2013-14,21,0,79,5,12,4,11,1,1,11,19,15,11,26,2,6,3,4,9,22,0.416666667,0.363636364,1.0,0.578947368,0.458333333
Tony Parker,19,SAS,NBA,2001-02,77,72,2267,268,639,207,450,61,189,108,160,33,164,197,334,89,7,151,166,705,0.419405321,0.46,0.322751323,0.675,0.46713615
Tony Snell,22,CHI,NBA,2013-14,77,12,1231,129,336,72,158,57,178,31,41,19,105,124,68,29,15,44,84,346,0.383928571,0.455696203,0.320224719,0.756097561,0.46875
Tony Wroten,19,MEM,NBA,2012-13,35,0,272,33,86,29,70,4,16,21,29,13,15,28,43,8,4,29,34,91,0.38372093,0.414285714,0.25,0.724137931,0.406976744
Tornike Shengelia,21,BRK,NBA,2012-13,19,0,93,10,23,9,21,1,2,9,16,9,14,23,3,3,1,11,11,30,0.434782609,0.428571429,0.5,0.5625,0.456521739
Torraye Braggs,27,TOT,NBA,2003-04,15,0,154,16,33,16,33,0,0,8,12,18,21,39,7,4,2,13,29,40,0.484848485,0.484848485,0.0,0.666666667,0.484848485
Toure' Murry,24,NYK,NBA,2013-14,51,0,373,56,129,51,117,5,12,23,39,13,31,44,49,19,1,34,46,140,0.434108527,0.435897436,0.416666667,0.58974359,0.453488372
Travis Diener,23,ORL,NBA,2005-06,23,0,246,29,69,4,12,25,57,5,6,4,17,21,16,7,0,10,22,88,0.420289855,0.333333333,0.438596491,0.833333333,0.601449275
Travis Hansen,25,ATL,NBA,2003-04,41,4,507,46,130,37,100,9,30,22,27,30,40,70,19,10,9,15,67,123,0.353846154,0.37,0.3,0.814814815,0.388461538
Travis Leslie,21,LAC,NBA,2011-12,10,0,45,5,14,5,14,0,0,4,9,6,3,9,5,2,2,2,4,14,0.357142857,0.357142857,0.0,0.444444444,0.357142857
Travis Outlaw,19,POR,NBA,2003-04,8,0,19,3,7,3,7,0,0,2,4,2,2,4,1,1,0,1,1,8,0.428571429,0.428571429,0.0,0.5,0.428571429
Travis Wear,24,NYK,NBA,2014-15,51,1,672,84,209,73,179,11,30,20,26,31,75,106,40,15,11,35,55,199,0.401913876,0.407821229,0.366666667,0.769230769,0.428229665
Tremaine Fowlkes,25,LAC,NBA,2001-02,22,17,343,25,64,25,64,0,0,24,31,32,32,64,17,11,1,13,39,74,0.390625,0.390625,0.0,0.774193548,0.390625
Trenton Hassell,22,CHI,NBA,2001-02,78,47,2237,267,628,207,463,60,165,87,114,65,190,255,172,55,44,101,184,681,0.425159236,0.447084233,0.363636364,0.763157895,0.472929936
Treveon Graham,23,CHO,NBA,2016-17,27,1,189,19,40,10,25,9,15,10,15,5,17,22,6,6,1,3,18,57,0.475,0.4,0.6,0.666666667,0.5875
Trevor Ariza,19,NYK,NBA,2004-05,80,12,1382,172,389,169,376,3,13,121,174,89,153,242,85,70,18,73,150,468,0.442159383,0.449468085,0.230769231,0.695402299,0.446015424
Trevor Booker,23,WAS,NBA,2010-11,65,14,1063,139,253,139,252,0,1,68,101,98,153,251,35,29,42,38,115,346,0.549407115,0.551587302,0.0,0.673267327,0.549407115
Trey Burke,21,UTA,NBA,2013-14,70,68,2262,341,897,230,561,111,336,102,113,37,171,208,396,42,6,131,145,895,0.380156076,0.409982175,0.330357143,0.902654867,0.442028986
Trey Gilder,25,MEM,NBA,2009-10,2,0,5,1,1,1,1,0,0,0,0,0,1,1,0,1,0,0,0,2,1.0,1.0,0.0,0.0,1.0
Trey Johnson,24,CLE,NBA,2008-09,4,0,14,0,5,0,5,0,0,4,4,0,1,1,0,0,0,1,4,4,0.0,0.0,0.0,1.0,0.0
Trey Lyles,20,UTA,NBA,2015-16,80,33,1382,191,436,142,308,49,128,57,82,59,240,299,59,26,18,65,114,488,0.438073394,0.461038961,0.3828125,0.695121951,0.494266055
Trey Thompkins,21,LAC,NBA,2011-12,24,0,119,24,61,20,48,4,13,5,7,4,20,24,3,3,3,6,10,57,0.393442623,0.416666667,0.307692308,0.714285714,0.426229508
Tristan Thompson,20,CLE,NBA,2011-12,60,25,1424,194,442,194,440,0,2,106,192,187,202,389,27,27,62,81,134,494,0.438914027,0.440909091,0.0,0.552083333,0.438914027
Troy Bell,23,MEM,NBA,2003-04,6,0,34,4,18,4,14,0,4,3,3,3,1,4,4,1,0,6,6,11,0.222222222,0.285714286,0.0,1.0,0.222222222
Troy Daniels,22,HOU,NBA,2013-14,5,1,75,15,31,3,6,12,25,0,0,0,4,4,5,0,0,3,6,42,0.483870968,0.5,0.48,0.0,0.677419355
Troy Murphy,21,GSW,NBA,2001-02,82,4,1448,178,423,175,414,3,9,121,156,99,223,322,70,36,21,84,217,480,0.420803783,0.422705314,0.333333333,0.775641026,0.424349882
Troy Williams,22,TOT,NBA,2016-17,30,16,557,73,167,55,105,18,62,21,32,15,54,69,25,27,10,33,60,185,0.437125749,0.523809524,0.290322581,0.65625,0.491017964
Ty Lawson,22,DEN,NBA,2009-10,65,8,1318,201,390,167,307,34,83,106,140,42,82,124,203,48,2,82,89,542,0.515384615,0.543973941,0.409638554,0.757142857,0.558974359
Tyler Ennis,20,TOT,NBA,2014-15,33,1,411,52,144,40,101,12,43,5,7,7,28,35,73,18,5,42,36,121,0.361111111,0.396039604,0.279069767,0.714285714,0.402777778
Tyler Hansbrough,24,IND,NBA,2009-10,29,1,511,81,225,81,221,0,4,84,113,60,78,138,28,17,8,21,70,246,0.36,0.366515837,0.0,0.743362832,0.36
Tyler Honeycutt,21,SAC,NBA,2011-12,15,0,88,8,24,7,21,1,3,3,5,3,11,14,7,4,3,2,3,20,0.333333333,0.333333333,0.333333333,0.6,0.354166667
Tyler Johnson,22,MIA,NBA,2014-15,32,2,603,70,167,52,119,18,48,32,47,14,67,81,42,33,9,30,42,190,0.419161677,0.43697479,0.375,0.680851064,0.473053892
Tyler Ulis,21,PHO,NBA,2016-17,61,15,1123,184,437,163,358,21,79,55,71,20,75,95,226,48,5,77,73,444,0.421052632,0.455307263,0.265822785,0.774647887,0.445080092
Tyler Zeller,23,CLE,NBA,2012-13,77,55,2033,245,559,245,555,0,4,120,157,159,279,438,96,35,70,95,251,610,0.438282648,0.441441441,0.0,0.76433121,0.438282648
Tyreke Evans,20,SAC,NBA,2009-10,72,72,2677,533,1165,497,1024,36,141,348,465,66,314,380,414,109,26,216,204,1450,0.45751073,0.485351563,0.255319149,0.748387097,0.472961373
Tyrus Thomas,20,CHI,NBA,2006-07,72,4,966,134,282,134,280,0,2,106,175,89,180,269,40,46,76,94,162,374,0.475177305,0.478571429,0.0,0.605714286,0.475177305
Tyshawn Taylor,22,BRK,NBA,2012-13,38,0,221,32,87,26,74,6,13,15,27,2,16,18,21,13,0,25,25,85,0.367816092,0.351351351,0.461538462,0.555555556,0.402298851
Tyson Chandler,19,CHI,NBA,2001-02,71,31,1389,151,304,151,304,0,0,134,222,114,229,343,54,28,93,99,179,436,0.496710526,0.496710526,0.0,0.603603604,0.496710526
Tyus Jones,19,MIN,NBA,2015-16,37,0,573,56,156,40,103,16,53,28,39,7,40,47,108,31,3,33,33,156,0.358974359,0.388349515,0.301886792,0.717948718,0.41025641
Udonis Haslem,23,MIA,NBA,2003-04,75,24,1795,205,447,205,444,0,3,140,183,189,284,473,51,33,24,74,197,550,0.458612975,0.461711712,0.0,0.765027322,0.458612975
Uros Slokar,23,TOR,NBA,2006-07,20,0,72,14,26,13,24,1,2,9,13,7,7,14,1,1,2,9,11,38,0.538461538,0.541666667,0.5,0.692307692,0.557692308
Vander Blue,21,BOS,NBA,2013-14,3,0,15,2,4,2,3,0,1,1,5,0,3,3,1,0,0,2,1,5,0.5,0.666666667,0.0,0.2,0.5
Vassilis Spanoulis,24,HOU,NBA,2006-07,31,0,272,23,72,18,43,5,29,34,42,5,17,22,28,7,1,29,33,85,0.319444444,0.418604651,0.172413793,0.80952381,0.354166667
Vernon Macklin,25,DET,NBA,2011-12,23,0,135,19,35,19,35,0,0,8,14,14,20,34,5,4,4,3,9,46,0.542857143,0.542857143,0.0,0.571428571,0.542857143
Viacheslav Kravtsov,25,DET,NBA,2012-13,25,0,224,33,46,33,46,0,0,11,37,24,21,45,9,5,9,14,32,77,0.717391304,0.717391304,0.0,0.297297297,0.717391304
Victor Claver,24,POR,NBA,2012-13,49,16,812,74,189,49,102,25,87,14,30,31,88,119,43,26,12,43,75,187,0.391534392,0.480392157,0.287356322,0.466666667,0.457671958
Victor Oladipo,21,ORL,NBA,2013-14,80,44,2487,392,936,318,710,74,226,248,318,43,286,329,327,129,37,256,210,1106,0.418803419,0.447887324,0.327433628,0.779874214,0.458333333
Viktor Khryapa,22,POR,NBA,2004-05,32,5,523,54,124,50,113,4,11,23,42,28,80,108,25,20,18,33,80,135,0.435483871,0.442477876,0.363636364,0.547619048,0.451612903
Vincent Yarbrough,21,DEN,NBA,2002-03,59,39,1381,168,428,147,350,21,78,49,62,36,126,162,130,57,33,81,145,406,0.392523364,0.42,0.269230769,0.790322581,0.417056075
Vitor Faverani,25,BOS,NBA,2013-14,37,8,488,64,147,52,107,12,40,24,37,42,86,128,16,14,27,41,74,164,0.43537415,0.485981308,0.3,0.648648649,0.476190476
Vladimir Radmanovic,21,SEA,NBA,2001-02,61,16,1230,146,354,80,197,66,157,49,72,45,185,230,81,56,24,72,119,407,0.412429379,0.406091371,0.420382166,0.680555556,0.505649718
Von Wafer,20,LAL,NBA,2005-06,16,0,73,6,38,4,21,2,17,6,8,5,3,8,4,3,0,1,12,20,0.157894737,0.19047619,0.117647059,0.75,0.184210526
Wade Baldwin,20,MEM,NBA,2016-17,33,1,405,36,115,33,93,3,22,31,37,11,35,46,61,18,7,40,40,106,0.313043478,0.35483871,0.136363636,0.837837838,0.326086957
Walker Russell,29,DET,NBA,2011-12,28,0,357,33,95,29,82,4,13,14,22,7,19,26,58,18,1,33,29,84,0.347368421,0.353658537,0.307692308,0.636363636,0.368421053
Walter Herrmann,27,CHA,NBA,2006-07,48,12,936,174,330,121,215,53,115,41,53,28,111,139,26,17,7,32,76,442,0.527272727,0.562790698,0.460869565,0.773584906,0.607575758
Walter Sharpe,22,DET,NBA,2008-09,8,0,20,4,11,4,9,0,2,0,2,0,3,3,0,0,2,0,3,8,0.363636364,0.444444444,0.0,0.0,0.363636364
Wang Zhizhi,23,DAL,NBA,2000-01,5,0,38,8,19,8,17,0,2,8,10,1,6,7,0,0,0,1,8,24,0.421052632,0.470588235,0.0,0.8,0.421052632
Wayne Ellington,22,MIN,NBA,2009-10,76,1,1384,190,448,126,286,64,162,61,70,33,126,159,74,20,5,74,72,505,0.424107143,0.440559441,0.395061728,0.871428571,0.495535714
Wayne Selden,22,TOT,NBA,2016-17,14,5,236,25,58,18,30,7,28,14,22,1,15,16,13,6,1,12,18,71,0.431034483,0.6,0.25,0.636363636,0.49137931
Wayne Simien,22,MIA,NBA,2005-06,43,2,414,58,120,58,120,0,0,30,34,38,50,88,7,13,1,24,70,146,0.483333333,0.483333333,0.0,0.882352941,0.483333333
Wesley Johnson,23,MIN,NBA,2010-11,79,63,2069,271,682,168,393,103,289,64,92,51,189,240,148,58,54,95,163,709,0.397360704,0.427480916,0.356401384,0.695652174,0.4728739
Wesley Matthews,23,UTA,NBA,2009-10,82,48,2025,273,565,210,400,63,165,160,193,50,141,191,124,64,15,93,152,769,0.483185841,0.525,0.381818182,0.829015544,0.538938053
Will Barton,22,POR,NBA,2012-13,73,5,894,118,309,109,244,9,65,50,65,36,109,145,58,34,9,60,56,295,0.381877023,0.446721311,0.138461538,0.769230769,0.396440129
Will Blalock,23,DET,NBA,2006-07,14,0,166,9,30,8,25,1,5,6,6,6,9,15,17,5,0,12,9,25,0.3,0.32,0.2,1.0,0.316666667
Will Bynum,23,GSW,NBA,2005-06,15,0,162,21,52,19,43,2,9,10,16,3,9,12,19,7,0,14,10,54,0.403846154,0.441860465,0.222222222,0.625,0.423076923
Will Cherry,23,CLE,NBA,2014-15,8,0,69,5,19,3,10,2,9,3,6,1,4,5,8,6,1,4,10,15,0.263157895,0.3,0.222222222,0.5,0.315789474
Will Conroy,24,TOT,NBA,2006-07,7,0,52,0,3,0,3,0,0,0,4,3,4,7,9,0,0,2,7,0,0.0,0.0,0.0,0.0,0.0
Will Solomon,23,MEM,NBA,2001-02,62,4,872,113,331,67,169,46,162,49,73,12,56,68,92,35,7,62,76,321,0.341389728,0.396449704,0.283950617,0.671232877,0.410876133
Willie Cauley-Stein,22,SAC,NBA,2015-16,66,39,1412,191,339,191,337,0,2,81,125,134,218,352,37,48,66,46,146,463,0.563421829,0.566765579,0.0,0.648,0.563421829
Willie Green,22,PHI,NBA,2003-04,53,0,767,143,357,124,296,19,61,59,81,16,49,65,53,26,5,59,83,364,0.400560224,0.418918919,0.31147541,0.728395062,0.427170868
Willie Reed,25,BRK,NBA,2015-16,39,2,426,76,133,76,133,0,0,30,55,49,73,122,10,6,30,16,47,182,0.571428571,0.571428571,0.0,0.545454545,0.571428571
Willie Warren,21,LAC,NBA,2010-11,19,0,134,13,35,8,20,5,15,6,8,1,11,12,27,6,0,8,16,37,0.371428571,0.4,0.333333333,0.75,0.442857143
Willy Hernangomez,22,NYK,NBA,2016-17,72,22,1324,246,465,242,450,4,15,91,125,170,332,502,96,41,36,100,150,587,0.529032258,0.537777778,0.266666667,0.728,0.533333333
Wilson Chandler,20,NYK,NBA,2007-08,35,16,685,106,242,97,212,9,30,34,54,38,89,127,33,15,16,27,83,255,0.438016529,0.45754717,0.3,0.62962963,0.45661157
Xavier Henry,19,MEM,NBA,2010-11,38,16,527,65,160,63,143,2,17,33,52,9,28,37,18,11,3,13,48,165,0.40625,0.440559441,0.117647059,0.634615385,0.4125
Xavier Munford,23,MEM,NBA,2015-16,14,0,244,32,77,23,54,9,23,7,14,3,28,31,22,13,3,15,25,80,0.415584416,0.425925926,0.391304348,0.5,0.474025974
Xavier Silas,24,PHI,NBA,2011-12,2,0,39,4,15,3,9,1,6,2,3,2,2,4,3,0,0,3,5,11,0.266666667,0.333333333,0.166666667,0.666666667,0.3
Yakhouba Diawara,24,DEN,NBA,2006-07,64,19,1177,100,292,51,122,49,170,35,53,27,83,110,55,30,7,37,132,284,0.342465753,0.418032787,0.288235294,0.660377358,0.426369863
Yao Ming,22,HOU,NBA,2002-03,82,72,2382,401,805,400,803,1,2,301,371,196,479,675,137,31,147,173,230,1104,0.498136646,0.498132005,0.5,0.811320755,0.498757764
Yaroslav Korolev,18,LAC,NBA,2005-06,24,0,127,9,30,7,23,2,7,7,10,5,8,13,9,3,0,6,11,27,0.3,0.304347826,0.285714286,0.7,0.333333333
Yi Jianlian,20,MIL,NBA,2007-08,66,49,1647,219,520,213,499,6,21,122,145,106,238,344,55,36,56,90,153,566,0.421153846,0.426853707,0.285714286,0.84137931,0.426923077
Yogi Ferrell,23,TOT,NBA,2016-17,46,29,1197,160,394,92,218,68,176,74,89,20,91,111,172,42,9,70,90,462,0.406091371,0.422018349,0.386363636,0.831460674,0.492385787
Yuta Tabuse,24,PHO,NBA,2004-05,4,0,17,1,6,0,5,1,1,4,4,2,2,4,3,0,0,1,1,7,0.166666667,0.0,1.0,1.0,0.25
Zabian Dowdell,26,PHO,NBA,2010-11,24,0,292,51,125,48,115,3,10,16,17,5,15,20,51,20,2,29,30,121,0.408,0.417391304,0.3,0.941176471,0.42
Zach LaVine,19,MIN,NBA,2014-15,77,40,1902,286,677,229,510,57,167,149,177,27,187,214,276,54,10,193,158,778,0.422451994,0.449019608,0.341317365,0.84180791,0.464549483
Zach Randolph,20,POR,NBA,2001-02,41,0,238,48,107,48,107,0,0,18,27,31,38,69,13,7,4,15,29,114,0.448598131,0.448598131,0.0,0.666666667,0.448598131
Zarko Cabarkapa,22,PHO,NBA,2003-04,49,4,570,81,197,75,165,6,32,35,53,26,73,99,40,10,13,54,75,203,0.411167513,0.454545455,0.1875,0.660377358,0.426395939
Zaza Pachulia,19,ORL,NBA,2003-04,59,2,664,68,175,68,175,0,0,58,90,69,105,174,13,21,12,34,87,194,0.388571429,0.388571429,0.0,0.644444444,0.388571429
Zeljko Rebraca,29,DET,NBA,2001-02,74,4,1179,189,374,189,374,0,0,135,175,84,206,290,38,28,73,84,192,513,0.505347594,0.505347594,0.0,0.771428571,0.505347594
Zendon Hamilton,25,LAC,NBA,2000-01,3,0,19,2,9,2,9,0,0,5,8,3,5,8,0,0,0,2,4,9,0.222222222,0.222222222,0.0,0.625,0.222222222
Zoran Dragic,25,TOT,NBA,2014-15,16,1,75,11,30,8,16,3,14,3,5,5,3,8,5,2,0,5,6,28,0.366666667,0.5,0.214285714,0.6,0.416666667
Zoran Planinic,21,NJN,NBA,2003-04,49,1,473,53,129,44,97,9,32,38,60,14,41,55,68,13,3,36,70,153,0.410852713,0.453608247,0.28125,0.633333333,0.445736434
